id_game,id_player,slug_team,slug_opponent,name_player,poss_calc,mp_calc,mp_nbastatr,mp_diff,pts_o_calc,pts_d_calc,pm_calc,pm_nbastatr,pm_diff
21700001,201143,BOS,CLE,Al Horford,156,32.0166666666667,32,0.0166666666666657,74,69,5,8,-3
21700001,202330,BOS,CLE,Gordon Hayward,25,5.25,5,0.25,12,9,3,3,0
21700001,202681,BOS,CLE,Kyrie Irving,191,39.35,39,0.350000000000001,84,85,-1,-2,1
21700001,203382,BOS,CLE,Aron Baynes,88,19.1833333333333,19,0.183333333333334,26,39,-13,-14,1
21700001,203499,BOS,CLE,Shane Larkin,23,4.81666666666667,5,-0.183333333333334,11,9,2,2,0
21700001,203935,BOS,CLE,Marcus Smart,167,35,35,0,71,81,-10,-8,-2
21700001,1626179,BOS,CLE,Terry Rozier,92,19.35,20,-0.649999999999999,40,35,5,5,0
21700001,1627759,BOS,CLE,Jaylen Brown,191,39.8,40,-0.200000000000003,85,89,-4,-5,1
21700001,1628369,BOS,CLE,Jayson Tatum,182,36.7833333333333,37,-0.216666666666669,81,73,8,5,3
21700001,1628400,BOS,CLE,Semi Ojeleye,40,8.45,9,-0.550000000000001,11,21,-10,-9,-1
21700001,2544,CLE,BOS,LeBron James,198,41.45,41,0.450000000000003,90,87,3,3,0
21700001,2548,CLE,BOS,Dwyane Wade,135,28.8,28,0.799999999999997,61,60,1,-1,2
21700001,2594,CLE,BOS,Kyle Korver,34,7.06666666666667,7,0.0666666666666664,12,14,-2,-1,-1
21700001,2747,CLE,BOS,JR Smith,104,21.8666666666667,22,-0.133333333333333,49,42,7,7,0
21700001,201145,CLE,BOS,Jeff Green,65,13.95,14,-0.0500000000000007,27,27,0,-3,3
21700001,201565,CLE,BOS,Derrick Rose,158,31.4333333333333,31,0.433333333333337,64,72,-8,-7,-1
21700001,201567,CLE,BOS,Kevin Love,137,28.3333333333333,28,0.333333333333332,61,62,-1,1,-2
21700001,202684,CLE,BOS,Tristan Thompson,94,19.6666666666667,20,-0.333333333333332,41,37,4,2,2
21700001,202697,CLE,BOS,Iman Shumpert,58,12.4166666666667,13,-0.583333333333334,28,22,6,6,0
21700001,203109,CLE,BOS,Jae Crowder,172,35.0166666666667,35,0.0166666666666657,77,72,5,8,-3
21700002,2561,GSW,HOU,David West,42,9.2,9,0.199999999999999,21,21,0,0,0
21700002,2585,GSW,HOU,Zaza Pachulia,51,10.1,10,0.100000000000001,35,26,9,8,1
21700002,2733,GSW,HOU,Shaun Livingston,84,18.6833333333333,19,-0.316666666666666,43,48,-5,-8,3
21700002,201142,GSW,HOU,Kevin Durant,182,37.75,38,-0.25,100,88,12,11,1
21700002,201156,GSW,HOU,Nick Young,126,25.9833333333333,26,-0.0166666666666657,59,70,-11,-10,-1
21700002,201939,GSW,HOU,Stephen Curry,136,29.3666666666667,30,-0.633333333333333,79,70,9,9,0
21700002,201956,GSW,HOU,Omri Casspi,21,4.46666666666667,4,0.466666666666667,12,16,-4,-4,0
21700002,202691,GSW,HOU,Klay Thompson,190,37.9333333333333,38,-0.0666666666666629,98,100,-2,0,-2
21700002,203110,GSW,HOU,Draymond Green,144,27.85,28,-0.149999999999999,77,70,7,7,0
21700002,1626172,GSW,HOU,Kevon Looney,34,7.8,8,-0.199999999999999,16,23,-7,-7,0
21700002,1627775,GSW,HOU,Patrick McCaw,98,18.75,19,-0.25,40,50,-10,-9,-1
21700002,1628395,GSW,HOU,Jordan Bell,62,11.7,12,-0.300000000000001,25,28,-3,-2,-1
21700002,2772,HOU,GSW,Trevor Ariza,184,37.75,38,-0.25,92,97,-5,-8,3
21700002,101108,HOU,GSW,Chris Paul,160,32.9666666666667,33,-0.0333333333333314,81,93,-12,-13,1
21700002,200782,HOU,GSW,PJ Tucker,144,28.6333333333333,29,-0.366666666666667,81,61,20,20,0
21700002,201569,HOU,GSW,Eric Gordon,143,29.3666666666667,29,0.366666666666667,76,61,15,16,-1
21700002,201583,HOU,GSW,Ryan Anderson,162,32.9,33,-0.100000000000001,91,85,6,8,-2
21700002,201601,HOU,GSW,Luc Mbah a Moute,112,23.5,23,0.5,54,50,4,4,0
21700002,201935,HOU,GSW,James Harden,177,36.3333333333333,36,0.333333333333329,97,96,1,1,0
21700002,203991,HOU,GSW,Clint Capela,88,18.1333333333333,18,0.133333333333333,38,62,-24,-23,-1
21700003,202340,DET,CHA,Avery Bradley,107,22.9333333333333,23,-0.0666666666666664,60,48,12,10,2
21700003,202397,DET,CHA,Ish Smith,98,20.9166666666667,21,-0.0833333333333357,37,37,0,2,-2
21700003,202699,DET,CHA,Tobias Harris,152,33.8666666666667,34,-0.133333333333333,77,68,9,10,-1
21700003,202704,DET,CHA,Reggie Jackson,121,26.7333333333333,27,-0.266666666666666,64,53,11,10,1
21700003,202720,DET,CHA,Jon Leuer,90,19.2666666666667,19,0.266666666666666,38,34,4,6,-2
21700003,203083,DET,CHA,Andre Drummond,101,21.8666666666667,22,-0.133333333333333,52,44,8,8,0
21700003,203961,DET,CHA,Eric Moreland,52,11.9333333333333,12,-0.0666666666666664,27,26,1,2,-1
21700003,204038,DET,CHA,Langston Galloway,112,24.7166666666667,25,-0.283333333333331,41,42,-1,2,-3
21700003,1626169,DET,CHA,Stanley Johnson,185,39.7666666666667,40,-0.233333333333334,81,74,7,6,1
21700003,1627740,DET,CHA,Henry Ellenson,77,16.25,16,0.25,28,24,4,4,0
21700003,2730,CHA,DET,Dwight Howard,141,31.1666666666667,31,0.166666666666664,67,70,-3,-3,0
21700003,101107,CHA,DET,Marvin Williams,118,26.2833333333333,27,-0.716666666666669,56,65,-9,-10,1
21700003,202689,CHA,DET,Kemba Walker,159,35.3833333333333,35,0.383333333333333,69,79,-10,-11,1
21700003,202933,CHA,DET,Julyan Stone,60,12.2666666666667,13,-0.733333333333334,21,22,-1,-1,0
21700003,203087,CHA,DET,Jeremy Lamb,124,27.9,28,-0.100000000000001,58,66,-8,-10,2
21700003,203469,CHA,DET,Cody Zeller,111,23.3666666666667,23,0.366666666666667,36,41,-5,-4,-1
21700003,1626163,CHA,DET,Frank Kaminsky,108,23.3333333333333,23,0.333333333333336,42,48,-6,-6,0
21700003,1626203,CHA,DET,Treveon Graham,79,16.9666666666667,17,-0.0333333333333314,34,26,8,8,0
21700003,1628370,CHA,DET,Malik Monk,102,21.2833333333333,21,0.283333333333331,32,40,-8,-8,0
21700003,1628407,CHA,DET,Dwayne Bacon,93,20.3,20,0.300000000000001,35,48,-13,-15,2
21700004,201960,BKN,IND,DeMarre Carroll,156,27.2833333333333,28,-0.716666666666669,69,79,-10,-10,0
21700004,202344,BKN,IND,Trevor Booker,164,27.9333333333333,28,-0.0666666666666664,81,80,1,1,0
21700004,202389,BKN,IND,Timofey Mozgov,74,14.2,14,0.199999999999999,34,45,-11,-11,0
21700004,202391,BKN,IND,Jeremy Lin,142,25.2,25,0.199999999999999,67,75,-8,-6,-2
21700004,203112,BKN,IND,Quincy Acy,86,15.8666666666667,16,-0.133333333333333,45,45,0,0,0
21700004,203459,BKN,IND,Allen Crabbe,152,26.7833333333333,27,-0.216666666666669,77,71,6,4,2
21700004,203915,BKN,IND,Spencer Dinwiddie,88,16.4666666666667,17,-0.533333333333335,45,49,-4,-6,2
21700004,1626156,BKN,IND,D'Angelo Russell,168,30.1,30,0.100000000000001,82,89,-7,-5,-2
21700004,1626178,BKN,IND,Rondae Hollis-Jefferson,149,27.5666666666667,28,-0.433333333333337,74,84,-10,-10,0
21700004,1627747,BKN,IND,Caris LeVert,156,27.6833333333333,28,-0.31666666666667,81,83,-2,-2,0
21700004,2863,IND,BKN,Damien Wilkins,59,10.8666666666667,11,-0.133333333333333,23,25,-2,0,-2
21700004,201152,IND,BKN,Thaddeus Young,189,33.5,33,0.5,99,85,14,13,1
21700004,201954,IND,BKN,Darren Collison,166,29.9,30,-0.100000000000001,93,84,9,8,1
21700004,202362,IND,BKN,Lance Stephenson,135,24.5333333333333,24,0.533333333333331,72,75,-3,-2,-1
21700004,202709,IND,BKN,Cory Joseph,144,24.7833333333333,25,-0.216666666666669,79,73,6,7,-1
21700004,202711,IND,BKN,Bojan Bogdanovic,161,29.2333333333333,29,0.233333333333334,83,77,6,3,3
21700004,203506,IND,BKN,Victor Oladipo,136,24.1333333333333,25,-0.866666666666667,70,59,11,11,0
21700004,1626167,IND,BKN,Myles Turner,193,33.95,34,-0.0499999999999972,105,95,10,12,-2
21700004,1627734,IND,BKN,Domantas Sabonis,103,19.0333333333333,19,0.0333333333333314,53,56,-3,-4,1
21700004,1628388,IND,BKN,TJ Leaf,49,9.15,10,-0.850000000000001,23,26,-3,-3,0
21700005,201609,MIA,ORL,Goran Dragic,159,30.2833333333333,31,-0.716666666666669,67,76,-9,-9,0
21700005,201949,MIA,ORL,James Johnson,98,18.5166666666667,19,-0.483333333333334,51,41,10,6,4
21700005,201961,MIA,ORL,Wayne Ellington,48,10.3333333333333,10,0.333333333333332,15,22,-7,-5,-2
21700005,202355,MIA,ORL,Hassan Whiteside,181,35.8,36,-0.200000000000003,83,86,-3,-5,2
21700005,203079,MIA,ORL,Dion Waiters,198,38.1,38,0.100000000000001,86,94,-8,-6,-2
21700005,203482,MIA,ORL,Kelly Olynyk,105,21.15,21,0.149999999999999,45,57,-12,-10,-2
21700005,204020,MIA,ORL,Tyler Johnson,111,21.3,21,0.300000000000001,54,49,5,1,4
21700005,1626159,MIA,ORL,Justise Winslow,119,23.75,23,0.75,45,60,-15,-13,-2
21700005,1626196,MIA,ORL,Josh Richardson,174,34.5,35,-0.5,86,83,3,3,0
21700005,1628389,MIA,ORL,Bam Adebayo,27,5.85,6,-0.15,13,12,1,3,-2
21700005,201571,ORL,MIA,D.J. Augustin,82,16.9166666666667,16,0.916666666666664,36,36,0,-2,2
21700005,202687,ORL,MIA,Bismack Biyombo,81,16.5333333333333,16,0.533333333333331,34,36,-2,-2,0
21700005,202696,ORL,MIA,Nikola Vucevic,160,31.15,32,-0.850000000000001,82,71,11,11,0
21700005,203082,ORL,MIA,Terrence Ross,159,31.6,31,0.600000000000001,79,61,18,18,0
21700005,203095,ORL,MIA,Evan Fournier,177,34.15,34,0.149999999999999,84,82,2,2,0
21700005,203613,ORL,MIA,Jonathon Simmons,136,26.9,28,-1.1,56,66,-10,-10,0
21700005,203901,ORL,MIA,Elfrid Payton,162,31,32,-1,80,73,7,9,-2
21700005,203932,ORL,MIA,Aaron Gordon,178,33.75,34,-0.25,90,82,8,10,-2
21700005,1628371,ORL,MIA,Jonathan Isaac,85,17.5833333333333,17,0.583333333333336,39,38,1,-1,2
21700006,101161,PHI,WAS,Amir Johnson,79,15.5,15,0.5,33,39,-6,-7,1
21700006,200755,PHI,WAS,JJ Redick,163,32,32,0,82,66,16,17,-1
21700006,201573,PHI,WAS,Jerryd Bayless,138,27.6333333333333,28,-0.366666666666667,78,61,17,11,6
21700006,203496,PHI,WAS,Robert Covington,151,28.85,29,-0.149999999999999,78,65,13,10,3
21700006,203954,PHI,WAS,Joel Embiid,138,26.8166666666667,27,-0.183333333333334,64,64,0,1,-1
21700006,203967,PHI,WAS,Dario Saric,116,22.7166666666667,23,-0.283333333333331,51,61,-10,-9,-1
21700006,204456,PHI,WAS,T.J. McConnell,78,14.9833333333333,15,-0.0166666666666657,32,45,-13,-14,1
21700006,1627732,PHI,WAS,Ben Simmons,177,34.4166666666667,35,-0.583333333333336,85,82,3,3,0
21700006,1627789,PHI,WAS,Timothe Luwawu-Cabarrot,101,19.0666666666667,18,1.06666666666667,40,59,-19,-19,0
21700006,1628365,PHI,WAS,Markelle Fultz,94,17.9333333333333,18,-0.0666666666666664,32,53,-21,-18,-3
21700006,101133,WAS,PHI,Ian Mahinmi,70,13.3666666666667,14,-0.633333333333333,29,40,-11,-11,0
21700006,101162,WAS,PHI,Marcin Gortat,177,34.6166666666667,34,0.616666666666667,90,75,15,16,-1
21700006,201160,WAS,PHI,Jason Smith,33,6.88333333333333,7,-0.116666666666667,18,14,4,4,0
21700006,201975,WAS,PHI,Jodie Meeks,95,19.1333333333333,19,0.133333333333333,47,49,-2,-4,2
21700006,202322,WAS,PHI,John Wall,192,37.1166666666667,37,0.11666666666666,96,78,18,19,-1
21700006,203078,WAS,PHI,Bradley Beal,186,35.7833333333333,36,-0.216666666666669,90,79,11,12,-1
21700006,203118,WAS,PHI,Mike Scott,75,15.2166666666667,15,0.216666666666667,34,43,-9,-9,0
21700006,203490,WAS,PHI,Otto Porter Jr.,172,32.7666666666667,33,-0.233333333333334,85,72,13,14,-1
21700006,204025,WAS,PHI,Tim Frazier,63,12.65,13,-0.35,27,39,-12,-12,0
21700006,1626162,WAS,PHI,Kelly Oubre Jr.,172,32.3833333333333,32,0.383333333333333,79,86,-7,-4,-3
21700007,201143,BOS,MIL,Al Horford,167,33.7833333333333,33,0.783333333333331,76,73,3,1,2
21700007,202681,BOS,MIL,Kyrie Irving,181,38.05,39,-0.950000000000003,83,86,-3,-2,-1
21700007,203382,BOS,MIL,Aron Baynes,70,15.8333333333333,16,-0.166666666666666,29,38,-9,-7,-2
21700007,203935,BOS,MIL,Marcus Smart,164,32.9333333333333,32,0.933333333333337,66,69,-3,-4,1
21700007,1626179,BOS,MIL,Terry Rozier,128,26.7166666666667,27,-0.283333333333331,56,69,-13,-11,-2
21700007,1627759,BOS,MIL,Jaylen Brown,124,27.3666666666667,28,-0.633333333333333,61,59,2,0,2
21700007,1627846,BOS,MIL,Abdel Nader,50,11.6833333333333,11,0.683333333333334,24,29,-5,-4,-1
21700007,1628369,BOS,MIL,Jayson Tatum,173,36.5666666666667,37,-0.433333333333337,70,84,-14,-15,1
21700007,1628400,BOS,MIL,Semi Ojeleye,48,11.5833333333333,12,-0.416666666666668,20,18,2,0,2
21700007,1628464,BOS,MIL,Daniel Theis,25,4.48333333333333,5,-0.516666666666668,15,15,0,2,-2
21700007,202328,MIL,BOS,Greg Monroe,68,16.7166666666667,17,-0.283333333333331,41,31,10,10,0
21700007,203089,MIL,BOS,John Henson,86,17.0833333333333,17,0.0833333333333357,42,35,7,7,0
21700007,203114,MIL,BOS,Khris Middleton,200,43.2666666666667,43,0.266666666666666,97,86,11,10,1
21700007,203141,MIL,BOS,Mirza Teletovic,51,11.1,11,0.100000000000001,22,22,0,0,0
21700007,203503,MIL,BOS,Tony Snell,137,29.3666666666667,29,0.366666666666667,62,66,-4,-4,0
21700007,203507,MIL,BOS,Giannis Antetokounmpo,181,36.7166666666667,37,-0.283333333333331,87,80,7,7,0
21700007,203521,MIL,BOS,Matthew Dellavedova,124,26.2833333333333,26,0.283333333333331,64,56,8,8,0
21700007,1626173,MIL,BOS,Rashad Vaughn,19,3.41666666666667,3,0.416666666666667,9,9,0,0,0
21700007,1627748,MIL,BOS,Thon Maker,69,13.8333333333333,14,-0.166666666666668,23,31,-8,-8,0
21700007,1627763,MIL,BOS,Malcolm Brogdon,195,41.2166666666667,41,0.216666666666669,93,84,9,10,-1
21700008,2754,NOP,MEM,Tony Allen,54,10.8666666666667,11,-0.133333333333333,19,25,-6,-4,-2
21700008,201950,NOP,MEM,Jrue Holiday,187,38.6333333333333,39,-0.366666666666667,75,78,-3,-2,-1
21700008,201967,NOP,MEM,Dante Cunningham,131,25.7,26,-0.300000000000001,50,56,-6,-8,2
21700008,202326,NOP,MEM,DeMarcus Cousins,184,38.35,38,0.349999999999994,83,78,5,6,-1
21700008,202348,NOP,MEM,Jordan Crawford,63,12.3166666666667,13,-0.683333333333334,23,33,-10,-10,0
21700008,202734,NOP,MEM,E'Twaun Moore,158,34.4333333333333,34,0.43333333333333,62,64,-2,0,-2
21700008,203076,NOP,MEM,Anthony Davis,194,39.9,40,-0.100000000000001,71,87,-16,-15,-1
21700008,203121,NOP,MEM,Darius Miller,85,16.7333333333333,17,-0.266666666666666,26,38,-12,-12,0
21700008,203546,NOP,MEM,Ian Clark,107,21.0333333333333,21,0.0333333333333314,41,54,-13,-13,0
21700008,1627767,NOP,MEM,Cheick Diallo,2,0.533333333333333,1,-0.466666666666667,0,2,-2,-2,0
21700008,201144,MEM,NOP,Mike Conley,152,32.1,33,-0.899999999999999,71,63,8,8,0
21700008,201148,MEM,NOP,Brandan Wright,137,26.7333333333333,27,-0.266666666666666,59,61,-2,5,-7
21700008,201188,MEM,NOP,Marc Gasol,141,29.35,29,0.350000000000001,63,47,16,8,8
21700008,201596,MEM,NOP,Mario Chalmers,126,25.1666666666667,26,-0.833333333333336,54,42,12,11,1
21700008,201936,MEM,NOP,Tyreke Evans,100,19.9666666666667,20,-0.0333333333333314,43,33,10,8,2
21700008,202718,MEM,NOP,Chandler Parsons,72,15.2166666666667,15,0.216666666666665,35,29,6,6,0
21700008,203210,MEM,NOP,JaMychal Green,18,3.75,4,-0.25,9,9,0,0,0
21700008,203516,MEM,NOP,James Ennis III,94,18.65,19,-0.350000000000001,38,43,-5,-5,0
21700008,1626150,MEM,NOP,Andrew Harrison,94,19.3333333333333,19,0.333333333333336,40,42,-2,-2,0
21700008,1626185,MEM,NOP,Jarell Martin,92,19.1833333333333,19,0.183333333333334,38,34,4,4,0
21700008,1628415,MEM,NOP,Dillon Brooks,139,29.05,29,0.0500000000000007,65,47,18,17,1
21700009,101141,ATL,DAL,Ersan Ilyasova,108,23.3,24,-0.700000000000003,51,59,-8,-10,2
21700009,201158,ATL,DAL,Marco Belinelli,123,25.7666666666667,26,-0.233333333333334,69,56,13,14,-1
21700009,202337,ATL,DAL,Luke Babbitt,44,9.16666666666667,9,0.166666666666668,30,13,17,17,0
21700009,203145,ATL,DAL,Kent Bazemore,128,26.5,27,-0.5,57,63,-6,-5,-1
21700009,203471,ATL,DAL,Dennis Schroder,162,34.0333333333333,34,0.0333333333333314,80,81,-1,-3,2
21700009,203473,ATL,DAL,Dewayne Dedmon,120,25.1166666666667,26,-0.883333333333333,59,58,1,-2,3
21700009,203488,ATL,DAL,Mike Muscala,69,13.7666666666667,14,-0.233333333333334,30,37,-7,-5,-2
21700009,203705,ATL,DAL,Josh Magette,22,4.3,4,0.3,14,7,7,9,-2
21700009,1627098,ATL,DAL,Malcolm Delaney,59,11.3166666666667,11,0.316666666666666,28,29,-1,-1,0
21700009,1627752,ATL,DAL,Taurean Prince,122,25.7166666666667,26,-0.283333333333331,55,59,-4,-5,1
21700009,1627761,ATL,DAL,DeAndre' Bembry,91,18,18,0,54,40,14,13,1
21700009,1628381,ATL,DAL,John Collins,112,22.85,22,0.850000000000001,58,53,5,8,-3
21700009,1717,DAL,ATL,Dirk Nowitzki,122,24.6,24,0.600000000000001,47,64,-17,-18,1
21700009,2734,DAL,ATL,Devin Harris,78,16.0833333333333,16,0.0833333333333322,38,37,1,3,-2
21700009,200826,DAL,ATL,J.J. Barea,88,18.05,18,0.0500000000000007,41,51,-10,-9,-1
21700009,202083,DAL,ATL,Wesley Matthews,178,37.4,37,0.399999999999999,91,91,0,-1,1
21700009,203084,DAL,ATL,Harrison Barnes,182,38.35,38,0.349999999999994,91,91,0,1,-1
21700009,203457,DAL,ATL,Nerlens Noel,96,19.8166666666667,20,-0.183333333333334,51,44,7,9,-2
21700009,203939,DAL,ATL,Dwight Powell,66,13.25,14,-0.75,33,39,-6,-4,-2
21700009,1627812,DAL,ATL,Yogi Ferrell,152,31.8,32,-0.199999999999999,73,76,-3,-9,6
21700009,1627827,DAL,ATL,Dorian Finney-Smith,54,10.5666666666667,11,-0.433333333333334,20,26,-6,-5,-1
21700009,1628372,DAL,ATL,Dennis Smith Jr.,144,29.9166666666667,30,-0.0833333333333357,70,66,4,3,1
21700010,200794,DEN,UTA,Paul Millsap,151,33.6833333333333,34,-0.316666666666663,64,70,-6,-6,0
21700010,201163,DEN,UTA,Wilson Chandler,157,34.4166666666667,34,0.416666666666671,66,86,-20,-23,3
21700010,202702,DEN,UTA,Kenneth Faried,25,6.11666666666667,6,0.116666666666666,14,12,2,2,0
21700010,203115,DEN,UTA,Will Barton,141,31.2333333333333,31,0.233333333333334,57,66,-9,-10,1
21700010,203486,DEN,UTA,Mason Plumlee,74,16.0666666666667,16,0.0666666666666664,26,41,-15,-14,-1
21700010,203914,DEN,UTA,Gary Harris,164,35.85,36,-0.150000000000006,71,73,-2,0,-2
21700010,203999,DEN,UTA,Nikola Jokic,156,35.2333333333333,36,-0.766666666666666,74,82,-8,-9,1
21700010,1626144,DEN,UTA,Emmanuel Mudiay,77,18.4,19,-0.600000000000001,34,44,-10,-12,2
21700010,1626168,DEN,UTA,Trey Lyles,5,1.21666666666667,2,-0.783333333333333,6,0,6,6,0
21700010,1627736,DEN,UTA,Malik Beasley,5,1.21666666666667,2,-0.783333333333333,6,0,6,6,0
21700010,1627750,DEN,UTA,Jamal Murray,89,19.6666666666667,20,-0.333333333333336,49,44,5,9,-4
21700010,1627823,DEN,UTA,Juancho Hernangomez,21,5.4,6,-0.6,13,12,1,1,0
21700010,2207,UTA,DEN,Joe Johnson,90,19.5166666666667,20,-0.483333333333334,49,43,6,6,0
21700010,200757,UTA,DEN,Thabo Sefolosha,89,20.2166666666667,21,-0.783333333333331,49,24,25,25,0
21700010,201937,UTA,DEN,Ricky Rubio,144,31.5,32,-0.5,62,72,-10,-14,4
21700010,202324,UTA,DEN,Derrick Favors,123,28.1833333333333,28,0.183333333333334,57,53,4,4,0
21700010,202327,UTA,DEN,Ekpe Udoh,55,12.6166666666667,13,-0.383333333333333,40,18,22,24,-2
21700010,202692,UTA,DEN,Alec Burks,66,14.9666666666667,15,-0.0333333333333332,38,24,14,16,-2
21700010,203497,UTA,DEN,Rudy Gobert,158,35.0833333333333,35,0.0833333333333357,66,78,-12,-14,2
21700010,203918,UTA,DEN,Rodney Hood,79,17.5166666666667,18,-0.483333333333334,39,53,-14,-13,-1
21700010,204060,UTA,DEN,Joe Ingles,147,32.7333333333333,33,-0.266666666666666,68,72,-4,-6,2
21700010,1628378,UTA,DEN,Donovan Mitchell,114,26.1666666666667,26,0.166666666666664,62,43,19,22,-3
21700011,2037,MIN,SAS,Jamal Crawford,114,23.8666666666667,24,-0.133333333333333,50,44,6,5,1
21700011,201952,MIN,SAS,Jeff Teague,113,24.95,25,-0.0500000000000007,50,65,-15,-17,2
21700011,201959,MIN,SAS,Taj Gibson,122,26.8333333333333,27,-0.166666666666668,54,69,-15,-17,2
21700011,202357,MIN,SAS,Nemanja Bjelica,65,13.2,13,0.199999999999999,28,16,12,15,-3
21700011,202710,MIN,SAS,Jimmy Butler,157,35.3333333333333,35,0.333333333333329,71,89,-18,-19,1
21700011,203476,MIN,SAS,Gorgui Dieng,64,13.75,14,-0.25,23,30,-7,-8,1
21700011,203498,MIN,SAS,Shabazz Muhammad,70,14.3666666666667,14,0.366666666666667,31,21,10,11,-1
21700011,203952,MIN,SAS,Andrew Wiggins,138,30.1,30,0.100000000000001,63,82,-19,-19,0
21700011,1626145,MIN,SAS,Tyus Jones,109,22.95,23,-0.0500000000000007,49,42,7,9,-2
21700011,1626157,MIN,SAS,Karl-Anthony Towns,158,34.15,35,-0.849999999999994,76,77,-1,0,-1
21700011,1938,SAS,MIN,Manu Ginobili,100,20.9333333333333,21,-0.0666666666666664,47,44,3,6,-3
21700011,2200,SAS,MIN,Pau Gasol,132,28.1833333333333,29,-0.816666666666666,65,58,7,6,1
21700011,200746,SAS,MIN,LaMarcus Aldridge,174,38.7666666666667,39,-0.233333333333334,89,77,12,15,-3
21700011,200752,SAS,MIN,Rudy Gay,117,23.9,24,-0.100000000000001,47,46,1,3,-2
21700011,201980,SAS,MIN,Danny Green,146,32.5166666666667,33,-0.483333333333334,72,65,7,11,-4
21700011,201988,SAS,MIN,Patty Mills,110,22.85,22,0.850000000000001,47,44,3,6,-3
21700011,202722,SAS,MIN,Davis Bertans,22,4.18333333333333,4,0.183333333333334,6,10,-4,-6,2
21700011,203464,SAS,MIN,Brandon Paul,2,0.116666666666667,0,0.116666666666667,2,2,0,-2,2
21700011,203530,SAS,MIN,Joffrey Lauvergne,61,13.1333333333333,13,0.133333333333333,30,28,2,0,2
21700011,203937,SAS,MIN,Kyle Anderson,132,29.75,30,-0.25,68,64,4,1,3
21700011,1627749,SAS,MIN,Dejounte Murray,110,24.9333333333333,25,-0.0666666666666664,58,53,5,4,1
21700011,1627854,SAS,MIN,Bryn Forbes,2,0.116666666666667,0,0.116666666666667,2,2,0,-2,2
21700011,1628401,SAS,MIN,Derrick White,2,0.116666666666667,0,0.116666666666667,2,2,0,-2,2
21700012,2199,PHX,POR,Tyson Chandler,113,22.75,23,-0.25,26,59,-33,-33,0
21700012,202339,PHX,POR,Eric Bledsoe,150,29.3,29,0.300000000000001,47,88,-41,-41,0
21700012,203584,PHX,POR,Troy Daniels,110,21.3,21,0.299999999999997,34,66,-32,-32,0
21700012,203933,PHX,POR,T.J. Warren,136,28.0666666666667,28,0.0666666666666664,42,86,-44,-42,-2
21700012,1626164,PHX,POR,Devin Booker,134,27.1,27,0.100000000000001,35,64,-29,-29,0
21700012,1627733,PHX,POR,Dragan Bender,105,21,21,0,43,54,-11,-10,-1
21700012,1627737,PHX,POR,Marquese Chriss,59,11.8833333333333,12,-0.116666666666667,15,31,-16,-17,1
21700012,1627755,PHX,POR,Tyler Ulis,73,14.7833333333333,15,-0.216666666666667,24,40,-16,-16,0
21700012,1627884,PHX,POR,Derrick Jones Jr.,49,10.4833333333333,11,-0.516666666666668,21,20,1,1,0
21700012,1628367,PHX,POR,Josh Jackson,153,31.7,32,-0.299999999999997,51,72,-21,-23,2
21700012,1628409,PHX,POR,Alec Peters,49,10.4833333333333,11,-0.516666666666668,21,20,1,1,0
21700012,1628455,PHX,POR,Mike James,49,10.4833333333333,11,-0.516666666666668,21,20,1,1,0
21700012,202323,POR,PHX,Evan Turner,130,25.2833333333333,25,0.283333333333331,71,31,40,43,-3
21700012,202329,POR,PHX,Al-Farouq Aminu,139,27.5166666666667,28,-0.483333333333334,76,42,34,34,0
21700012,202334,POR,PHX,Ed Davis,70,14.1166666666667,14,0.116666666666667,47,23,24,26,-2
21700012,203081,POR,PHX,Damian Lillard,146,29.65,30,-0.350000000000001,78,44,34,34,0
21700012,203086,POR,PHX,Meyers Leonard,49,10.4833333333333,11,-0.516666666666668,20,21,-1,-1,0
21700012,203090,POR,PHX,Maurice Harkless,130,25.2666666666667,26,-0.733333333333334,64,38,26,22,4
21700012,203894,POR,PHX,Shabazz Napier,109,22.5833333333333,23,-0.416666666666664,55,38,17,17,0
21700012,203994,POR,PHX,Jusuf Nurkic,113,22.7,23,-0.300000000000001,54,32,22,20,2
21700012,1626192,POR,PHX,Pat Connaughton,158,32.3166666666667,32,0.316666666666663,89,57,32,34,-2
21700012,1627774,POR,PHX,Jake Layman,54,11.8666666666667,12,-0.133333333333333,26,21,5,5,0
21700012,1628403,POR,PHX,Caleb Swanigan,82,17.55,18,-0.450000000000003,40,33,7,6,1
21700013,2403,HOU,SAC,Nene,85,17.95,18,-0.0499999999999972,34,33,1,-1,2
21700013,2772,HOU,SAC,Trevor Ariza,151,32.4333333333333,32,0.43333333333333,72,78,-6,-6,0
21700013,200782,HOU,SAC,PJ Tucker,137,29.5166666666667,29,0.516666666666666,65,61,4,-1,5
21700013,201569,HOU,SAC,Eric Gordon,164,34.3833333333333,35,-0.616666666666667,76,66,10,14,-4
21700013,201583,HOU,SAC,Ryan Anderson,117,25.4666666666667,26,-0.533333333333335,56,56,0,7,-7
21700013,201601,HOU,SAC,Luc Mbah a Moute,114,24.15,24,0.149999999999999,53,48,5,-2,7
21700013,201935,HOU,SAC,James Harden,176,37.85,38,-0.149999999999999,86,83,3,1,2
21700013,203991,HOU,SAC,Clint Capela,124,28.1,28,0.100000000000001,64,58,6,9,-3
21700013,1627743,HOU,SAC,Demetrius Jackson,47,10.15,10,0.149999999999999,19,17,2,4,-2
21700013,1713,SAC,HOU,Vince Carter,66,14.3166666666667,14,0.316666666666666,23,31,-8,-6,-2
21700013,201585,SAC,HOU,Kosta Koufos,84,17.9166666666667,18,-0.0833333333333357,31,38,-7,-5,-2
21700013,201588,SAC,HOU,George Hill,154,32.6666666666667,33,-0.333333333333336,74,72,2,2,0
21700013,202066,SAC,HOU,Garrett Temple,141,30.0333333333333,30,0.0333333333333314,65,62,3,1,2
21700013,1626161,SAC,HOU,Willie Cauley-Stein,147,31.3666666666667,32,-0.633333333333333,73,74,-1,1,-2
21700013,1627741,SAC,HOU,Buddy Hield,153,32.9166666666667,33,-0.0833333333333286,75,72,3,3,0
21700013,1627746,SAC,HOU,Skal Labissiere,144,32.5166666666667,33,-0.483333333333334,68,64,4,4,0
21700013,1627781,SAC,HOU,Malachi Richardson,25,5.45,6,-0.55,9,10,-1,-3,2
21700013,1628368,SAC,HOU,De'Aaron Fox,110,23.7,24,-0.300000000000001,45,54,-9,-7,-2
21700013,1628382,SAC,HOU,Justin Jackson,91,19.1166666666667,19,0.116666666666667,37,48,-11,-15,4
21700014,201577,CHI,TOR,Robin Lopez,156,31.4166666666667,32,-0.583333333333336,71,67,4,3,1
21700014,202347,CHI,TOR,Quincy Pondexter,66,12.0166666666667,12,0.0166666666666657,29,39,-10,-5,-5
21700014,203200,CHI,TOR,Justin Holiday,171,34.8333333333333,35,-0.166666666666671,75,75,0,1,-1
21700014,1626170,CHI,TOR,Jerian Grant,130,26.55,27,-0.449999999999999,54,61,-7,-11,4
21700014,1626245,CHI,TOR,Cristiano Felicio,77,16.2166666666667,16,0.216666666666669,29,50,-21,-20,-1
21700014,1627756,CHI,TOR,Denzel Valentine,122,25.45,26,-0.549999999999997,51,68,-17,-19,2
21700014,1627770,CHI,TOR,Kay Felder,77,15.8166666666667,16,-0.183333333333334,37,36,1,3,-2
21700014,1627835,CHI,TOR,Paul Zipser,107,23.45,24,-0.550000000000001,42,51,-9,-15,6
21700014,1627853,CHI,TOR,Ryan Arcidiacono,26,5.26666666666667,5,0.266666666666668,9,20,-11,-9,-2
21700014,1628021,CHI,TOR,David Nwaba,62,12.8,13,-0.199999999999999,25,42,-17,-15,-2
21700014,1628374,CHI,TOR,Lauri Markkanen,165,33.1666666666667,33,0.166666666666671,72,72,0,-2,2
21700014,1628469,CHI,TOR,Antonio Blakeney,6,1.18333333333333,1,0.183333333333333,6,4,2,4,-2
21700014,101139,TOR,CHI,CJ Miles,92,19.8,20,-0.200000000000003,54,32,22,25,-3
21700014,200768,TOR,CHI,Kyle Lowry,155,31.25,31,0.25,71,72,-1,1,-2
21700014,201586,TOR,CHI,Serge Ibaka,121,24.2333333333333,24,0.233333333333334,50,54,-4,-4,0
21700014,201942,TOR,CHI,DeMar DeRozan,160,31.9666666666667,32,-0.0333333333333314,70,72,-2,-3,1
21700014,202685,TOR,CHI,Jonas Valanciunas,152,30.4333333333333,31,-0.566666666666666,73,73,0,-2,2
21700014,1626153,TOR,CHI,Delon Wright,110,23,23,0,67,46,21,21,0
21700014,1626181,TOR,CHI,Norman Powell,122,24.6,25,-0.399999999999999,50,49,1,1,0
21700014,1627751,TOR,CHI,Jakob Poeltl,81,17.2,18,-0.800000000000001,44,27,17,19,-2
21700014,1627783,TOR,CHI,Pascal Siakam,26,4.83333333333333,5,-0.166666666666666,15,19,-4,-7,3
21700014,1627832,TOR,CHI,Fred VanVleet,61,12.7,13,-0.300000000000001,37,23,14,12,2
21700014,1628035,TOR,CHI,Alfonzo McKinnie,6,1.18333333333333,1,0.183333333333333,4,6,-2,-4,2
21700014,1628384,TOR,CHI,OG Anunoby,79,16.9666666666667,17,-0.0333333333333314,50,27,23,26,-3
21700015,201196,NYK,OKC,Ramon Sessions,97,20.6,21,-0.399999999999999,28,50,-22,-23,1
21700015,201563,NYK,OKC,Michael Beasley,3,0.566666666666667,1,-0.433333333333333,4,0,4,3,1
21700015,201584,NYK,OKC,Courtney Lee,158,31.6333333333333,31,0.633333333333333,50,72,-22,-22,0
21700015,202498,NYK,OKC,Lance Thomas,81,15.25,15,0.25,20,39,-19,-23,4
21700015,202683,NYK,OKC,Enes Kanter,106,22.3,22,0.300000000000001,30,51,-21,-22,1
21700015,203124,NYK,OKC,Kyle O'Quinn,107,21.75,22,-0.25,48,50,-2,-1,-1
21700015,203501,NYK,OKC,Tim Hardaway Jr.,138,29.1,29,0.100000000000001,54,61,-7,-6,-1
21700015,203926,NYK,OKC,Doug McDermott,119,23.3666666666667,24,-0.633333333333333,50,48,2,4,-2
21700015,204001,NYK,OKC,Kristaps Porzingis,181,38.1333333333333,38,0.133333333333333,68,87,-19,-17,-2
21700015,1626195,NYK,OKC,Willy Hernangomez,23,3.46666666666667,4,-0.533333333333333,4,4,0,0,0
21700015,1627758,NYK,OKC,Ron Baker,114,22.25,23,-0.75,47,45,2,4,-2
21700015,1628373,NYK,OKC,Frank Ntilikina,45,7.46666666666667,8,-0.533333333333333,13,14,-1,-2,1
21700015,1628422,NYK,OKC,Damyean Dotson,18,2.61666666666667,3,-0.383333333333333,4,4,0,0,0
21700015,2546,OKC,NYK,Carmelo Anthony,158,33.2833333333333,34,-0.716666666666669,65,66,-1,1,-2
21700015,101109,OKC,NYK,Raymond Felton,78,15.4666666666667,16,-0.533333333333333,23,35,-12,-12,0
21700015,201566,OKC,NYK,Russell Westbrook,165,33.4333333333333,33,0.433333333333337,82,53,29,29,0
21700015,202331,OKC,NYK,Paul George,188,39.0666666666667,39,0.0666666666666629,90,69,21,23,-2
21700015,202335,OKC,NYK,Patrick Patterson,35,6.7,7,-0.3,11,12,-1,-1,0
21700015,203460,OKC,NYK,Andre Roberson,101,21.0333333333333,21,0.0333333333333314,42,37,5,3,2
21700015,203500,OKC,NYK,Steven Adams,141,29.1833333333333,30,-0.816666666666666,68,43,25,27,-2
21700015,203518,OKC,NYK,Alex Abrines,127,23.6833333333333,24,-0.316666666666666,59,38,21,23,-2
21700015,203924,OKC,NYK,Jerami Grant,105,20.85,21,-0.149999999999999,54,39,15,13,2
21700015,203962,OKC,NYK,Josh Huestis,16,2.28333333333333,3,-0.716666666666667,4,4,0,0,0
21700015,1626177,OKC,NYK,Dakari Johnson,18,2.61666666666667,3,-0.383333333333333,4,4,0,0,0
21700015,1628390,OKC,NYK,Terrance Ferguson,58,10.9,11,-0.100000000000001,23,20,3,-1,4
21700016,101150,LAC,LAL,Lou Williams,130,24.8166666666667,25,-0.183333333333334,52,42,10,13,-3
21700016,201568,LAC,LAL,Danilo Gallinari,175,33,33,0,80,61,19,19,0
21700016,201599,LAC,LAL,DeAndre Jordan,167,31.5166666666667,32,-0.483333333333334,69,57,12,11,1
21700016,201933,LAC,LAL,Blake Griffin,183,33.8,34,-0.200000000000003,74,56,18,20,-2
21700016,201976,LAC,LAL,Patrick Beverley,126,23.7333333333333,24,-0.266666666666666,62,41,21,20,1
21700016,202325,LAC,LAL,Wesley Johnson,104,19.5166666666667,20,-0.483333333333334,44,39,5,5,0
21700016,203085,LAC,LAL,Austin Rivers,142,26.4166666666667,26,0.416666666666664,50,55,-5,-5,0
21700016,203186,LAC,LAL,Willie Reed,72,13.2,13,0.199999999999999,32,24,8,8,0
21700016,1626149,LAC,LAL,Montrezl Harrell,16,2.88333333333333,3,-0.116666666666667,7,11,-4,-3,-1
21700016,1626155,LAC,LAL,Sam Dekker,27,4.8,5,-0.2,9,21,-12,-14,2
21700016,1628414,LAC,LAL,Sindarius Thornwell,18,3.01666666666667,3,0.0166666666666666,9,13,-4,-6,2
21700016,1628462,LAC,LAL,Milos Teodosic,115,21.3,21,0.299999999999997,52,40,12,12,0
21700016,2736,LAL,LAC,Luol Deng,71,13.0833333333333,13,0.0833333333333339,26,33,-7,-7,0
21700016,101106,LAL,LAC,Andrew Bogut,61,11.1333333333333,11,0.133333333333333,17,27,-10,-10,0
21700016,201147,LAL,LAC,Corey Brewer,83,16.1666666666667,16,0.166666666666668,36,38,-2,0,-2
21700016,201572,LAL,LAC,Brook Lopez,152,28.3166666666667,29,-0.683333333333334,58,59,-1,-1,0
21700016,203898,LAL,LAC,Tyler Ennis,50,9.43333333333333,10,-0.566666666666666,27,13,14,14,0
21700016,203903,LAL,LAC,Jordan Clarkson,121,22.5666666666667,23,-0.433333333333334,39,50,-11,-11,0
21700016,203944,LAL,LAC,Julius Randle,99,18.0166666666667,18,0.0166666666666657,29,54,-25,-25,0
21700016,1626204,LAL,LAC,Larry Nance Jr.,154,29.4,30,-0.600000000000001,58,53,5,3,2
21700016,1627742,LAL,LAC,Brandon Ingram,161,30.45,31,-0.549999999999997,58,58,0,-2,2
21700016,1627936,LAL,LAC,Alex Caruso,65,11.8333333333333,12,-0.166666666666668,26,40,-14,-10,-4
21700016,1628366,LAL,LAC,Lonzo Ball,158,29.35,29,0.350000000000001,52,64,-12,-14,2
21700016,1628398,LAL,LAC,Kyle Kuzma,100,18.25,19,-0.75,34,51,-17,-17,0
21700017,101141,ATL,CHA,Ersan Ilyasova,104,21.25,21,0.25,40,46,-6,-5,-1
21700017,201158,ATL,CHA,Marco Belinelli,111,21.9333333333333,22,-0.0666666666666664,44,51,-7,-9,2
21700017,202337,ATL,CHA,Luke Babbitt,79,15.7333333333333,16,-0.266666666666666,30,37,-7,-7,0
21700017,203145,ATL,CHA,Kent Bazemore,129,25.6333333333333,26,-0.366666666666667,54,60,-6,-9,3
21700017,203471,ATL,CHA,Dennis Schroder,162,31.8333333333333,32,-0.166666666666668,64,69,-5,-3,-2
21700017,203473,ATL,CHA,Dewayne Dedmon,125,24.6833333333333,25,-0.31666666666667,48,63,-15,-10,-5
21700017,203488,ATL,CHA,Mike Muscala,95,18.5333333333333,19,-0.466666666666669,39,38,1,-6,7
21700017,203705,ATL,CHA,Josh Magette,32,6.73333333333333,7,-0.266666666666668,15,12,3,0,3
21700017,1627098,ATL,CHA,Malcolm Delaney,118,22.7666666666667,23,-0.233333333333334,38,65,-27,-30,3
21700017,1627752,ATL,CHA,Taurean Prince,148,29.2333333333333,29,0.233333333333334,50,66,-16,-19,3
21700017,1627852,ATL,CHA,Nicolas Brussino,13,2.63333333333333,3,-0.366666666666667,4,2,2,2,0
21700017,1628381,ATL,CHA,John Collins,81,15.4,15,0.4,25,34,-9,-16,7
21700017,1628416,ATL,CHA,Tyler Dorsey,13,2.63333333333333,3,-0.366666666666667,4,2,2,2,0
21700017,2730,CHA,ATL,Dwight Howard,165,32.6333333333333,33,-0.366666666666667,85,53,32,34,-2
21700017,101107,CHA,ATL,Marvin Williams,83,15.8,16,-0.199999999999999,32,31,1,2,-1
21700017,202689,CHA,ATL,Kemba Walker,192,37.6333333333333,38,-0.366666666666667,98,63,35,35,0
21700017,202933,CHA,ATL,Julyan Stone,28,6.03333333333333,6,0.0333333333333332,6,18,-12,-12,0
21700017,203087,CHA,ATL,Jeremy Lamb,199,38.4,38,0.399999999999999,95,69,26,26,0
21700017,203948,CHA,ATL,Johnny O'Bryant III,72,14.2833333333333,14,0.283333333333333,21,37,-16,-18,2
21700017,1626163,CHA,ATL,Frank Kaminsky,164,32.8833333333333,33,-0.116666666666667,80,61,19,18,1
21700017,1626203,CHA,ATL,Treveon Graham,116,23.95,24,-0.0500000000000007,48,45,3,5,-2
21700017,1628370,CHA,ATL,Malik Monk,91,18.1666666666667,19,-0.833333333333336,33,44,-11,-13,2
21700017,1628407,CHA,ATL,Dwayne Bacon,100,19.2166666666667,19,0.216666666666669,47,34,13,13,0
21700018,2744,IND,POR,Al Jefferson,70,16.0833333333333,16,0.0833333333333357,37,44,-7,-7,0
21700018,2863,IND,POR,Damien Wilkins,35,8.25,9,-0.75,21,20,1,3,-2
21700018,201152,IND,POR,Thaddeus Young,138,29.1,29,0.100000000000001,51,66,-15,-15,0
21700018,201954,IND,POR,Darren Collison,151,30.95,31,-0.0500000000000007,61,67,-6,-3,-3
21700018,202362,IND,POR,Lance Stephenson,91,19.6166666666667,20,-0.383333333333333,44,58,-14,-12,-2
21700018,202709,IND,POR,Cory Joseph,91,20.0833333333333,20,0.0833333333333357,45,60,-15,-16,1
21700018,202711,IND,POR,Bojan Bogdanovic,118,24.45,24,0.449999999999999,45,51,-6,-10,4
21700018,203506,IND,POR,Victor Oladipo,155,32.7666666666667,33,-0.233333333333334,58,74,-16,-18,2
21700018,1626202,IND,POR,Joe Young,17,3.86666666666667,4,-0.133333333333333,7,6,1,1,0
21700018,1627734,IND,POR,Domantas Sabonis,139,28.7666666666667,29,-0.233333333333334,48,68,-20,-18,-2
21700018,1627816,IND,POR,Alex Poythress,17,3.86666666666667,4,-0.133333333333333,7,6,1,1,0
21700018,1628387,IND,POR,Ike Anigbogu,12,2.4,2,0.4,7,2,5,5,0
21700018,1628388,IND,POR,TJ Leaf,91,19.55,19,0.550000000000001,49,48,1,-1,2
21700018,202323,POR,IND,Evan Turner,147,31.85,32,-0.149999999999999,86,64,22,22,0
21700018,202329,POR,IND,Al-Farouq Aminu,164,34.7333333333333,35,-0.266666666666666,85,59,26,27,-1
21700018,202334,POR,IND,Ed Davis,95,20.4333333333333,20,0.433333333333334,55,46,9,12,-3
21700018,203081,POR,IND,Damian Lillard,157,33.0333333333333,33,0.0333333333333314,81,56,25,25,0
21700018,203090,POR,IND,Maurice Harkless,94,19.95,20,-0.0499999999999972,43,34,9,9,0
21700018,203468,POR,IND,CJ McCollum,150,32.2,32,0.200000000000003,72,67,5,3,2
21700018,203894,POR,IND,Shabazz Napier,12,2.4,2,0.4,2,7,-5,-5,0
21700018,203994,POR,IND,Jusuf Nurkic,118,25.1166666666667,26,-0.883333333333333,57,43,14,11,3
21700018,1626192,POR,IND,Pat Connaughton,103,22.0166666666667,22,0.0166666666666657,56,53,3,5,-2
21700018,1627774,POR,IND,Jake Layman,12,2.4,2,0.4,2,7,-5,-5,0
21700018,1628380,POR,IND,Zach Collins,35,7.03333333333333,7,0.0333333333333332,12,21,-9,-10,1
21700018,1628403,POR,IND,Caleb Swanigan,38,8.58333333333333,9,-0.416666666666668,19,23,-4,-4,0
21700019,201143,BOS,PHI,Al Horford,185,36,36,0,77,70,7,5,2
21700019,202681,BOS,PHI,Kyrie Irving,188,35.6333333333333,36,-0.366666666666667,71,71,0,2,-2
21700019,203382,BOS,PHI,Aron Baynes,69,13.3833333333333,14,-0.616666666666667,27,28,-1,-3,2
21700019,203499,BOS,PHI,Shane Larkin,77,19.3333333333333,19,0.333333333333332,43,32,11,16,-5
21700019,1626179,BOS,PHI,Terry Rozier,156,30.25,30,0.25,65,59,6,6,0
21700019,1627759,BOS,PHI,Jaylen Brown,173,37.05,37,0.0499999999999972,82,73,9,15,-6
21700019,1627824,BOS,PHI,Guerschon Yabusele,13,3.46666666666667,3,0.466666666666667,8,3,5,4,1
21700019,1627846,BOS,PHI,Abdel Nader,29,7.11666666666667,7,0.116666666666667,12,12,0,-2,2
21700019,1628369,BOS,PHI,Jayson Tatum,174,32.2666666666667,33,-0.733333333333334,63,65,-2,-4,2
21700019,1628444,BOS,PHI,Jabari Bird,66,13.95,14,-0.0500000000000007,40,23,17,11,6
21700019,1628464,BOS,PHI,Daniel Theis,50,10.6333333333333,11,-0.366666666666667,22,24,-2,0,-2
21700019,101161,PHI,BOS,Amir Johnson,58,11.4166666666667,11,0.416666666666666,23,22,1,-1,2
21700019,200755,PHI,BOS,JJ Redick,167,36.0333333333333,36,0.0333333333333314,70,82,-12,-14,2
21700019,201573,PHI,BOS,Jerryd Bayless,138,29.9666666666667,30,-0.0333333333333314,57,65,-8,-9,1
21700019,203496,PHI,BOS,Robert Covington,124,27.5666666666667,27,0.566666666666666,52,63,-11,-11,0
21700019,203954,PHI,BOS,Joel Embiid,144,28.0166666666667,28,0.0166666666666657,52,58,-6,-4,-2
21700019,203967,PHI,BOS,Dario Saric,120,23.25,24,-0.75,48,48,0,2,-2
21700019,204456,PHI,BOS,T.J. McConnell,68,11.95,12,-0.0500000000000007,18,24,-6,-3,-3
21700019,1626147,PHI,BOS,Justin Anderson,12,2.66666666666667,3,-0.333333333333333,2,4,-2,-4,2
21700019,1627732,PHI,BOS,Ben Simmons,175,37.0833333333333,37,0.0833333333333286,79,83,-4,-7,3
21700019,1627789,PHI,BOS,Timothe Luwawu-Cabarrot,83,14.1666666666667,14,0.166666666666666,29,26,3,8,-5
21700019,1628365,PHI,BOS,Markelle Fultz,91,16.9666666666667,17,-0.033333333333335,30,35,-5,-7,2
21700020,101133,WAS,DET,Ian Mahinmi,61,13.1666666666667,13,0.166666666666666,30,29,1,-1,2
21700020,101162,WAS,DET,Marcin Gortat,166,34.1333333333333,35,-0.866666666666667,83,80,3,3,0
21700020,201975,WAS,DET,Jodie Meeks,71,14.9833333333333,15,-0.0166666666666657,32,38,-6,-7,1
21700020,202322,WAS,DET,John Wall,162,33.55,34,-0.450000000000003,82,76,6,4,2
21700020,203078,WAS,DET,Bradley Beal,170,34.9666666666667,35,-0.0333333333333314,91,73,18,15,3
21700020,203118,WAS,DET,Mike Scott,98,20.5333333333333,21,-0.466666666666669,43,50,-7,-10,3
21700020,203490,WAS,DET,Otto Porter Jr.,179,38,38,0,93,86,7,6,1
21700020,204025,WAS,DET,Tim Frazier,68,14.4333333333333,14,0.433333333333334,33,33,0,0,0
21700020,1626162,WAS,DET,Kelly Oubre Jr.,175,36.15,36,0.149999999999999,88,80,8,10,-2
21700020,202340,DET,WAS,Avery Bradley,159,33,33,0,71,83,-12,-11,-1
21700020,202397,DET,WAS,Ish Smith,76,16.4833333333333,16,0.483333333333334,30,42,-12,-12,0
21700020,202699,DET,WAS,Tobias Harris,164,33.9166666666667,34,-0.0833333333333286,81,79,2,2,0
21700020,202704,DET,WAS,Reggie Jackson,154,31.5,32,-0.5,79,73,6,8,-2
21700020,202720,DET,WAS,Jon Leuer,155,31.8166666666667,32,-0.183333333333334,75,72,3,9,-6
21700020,203083,DET,WAS,Andre Drummond,123,25.75,26,-0.25,59,63,-4,-7,3
21700020,203961,DET,WAS,Eric Moreland,60,12.9833333333333,12,0.983333333333333,24,35,-11,-8,-3
21700020,204038,DET,WAS,Langston Galloway,56,12.2,12,0.199999999999999,29,28,1,2,-1
21700020,1626169,DET,WAS,Stanley Johnson,112,23.6,24,-0.399999999999999,50,53,-3,-3,0
21700020,1628379,DET,WAS,Luke Kennard,91,18.6666666666667,19,-0.333333333333332,47,47,0,0,0
21700021,2544,CLE,MIL,LeBron James,162,36.75,37,-0.25,95,84,11,13,-2
21700021,2548,CLE,MIL,Dwyane Wade,123,26.2333333333333,26,0.233333333333334,54,58,-4,-1,-3
21700021,2594,CLE,MIL,Kyle Korver,78,19.2,19,0.199999999999999,50,36,14,14,0
21700021,2747,CLE,MIL,JR Smith,100,22.8833333333333,23,-0.116666666666667,56,39,17,16,1
21700021,101112,CLE,MIL,Channing Frye,4,1.01666666666667,1,0.0166666666666666,5,0,5,5,0
21700021,101181,CLE,MIL,Jose Calderon,4,1.01666666666667,1,0.0166666666666666,5,0,5,5,0
21700021,201145,CLE,MIL,Jeff Green,72,17.3166666666667,18,-0.683333333333334,37,25,12,11,1
21700021,201565,CLE,MIL,Derrick Rose,106,23.05,23,0.0500000000000007,65,56,9,9,0
21700021,201567,CLE,MIL,Kevin Love,123,26.85,27,-0.149999999999999,66,72,-6,-2,-4
21700021,202684,CLE,MIL,Tristan Thompson,106,24.5,24,0.5,56,38,18,17,1
21700021,202697,CLE,MIL,Iman Shumpert,58,13.4166666666667,14,-0.583333333333334,23,18,5,4,1
21700021,203109,CLE,MIL,Jae Crowder,115,25.25,25,0.25,63,59,4,4,0
21700021,1626224,CLE,MIL,Cedi Osman,4,1.01666666666667,1,0.0166666666666666,5,0,5,5,0
21700021,1891,MIL,CLE,Jason Terry,76,16.3166666666667,16,0.31666666666667,31,42,-11,-11,0
21700021,202328,MIL,CLE,Greg Monroe,79,18.2166666666667,18,0.216666666666669,27,40,-13,-15,2
21700021,203089,MIL,CLE,John Henson,38,8.3,8,0.300000000000001,19,26,-7,-5,-2
21700021,203114,MIL,CLE,Khris Middleton,160,35.4,35,0.399999999999999,80,84,-4,-4,0
21700021,203141,MIL,CLE,Mirza Teletovic,37,8.55,9,-0.449999999999999,11,12,-1,-1,0
21700021,203503,MIL,CLE,Tony Snell,138,31.6,32,-0.399999999999999,66,71,-5,-5,0
21700021,203507,MIL,CLE,Giannis Antetokounmpo,170,38.5833333333333,39,-0.416666666666671,84,99,-15,-17,2
21700021,203521,MIL,CLE,Matthew Dellavedova,103,23.9833333333333,24,-0.0166666666666657,43,48,-5,-5,0
21700021,1626173,MIL,CLE,Rashad Vaughn,4,1.01666666666667,1,0.0166666666666666,0,5,-5,-5,0
21700021,1627748,MIL,CLE,Thon Maker,76,16.6,17,-0.399999999999999,40,43,-3,-3,0
21700021,1627763,MIL,CLE,Malcolm Brogdon,146,33.55,34,-0.450000000000003,75,90,-15,-15,0
21700021,1628391,MIL,CLE,D.J. Wilson,4,1.01666666666667,1,0.0166666666666666,0,5,-5,-5,0
21700021,1628425,MIL,CLE,Sterling Brown,24,5.36666666666667,6,-0.633333333333333,9,15,-6,-4,-2
21700022,201960,BKN,ORL,DeMarre Carroll,151,27.3833333333333,28,-0.616666666666667,70,75,-5,-5,0
21700022,202344,BKN,ORL,Trevor Booker,116,21.6,22,-0.399999999999999,55,52,3,0,3
21700022,202389,BKN,ORL,Timofey Mozgov,80,15.7833333333333,16,-0.216666666666665,40,42,-2,-1,-1
21700022,203112,BKN,ORL,Quincy Acy,82,16.6833333333333,17,-0.316666666666666,44,40,4,4,0
21700022,203459,BKN,ORL,Allen Crabbe,123,22.9833333333333,23,-0.0166666666666657,58,67,-9,-7,-2
21700022,203915,BKN,ORL,Spencer Dinwiddie,120,24.5833333333333,25,-0.416666666666668,71,57,14,12,2
21700022,203925,BKN,ORL,Joe Harris,89,18.6333333333333,18,0.633333333333333,52,43,9,9,0
21700022,1626156,BKN,ORL,D'Angelo Russell,140,25.5166666666667,25,0.516666666666666,59,69,-10,-7,-3
21700022,1626178,BKN,ORL,Rondae Hollis-Jefferson,140,25.1,25,0.100000000000001,68,68,0,1,-1
21700022,1627747,BKN,ORL,Caris LeVert,139,27.1833333333333,27,0.183333333333334,74,60,14,12,2
21700022,1628386,BKN,ORL,Jarrett Allen,70,14.55,15,-0.449999999999999,39,32,7,7,0
21700022,201167,ORL,BKN,Arron Afflalo,71,14.6166666666667,15,-0.383333333333333,39,37,2,-3,5
21700022,201571,ORL,BKN,D.J. Augustin,110,22.8,23,-0.200000000000003,59,66,-7,-8,1
21700022,201578,ORL,BKN,Marreese Speights,16,3.55,3,0.55,5,11,-6,-5,-1
21700022,202687,ORL,BKN,Bismack Biyombo,60,12.4333333333333,13,-0.566666666666666,20,38,-18,-20,2
21700022,202696,ORL,BKN,Nikola Vucevic,190,35.5666666666667,35,0.566666666666663,101,88,13,15,-2
21700022,202714,ORL,BKN,Shelvin Mack,59,10.4166666666667,10,0.416666666666666,21,27,-6,-6,0
21700022,203082,ORL,BKN,Terrence Ross,164,30.35,30,0.350000000000001,82,80,2,6,-4
21700022,203095,ORL,BKN,Evan Fournier,194,35.7333333333333,36,-0.266666666666666,88,92,-4,-3,-1
21700022,203613,ORL,BKN,Jonathon Simmons,106,21.7666666666667,22,-0.233333333333334,51,59,-8,-8,0
21700022,203901,ORL,BKN,Elfrid Payton,80,14.6,14,0.6,41,32,9,10,-1
21700022,1626209,ORL,BKN,Mario Hezonja,81,15.3666666666667,16,-0.633333333333333,39,37,2,0,2
21700022,1628371,ORL,BKN,Jonathan Isaac,119,22.8,23,-0.200000000000003,59,63,-4,-3,-1
21700023,2037,MIN,UTA,Jamal Crawford,85,19.25,19,0.25,37,44,-7,-5,-2
21700023,201952,MIN,UTA,Jeff Teague,151,32.6166666666667,33,-0.383333333333333,65,64,1,-3,4
21700023,201959,MIN,UTA,Taj Gibson,121,26.5166666666667,26,0.516666666666666,53,49,4,-3,7
21700023,202357,MIN,UTA,Nemanja Bjelica,53,13.1333333333333,13,0.133333333333333,36,22,14,16,-2
21700023,202710,MIN,UTA,Jimmy Butler,181,38.5333333333333,39,-0.466666666666669,78,79,-1,-8,7
21700023,203476,MIN,UTA,Gorgui Dieng,63,15.3333333333333,16,-0.666666666666668,33,20,13,7,6
21700023,203498,MIN,UTA,Shabazz Muhammad,51,12.0166666666667,12,0.0166666666666657,27,30,-3,-3,0
21700023,203952,MIN,UTA,Andrew Wiggins,157,34.55,35,-0.450000000000003,69,64,5,0,5
21700023,1626145,MIN,UTA,Tyus Jones,65,15.3833333333333,15,0.383333333333333,35,32,3,2,1
21700023,1626157,MIN,UTA,Karl-Anthony Towns,153,32.6666666666667,32,0.666666666666671,67,76,-9,-8,-1
21700023,2207,UTA,MIN,Joe Johnson,82,19.3,19,0.299999999999997,29,47,-18,-13,-5
21700023,200757,UTA,MIN,Thabo Sefolosha,107,24.8666666666667,25,-0.133333333333333,47,52,-5,-4,-1
21700023,201937,UTA,MIN,Ricky Rubio,153,32.9333333333333,33,-0.0666666666666629,66,73,-7,-2,-5
21700023,202324,UTA,MIN,Derrick Favors,134,28.7,29,-0.300000000000001,67,53,14,14,0
21700023,202327,UTA,MIN,Ekpe Udoh,62,15.1333333333333,15,0.133333333333333,37,24,13,10,3
21700023,202692,UTA,MIN,Alec Burks,33,8.1,9,-0.9,12,17,-5,-7,2
21700023,203497,UTA,MIN,Rudy Gobert,154,32.8666666666667,33,-0.133333333333333,59,76,-17,-9,-8
21700023,203918,UTA,MIN,Rodney Hood,108,23.5166666666667,24,-0.483333333333334,53,41,12,10,2
21700023,204060,UTA,MIN,Joe Ingles,161,34.5666666666667,34,0.566666666666663,71,75,-4,3,-7
21700023,1628378,UTA,MIN,Donovan Mitchell,86,20.0166666666667,20,0.0166666666666657,39,42,-3,3,-6
21700024,1717,DAL,SAC,Dirk Nowitzki,127,28.85,29,-0.149999999999999,64,58,6,6,0
21700024,200826,DAL,SAC,J.J. Barea,116,26.65,27,-0.350000000000001,56,58,-2,0,-2
21700024,202083,DAL,SAC,Wesley Matthews,144,33.6666666666667,34,-0.333333333333336,59,72,-13,-13,0
21700024,203084,DAL,SAC,Harrison Barnes,167,39.1166666666667,39,0.116666666666667,71,78,-7,-7,0
21700024,203457,DAL,SAC,Nerlens Noel,112,27.0833333333333,27,0.0833333333333322,45,59,-14,-16,2
21700024,203939,DAL,SAC,Dwight Powell,43,9.93333333333333,10,-0.0666666666666664,10,12,-2,-1,-1
21700024,1626257,DAL,SAC,Salah Mejri,60,12.8,13,-0.199999999999999,21,21,0,0,0
21700024,1627812,DAL,SAC,Yogi Ferrell,137,31.0333333333333,30,1.03333333333333,50,60,-10,-9,-1
21700024,1627827,DAL,SAC,Dorian Finney-Smith,90,20.8166666666667,21,-0.183333333333334,40,36,4,2,2
21700024,1628492,DAL,SAC,Gian Clavell,44,9.8,10,-0.199999999999999,24,11,13,13,0
21700024,1713,SAC,DAL,Vince Carter,77,17.3833333333333,17,0.383333333333333,30,37,-7,-8,1
21700024,2216,SAC,DAL,Zach Randolph,126,30.1333333333333,30,0.133333333333333,61,49,12,12,0
21700024,201585,SAC,DAL,Kosta Koufos,90,21.2,21,0.200000000000003,36,44,-8,-9,1
21700024,201588,SAC,DAL,George Hill,137,31.85,32,-0.149999999999999,68,54,14,14,0
21700024,202066,SAC,DAL,Garrett Temple,129,28.55,28,0.550000000000001,56,57,-1,0,-1
21700024,1626161,SAC,DAL,Willie Cauley-Stein,118,26.75,27,-0.25,57,44,13,14,-1
21700024,1627741,SAC,DAL,Buddy Hield,125,27.9333333333333,27,0.933333333333334,56,50,6,7,-1
21700024,1627746,SAC,DAL,Skal Labissiere,55,12.8666666666667,13,-0.133333333333333,22,23,-1,-1,0
21700024,1628368,SAC,DAL,De'Aaron Fox,114,25.8666666666667,26,-0.133333333333333,48,54,-6,-7,1
21700024,1628382,SAC,DAL,Justin Jackson,69,17.2166666666667,17,0.216666666666669,31,28,3,3,0
21700026,101106,LAL,PHX,Andrew Bogut,42,7.45,7,0.449999999999999,17,25,-8,-8,0
21700026,201147,LAL,PHX,Corey Brewer,188,33.4,33,0.399999999999999,92,76,16,14,2
21700026,201572,LAL,PHX,Brook Lopez,175,31.8833333333333,32,-0.116666666666667,87,78,9,14,-5
21700026,203898,LAL,PHX,Tyler Ennis,19,3.9,4,-0.100000000000001,9,6,3,4,-1
21700026,203903,LAL,PHX,Jordan Clarkson,95,17.4666666666667,17,0.466666666666669,45,54,-9,-7,-2
21700026,203944,LAL,PHX,Julius Randle,68,12.6833333333333,13,-0.316666666666666,37,38,-1,-2,1
21700026,1626204,LAL,PHX,Larry Nance Jr.,133,21.8833333333333,22,-0.116666666666667,66,56,10,11,-1
21700026,1627742,LAL,PHX,Brandon Ingram,203,36.3833333333333,37,-0.616666666666667,104,98,6,8,-2
21700026,1627936,LAL,PHX,Alex Caruso,40,6.98333333333333,7,-0.0166666666666675,19,22,-3,-3,0
21700026,1628366,LAL,PHX,Lonzo Ball,210,37.1166666666667,37,0.116666666666667,103,102,1,1,0
21700026,1628398,LAL,PHX,Kyle Kuzma,158,28.5333333333333,28,0.533333333333331,72,87,-15,-18,3
21700026,1628404,LAL,PHX,Josh Hart,14,2.31666666666667,2,0.316666666666666,4,8,-4,-4,0
21700026,2199,PHX,LAL,Tyson Chandler,136,23.55,24,-0.450000000000003,67,59,8,6,2
21700026,202339,PHX,LAL,Eric Bledsoe,176,30,30,0,77,82,-5,-8,3
21700026,203458,PHX,LAL,Alex Len,111,21.45,21,0.449999999999999,56,61,-5,-5,0
21700026,203584,PHX,LAL,Troy Daniels,21,3.5,3,0.5,11,10,1,1,0
21700026,203933,PHX,LAL,T.J. Warren,222,39.5666666666667,39,0.566666666666663,110,108,2,0,2
21700026,1626164,PHX,LAL,Devin Booker,221,39.8166666666667,40,-0.183333333333337,97,107,-10,-10,0
21700026,1627733,PHX,LAL,Dragan Bender,100,19.1666666666667,19,0.166666666666664,56,41,15,16,-1
21700026,1627737,PHX,LAL,Marquese Chriss,106,17.95,18,-0.0500000000000007,53,56,-3,-5,2
21700026,1628367,PHX,LAL,Josh Jackson,137,23.2666666666667,23,0.266666666666666,62,73,-11,-10,-1
21700026,1628455,PHX,LAL,Mike James,115,21.7333333333333,22,-0.266666666666666,61,58,3,5,-2
21700027,101161,PHI,TOR,Amir Johnson,68,13.9833333333333,14,-0.0166666666666657,28,29,-1,-1,0
21700027,200755,PHI,TOR,JJ Redick,128,26.3666666666667,26,0.366666666666667,61,66,-5,-6,1
21700027,201573,PHI,TOR,Jerryd Bayless,137,26.3833333333333,27,-0.616666666666667,53,79,-26,-25,-1
21700027,203496,PHI,TOR,Robert Covington,71,14.4333333333333,15,-0.566666666666666,33,42,-9,-11,2
21700027,203917,PHI,TOR,Nik Stauskas,41,8.21666666666667,8,0.216666666666667,13,17,-4,-4,0
21700027,203967,PHI,TOR,Dario Saric,122,24.2166666666667,24,0.216666666666669,47,64,-17,-16,-1
21700027,204456,PHI,TOR,T.J. McConnell,92,18.3833333333333,18,0.383333333333333,30,45,-15,-14,-1
21700027,1626143,PHI,TOR,Jahlil Okafor,109,21.8833333333333,22,-0.116666666666667,45,61,-16,-16,0
21700027,1626147,PHI,TOR,Justin Anderson,88,17.2,17,0.199999999999999,29,43,-14,-14,0
21700027,1627732,PHI,TOR,Ben Simmons,169,33.1333333333333,33,0.133333333333333,72,91,-19,-20,1
21700027,1627789,PHI,TOR,Timothe Luwawu-Cabarrot,61,10.5333333333333,11,-0.466666666666667,15,39,-24,-23,-1
21700027,1628365,PHI,TOR,Markelle Fultz,124,24.35,24,0.350000000000001,44,64,-20,-20,0
21700027,101139,TOR,PHI,CJ Miles,87,16.8666666666667,17,-0.133333333333333,44,32,12,13,-1
21700027,200768,TOR,PHI,Kyle Lowry,139,28.15,28,0.149999999999999,79,59,20,17,3
21700027,201586,TOR,PHI,Serge Ibaka,123,24.4833333333333,25,-0.516666666666666,72,49,23,23,0
21700027,201942,TOR,PHI,DeMar DeRozan,134,26.7666666666667,27,-0.233333333333334,81,57,24,26,-2
21700027,202685,TOR,PHI,Jonas Valanciunas,74,15.05,15,0.0500000000000007,32,33,-1,-4,3
21700027,203512,TOR,PHI,Lucas Nogueira,79,16.05,16,0.0500000000000007,44,27,17,16,1
21700027,203998,TOR,PHI,Bruno Caboclo,31,5.95,6,-0.0499999999999998,14,6,8,8,0
21700027,1626153,TOR,PHI,Delon Wright,163,31.5833333333333,31,0.583333333333332,82,60,22,23,-1
21700027,1626181,TOR,PHI,Norman Powell,84,17.0833333333333,17,0.0833333333333322,49,35,14,14,0
21700027,1627751,TOR,PHI,Jakob Poeltl,89,16.7166666666667,17,-0.283333333333331,52,34,18,22,-4
21700027,1627783,TOR,PHI,Pascal Siakam,41,8.21666666666667,8,0.216666666666667,17,13,4,4,0
21700027,1627832,TOR,PHI,Fred VanVleet,87,17.0166666666667,17,0.0166666666666657,36,32,4,4,0
21700027,1628384,TOR,PHI,OG Anunoby,79,15.15,15,0.15,38,33,5,4,1
21700028,2544,CLE,ORL,LeBron James,145,31.25,31,0.25,48,79,-31,-31,0
21700028,2548,CLE,ORL,Dwyane Wade,74,16,16,0,29,33,-4,-4,0
21700028,2594,CLE,ORL,Kyle Korver,63,13.1833333333333,13,0.183333333333334,22,44,-22,-22,0
21700028,2747,CLE,ORL,JR Smith,98,20.5166666666667,21,-0.483333333333334,28,61,-33,-33,0
21700028,101112,CLE,ORL,Channing Frye,43,8.38333333333333,8,0.383333333333333,26,15,11,11,0
21700028,101181,CLE,ORL,Jose Calderon,66,13.5666666666667,14,-0.433333333333334,30,30,0,0,0
21700028,201145,CLE,ORL,Jeff Green,100,20.6833333333333,21,-0.316666666666666,39,58,-19,-17,-2
21700028,201567,CLE,ORL,Kevin Love,126,27.0166666666667,27,0.0166666666666657,49,59,-10,-12,2
21700028,202684,CLE,ORL,Tristan Thompson,125,25.5666666666667,26,-0.433333333333334,47,68,-21,-21,0
21700028,202697,CLE,ORL,Iman Shumpert,145,29.7833333333333,30,-0.216666666666669,68,55,13,13,0
21700028,203109,CLE,ORL,Jae Crowder,86,18.5833333333333,19,-0.416666666666664,29,40,-11,-13,2
21700028,1626224,CLE,ORL,Cedi Osman,43,8.38333333333333,8,0.383333333333333,26,15,11,11,0
21700028,1627790,CLE,ORL,Ante Zizic,36,7.08333333333333,7,0.083333333333333,24,13,11,13,-2
21700028,201167,ORL,CLE,Arron Afflalo,28,5.53333333333333,5,0.533333333333333,11,13,-2,-4,2
21700028,201571,ORL,CLE,D.J. Augustin,125,26.9166666666667,27,-0.0833333333333357,61,40,21,19,2
21700028,201578,ORL,CLE,Marreese Speights,90,18.0166666666667,18,0.0166666666666657,40,42,-2,1,-3
21700028,202687,ORL,CLE,Bismack Biyombo,73,14.0333333333333,14,0.0333333333333332,34,36,-2,-1,-1
21700028,202696,ORL,CLE,Nikola Vucevic,130,28.3,28,0.299999999999997,72,43,29,28,1
21700028,202714,ORL,CLE,Shelvin Mack,105,21.0833333333333,21,0.0833333333333357,53,53,0,2,-2
21700028,203082,ORL,CLE,Terrence Ross,102,22.2333333333333,22,0.233333333333334,47,34,13,15,-2
21700028,203095,ORL,CLE,Evan Fournier,124,26.65,27,-0.350000000000001,68,41,27,27,0
21700028,203613,ORL,CLE,Jonathon Simmons,102,20.3666666666667,20,0.366666666666667,59,43,16,14,2
21700028,203920,ORL,CLE,Khem Birch,24,5.15,5,0.15,8,14,-6,-6,0
21700028,1626209,ORL,CLE,Mario Hezonja,122,24.7166666666667,25,-0.283333333333335,57,56,1,0,1
21700028,1628371,ORL,CLE,Jonathan Isaac,99,21.6,21,0.600000000000001,52,34,18,18,0
21700028,1628411,ORL,CLE,Wes Iwundu,26,5.4,5,0.4,8,16,-8,-8,0
21700029,201609,MIA,IND,Goran Dragic,154,31.9166666666667,32,-0.0833333333333357,79,64,15,-1,16
21700029,201949,MIA,IND,James Johnson,141,29.4666666666667,30,-0.533333333333335,79,59,20,3,17
21700029,201961,MIA,IND,Wayne Ellington,75,15.5166666666667,15,0.516666666666666,33,28,5,5,0
21700029,203079,MIA,IND,Dion Waiters,156,32.4666666666667,33,-0.533333333333331,79,66,13,-1,14
21700029,203482,MIA,IND,Kelly Olynyk,128,27.4166666666667,27,0.416666666666664,54,57,-3,-3,0
21700029,204020,MIA,IND,Tyler Johnson,123,26.3833333333333,26,0.383333333333333,55,50,5,5,0
21700029,1626159,MIA,IND,Justise Winslow,129,25.7333333333333,25,0.733333333333334,51,52,-1,2,-3
21700029,1626175,MIA,IND,Jordan Mickey,64,13.35,14,-0.649999999999999,40,20,20,6,14
21700029,1626196,MIA,IND,Josh Richardson,185,37.6666666666667,38,-0.333333333333329,90,74,16,4,12
21700029,2744,IND,MIA,Al Jefferson,65,14,14,0,29,29,0,0,0
21700029,2863,IND,MIA,Damien Wilkins,58,12.7,12,0.699999999999999,21,27,-6,-6,0
21700029,201152,IND,MIA,Thaddeus Young,147,30.7166666666667,31,-0.283333333333331,60,84,-24,-6,-18
21700029,201954,IND,MIA,Darren Collison,154,31.9166666666667,32,-0.0833333333333322,63,82,-19,-4,-15
21700029,202362,IND,MIA,Lance Stephenson,85,18.4,18,0.399999999999999,37,35,2,2,0
21700029,202709,IND,MIA,Cory Joseph,133,27.2666666666667,27,0.266666666666666,59,51,8,9,-1
21700029,202711,IND,MIA,Bojan Bogdanovic,102,20.55,21,-0.450000000000003,33,64,-31,-19,-12
21700029,203506,IND,MIA,Victor Oladipo,179,36.6333333333333,37,-0.366666666666667,74,88,-14,0,-14
21700029,1627734,IND,MIA,Domantas Sabonis,148,30.4666666666667,30,0.466666666666669,60,72,-12,2,-14
21700029,1628388,IND,MIA,TJ Leaf,84,17.2666666666667,17,0.266666666666666,34,28,6,2,4
21700030,201196,NYK,DET,Ramon Sessions,158,32.55,33,-0.450000000000003,66,75,-9,-11,2
21700030,201563,NYK,DET,Michael Beasley,81,17.7666666666667,18,-0.233333333333334,43,39,4,4,0
21700030,201584,NYK,DET,Courtney Lee,135,29.15,29,0.149999999999999,59,66,-7,-5,-2
21700030,202683,NYK,DET,Enes Kanter,118,23.8666666666667,24,-0.133333333333333,49,60,-11,-9,-2
21700030,203124,NYK,DET,Kyle O'Quinn,108,24.2666666666667,24,0.266666666666666,58,53,5,5,0
21700030,203501,NYK,DET,Tim Hardaway Jr.,165,34.3333333333333,35,-0.666666666666671,73,80,-7,-7,0
21700030,203926,NYK,DET,Doug McDermott,128,27.9666666666667,28,-0.0333333333333314,65,62,3,1,2
21700030,204001,NYK,DET,Kristaps Porzingis,166,34.7833333333333,35,-0.216666666666669,81,86,-5,-5,0
21700030,1627758,NYK,DET,Ron Baker,66,15.3166666666667,15,0.316666666666666,41,34,7,7,0
21700030,201229,DET,NYK,Anthony Tolliver,95,20.1833333333333,20,0.183333333333334,55,34,21,21,0
21700030,202340,DET,NYK,Avery Bradley,108,21.8666666666667,22,-0.133333333333333,58,45,13,11,2
21700030,202397,DET,NYK,Ish Smith,94,21.2166666666667,22,-0.783333333333331,38,49,-11,-10,-1
21700030,202699,DET,NYK,Tobias Harris,182,38.05,38,0.0499999999999972,90,85,5,7,-2
21700030,202704,DET,NYK,Reggie Jackson,131,26.7833333333333,26,0.783333333333331,73,58,15,14,1
21700030,202720,DET,NYK,Jon Leuer,82,18.9166666666667,19,-0.0833333333333357,39,48,-9,-9,0
21700030,203083,DET,NYK,Andre Drummond,185,37.9833333333333,38,-0.0166666666666657,93,86,7,7,0
21700030,1626169,DET,NYK,Stanley Johnson,133,28.9833333333333,29,-0.0166666666666657,63,67,-4,-6,2
21700030,1626246,DET,NYK,Boban Marjanovic,19,4.78333333333333,4,0.783333333333333,6,12,-6,-6,0
21700030,1627740,DET,NYK,Henry Ellenson,18,4.15,4,0.15,6,12,-6,-6,0
21700030,1628379,DET,NYK,Luke Kennard,78,17.0833333333333,17,0.0833333333333322,34,39,-5,-3,-2
21700031,201577,CHI,SAS,Robin Lopez,140,29.5166666666667,30,-0.483333333333334,55,56,-1,-3,2
21700031,203200,CHI,SAS,Justin Holiday,170,36.45,36,0.450000000000003,62,66,-4,-5,1
21700031,1626170,CHI,SAS,Jerian Grant,155,33.0666666666667,33,0.06666666666667,60,62,-2,-2,0
21700031,1626245,CHI,SAS,Cristiano Felicio,82,18.3666666666667,18,0.366666666666667,22,31,-9,-7,-2
21700031,1627756,CHI,SAS,Denzel Valentine,119,26.8166666666667,27,-0.183333333333334,34,43,-9,-5,-4
21700031,1627770,CHI,SAS,Kay Felder,67,14.8166666666667,15,-0.183333333333334,17,25,-8,-8,0
21700031,1627835,CHI,SAS,Paul Zipser,123,25.8166666666667,26,-0.183333333333334,40,50,-10,-13,3
21700031,1628021,CHI,SAS,David Nwaba,82,17.8,18,-0.200000000000003,31,33,-2,-2,0
21700031,1628374,CHI,SAS,Lauri Markkanen,172,36.7666666666667,37,-0.233333333333334,64,69,-5,-5,0
21700031,1938,SAS,CHI,Manu Ginobili,103,22.7666666666667,23,-0.233333333333334,35,31,4,3,1
21700031,2200,SAS,CHI,Pau Gasol,95,19.7166666666667,20,-0.283333333333331,38,35,3,3,0
21700031,200746,SAS,CHI,LaMarcus Aldridge,152,32.7166666666667,33,-0.283333333333331,66,51,15,13,2
21700031,200752,SAS,CHI,Rudy Gay,102,23.2666666666667,23,0.266666666666666,48,32,16,18,-2
21700031,201980,SAS,CHI,Danny Green,138,28.6,29,-0.399999999999999,58,50,8,10,-2
21700031,201988,SAS,CHI,Patty Mills,102,22.1,22,0.100000000000001,35,40,-5,-5,0
21700031,203464,SAS,CHI,Brandon Paul,1,0.1,0,0.1,,0,,0,
21700031,203530,SAS,CHI,Joffrey Lauvergne,78,17.4333333333333,17,0.433333333333334,24,29,-5,-3,-2
21700031,203937,SAS,CHI,Kyle Anderson,149,31.3,32,-0.699999999999999,56,58,-2,-3,1
21700031,1627749,SAS,CHI,Dejounte Murray,119,25.6833333333333,26,-0.316666666666666,52,37,15,15,0
21700031,1627854,SAS,CHI,Bryn Forbes,71,15.7333333333333,16,-0.266666666666666,23,22,1,-1,2
21700032,1717,DAL,HOU,Dirk Nowitzki,83,17.7833333333333,18,-0.216666666666665,28,40,-12,-15,3
21700032,200826,DAL,HOU,J.J. Barea,103,21.35,22,-0.649999999999999,35,50,-15,-16,1
21700032,202083,DAL,HOU,Wesley Matthews,145,30.7333333333333,31,-0.266666666666666,52,84,-32,-31,-1
21700032,203084,DAL,HOU,Harrison Barnes,145,30.7333333333333,31,-0.266666666666666,52,84,-32,-31,-1
21700032,203457,DAL,HOU,Nerlens Noel,77,16.0333333333333,16,0.0333333333333314,27,48,-21,-17,-4
21700032,203481,DAL,HOU,Jeff Withey,39,8.61666666666667,9,-0.383333333333333,21,9,12,14,-2
21700032,203939,DAL,HOU,Dwight Powell,90,20.2333333333333,20,0.233333333333334,42,29,13,14,-1
21700032,1627812,DAL,HOU,Yogi Ferrell,190,41.0666666666667,41,0.0666666666666629,81,95,-14,-13,-1
21700032,1627827,DAL,HOU,Dorian Finney-Smith,68,15.6,16,-0.400000000000002,29,38,-9,-12,3
21700032,1628467,DAL,HOU,Maxi Kleber,51,11.6166666666667,12,-0.383333333333333,33,15,18,18,0
21700032,1628492,DAL,HOU,Gian Clavell,109,24.2333333333333,25,-0.766666666666666,50,43,7,9,-2
21700032,2403,HOU,DAL,Nene,46,10.05,10,0.0500000000000007,27,24,3,6,-3
21700032,2772,HOU,DAL,Trevor Ariza,147,30.9333333333333,31,-0.0666666666666664,85,50,35,34,1
21700032,200782,HOU,DAL,PJ Tucker,121,26.8833333333333,27,-0.116666666666667,56,50,6,3,3
21700032,201569,HOU,DAL,Eric Gordon,111,24.0666666666667,24,0.0666666666666664,56,48,8,11,-3
21700032,201583,HOU,DAL,Ryan Anderson,106,22.9333333333333,23,-0.0666666666666664,55,38,17,19,-2
21700032,201601,HOU,DAL,Luc Mbah a Moute,120,26.3333333333333,26,0.333333333333332,57,52,5,1,4
21700032,201628,HOU,DAL,Bobby Brown,23,5.05,5,0.0499999999999998,5,14,-9,-9,0
21700032,201935,HOU,DAL,James Harden,145,30.7333333333333,31,-0.266666666666666,84,52,32,31,1
21700032,203991,HOU,DAL,Clint Capela,97,20.75,21,-0.25,52,38,14,10,4
21700032,204028,HOU,DAL,Tarik Black,60,12.8166666666667,13,-0.183333333333334,23,23,0,0,0
21700032,1627743,HOU,DAL,Demetrius Jackson,75,16.8666666666667,17,-0.133333333333333,23,38,-15,-15,0
21700032,1627753,HOU,DAL,Zhou Qi,31,7,7,0,7,14,-7,-7,0
21700032,1627786,HOU,DAL,Troy Williams,18,3.58333333333333,4,-0.416666666666667,5,9,-4,-4,0
21700033,2561,GSW,MEM,David West,44,9.08333333333333,9,0.0833333333333322,16,13,3,3,0
21700033,2585,GSW,MEM,Zaza Pachulia,55,11.9333333333333,12,-0.0666666666666664,20,25,-5,-5,0
21700033,2733,GSW,MEM,Shaun Livingston,83,17.7333333333333,18,-0.266666666666666,33,34,-1,-7,6
21700033,2738,GSW,MEM,Andre Iguodala,141,28.85,29,-0.149999999999999,64,72,-8,-4,-4
21700033,201142,GSW,MEM,Kevin Durant,185,39.75,40,-0.25,79,83,-4,-2,-2
21700033,201156,GSW,MEM,Nick Young,28,5.08333333333333,5,0.083333333333333,11,12,-1,-3,2
21700033,201580,GSW,MEM,JaVale McGee,22,4.71666666666667,4,0.716666666666667,11,19,-8,-8,0
21700033,201939,GSW,MEM,Stephen Curry,139,30.1666666666667,30,0.166666666666668,70,75,-5,-6,1
21700033,202691,GSW,MEM,Klay Thompson,178,37.8833333333333,38,-0.11666666666666,81,83,-2,0,-2
21700033,203110,GSW,MEM,Draymond Green,171,36.6,36,0.599999999999994,81,94,-13,-13,0
21700033,1626188,GSW,MEM,Quinn Cook,4,0.533333333333333,1,-0.466666666666667,2,2,0,0,0
21700033,1627775,GSW,MEM,Patrick McCaw,58,12.7166666666667,12,0.716666666666667,26,36,-10,-9,-1
21700033,1628395,GSW,MEM,Jordan Bell,22,4.03333333333333,4,0.0333333333333332,11,7,4,4,0
21700033,201144,MEM,GSW,Mike Conley,147,31.9666666666667,32,-0.033333333333335,66,67,-1,2,-3
21700033,201148,MEM,GSW,Brandan Wright,54,11,11,0,27,23,4,2,2
21700033,201188,MEM,GSW,Marc Gasol,170,36.2833333333333,36,0.283333333333331,82,76,6,10,-4
21700033,201596,MEM,GSW,Mario Chalmers,105,21.6166666666667,22,-0.383333333333333,59,47,12,9,3
21700033,201936,MEM,GSW,Tyreke Evans,115,23.2,23,0.199999999999999,53,53,0,-2,2
21700033,202718,MEM,GSW,Chandler Parsons,79,15.2,15,0.200000000000001,35,31,4,8,-4
21700033,203516,MEM,GSW,James Ennis III,114,24.55,25,-0.449999999999999,63,50,13,13,0
21700033,1626150,MEM,GSW,Andrew Harrison,67,14.4666666666667,15,-0.533333333333333,34,26,8,8,0
21700033,1626185,MEM,GSW,Jarell Martin,126,28.6333333333333,29,-0.366666666666667,63,59,4,0,4
21700033,1628415,MEM,GSW,Dillon Brooks,153,32.1666666666667,32,0.166666666666664,73,73,0,0,0
21700034,1891,MIL,POR,Jason Terry,22,4.96666666666667,5,-0.0333333333333332,9,14,-5,-5,0
21700034,202328,MIL,POR,Greg Monroe,35,6.83333333333333,7,-0.166666666666666,12,17,-5,-3,-2
21700034,202732,MIL,POR,DeAndre Liggins,90,18.8333333333333,18,0.833333333333332,45,39,6,10,-4
21700034,203089,MIL,POR,John Henson,116,24.3166666666667,24,0.316666666666666,62,53,9,9,0
21700034,203114,MIL,POR,Khris Middleton,136,29.7833333333333,30,-0.216666666666665,68,63,5,-1,6
21700034,203141,MIL,POR,Mirza Teletovic,86,17.3333333333333,17,0.333333333333336,45,40,5,-2,7
21700034,203503,MIL,POR,Tony Snell,164,34.15,34,0.150000000000006,82,82,0,-8,8
21700034,203507,MIL,POR,Giannis Antetokounmpo,186,38.8833333333333,39,-0.116666666666667,90,89,1,0,1
21700034,203521,MIL,POR,Matthew Dellavedova,74,15.9333333333333,16,-0.0666666666666664,37,36,1,-1,2
21700034,1627748,MIL,POR,Thon Maker,82,17.7166666666667,18,-0.283333333333331,41,44,-3,-9,6
21700034,1627763,MIL,POR,Malcolm Brogdon,149,31.1666666666667,31,0.166666666666664,74,68,6,0,6
21700034,202323,POR,MIL,Evan Turner,156,32.7666666666667,33,-0.233333333333334,76,80,-4,-2,-2
21700034,202329,POR,MIL,Al-Farouq Aminu,123,25.5666666666667,25,0.566666666666666,58,57,1,2,-1
21700034,202334,POR,MIL,Ed Davis,69,16,16,0,37,34,3,4,-1
21700034,203081,POR,MIL,Damian Lillard,165,34.2833333333333,34,0.283333333333331,75,83,-8,0,-8
21700034,203090,POR,MIL,Maurice Harkless,176,37.5166666666667,38,-0.483333333333334,84,89,-5,6,-11
21700034,203468,POR,MIL,CJ McCollum,177,37.3166666666667,37,0.316666666666663,90,88,2,6,-4
21700034,203894,POR,MIL,Shabazz Napier,25,5.81666666666667,6,-0.183333333333334,12,16,-4,-2,-2
21700034,203994,POR,MIL,Jusuf Nurkic,159,31.9833333333333,32,-0.0166666666666657,72,79,-7,-2,-5
21700034,1626192,POR,MIL,Pat Connaughton,90,18.6666666666667,19,-0.333333333333336,41,39,2,-2,4
21700035,200794,DEN,SAC,Paul Millsap,131,29.0333333333333,29,0.0333333333333314,52,43,9,8,1
21700035,201163,DEN,SAC,Wilson Chandler,131,29.4666666666667,30,-0.533333333333331,45,40,5,5,0
21700035,202702,DEN,SAC,Kenneth Faried,103,22.65,23,-0.350000000000001,55,43,12,10,2
21700035,203115,DEN,SAC,Will Barton,137,28.2166666666667,28,0.216666666666669,64,54,10,12,-2
21700035,203486,DEN,SAC,Mason Plumlee,59,10.75,11,-0.25,19,25,-6,-6,0
21700035,203914,DEN,SAC,Gary Harris,137,30,30,0,59,47,12,14,-2
21700035,203999,DEN,SAC,Nikola Jokic,134,29.8166666666667,30,-0.183333333333334,55,36,19,21,-2
21700035,1626144,DEN,SAC,Emmanuel Mudiay,136,27.9,28,-0.100000000000001,64,54,10,10,0
21700035,1626168,DEN,SAC,Trey Lyles,15,3.31666666666667,3,0.316666666666666,11,11,0,1,-1
21700035,1627736,DEN,SAC,Malik Beasley,6,1.26666666666667,1,0.266666666666667,4,5,-1,-3,2
21700035,1627750,DEN,SAC,Jamal Murray,85,19.8833333333333,20,-0.116666666666667,32,25,7,7,0
21700035,1627823,DEN,SAC,Juancho Hernangomez,31,6.61666666666667,7,-0.383333333333333,20,12,8,6,2
21700035,1713,SAC,DEN,Vince Carter,29,5.55,6,-0.45,8,11,-3,-3,0
21700035,2216,SAC,DEN,Zach Randolph,85,19.6333333333333,20,-0.366666666666667,22,35,-13,-13,0
21700035,201585,SAC,DEN,Kosta Koufos,78,15.3833333333333,16,-0.616666666666667,28,32,-4,-4,0
21700035,201588,SAC,DEN,George Hill,98,22.3166666666667,22,0.316666666666666,29,37,-8,-8,0
21700035,202066,SAC,DEN,Garrett Temple,84,16.7333333333333,17,-0.266666666666666,24,35,-11,-11,0
21700035,203960,SAC,DEN,JaKarr Sampson,26,5.78333333333333,6,-0.216666666666667,16,17,-1,-1,0
21700035,1626161,SAC,DEN,Willie Cauley-Stein,117,26.6166666666667,27,-0.383333333333333,35,47,-12,-12,0
21700035,1627741,SAC,DEN,Buddy Hield,93,22.7666666666667,22,0.766666666666666,27,37,-10,-10,0
21700035,1627746,SAC,DEN,Skal Labissiere,121,25,25,0,55,52,3,5,-2
21700035,1627781,SAC,DEN,Malachi Richardson,67,14.2333333333333,14,0.233333333333334,33,37,-4,-4,0
21700035,1628368,SAC,DEN,De'Aaron Fox,143,28.6833333333333,29,-0.316666666666666,61,65,-4,-6,2
21700035,1628382,SAC,DEN,Justin Jackson,88,19.25,20,-0.75,24,32,-8,-8,0
21700035,1628412,SAC,DEN,Frank Mason,76,16.9666666666667,17,-0.0333333333333314,33,43,-10,-10,0
21700036,2546,OKC,UTA,Carmelo Anthony,158,36.3833333333333,37,-0.616666666666667,70,76,-6,-6,0
21700036,101109,OKC,UTA,Raymond Felton,73,17.6,18,-0.399999999999999,31,27,4,1,3
21700036,201566,OKC,UTA,Russell Westbrook,160,36.0166666666667,36,0.0166666666666657,61,80,-19,-18,-1
21700036,202331,OKC,UTA,Paul George,169,37.1833333333333,38,-0.81666666666667,65,79,-14,-14,0
21700036,202335,OKC,UTA,Patrick Patterson,46,11.7166666666667,12,-0.283333333333333,19,22,-3,-5,2
21700036,203460,OKC,UTA,Andre Roberson,60,13.1833333333333,14,-0.816666666666666,25,28,-3,-3,0
21700036,203500,OKC,UTA,Steven Adams,149,33.1666666666667,33,0.166666666666664,61,71,-10,-6,-4
21700036,203518,OKC,UTA,Alex Abrines,133,29.8166666666667,29,0.81666666666667,59,56,3,5,-2
21700036,203924,OKC,UTA,Jerami Grant,62,13.1166666666667,13,0.116666666666667,18,23,-5,-6,1
21700036,203962,OKC,UTA,Josh Huestis,7,1.45,2,-0.55,6,0,6,5,1
21700036,1628390,OKC,UTA,Terrance Ferguson,38,9.95,10,-0.0500000000000007,20,18,2,2,0
21700036,2207,UTA,OKC,Joe Johnson,105,22.1,22,0.100000000000001,43,35,8,8,0
21700036,200757,UTA,OKC,Thabo Sefolosha,126,27.6833333333333,28,-0.316666666666666,51,45,6,6,0
21700036,201937,UTA,OKC,Ricky Rubio,165,36.8333333333333,37,-0.166666666666671,80,67,13,13,0
21700036,202324,UTA,OKC,Derrick Favors,102,24.85,25,-0.149999999999999,53,50,3,3,0
21700036,202327,UTA,OKC,Ekpe Udoh,63,15.4666666666667,16,-0.533333333333333,30,22,8,11,-3
21700036,202692,UTA,OKC,Alec Burks,82,19.4,20,-0.600000000000001,39,36,3,4,-1
21700036,203497,UTA,OKC,Rudy Gobert,148,32.45,32,0.450000000000003,66,65,1,-2,3
21700036,203526,UTA,OKC,Raul Neto,45,10.75,11,-0.25,16,18,-2,-2,0
21700036,204060,UTA,OKC,Joe Ingles,114,26.6833333333333,27,-0.31666666666667,57,54,3,3,0
21700036,1626220,UTA,OKC,Royce O'Neale,4,0.966666666666667,1,-0.0333333333333333,0,2,-2,-2,0
21700036,1628378,UTA,OKC,Donovan Mitchell,101,22.4,22,0.399999999999999,45,41,4,3,1
21700037,101150,LAC,PHX,Lou Williams,119,24.1666666666667,24,0.166666666666664,71,50,21,16,5
21700037,201568,LAC,PHX,Danilo Gallinari,132,29.65,30,-0.350000000000001,70,47,23,24,-1
21700037,201599,LAC,PHX,DeAndre Jordan,123,27.35,28,-0.649999999999999,68,45,23,21,2
21700037,201933,LAC,PHX,Blake Griffin,130,27.5833333333333,28,-0.416666666666668,64,48,16,15,1
21700037,201976,LAC,PHX,Patrick Beverley,119,26.0333333333333,26,0.0333333333333314,66,44,22,21,1
21700037,202325,LAC,PHX,Wesley Johnson,68,14.2333333333333,14,0.233333333333334,35,29,6,5,1
21700037,203085,LAC,PHX,Austin Rivers,154,32.6833333333333,33,-0.31666666666667,85,53,32,35,-3
21700037,203186,LAC,PHX,Willie Reed,64,13.1666666666667,13,0.166666666666668,35,26,9,10,-1
21700037,1626149,LAC,PHX,Montrezl Harrell,39,7.43333333333333,7,0.433333333333334,27,16,11,11,0
21700037,1626155,LAC,PHX,Sam Dekker,66,13.6833333333333,14,-0.316666666666666,49,30,19,19,0
21700037,1627744,LAC,PHX,Brice Johnson,34,6.36666666666667,6,0.366666666666667,27,11,16,16,0
21700037,1628414,LAC,PHX,Sindarius Thornwell,35,6.81666666666667,7,-0.183333333333334,27,13,14,14,0
21700037,1628462,LAC,PHX,Milos Teodosic,47,10.5833333333333,11,-0.416666666666668,26,23,3,3,0
21700037,2199,PHX,LAC,Tyson Chandler,108,23.45,24,-0.550000000000001,41,57,-16,-14,-2
21700037,202339,PHX,LAC,Eric Bledsoe,109,23.4166666666667,24,-0.583333333333336,37,60,-23,-23,0
21700037,203458,PHX,LAC,Alex Len,113,24.3333333333333,24,0.333333333333332,51,65,-14,-17,3
21700037,203584,PHX,LAC,Troy Daniels,45,9.63333333333333,10,-0.366666666666667,15,31,-16,-13,-3
21700037,203933,PHX,LAC,T.J. Warren,93,21.2166666666667,21,0.216666666666669,34,46,-12,-17,5
21700037,1626164,PHX,LAC,Devin Booker,150,32.0166666666667,32,0.0166666666666657,58,78,-20,-21,1
21700037,1627733,PHX,LAC,Dragan Bender,92,18.45,19,-0.550000000000001,38,64,-26,-22,-4
21700037,1627737,PHX,LAC,Marquese Chriss,76,15.8333333333333,16,-0.166666666666668,32,43,-11,-5,-6
21700037,1627755,PHX,LAC,Tyler Ulis,40,7.76666666666667,8,-0.233333333333333,17,27,-10,-10,0
21700037,1627884,PHX,LAC,Derrick Jones Jr.,34,6.36666666666667,6,0.366666666666667,11,27,-16,-16,0
21700037,1628367,PHX,LAC,Josh Jackson,131,28.8666666666667,29,-0.133333333333333,48,66,-18,-22,4
21700037,1628409,PHX,LAC,Alec Peters,22,3.86666666666667,4,-0.133333333333333,3,16,-13,-11,-2
21700037,1628455,PHX,LAC,Mike James,117,24.5333333333333,24,0.533333333333331,50,70,-20,-19,-1
21700038,101141,ATL,BKN,Ersan Ilyasova,116,22.0333333333333,22,0.0333333333333314,41,42,-1,-3,2
21700038,201158,ATL,BKN,Marco Belinelli,176,30.55,31,-0.450000000000003,73,77,-4,-3,-1
21700038,202337,ATL,BKN,Luke Babbitt,29,5.96666666666667,6,-0.0333333333333332,12,21,-9,-9,0
21700038,203145,ATL,BKN,Kent Bazemore,173,31.45,32,-0.550000000000001,67,75,-8,-3,-5
21700038,203471,ATL,BKN,Dennis Schroder,168,31.7166666666667,31,0.716666666666665,64,78,-14,-12,-2
21700038,203473,ATL,BKN,Dewayne Dedmon,103,20.6333333333333,21,-0.366666666666667,39,47,-8,-8,0
21700038,203488,ATL,BKN,Mike Muscala,143,25.4333333333333,25,0.43333333333333,60,64,-4,-2,-2
21700038,203705,ATL,BKN,Josh Magette,15,3.1,3,0.1,7,10,-3,-3,0
21700038,1627098,ATL,BKN,Malcolm Delaney,120,22.1833333333333,22,0.183333333333334,51,56,-5,-9,4
21700038,1627752,ATL,BKN,Taurean Prince,119,22.2666666666667,23,-0.733333333333334,41,51,-10,-9,-1
21700038,1627819,ATL,BKN,Isaiah Taylor,7,1.41666666666667,1,0.416666666666667,7,2,5,0,5
21700038,1628381,ATL,BKN,John Collins,123,20.8,21,-0.199999999999999,56,55,1,1,0
21700038,1628416,ATL,BKN,Tyler Dorsey,3,0.783333333333333,1,-0.216666666666667,2,2,0,0,0
21700038,201960,BKN,ATL,DeMarre Carroll,152,27.65,28,-0.350000000000001,69,50,19,19,0
21700038,202344,BKN,ATL,Trevor Booker,147,27.9166666666667,28,-0.0833333333333357,80,62,18,16,2
21700038,202389,BKN,ATL,Timofey Mozgov,87,17.3666666666667,18,-0.633333333333333,40,33,7,9,-2
21700038,203112,BKN,ATL,Quincy Acy,64,11.55,11,0.550000000000001,26,25,1,5,-4
21700038,203459,BKN,ATL,Allen Crabbe,146,25.8166666666667,26,-0.183333333333334,69,60,9,13,-4
21700038,203915,BKN,ATL,Spencer Dinwiddie,102,18.6166666666667,19,-0.383333333333333,48,44,4,1,3
21700038,203925,BKN,ATL,Joe Harris,90,17.1,17,0.100000000000001,42,43,-1,-2,1
21700038,1626156,BKN,ATL,D'Angelo Russell,157,29.05,29,0.0499999999999972,68,60,8,11,-3
21700038,1626178,BKN,ATL,Rondae Hollis-Jefferson,105,19.1,19,0.100000000000001,31,45,-14,-18,4
21700038,1627747,BKN,ATL,Caris LeVert,153,29.4166666666667,30,-0.583333333333336,69,60,9,6,3
21700038,1628386,BKN,ATL,Jarrett Allen,92,14.75,15,-0.25,38,38,0,0,0
21700039,2037,MIN,OKC,Jamal Crawford,74,15.85,16,-0.15,27,45,-18,-19,1
21700039,201952,MIN,OKC,Jeff Teague,194,39.0166666666667,39,0.0166666666666657,101,86,15,14,1
21700039,201959,MIN,OKC,Taj Gibson,164,33.1833333333333,33,0.183333333333337,91,71,20,21,-1
21700039,202357,MIN,OKC,Nemanja Bjelica,41,8.7,9,-0.300000000000001,16,24,-8,-8,0
21700039,202710,MIN,OKC,Jimmy Butler,193,39.3,39,0.299999999999997,99,89,10,10,0
21700039,203476,MIN,OKC,Gorgui Dieng,57,12.5833333333333,12,0.583333333333332,26,26,0,0,0
21700039,203498,MIN,OKC,Shabazz Muhammad,37,7.56666666666667,8,-0.433333333333334,14,26,-12,-13,1
21700039,203952,MIN,OKC,Andrew Wiggins,193,39.4,39,0.399999999999999,98,84,14,15,-1
21700039,1626145,MIN,OKC,Tyus Jones,40,8.98333333333333,9,-0.0166666666666657,14,27,-13,-12,-1
21700039,1626157,MIN,OKC,Karl-Anthony Towns,177,35.4166666666667,36,-0.583333333333336,89,87,2,2,0
21700039,2546,OKC,MIN,Carmelo Anthony,185,37.2166666666667,37,0.216666666666669,94,84,10,12,-2
21700039,101109,OKC,MIN,Raymond Felton,89,18.65,18,0.649999999999999,54,33,21,23,-2
21700039,201566,OKC,MIN,Russell Westbrook,180,36.7333333333333,37,-0.266666666666666,80,97,-17,-17,0
21700039,202331,OKC,MIN,Paul George,180,36.85,37,-0.149999999999999,86,88,-2,-4,2
21700039,202335,OKC,MIN,Patrick Patterson,28,5.68333333333333,6,-0.316666666666666,10,15,-5,-6,1
21700039,203460,OKC,MIN,Andre Roberson,105,21.7833333333333,22,-0.216666666666669,38,59,-21,-21,0
21700039,203500,OKC,MIN,Steven Adams,172,35.3166666666667,35,0.316666666666663,78,95,-17,-17,0
21700039,203518,OKC,MIN,Alex Abrines,68,14.3166666666667,14,0.316666666666666,44,29,15,13,2
21700039,203924,OKC,MIN,Jerami Grant,90,18.9666666666667,19,-0.0333333333333314,46,38,8,7,1
21700039,203962,OKC,MIN,Josh Huestis,73,14.4833333333333,14,0.483333333333333,35,37,-2,0,-2
21700040,2749,NOP,LAL,Jameer Nelson,115,23.65,24,-0.350000000000001,69,63,6,4,2
21700040,2754,NOP,LAL,Tony Allen,37,7.53333333333333,8,-0.466666666666667,22,21,1,-1,2
21700040,201950,NOP,LAL,Jrue Holiday,186,37.85,38,-0.150000000000006,91,87,4,4,0
21700040,201967,NOP,LAL,Dante Cunningham,128,26.0666666666667,26,0.0666666666666664,61,50,11,9,2
21700040,202326,NOP,LAL,DeMarcus Cousins,173,35.7,36,-0.299999999999997,92,84,8,6,2
21700040,202734,NOP,LAL,E'Twaun Moore,154,32.1833333333333,32,0.183333333333337,76,62,14,18,-4
21700040,203076,NOP,LAL,Anthony Davis,190,38.6166666666667,39,-0.383333333333333,93,87,6,8,-2
21700040,203121,NOP,LAL,Darius Miller,66,13.1666666666667,13,0.166666666666668,36,35,1,3,-2
21700040,203546,NOP,LAL,Ian Clark,116,23.5666666666667,24,-0.433333333333334,55,71,-16,-16,0
21700040,101106,LAL,NOP,Andrew Bogut,44,8.91666666666667,9,-0.0833333333333322,20,19,1,1,0
21700040,201147,LAL,NOP,Corey Brewer,44,8.65,9,-0.350000000000001,18,29,-11,-11,0
21700040,201572,LAL,NOP,Brook Lopez,90,17.5333333333333,18,-0.466666666666669,36,47,-11,-9,-2
21700040,203484,LAL,NOP,Kentavious Caldwell-Pope,156,30.8333333333333,31,-0.166666666666664,62,80,-18,-19,1
21700040,203898,LAL,NOP,Tyler Ennis,15,3.35,3,0.35,6,14,-8,-8,0
21700040,203903,LAL,NOP,Jordan Clarkson,118,24.95,26,-1.05,66,61,5,4,1
21700040,203944,LAL,NOP,Julius Randle,114,23.8166666666667,24,-0.183333333333334,63,63,0,2,-2
21700040,1626204,LAL,NOP,Larry Nance Jr.,75,14.9333333333333,15,-0.0666666666666664,29,37,-8,-10,2
21700040,1627742,LAL,NOP,Brandon Ingram,122,24.4833333333333,24,0.483333333333334,65,53,12,16,-4
21700040,1628366,LAL,NOP,Lonzo Ball,180,36.2166666666667,36,0.216666666666669,75,97,-22,-24,2
21700040,1628398,LAL,NOP,Kyle Kuzma,143,30.1333333333333,30,0.133333333333333,76,72,4,2,2
21700040,1628404,LAL,NOP,Josh Hart,64,14.5166666666667,15,-0.483333333333334,44,23,21,21,0
21700041,101161,PHI,DET,Amir Johnson,92,18.65,19,-0.350000000000001,28,41,-13,-11,-2
21700041,200755,PHI,DET,JJ Redick,146,32.9333333333333,34,-1.06666666666666,66,46,20,20,0
21700041,201573,PHI,DET,Jerryd Bayless,147,31.8,32,-0.200000000000003,65,61,4,4,0
21700041,203496,PHI,DET,Robert Covington,158,34.1333333333333,35,-0.866666666666667,67,59,8,8,0
21700041,203954,PHI,DET,Joel Embiid,121,27.6833333333333,28,-0.316666666666666,65,42,23,21,2
21700041,203967,PHI,DET,Dario Saric,92,19.95,20,-0.0500000000000007,37,41,-4,-4,0
21700041,204456,PHI,DET,T.J. McConnell,76,15.7333333333333,16,-0.266666666666666,36,33,3,2,1
21700041,1627732,PHI,DET,Ben Simmons,155,33.1666666666667,34,-0.833333333333329,70,57,13,12,1
21700041,1627789,PHI,DET,Timothe Luwawu-Cabarrot,39,7.61666666666667,8,-0.383333333333333,20,19,1,1,0
21700041,1628365,PHI,DET,Markelle Fultz,74,16.4166666666667,16,0.416666666666668,31,31,0,2,-2
21700041,201229,DET,PHI,Anthony Tolliver,84,19.3166666666667,20,-0.683333333333334,30,43,-13,-15,2
21700041,202340,DET,PHI,Avery Bradley,172,37.4833333333333,38,-0.516666666666666,67,69,-2,-4,2
21700041,202397,DET,PHI,Ish Smith,82,16.9166666666667,17,-0.0833333333333357,34,39,-5,-5,0
21700041,202699,DET,PHI,Tobias Harris,150,32.9833333333333,33,-0.0166666666666657,55,62,-7,-7,0
21700041,202704,DET,PHI,Reggie Jackson,139,30.7,31,-0.300000000000001,52,59,-7,-6,-1
21700041,202720,DET,PHI,Jon Leuer,75,15.9333333333333,16,-0.0666666666666664,30,34,-4,-2,-2
21700041,203083,DET,PHI,Andre Drummond,174,37.8666666666667,38,-0.133333333333333,69,80,-11,-11,0
21700041,204038,DET,PHI,Langston Galloway,65,12.8166666666667,13,-0.183333333333334,34,17,17,17,0
21700041,1626169,DET,PHI,Stanley Johnson,79,17.4666666666667,18,-0.533333333333331,26,44,-18,-18,0
21700041,1628379,DET,PHI,Luke Kennard,80,16.6,17,-0.399999999999999,33,38,-5,-4,-1
21700042,201158,ATL,MIA,Marco Belinelli,124,26.8166666666667,27,-0.183333333333334,63,61,2,3,-1
21700042,202337,ATL,MIA,Luke Babbitt,110,23.4333333333333,23,0.43333333333333,55,62,-7,-8,1
21700042,203145,ATL,MIA,Kent Bazemore,148,30.7333333333333,31,-0.266666666666666,54,61,-7,-6,-1
21700042,203473,ATL,MIA,Dewayne Dedmon,138,29.5833333333333,30,-0.416666666666664,48,60,-12,-11,-1
21700042,203488,ATL,MIA,Mike Muscala,104,22.75,23,-0.25,35,37,-2,0,-2
21700042,1627098,ATL,MIA,Malcolm Delaney,151,33,33,0,59,74,-15,-17,2
21700042,1627752,ATL,MIA,Taurean Prince,171,36.7833333333333,37,-0.216666666666669,74,78,-4,-4,0
21700042,1627819,ATL,MIA,Isaiah Taylor,64,13.1333333333333,13,0.133333333333333,29,32,-3,-4,1
21700042,1628381,ATL,MIA,John Collins,85,18.3,18,0.299999999999997,45,44,1,0,1
21700042,1628416,ATL,MIA,Tyler Dorsey,20,4.88333333333333,5,-0.116666666666667,3,11,-8,-8,0
21700042,201609,MIA,ATL,Goran Dragic,154,32.4,33,-0.600000000000001,74,71,3,3,0
21700042,201949,MIA,ATL,James Johnson,126,26,26,0,59,52,7,7,0
21700042,201961,MIA,ATL,Wayne Ellington,112,25.05,25,0.0500000000000007,59,44,15,15,0
21700042,203079,MIA,ATL,Dion Waiters,108,22.85,23,-0.149999999999999,43,42,1,1,0
21700042,203482,MIA,ATL,Kelly Olynyk,132,29.2333333333333,29,0.233333333333334,65,60,5,7,-2
21700042,204020,MIA,ATL,Tyler Johnson,119,26.8333333333333,27,-0.166666666666668,55,53,2,4,-2
21700042,1626159,MIA,ATL,Justise Winslow,119,26.1833333333333,26,0.18333333333333,58,51,7,7,0
21700042,1626175,MIA,ATL,Jordan Mickey,69,14.35,15,-0.65,26,23,3,1,2
21700042,1626196,MIA,ATL,Josh Richardson,176,36.5166666666667,37,-0.483333333333334,81,69,12,10,2
21700043,2403,HOU,MEM,Nene,75,15.65,16,-0.35,26,31,-5,-2,-3
21700043,2772,HOU,MEM,Trevor Ariza,170,39.6166666666667,40,-0.383333333333333,73,86,-13,-15,2
21700043,200782,HOU,MEM,PJ Tucker,129,28.45,28,0.449999999999999,43,59,-16,-16,0
21700043,201569,HOU,MEM,Eric Gordon,140,33.15,33,0.150000000000006,71,61,10,9,1
21700043,201583,HOU,MEM,Ryan Anderson,132,31.25,31,0.25,69,58,11,12,-1
21700043,201601,HOU,MEM,Luc Mbah a Moute,130,28.1666666666667,28,0.166666666666664,46,58,-12,-10,-2
21700043,201935,HOU,MEM,James Harden,150,34.7166666666667,35,-0.283333333333331,66,79,-13,-14,1
21700043,203991,HOU,MEM,Clint Capela,102,24.65,25,-0.350000000000001,54,52,2,0,2
21700043,1627743,HOU,MEM,Demetrius Jackson,17,3.6,4,-0.4,2,6,-4,-4,0
21700043,201144,MEM,HOU,Mike Conley,118,27.8833333333333,28,-0.116666666666667,62,50,12,6,6
21700043,201148,MEM,HOU,Brandan Wright,46,10.5166666666667,10,0.516666666666666,14,19,-5,-9,4
21700043,201188,MEM,HOU,Marc Gasol,163,37.3333333333333,38,-0.666666666666671,84,71,13,17,-4
21700043,201596,MEM,HOU,Mario Chalmers,114,25.5833333333333,26,-0.416666666666664,55,37,18,19,-1
21700043,201936,MEM,HOU,Tyreke Evans,104,23.1833333333333,23,0.183333333333334,47,37,10,11,-1
21700043,202718,MEM,HOU,Chandler Parsons,75,15.6166666666667,16,-0.383333333333333,27,27,0,0,0
21700043,203516,MEM,HOU,James Ennis III,159,37.35,37,0.350000000000001,80,70,10,10,0
21700043,1626150,MEM,HOU,Andrew Harrison,82,19.9,20,-0.100000000000001,37,51,-14,-13,-1
21700043,1626185,MEM,HOU,Jarell Martin,84,20.7666666666667,21,-0.233333333333334,43,49,-6,-6,0
21700043,1628415,MEM,HOU,Dillon Brooks,100,21.1166666666667,21,0.116666666666667,41,39,2,5,-3
21700044,202328,MIL,CHA,Greg Monroe,94,21.2833333333333,21,0.283333333333331,50,47,3,5,-2
21700044,202732,MIL,CHA,DeAndre Liggins,92,20.8666666666667,21,-0.133333333333333,28,44,-16,-12,-4
21700044,203089,MIL,CHA,John Henson,53,11.8666666666667,12,-0.133333333333333,20,17,3,3,0
21700044,203114,MIL,CHA,Khris Middleton,160,34.6833333333333,35,-0.316666666666663,72,64,8,10,-2
21700044,203141,MIL,CHA,Mirza Teletovic,102,23.6333333333333,24,-0.366666666666667,49,49,0,0,0
21700044,203503,MIL,CHA,Tony Snell,170,36.9833333333333,37,-0.0166666666666657,92,70,22,22,0
21700044,203507,MIL,CHA,Giannis Antetokounmpo,181,39.25,39,0.25,89,80,9,7,2
21700044,203521,MIL,CHA,Matthew Dellavedova,152,32.6333333333333,33,-0.366666666666667,80,59,21,17,4
21700044,1627748,MIL,CHA,Thon Maker,71,14.7166666666667,16,-1.28333333333333,33,30,3,1,2
21700044,1627780,MIL,CHA,Gary Payton II,15,3.41666666666667,3,0.416666666666667,2,10,-8,-8,0
21700044,2730,CHA,MIL,Dwight Howard,154,34.05,34,0.0499999999999972,67,64,3,5,-2
21700044,101107,CHA,MIL,Marvin Williams,131,27.75,28,-0.25,54,50,4,0,4
21700044,202689,CHA,MIL,Kemba Walker,154,34.05,34,0.0499999999999972,67,64,3,5,-2
21700044,203087,CHA,MIL,Jeremy Lamb,156,33.9333333333333,34,-0.0666666666666629,65,81,-16,-18,2
21700044,203948,CHA,MIL,Johnny O'Bryant III,64,13.8166666666667,14,-0.183333333333334,27,39,-12,-12,0
21700044,1626163,CHA,MIL,Frank Kaminsky,151,33.7333333333333,34,-0.266666666666666,68,78,-10,-6,-4
21700044,1626203,CHA,MIL,Treveon Graham,87,20.1166666666667,20,0.116666666666667,40,53,-13,-7,-6
21700044,1628370,CHA,MIL,Malik Monk,82,17.4333333333333,18,-0.56666666666667,35,45,-10,-10,0
21700044,1628407,CHA,MIL,Dwayne Bacon,111,24.45,24,0.449999999999999,47,41,6,8,-2
21700045,1717,DAL,GSW,Dirk Nowitzki,148,29.05,29,0.0500000000000007,60,91,-31,-29,-2
21700045,200826,DAL,GSW,J.J. Barea,135,25.8666666666667,26,-0.133333333333333,61,66,-5,-3,-2
21700045,202083,DAL,GSW,Wesley Matthews,170,33.7333333333333,34,-0.266666666666666,71,96,-25,-21,-4
21700045,203084,DAL,GSW,Harrison Barnes,154,30.85,31,-0.150000000000002,61,79,-18,-20,2
21700045,203457,DAL,GSW,Nerlens Noel,58,11.1833333333333,12,-0.816666666666666,24,25,-1,-3,2
21700045,203481,DAL,GSW,Jeff Withey,27,5.08333333333333,5,0.083333333333333,14,16,-2,-2,0
21700045,203939,DAL,GSW,Dwight Powell,99,19.5333333333333,19,0.533333333333331,47,55,-8,-6,-2
21700045,1627812,DAL,GSW,Yogi Ferrell,175,34.9,35,-0.100000000000001,71,92,-21,-21,0
21700045,1627827,DAL,GSW,Dorian Finney-Smith,39,7.25,7,0.25,17,16,1,-1,2
21700045,1628372,DAL,GSW,Dennis Smith Jr.,149,29.85,30,-0.149999999999999,60,92,-32,-34,2
21700045,1628467,DAL,GSW,Maxi Kleber,32,6.26666666666667,6,0.266666666666667,14,18,-4,-4,0
21700045,1628492,DAL,GSW,Gian Clavell,29,5.68333333333333,6,-0.316666666666666,15,19,-4,-6,2
21700045,2561,GSW,DAL,David West,55,11.6166666666667,12,-0.383333333333333,26,20,6,6,0
21700045,2585,GSW,DAL,Zaza Pachulia,68,13.9833333333333,14,-0.0166666666666657,43,23,20,22,-2
21700045,2733,GSW,DAL,Shaun Livingston,75,15.1833333333333,15,0.183333333333334,33,27,6,4,2
21700045,2738,GSW,DAL,Andre Iguodala,127,24.5166666666667,24,0.516666666666666,65,59,6,4,2
21700045,201142,GSW,DAL,Kevin Durant,165,33.1833333333333,33,0.183333333333337,89,67,22,25,-3
21700045,201156,GSW,DAL,Nick Young,102,19.1166666666667,19,0.116666666666667,52,47,5,6,-1
21700045,201580,GSW,DAL,JaVale McGee,55,10.35,11,-0.65,27,26,1,-4,5
21700045,201939,GSW,DAL,Stephen Curry,161,31.15,31,0.149999999999999,91,69,22,22,0
21700045,201956,GSW,DAL,Omri Casspi,32,6.26666666666667,6,0.266666666666667,18,14,4,4,0
21700045,202691,GSW,DAL,Klay Thompson,135,27.7,28,-0.300000000000001,79,56,23,24,-1
21700045,203110,GSW,DAL,Draymond Green,152,29.5333333333333,30,-0.466666666666665,86,68,18,17,1
21700045,1627775,GSW,DAL,Patrick McCaw,35,6.95,7,-0.0500000000000007,20,14,6,6,0
21700045,1628395,GSW,DAL,Jordan Bell,53,9.7,10,-0.300000000000001,36,25,11,14,-3
21700046,1938,SAS,TOR,Manu Ginobili,109,21.7333333333333,21,0.733333333333334,41,50,-9,-11,2
21700046,2200,SAS,TOR,Pau Gasol,105,21.8666666666667,22,-0.133333333333333,47,41,6,7,-1
21700046,200746,SAS,TOR,LaMarcus Aldridge,176,36.2,36,0.200000000000003,78,67,11,10,1
21700046,200752,SAS,TOR,Rudy Gay,107,22.0166666666667,22,0.0166666666666657,45,44,1,1,0
21700046,201980,SAS,TOR,Danny Green,159,33.9666666666667,34,-0.0333333333333314,75,60,15,15,0
21700046,201988,SAS,TOR,Patty Mills,102,20.7833333333333,21,-0.216666666666669,37,42,-5,-7,2
21700046,203464,SAS,TOR,Brandon Paul,31,7.01666666666667,7,0.0166666666666666,17,15,2,2,0
21700046,203530,SAS,TOR,Joffrey Lauvergne,85,16.35,16,0.350000000000001,27,40,-13,-15,2
21700046,203937,SAS,TOR,Kyle Anderson,133,27.9833333333333,28,-0.0166666666666657,57,58,-1,-1,0
21700046,1627749,SAS,TOR,Dejounte Murray,135,27.8833333333333,28,-0.116666666666667,66,54,12,13,-1
21700046,1627854,SAS,TOR,Bryn Forbes,28,4.11666666666667,4,0.116666666666666,15,9,6,6,0
21700046,101139,TOR,SAS,CJ Miles,120,24.9833333333333,25,-0.0166666666666657,50,58,-8,-7,-1
21700046,200768,TOR,SAS,Kyle Lowry,173,34.95,35,-0.0499999999999972,67,76,-9,-8,-1
21700046,201586,TOR,SAS,Serge Ibaka,124,25.4,25,0.399999999999999,49,51,-2,-4,2
21700046,201942,TOR,SAS,DeMar DeRozan,172,35.4666666666667,36,-0.533333333333331,70,76,-6,-1,-5
21700046,203512,TOR,SAS,Lucas Nogueira,87,18.9666666666667,19,-0.0333333333333314,30,39,-9,-10,1
21700046,1626153,TOR,SAS,Delon Wright,123,25.8833333333333,25,0.883333333333333,51,58,-7,-9,2
21700046,1626181,TOR,SAS,Norman Powell,108,22.3,22,0.300000000000001,44,38,6,6,0
21700046,1627751,TOR,SAS,Jakob Poeltl,136,26.0166666666667,26,0.0166666666666657,62,53,9,13,-4
21700046,1627832,TOR,SAS,Fred VanVleet,56,11.5,11,0.5,24,25,-1,-3,2
21700046,1628384,TOR,SAS,OG Anunoby,71,14.45,15,-0.550000000000001,33,31,2,3,-1
21700047,200794,DEN,WAS,Paul Millsap,145,30.45,30,0.450000000000003,63,67,-4,-4,0
21700047,201163,DEN,WAS,Wilson Chandler,156,32.1166666666667,32,0.116666666666667,64,79,-15,-15,0
21700047,202702,DEN,WAS,Kenneth Faried,51,11.1666666666667,12,-0.833333333333334,25,27,-2,-1,-1
21700047,203115,DEN,WAS,Will Barton,148,29.7166666666667,30,-0.283333333333331,74,71,3,5,-2
21700047,203486,DEN,WAS,Mason Plumlee,67,12.8833333333333,13,-0.116666666666667,29,30,-1,-2,1
21700047,203914,DEN,WAS,Gary Harris,162,33.7166666666667,34,-0.283333333333331,69,75,-6,-7,1
21700047,203999,DEN,WAS,Nikola Jokic,164,34.7833333333333,35,-0.216666666666669,75,76,-1,-1,0
21700047,1626144,DEN,WAS,Emmanuel Mudiay,97,18.7666666666667,19,-0.233333333333334,44,42,2,2,0
21700047,1627736,DEN,WAS,Malik Beasley,38,6.86666666666667,7,-0.133333333333333,17,9,8,7,1
21700047,1627750,DEN,WAS,Jamal Murray,137,29.5333333333333,29,0.533333333333331,60,69,-9,-9,0
21700047,101133,WAS,DEN,Ian Mahinmi,94,18.3333333333333,19,-0.666666666666668,44,42,2,5,-3
21700047,101162,WAS,DEN,Marcin Gortat,132,28.6166666666667,29,-0.383333333333333,58,58,0,0,0
21700047,201975,WAS,DEN,Jodie Meeks,82,15.7166666666667,16,-0.283333333333335,32,36,-4,-4,0
21700047,202322,WAS,DEN,John Wall,168,35.25,35,0.25,83,77,6,5,1
21700047,203078,WAS,DEN,Bradley Beal,165,35.05,35,0.0499999999999972,79,76,3,5,-2
21700047,203107,WAS,DEN,Tomas Satoransky,25,5.16666666666667,5,0.166666666666666,13,14,-1,-3,2
21700047,203118,WAS,DEN,Mike Scott,88,17.4833333333333,18,-0.516666666666666,41,41,0,-3,3
21700047,203490,WAS,DEN,Otto Porter Jr.,157,32.3,32,0.299999999999997,75,65,10,12,-2
21700047,204025,WAS,DEN,Tim Frazier,73,14.2666666666667,14,0.266666666666666,30,32,-2,-4,2
21700047,1626162,WAS,DEN,Kelly Oubre Jr.,181,37.8166666666667,38,-0.183333333333337,90,79,11,12,-1
21700048,2199,PHX,SAC,Tyson Chandler,149,30.4166666666667,31,-0.583333333333336,69,74,-5,-9,4
21700048,201162,PHX,SAC,Jared Dudley,23,4.7,5,-0.3,8,9,-1,1,-2
21700048,203458,PHX,SAC,Alex Len,86,17.4833333333333,17,0.483333333333334,45,39,6,8,-2
21700048,203584,PHX,SAC,Troy Daniels,99,19.3,19,0.299999999999997,45,47,-2,-3,1
21700048,203933,PHX,SAC,T.J. Warren,112,23.8666666666667,24,-0.133333333333333,57,47,10,9,1
21700048,1626164,PHX,SAC,Devin Booker,142,28.7666666666667,29,-0.233333333333334,75,66,9,8,1
21700048,1627733,PHX,SAC,Dragan Bender,66,13.9166666666667,14,-0.0833333333333339,23,35,-12,-14,2
21700048,1627737,PHX,SAC,Marquese Chriss,145,29.2166666666667,29,0.216666666666669,83,67,16,14,2
21700048,1627755,PHX,SAC,Tyler Ulis,107,21.3,21,0.299999999999997,53,56,-3,-9,6
21700048,1628367,PHX,SAC,Josh Jackson,130,24.2666666666667,24,0.266666666666666,63,68,-5,-6,1
21700048,1628455,PHX,SAC,Mike James,131,26.6833333333333,27,-0.31666666666667,64,57,7,11,-4
21700048,1713,SAC,PHX,Vince Carter,33,7.01666666666667,7,0.0166666666666666,16,12,4,4,0
21700048,2216,SAC,PHX,Zach Randolph,72,15.2,15,0.200000000000001,23,38,-15,-19,4
21700048,201585,SAC,PHX,Kosta Koufos,108,21.4666666666667,22,-0.533333333333331,58,48,10,8,2
21700048,201588,SAC,PHX,George Hill,126,25.2666666666667,25,0.266666666666666,53,67,-14,-16,2
21700048,202066,SAC,PHX,Garrett Temple,122,23.7333333333333,24,-0.266666666666666,69,59,10,14,-4
21700048,203992,SAC,PHX,Bogdan Bogdanovic,128,25.8333333333333,25,0.833333333333336,64,57,7,15,-8
21700048,1626161,SAC,PHX,Willie Cauley-Stein,138,28.4166666666667,28,0.416666666666668,60,73,-13,-9,-4
21700048,1627741,SAC,PHX,Buddy Hield,80,16.5833333333333,17,-0.416666666666668,28,46,-18,-18,0
21700048,1627746,SAC,PHX,Skal Labissiere,145,28.6666666666667,28,0.666666666666664,81,70,11,15,-4
21700048,1628368,SAC,PHX,De'Aaron Fox,155,30.5,30,0.5,85,69,16,16,0
21700048,1628382,SAC,PHX,Justin Jackson,83,17.2333333333333,17,0.233333333333334,28,46,-18,-20,2
21700049,2544,CLE,CHI,LeBron James,159,36.7833333333333,37,-0.216666666666669,92,87,5,7,-2
21700049,2548,CLE,CHI,Dwyane Wade,86,18.8333333333333,19,-0.166666666666664,50,44,6,8,-2
21700049,2594,CLE,CHI,Kyle Korver,106,22.5833333333333,23,-0.416666666666664,61,52,9,10,-1
21700049,2747,CLE,CHI,JR Smith,135,32.1166666666667,32,0.116666666666667,78,75,3,1,2
21700049,101112,CLE,CHI,Channing Frye,37,7.43333333333333,7,0.433333333333334,25,21,4,4,0
21700049,201145,CLE,CHI,Jeff Green,107,23.5333333333333,24,-0.466666666666669,61,53,8,10,-2
21700049,201567,CLE,CHI,Kevin Love,126,29.3833333333333,29,0.383333333333333,71,70,1,1,0
21700049,202684,CLE,CHI,Tristan Thompson,96,23.55,24,-0.450000000000003,54,56,-2,-4,2
21700049,202697,CLE,CHI,Iman Shumpert,64,13.75,14,-0.25,30,33,-3,-3,0
21700049,203109,CLE,CHI,Jae Crowder,129,30.7,31,-0.299999999999997,73,69,4,1,3
21700049,201577,CHI,CLE,Robin Lopez,123,29.6833333333333,30,-0.316666666666666,74,68,6,10,-4
21700049,202347,CHI,CLE,Quincy Pondexter,66,13.3666666666667,13,0.366666666666667,32,40,-8,-8,0
21700049,203200,CHI,CLE,Justin Holiday,156,36.2666666666667,37,-0.733333333333334,90,82,8,8,0
21700049,1626170,CHI,CLE,Jerian Grant,136,32.25,32,0.25,72,72,0,2,-2
21700049,1626245,CHI,CLE,Cristiano Felicio,76,16.35,16,0.350000000000001,30,42,-12,-17,5
21700049,1627756,CHI,CLE,Denzel Valentine,78,17.1833333333333,17,0.183333333333334,36,44,-8,-8,0
21700049,1627770,CHI,CLE,Kay Felder,73,15.4833333333333,16,-0.516666666666668,40,47,-7,-9,2
21700049,1627835,CHI,CLE,Paul Zipser,144,33.25,34,-0.75,78,80,-2,-1,-1
21700049,1628021,CHI,CLE,David Nwaba,60,13.3666666666667,13,0.366666666666667,32,44,-12,-12,0
21700049,1628374,CHI,CLE,Lauri Markkanen,133,31.4666666666667,32,-0.533333333333335,76,76,0,0,0
21700050,201960,BKN,ORL,DeMarre Carroll,140,27.2666666666667,27,0.266666666666666,65,72,-7,-8,1
21700050,202344,BKN,ORL,Trevor Booker,121,23.9166666666667,24,-0.0833333333333357,46,63,-17,-17,0
21700050,202389,BKN,ORL,Timofey Mozgov,81,16.4833333333333,17,-0.516666666666666,52,38,14,14,0
21700050,203112,BKN,ORL,Quincy Acy,72,13.0666666666667,13,0.0666666666666664,28,29,-1,1,-2
21700050,203459,BKN,ORL,Allen Crabbe,143,25.9666666666667,26,-0.033333333333335,58,69,-11,-12,1
21700050,203915,BKN,ORL,Spencer Dinwiddie,93,18.2166666666667,18,0.216666666666669,46,44,2,5,-3
21700050,203925,BKN,ORL,Joe Harris,87,17.15,18,-0.850000000000001,47,42,5,5,0
21700050,1626156,BKN,ORL,D'Angelo Russell,154,29.7833333333333,30,-0.216666666666669,75,80,-5,-9,4
21700050,1626178,BKN,ORL,Rondae Hollis-Jefferson,126,24.5833333333333,25,-0.416666666666664,77,64,13,10,3
21700050,1627747,BKN,ORL,Caris LeVert,145,28.7333333333333,29,-0.266666666666666,81,75,6,5,1
21700050,1628386,BKN,ORL,Jarrett Allen,73,14.8333333333333,15,-0.166666666666666,30,44,-14,-14,0
21700050,201571,ORL,BKN,D.J. Augustin,142,29.15,29,0.149999999999999,82,63,19,21,-2
21700050,202687,ORL,BKN,Bismack Biyombo,86,16.4333333333333,16,0.433333333333334,39,49,-10,-12,2
21700050,202696,ORL,BKN,Nikola Vucevic,161,31.5666666666667,32,-0.43333333333333,85,72,13,16,-3
21700050,202714,ORL,BKN,Shelvin Mack,89,16.5333333333333,17,-0.466666666666669,36,51,-15,-14,-1
21700050,203082,ORL,BKN,Terrence Ross,142,27.5333333333333,28,-0.466666666666669,74,67,7,10,-3
21700050,203095,ORL,BKN,Evan Fournier,180,36.2833333333333,36,0.283333333333331,102,80,22,22,0
21700050,203613,ORL,BKN,Jonathon Simmons,136,25.4166666666667,25,0.416666666666664,62,71,-9,-11,2
21700050,203932,ORL,BKN,Aaron Gordon,187,36.6166666666667,37,-0.383333333333333,97,87,10,7,3
21700050,1626209,ORL,BKN,Mario Hezonja,41,6.65,7,-0.35,15,23,-8,-7,-1
21700050,1628371,ORL,BKN,Jonathan Isaac,71,13.8166666666667,14,-0.183333333333334,28,42,-14,-12,-2
21700051,201143,BOS,NYK,Al Horford,133,28.4,29,-0.600000000000001,59,48,11,11,0
21700051,202681,BOS,NYK,Kyrie Irving,136,29.5833333333333,30,-0.416666666666671,63,53,10,13,-3
21700051,203382,BOS,NYK,Aron Baynes,103,22.3333333333333,22,0.333333333333336,42,34,8,10,-2
21700051,203499,BOS,NYK,Shane Larkin,86,19.6,20,-0.399999999999999,51,40,11,11,0
21700051,1626179,BOS,NYK,Terry Rozier,134,30.7,31,-0.300000000000004,76,52,24,24,0
21700051,1627759,BOS,NYK,Jaylen Brown,144,31.6833333333333,32,-0.31666666666667,66,55,11,11,0
21700051,1627824,BOS,NYK,Guerschon Yabusele,9,1.96666666666667,2,-0.0333333333333334,7,8,-1,-3,2
21700051,1627846,BOS,NYK,Abdel Nader,23,4.28333333333333,4,0.283333333333333,12,14,-2,-2,0
21700051,1628369,BOS,NYK,Jayson Tatum,138,31.8333333333333,31,0.833333333333332,69,59,10,10,0
21700051,1628400,BOS,NYK,Semi Ojeleye,71,15.6333333333333,16,-0.366666666666667,44,34,10,7,3
21700051,1628444,BOS,NYK,Jabari Bird,14,2.48333333333333,3,-0.516666666666667,7,8,-1,-1,0
21700051,1628464,BOS,NYK,Daniel Theis,89,20.5,21,-0.5,54,40,14,14,0
21700051,101127,NYK,BOS,Jarrett Jack,75,17.9166666666667,18,-0.0833333333333357,37,47,-10,-12,2
21700051,201196,NYK,BOS,Ramon Sessions,116,25.3,26,-0.700000000000003,38,51,-13,-11,-2
21700051,201563,NYK,BOS,Michael Beasley,62,13.6333333333333,14,-0.366666666666667,29,37,-8,-8,0
21700051,201584,NYK,BOS,Courtney Lee,158,35.3666666666667,35,0.366666666666667,61,74,-13,-10,-3
21700051,202498,NYK,BOS,Lance Thomas,42,10.0666666666667,10,0.0666666666666664,21,27,-6,-5,-1
21700051,202683,NYK,BOS,Enes Kanter,135,29.6,30,-0.400000000000002,50,60,-10,-10,0
21700051,203124,NYK,BOS,Kyle O'Quinn,26,6.23333333333333,6,0.233333333333333,7,19,-12,-10,-2
21700051,203501,NYK,BOS,Tim Hardaway Jr.,126,27.5333333333333,28,-0.466666666666669,42,56,-14,-11,-3
21700051,203926,NYK,BOS,Doug McDermott,75,16.3666666666667,17,-0.633333333333333,37,45,-8,-7,-1
21700051,204001,NYK,BOS,Kristaps Porzingis,145,31.5333333333333,32,-0.466666666666669,55,67,-12,-14,2
21700051,1626195,NYK,BOS,Willy Hernangomez,50,11.2,11,0.199999999999999,31,29,2,-1,3
21700051,1627758,NYK,BOS,Ron Baker,45,9.66666666666667,10,-0.333333333333332,23,26,-3,-8,5
21700051,1628422,NYK,BOS,Damyean Dotson,25,4.58333333333333,5,-0.416666666666667,14,12,2,2,0
21700052,2037,MIN,IND,Jamal Crawford,140,29.5666666666667,30,-0.433333333333334,72,73,-1,-1,0
21700052,201166,MIN,IND,Aaron Brooks,22,4.25,5,-0.75,7,12,-5,-5,0
21700052,201952,MIN,IND,Jeff Teague,127,25.6666666666667,26,-0.333333333333336,60,77,-17,-17,0
21700052,201959,MIN,IND,Taj Gibson,109,21.9,22,-0.100000000000001,50,67,-17,-17,0
21700052,202332,MIN,IND,Cole Aldrich,22,4.25,5,-0.75,7,12,-5,-5,0
21700052,202357,MIN,IND,Nemanja Bjelica,116,25.6833333333333,26,-0.316666666666666,57,63,-6,-6,0
21700052,203476,MIN,IND,Gorgui Dieng,52,12.4166666666667,13,-0.583333333333332,28,28,0,-2,2
21700052,203498,MIN,IND,Shabazz Muhammad,148,30.7166666666667,31,-0.283333333333331,68,89,-21,-19,-2
21700052,203952,MIN,IND,Andrew Wiggins,140,30.6333333333333,31,-0.366666666666667,67,86,-19,-21,2
21700052,1626145,MIN,IND,Tyus Jones,76,17.6666666666667,18,-0.333333333333336,40,41,-1,-1,0
21700052,1626157,MIN,IND,Karl-Anthony Towns,151,30.9166666666667,31,-0.0833333333333357,72,90,-18,-16,-2
21700052,1627875,MIN,IND,Marcus Georges-Hunt,22,4.25,5,-0.75,7,12,-5,-5,0
21700052,2744,IND,MIN,Al Jefferson,82,17.9666666666667,18,-0.0333333333333314,47,41,6,9,-3
21700052,2863,IND,MIN,Damien Wilkins,10,1.91666666666667,2,-0.0833333333333335,6,4,2,2,0
21700052,201152,IND,MIN,Thaddeus Young,150,31.2666666666667,31,0.266666666666666,91,65,26,24,2
21700052,201954,IND,MIN,Darren Collison,158,33.65,34,-0.350000000000001,96,73,23,21,2
21700052,202362,IND,MIN,Lance Stephenson,74,16.1333333333333,16,0.133333333333333,37,45,-8,-8,0
21700052,202709,IND,MIN,Cory Joseph,130,28.9833333333333,29,-0.0166666666666657,73,61,12,12,0
21700052,202711,IND,MIN,Bojan Bogdanovic,151,30.85,31,-0.149999999999999,89,67,22,24,-2
21700052,203506,IND,MIN,Victor Oladipo,136,28.1833333333333,28,0.183333333333334,81,63,18,18,0
21700052,1626202,IND,MIN,Joe Young,10,1.91666666666667,2,-0.0833333333333335,6,4,2,2,0
21700052,1627734,IND,MIN,Domantas Sabonis,122,25.0333333333333,25,0.0333333333333314,70,60,10,9,1
21700052,1627816,IND,MIN,Alex Poythress,6,1.11666666666667,1,0.116666666666667,2,4,-2,-2,0
21700052,1628387,IND,MIN,Ike Anigbogu,10,1.91666666666667,2,-0.0833333333333335,6,4,2,2,0
21700052,1628388,IND,MIN,TJ Leaf,86,18.9833333333333,19,-0.0166666666666657,46,44,2,2,0
21700053,2749,NOP,POR,Jameer Nelson,152,30.1333333333333,31,-0.866666666666667,62,68,-6,-4,-2
21700053,2754,NOP,POR,Tony Allen,73,14.8666666666667,15,-0.133333333333333,33,25,8,5,3
21700053,201950,NOP,POR,Jrue Holiday,172,34.9333333333333,35,-0.0666666666666629,69,76,-7,-8,1
21700053,201967,NOP,POR,Dante Cunningham,133,27.55,28,-0.450000000000003,49,68,-19,-19,0
21700053,202326,NOP,POR,DeMarcus Cousins,189,38.7333333333333,39,-0.266666666666666,79,73,6,6,0
21700053,202734,NOP,POR,E'Twaun Moore,133,27.7,28,-0.300000000000001,53,56,-3,-4,1
21700053,203076,NOP,POR,Anthony Davis,25,5.01666666666667,5,0.0166666666666666,8,9,-1,-1,0
21700053,203121,NOP,POR,Darius Miller,106,20.2833333333333,20,0.283333333333331,37,47,-10,-7,-3
21700053,203546,NOP,POR,Ian Clark,124,26.5166666666667,27,-0.483333333333334,51,56,-5,-5,0
21700053,1627767,NOP,POR,Cheick Diallo,68,12.7666666666667,13,-0.233333333333334,24,37,-13,-13,0
21700053,202323,POR,NOP,Evan Turner,147,29,30,-1,65,66,-1,0,-1
21700053,202329,POR,NOP,Al-Farouq Aminu,125,25.3166666666667,26,-0.683333333333334,48,48,0,0,0
21700053,202334,POR,NOP,Ed Davis,110,21.3666666666667,21,0.366666666666667,52,47,5,0,5
21700053,203081,POR,NOP,Damian Lillard,172,35.3833333333333,35,0.383333333333333,75,73,2,3,-1
21700053,203086,POR,NOP,Meyers Leonard,29,6.43333333333333,6,0.433333333333334,12,16,-4,0,-4
21700053,203090,POR,NOP,Maurice Harkless,112,23,23,0,37,44,-7,-8,1
21700053,203468,POR,NOP,CJ McCollum,172,35.7166666666667,36,-0.283333333333331,75,56,19,17,2
21700053,203894,POR,NOP,Shabazz Napier,18,3.48333333333333,4,-0.516666666666667,4,7,-3,-3,0
21700053,203994,POR,NOP,Jusuf Nurkic,96,19.9,20,-0.100000000000001,39,30,9,10,-1
21700053,1626192,POR,NOP,Pat Connaughton,118,23.1166666666667,23,0.116666666666667,63,50,13,14,-1
21700053,1628403,POR,NOP,Caleb Swanigan,76,15.7833333333333,16,-0.216666666666667,45,28,17,17,0
21700054,101150,LAC,UTA,Lou Williams,95,19.2166666666667,19,0.216666666666669,39,37,2,2,0
21700054,201568,LAC,UTA,Danilo Gallinari,162,37.85,39,-1.15,79,64,15,15,0
21700054,201599,LAC,UTA,DeAndre Jordan,150,36.3833333333333,37,-0.616666666666667,79,57,22,23,-1
21700054,201933,LAC,UTA,Blake Griffin,158,36.5166666666667,37,-0.483333333333334,84,58,26,24,2
21700054,201976,LAC,UTA,Patrick Beverley,187,42.1333333333333,42,0.133333333333333,91,71,20,18,2
21700054,202325,LAC,UTA,Wesley Johnson,83,16.7833333333333,16,0.783333333333335,33,33,0,2,-2
21700054,203085,LAC,UTA,Austin Rivers,142,33.95,35,-1.05,74,60,14,16,-2
21700054,203186,LAC,UTA,Willie Reed,62,11.2666666666667,11,0.266666666666666,23,27,-4,-5,1
21700054,1628414,LAC,UTA,Sindarius Thornwell,21,4.15,4,0.149999999999999,8,13,-5,-5,0
21700054,2207,UTA,LAC,Joe Johnson,106,22.2,22,0.200000000000003,42,51,-9,-7,-2
21700054,200757,UTA,LAC,Thabo Sefolosha,120,26.5,26,0.5,47,58,-11,-9,-2
21700054,201937,UTA,LAC,Ricky Rubio,128,31.1666666666667,31,0.166666666666668,46,71,-25,-26,1
21700054,201973,UTA,LAC,Jonas Jerebko,5,1.31666666666667,2,-0.683333333333333,0,2,-2,-2,0
21700054,202324,UTA,LAC,Derrick Favors,101,24.1333333333333,24,0.133333333333333,42,49,-7,-9,2
21700054,202327,UTA,LAC,Ekpe Udoh,84,16.4833333333333,17,-0.516666666666666,38,31,7,8,-1
21700054,202692,UTA,LAC,Alec Burks,76,15.1333333333333,15,0.133333333333333,25,37,-12,-12,0
21700054,203497,UTA,LAC,Rudy Gobert,128,31.1666666666667,31,0.166666666666668,46,71,-25,-26,1
21700054,203526,UTA,LAC,Raul Neto,84,16.4833333333333,17,-0.516666666666666,38,31,7,8,-1
21700054,204060,UTA,LAC,Joe Ingles,81,18.25,18,0.25,28,40,-12,-14,2
21700054,1626220,UTA,LAC,Royce O'Neale,23,5.83333333333333,7,-1.16666666666667,15,11,4,4,0
21700054,1628378,UTA,LAC,Donovan Mitchell,124,29.5833333333333,30,-0.416666666666664,53,58,-5,-5,0
21700055,200794,DEN,CHA,Paul Millsap,132,28.6833333333333,28,0.683333333333334,44,74,-30,-27,-3
21700055,201163,DEN,CHA,Wilson Chandler,143,30.55,31,-0.449999999999999,70,64,6,2,4
21700055,202702,DEN,CHA,Kenneth Faried,21,3.55,4,-0.45,3,11,-8,-8,0
21700055,203115,DEN,CHA,Will Barton,151,28.6166666666667,29,-0.383333333333333,59,67,-8,-7,-1
21700055,203486,DEN,CHA,Mason Plumlee,101,20.0833333333333,21,-0.916666666666668,48,38,10,7,3
21700055,203914,DEN,CHA,Gary Harris,144,30.5,31,-0.5,54,74,-20,-22,2
21700055,203999,DEN,CHA,Nikola Jokic,151,30.6833333333333,30,0.68333333333333,56,76,-20,-19,-1
21700055,1626144,DEN,CHA,Emmanuel Mudiay,71,13.85,14,-0.15,30,34,-4,-4,0
21700055,1626168,DEN,CHA,Trey Lyles,21,4.03333333333333,4,0.0333333333333332,10,4,6,6,0
21700055,1627736,DEN,CHA,Malik Beasley,78,15.0166666666667,15,0.0166666666666657,30,32,-2,0,-2
21700055,1627750,DEN,CHA,Jamal Murray,157,33.0166666666667,33,0.0166666666666657,61,76,-15,-13,-2
21700055,2730,CHA,DEN,Dwight Howard,127,26.4166666666667,27,-0.583333333333336,61,50,11,15,-4
21700055,101107,CHA,DEN,Marvin Williams,100,21.5833333333333,21,0.583333333333336,51,39,12,12,0
21700055,202689,CHA,DEN,Kemba Walker,155,32.45,32,0.450000000000003,80,56,24,26,-2
21700055,203077,CHA,DEN,Michael Kidd-Gilchrist,45,10.4,11,-0.600000000000001,19,21,-2,-2,0
21700055,203087,CHA,DEN,Jeremy Lamb,137,29.1666666666667,29,0.166666666666664,73,51,22,20,2
21700055,203948,CHA,DEN,Johnny O'Bryant III,99,19.6333333333333,20,-0.366666666666667,43,41,2,-2,4
21700055,1626163,CHA,DEN,Frank Kaminsky,146,27.3833333333333,28,-0.616666666666667,70,54,16,18,-2
21700055,1626203,CHA,DEN,Treveon Graham,77,15.6166666666667,16,-0.383333333333333,28,37,-9,-7,-2
21700055,1627779,CHA,DEN,Marcus Paige,13,2.63333333333333,3,-0.366666666666667,0,7,-7,-7,0
21700055,1628370,CHA,DEN,Malik Monk,131,24.6833333333333,25,-0.316666666666666,65,50,15,13,2
21700055,1628407,CHA,DEN,Dwayne Bacon,124,25.2666666666667,25,0.266666666666666,56,52,4,4,0
21700055,1628493,CHA,DEN,Mangok Mathiang,16,3.35,3,0.35,4,7,-3,-5,2
21700056,2037,MIN,DET,Jamal Crawford,109,24.45,24,0.449999999999999,46,54,-8,-10,2
21700056,201166,MIN,DET,Aaron Brooks,8,1.9,2,-0.1,2,5,-3,-3,0
21700056,201952,MIN,DET,Jeff Teague,146,28.6166666666667,29,-0.383333333333333,70,81,-11,-10,-1
21700056,201959,MIN,DET,Taj Gibson,123,24.5,24,0.5,64,70,-6,-4,-2
21700056,202332,MIN,DET,Cole Aldrich,8,1.9,2,-0.1,2,5,-3,-3,0
21700056,202357,MIN,DET,Nemanja Bjelica,107,23.35,24,-0.649999999999999,36,52,-16,-17,1
21700056,203476,MIN,DET,Gorgui Dieng,69,14.95,15,-0.0500000000000007,24,29,-5,-8,3
21700056,203498,MIN,DET,Shabazz Muhammad,143,28.4833333333333,29,-0.516666666666666,56,81,-25,-22,-3
21700056,203952,MIN,DET,Andrew Wiggins,177,35.5666666666667,36,-0.433333333333337,86,91,-5,-3,-2
21700056,1626145,MIN,DET,Tyus Jones,76,17.3333333333333,17,0.333333333333332,28,36,-8,-8,0
21700056,1626157,MIN,DET,Karl-Anthony Towns,176,36.3,36,0.299999999999997,84,101,-17,-14,-3
21700056,1627875,MIN,DET,Marcus Georges-Hunt,8,1.9,2,-0.1,2,5,-3,-3,0
21700056,202340,DET,MIN,Avery Bradley,153,30.45,30,0.449999999999999,80,76,4,3,1
21700056,202397,DET,MIN,Ish Smith,107,22.0666666666667,22,0.0666666666666664,55,34,21,20,1
21700056,202699,DET,MIN,Tobias Harris,187,39.1666666666667,39,0.166666666666671,105,88,17,17,0
21700056,202704,DET,MIN,Reggie Jackson,119,24.4166666666667,25,-0.583333333333336,64,66,-2,-2,0
21700056,202720,DET,MIN,Jon Leuer,91,18.7,19,-0.299999999999997,45,32,13,14,-1
21700056,203083,DET,MIN,Andre Drummond,135,27.7833333333333,28,-0.216666666666669,74,68,6,4,2
21700056,203961,DET,MIN,Eric Moreland,4,1.36666666666667,2,-0.633333333333333,3,0,3,3,0
21700056,204038,DET,MIN,Langston Galloway,77,17.4,18,-0.600000000000001,42,24,18,18,0
21700056,1626169,DET,MIN,Stanley Johnson,173,35.4333333333333,36,-0.566666666666663,88,86,2,1,1
21700056,1627740,DET,MIN,Henry Ellenson,100,21.1,21,0.100000000000001,51,26,25,24,1
21700056,1628379,DET,MIN,Luke Kennard,4,1.36666666666667,2,-0.633333333333333,3,0,3,3,0
21700057,200782,HOU,PHI,PJ Tucker,152,32.3666666666667,32,0.366666666666667,83,68,15,15,0
21700057,201569,HOU,PHI,Eric Gordon,189,40.0166666666667,40,0.0166666666666657,86,90,-4,-4,0
21700057,201583,HOU,PHI,Ryan Anderson,141,31,35,-4,68,71,-3,-1,-2
21700057,201601,HOU,PHI,Luc Mbah a Moute,168,35.1,36,-0.900000000000006,66,76,-10,-6,-4
21700057,201935,HOU,PHI,James Harden,220,46.7666666666667,41,5.76666666666667,108,95,13,9,4
21700057,203477,HOU,PHI,Isaiah Canaan,18,3.95,4,-0.0499999999999998,11,12,-1,-1,0
21700057,203991,HOU,PHI,Clint Capela,147,31.2333333333333,31,0.233333333333334,68,59,9,9,0
21700057,204028,HOU,PHI,Tarik Black,57,12.3,12,0.300000000000001,25,34,-9,-11,2
21700057,1627743,HOU,PHI,Demetrius Jackson,28,7.26666666666667,8,-0.733333333333333,10,15,-5,-5,0
21700057,101161,PHI,HOU,Amir Johnson,78,16.25,16,0.25,33,31,2,3,-1
21700057,200755,PHI,HOU,JJ Redick,161,34.0666666666667,34,0.0666666666666629,78,54,24,23,1
21700057,201573,PHI,HOU,Jerryd Bayless,146,30.5833333333333,31,-0.416666666666664,67,70,-3,-3,0
21700057,203496,PHI,HOU,Robert Covington,175,36.3,36,0.299999999999997,76,68,8,9,-1
21700057,203954,PHI,HOU,Joel Embiid,111,24.6833333333333,25,-0.316666666666666,58,58,0,-1,1
21700057,203967,PHI,HOU,Dario Saric,76,16.9833333333333,17,-0.0166666666666657,34,37,-3,-4,1
21700057,204456,PHI,HOU,T.J. McConnell,139,28.4833333333333,28,0.483333333333334,66,72,-6,-6,0
21700057,1626147,PHI,HOU,Justin Anderson,78,18.75,19,-0.25,42,54,-12,-13,1
21700057,1627732,PHI,HOU,Ben Simmons,156,33.9,34,-0.0999999999999943,66,81,-15,-13,-2
21700058,2544,CLE,BKN,LeBron James,200,41.3166666666667,41,0.316666666666663,91,92,-1,-2,1
21700058,2594,CLE,BKN,Kyle Korver,143,30.6,31,-0.399999999999999,79,73,6,6,0
21700058,2747,CLE,BKN,JR Smith,136,28.2333333333333,28,0.233333333333334,60,69,-9,-8,-1
21700058,101112,CLE,BKN,Channing Frye,21,4.88333333333333,5,-0.116666666666667,9,15,-6,-6,0
21700058,101181,CLE,BKN,Jose Calderon,68,14.0166666666667,14,0.0166666666666657,29,32,-3,-3,0
21700058,201145,CLE,BKN,Jeff Green,125,27.0666666666667,27,0.0666666666666664,69,65,4,5,-1
21700058,201567,CLE,BKN,Kevin Love,156,32.35,33,-0.649999999999999,72,71,1,-3,4
21700058,202684,CLE,BKN,Tristan Thompson,116,23,23,0,43,53,-10,-11,1
21700058,202697,CLE,BKN,Iman Shumpert,88,17.4833333333333,18,-0.516666666666666,44,37,7,6,1
21700058,203109,CLE,BKN,Jae Crowder,102,20.8833333333333,21,-0.116666666666667,39,48,-9,-9,0
21700058,201960,BKN,CLE,DeMarre Carroll,155,31.85,32,-0.149999999999999,73,74,-1,0,-1
21700058,202344,BKN,CLE,Trevor Booker,98,19.9,20,-0.100000000000001,56,41,15,12,3
21700058,202389,BKN,CLE,Timofey Mozgov,62,12.3833333333333,12,0.383333333333333,16,26,-10,-9,-1
21700058,203112,BKN,CLE,Quincy Acy,60,13.3333333333333,14,-0.666666666666668,39,27,12,12,0
21700058,203459,BKN,CLE,Allen Crabbe,114,24.4666666666667,24,0.466666666666665,73,59,14,15,-1
21700058,203915,BKN,CLE,Spencer Dinwiddie,154,31.5,32,-0.5,73,67,6,8,-2
21700058,203925,BKN,CLE,Joe Harris,84,18.0166666666667,18,0.0166666666666657,44,40,4,5,-1
21700058,203930,BKN,CLE,Sean Kilpatrick,46,9.88333333333333,10,-0.116666666666667,19,28,-9,-10,1
21700058,1626178,BKN,CLE,Rondae Hollis-Jefferson,171,34.6833333333333,35,-0.316666666666663,77,77,0,2,-2
21700058,1627747,BKN,CLE,Caris LeVert,148,30.0833333333333,30,0.0833333333333322,57,60,-3,-3,0
21700058,1628386,BKN,CLE,Jarrett Allen,63,13.7333333333333,14,-0.266666666666668,28,36,-8,-7,-1
21700059,201609,MIA,SAS,Goran Dragic,160,37.2666666666667,37,0.266666666666666,82,94,-12,-12,0
21700059,201949,MIA,SAS,James Johnson,151,35.6833333333333,36,-0.31666666666667,67,84,-17,-20,3
21700059,201961,MIA,SAS,Wayne Ellington,27,6.23333333333333,6,0.233333333333333,12,13,-1,-1,0
21700059,203079,MIA,SAS,Dion Waiters,169,39.45,40,-0.549999999999997,84,93,-9,-10,1
21700059,203482,MIA,SAS,Kelly Olynyk,54,11.9666666666667,12,-0.0333333333333332,35,34,1,2,-1
21700059,204020,MIA,SAS,Tyler Johnson,147,33.15,33,0.149999999999999,76,85,-9,-7,-2
21700059,1626159,MIA,SAS,Justise Winslow,96,22.5166666666667,22,0.516666666666666,47,59,-12,-9,-3
21700059,1626196,MIA,SAS,Josh Richardson,138,32.75,33,-0.25,64,78,-14,-14,0
21700059,1627855,MIA,SAS,Okaro White,1,0.3,0,0.3,,2,,-2,
21700059,1628389,MIA,SAS,Bam Adebayo,82,19.4333333333333,20,-0.56666666666667,33,43,-10,-12,2
21700059,1938,SAS,MIA,Manu Ginobili,100,21.8166666666667,22,-0.183333333333334,65,55,10,9,1
21700059,2200,SAS,MIA,Pau Gasol,84,19.2,19,0.200000000000003,42,38,4,1,3
21700059,200746,SAS,MIA,LaMarcus Aldridge,163,38.3666666666667,38,0.36666666666666,92,77,15,16,-1
21700059,200752,SAS,MIA,Rudy Gay,117,25.9833333333333,26,-0.0166666666666657,74,60,14,16,-2
21700059,201980,SAS,MIA,Danny Green,142,34.1666666666667,35,-0.833333333333336,86,65,21,20,1
21700059,201988,SAS,MIA,Patty Mills,119,25.3,26,-0.699999999999999,70,65,5,3,2
21700059,203464,SAS,MIA,Brandon Paul,81,19.3833333333333,19,0.383333333333333,53,40,13,12,1
21700059,203937,SAS,MIA,Kyle Anderson,110,26.9333333333333,27,-0.06666666666667,52,51,1,5,-4
21700059,1627749,SAS,MIA,Dejounte Murray,97,24.6666666666667,24,0.666666666666668,47,41,6,9,-3
21700059,1627854,SAS,MIA,Bryn Forbes,12,2.93333333333333,3,-0.0666666666666664,4,8,-4,-6,2
21700060,2744,IND,OKC,Al Jefferson,96,18.1,18,0.100000000000001,39,44,-5,-3,-2
21700060,2863,IND,OKC,Damien Wilkins,12,2.08333333333333,2,0.083333333333333,3,6,-3,-1,-2
21700060,201152,IND,OKC,Thaddeus Young,164,33.1,33,0.0999999999999943,61,78,-17,-15,-2
21700060,201954,IND,OKC,Darren Collison,190,37.3833333333333,38,-0.616666666666667,79,90,-11,-13,2
21700060,202362,IND,OKC,Lance Stephenson,90,17.4666666666667,17,0.466666666666669,41,35,6,4,2
21700060,202709,IND,OKC,Cory Joseph,111,21.45,21,0.449999999999999,50,53,-3,-5,2
21700060,202711,IND,OKC,Bojan Bogdanovic,143,28.5833333333333,29,-0.416666666666664,52,71,-19,-19,0
21700060,203506,IND,OKC,Victor Oladipo,186,35.95,36,-0.0499999999999972,69,87,-18,-20,2
21700060,1626202,IND,OKC,Joe Young,12,2.08333333333333,2,0.083333333333333,3,6,-3,-1,-2
21700060,1627734,IND,OKC,Domantas Sabonis,99,18.95,19,-0.0500000000000007,31,39,-8,-11,3
21700060,1627816,IND,OKC,Alex Poythress,12,2.08333333333333,2,0.083333333333333,3,6,-3,-1,-2
21700060,1628387,IND,OKC,Ike Anigbogu,12,2.08333333333333,2,0.083333333333333,3,6,-3,-1,-2
21700060,1628388,IND,OKC,TJ Leaf,103,19.1,19,0.100000000000001,46,49,-3,-4,1
21700060,2546,OKC,IND,Carmelo Anthony,169,33.05,33,0.0499999999999972,76,56,20,19,1
21700060,101109,OKC,IND,Raymond Felton,99,18.75,19,-0.25,37,47,-10,-7,-3
21700060,201566,OKC,IND,Russell Westbrook,178,35.1,35,0.0999999999999943,93,65,28,27,1
21700060,202331,OKC,IND,Paul George,92,18.8166666666667,19,-0.183333333333334,42,42,0,-2,2
21700060,202335,OKC,IND,Patrick Patterson,91,16.5333333333333,17,-0.466666666666669,40,39,1,6,-5
21700060,203460,OKC,IND,Andre Roberson,102,20.25,21,-0.75,49,34,15,11,4
21700060,203500,OKC,IND,Steven Adams,155,30.95,31,-0.0500000000000007,73,54,19,16,3
21700060,203518,OKC,IND,Alex Abrines,73,13.4166666666667,13,0.416666666666666,35,35,0,5,-5
21700060,203924,OKC,IND,Jerami Grant,126,24.7833333333333,25,-0.216666666666669,63,58,5,3,2
21700060,203962,OKC,IND,Josh Huestis,136,25.5,26,-0.5,60,47,13,12,1
21700060,1628390,OKC,IND,Terrance Ferguson,9,1.26666666666667,2,-0.733333333333333,2,3,-1,0,-1
21700061,1717,DAL,MEM,Dirk Nowitzki,104,24.5333333333333,25,-0.466666666666669,58,47,11,9,2
21700061,2734,DAL,MEM,Devin Harris,51,10.3833333333333,10,0.383333333333333,20,14,6,6,0
21700061,200826,DAL,MEM,J.J. Barea,89,19.3833333333333,19,0.383333333333333,42,41,1,3,-2
21700061,202083,DAL,MEM,Wesley Matthews,173,41.0666666666667,41,0.0666666666666629,90,85,5,6,-1
21700061,203084,DAL,MEM,Harrison Barnes,162,37.9166666666667,38,-0.0833333333333357,82,77,5,6,-1
21700061,203457,DAL,MEM,Nerlens Noel,82,19.6333333333333,20,-0.366666666666667,48,39,9,11,-2
21700061,203939,DAL,MEM,Dwight Powell,108,24.9333333333333,25,-0.0666666666666664,48,49,-1,-3,2
21700061,1627812,DAL,MEM,Yogi Ferrell,125,29.0666666666667,29,0.0666666666666664,57,55,2,0,2
21700061,1627827,DAL,MEM,Dorian Finney-Smith,19,4.2,4,0.2,8,7,1,1,0
21700061,1628372,DAL,MEM,Dennis Smith Jr.,112,28.05,28,0.0499999999999972,62,56,6,6,0
21700061,201144,MEM,DAL,Mike Conley,148,35.25,35,0.25,78,70,8,6,2
21700061,201148,MEM,DAL,Brandan Wright,45,10.75,11,-0.25,17,19,-2,-2,0
21700061,201188,MEM,DAL,Marc Gasol,160,37.0833333333333,37,0.0833333333333286,77,84,-7,-7,0
21700061,201596,MEM,DAL,Mario Chalmers,108,25.0166666666667,25,0.0166666666666657,38,56,-18,-17,-1
21700061,201936,MEM,DAL,Tyreke Evans,112,25.2,25,0.200000000000003,48,51,-3,0,-3
21700061,203516,MEM,DAL,James Ennis III,143,33.4,34,-0.600000000000001,64,81,-17,-17,0
21700061,1626150,MEM,DAL,Andrew Harrison,88,21.75,22,-0.25,44,45,-1,-4,3
21700061,1626185,MEM,DAL,Jarell Martin,99,22.9,23,-0.100000000000001,54,51,3,1,2
21700061,1628415,MEM,DAL,Dillon Brooks,122,27.8166666666667,28,-0.183333333333334,50,58,-8,-5,-3
21700062,2199,PHX,UTA,Tyson Chandler,106,21.6666666666667,22,-0.333333333333336,45,38,7,4,3
21700062,203458,PHX,UTA,Alex Len,146,29.4833333333333,30,-0.516666666666666,60,57,3,6,-3
21700062,203584,PHX,UTA,Troy Daniels,70,15.0166666666667,15,0.0166666666666657,34,28,6,4,2
21700062,203933,PHX,UTA,T.J. Warren,133,27.55,28,-0.450000000000003,55,51,4,5,-1
21700062,1626164,PHX,UTA,Devin Booker,164,32.8,33,-0.200000000000003,63,60,3,5,-2
21700062,1627733,PHX,UTA,Dragan Bender,105,21.1,21,0.100000000000001,46,38,8,10,-2
21700062,1627737,PHX,UTA,Marquese Chriss,110,23.25,23,0.25,43,43,0,-2,2
21700062,1627755,PHX,UTA,Tyler Ulis,126,26.05,26,0.0500000000000007,55,48,7,7,0
21700062,1628367,PHX,UTA,Josh Jackson,102,20.4,20,0.399999999999999,42,37,5,4,1
21700062,1628455,PHX,UTA,Mike James,108,21.7666666666667,22,-0.233333333333334,42,40,2,2,0
21700062,2207,UTA,PHX,Joe Johnson,88,17.0833333333333,17,0.0833333333333357,31,31,0,-2,2
21700062,200757,UTA,PHX,Thabo Sefolosha,88,18.1833333333333,18,0.183333333333334,32,32,0,-4,4
21700062,201937,UTA,PHX,Ricky Rubio,165,33.9833333333333,34,-0.0166666666666657,67,64,3,3,0
21700062,202324,UTA,PHX,Derrick Favors,146,30.7333333333333,31,-0.266666666666669,57,66,-9,-7,-2
21700062,202327,UTA,PHX,Ekpe Udoh,54,11.5,12,-0.5,20,29,-9,-9,0
21700062,203497,UTA,PHX,Rudy Gobert,180,36.3166666666667,36,0.316666666666663,68,68,0,0,0
21700062,203526,UTA,PHX,Raul Neto,69,13.8333333333333,14,-0.166666666666668,21,33,-12,-12,0
21700062,203918,UTA,PHX,Rodney Hood,170,35.1833333333333,35,0.183333333333337,66,75,-9,-7,-2
21700062,204060,UTA,PHX,Joe Ingles,146,29.6333333333333,30,-0.366666666666667,56,65,-9,-5,-4
21700062,1628378,UTA,PHX,Donovan Mitchell,64,12.6333333333333,13,-0.366666666666667,22,22,0,-2,2
21700063,2561,GSW,TOR,David West,42,9.6,10,-0.399999999999999,19,24,-5,-5,0
21700063,2585,GSW,TOR,Zaza Pachulia,65,14.3333333333333,14,0.333333333333332,35,38,-3,-3,0
21700063,2733,GSW,TOR,Shaun Livingston,73,15.5833333333333,16,-0.416666666666668,34,39,-5,-3,-2
21700063,2738,GSW,TOR,Andre Iguodala,143,30.55,30,0.550000000000001,67,69,-2,-4,2
21700063,201142,GSW,TOR,Kevin Durant,178,38.0666666666667,38,0.0666666666666629,99,92,7,7,0
21700063,201939,GSW,TOR,Stephen Curry,178,37.5,38,-0.5,98,84,14,14,0
21700063,202691,GSW,TOR,Klay Thompson,177,38.3166666666667,38,0.316666666666663,93,91,2,2,0
21700063,203110,GSW,TOR,Draymond Green,173,36.6833333333333,37,-0.31666666666667,92,81,11,11,0
21700063,1627775,GSW,TOR,Patrick McCaw,48,9.68333333333333,10,-0.316666666666666,24,21,3,3,0
21700063,1628395,GSW,TOR,Jordan Bell,48,9.68333333333333,10,-0.316666666666666,24,21,3,3,0
21700063,101139,TOR,GSW,CJ Miles,88,18.3333333333333,19,-0.666666666666668,41,46,-5,-5,0
21700063,200768,TOR,GSW,Kyle Lowry,178,38.2,38,0.200000000000003,89,92,-3,-5,2
21700063,201586,TOR,GSW,Serge Ibaka,129,27.8166666666667,28,-0.183333333333334,63,71,-8,-6,-2
21700063,201942,TOR,GSW,DeMar DeRozan,182,38.1833333333333,38,0.183333333333337,88,96,-8,-8,0
21700063,1626153,TOR,GSW,Delon Wright,144,29.5833333333333,29,0.583333333333336,63,73,-10,-6,-4
21700063,1626181,TOR,GSW,Norman Powell,71,16.15,16,0.149999999999999,45,40,5,3,2
21700063,1627751,TOR,GSW,Jakob Poeltl,125,26.8166666666667,27,-0.183333333333334,60,62,-2,-2,0
21700063,1627783,TOR,GSW,Pascal Siakam,98,21.3833333333333,21,0.383333333333333,54,55,-1,-3,2
21700063,1627832,TOR,GSW,Fred VanVleet,23,5.56666666666667,6,-0.433333333333334,12,13,-1,-1,0
21700063,1628384,TOR,GSW,OG Anunoby,87,17.9666666666667,18,-0.0333333333333314,45,37,8,8,0
21700064,101106,LAL,WAS,Andrew Bogut,9,2.41666666666667,2,0.416666666666667,5,5,0,2,-2
21700064,201147,LAL,WAS,Corey Brewer,44,9.66666666666667,9,0.666666666666668,18,19,-1,-3,2
21700064,201572,LAL,WAS,Brook Lopez,105,22.6333333333333,23,-0.366666666666667,43,37,6,2,4
21700064,203484,LAL,WAS,Kentavious Caldwell-Pope,191,41.8833333333333,42,-0.116666666666667,86,81,5,7,-2
21700064,203903,LAL,WAS,Jordan Clarkson,76,17.3333333333333,17,0.333333333333336,29,41,-12,-9,-3
21700064,203944,LAL,WAS,Julius Randle,87,19.55,19,0.550000000000001,41,38,3,5,-2
21700064,1626204,LAL,WAS,Larry Nance Jr.,110,23.7833333333333,24,-0.216666666666669,46,48,-2,-3,1
21700064,1627742,LAL,WAS,Brandon Ingram,178,38.7333333333333,39,-0.266666666666666,76,66,10,9,1
21700064,1628366,LAL,WAS,Lonzo Ball,185,39.6,40,-0.399999999999999,80,65,15,13,2
21700064,1628398,LAL,WAS,Kyle Kuzma,155,34,34,0,65,62,3,4,-1
21700064,1628404,LAL,WAS,Josh Hart,70,15.3166666666667,16,-0.683333333333334,21,33,-12,-12,0
21700064,101133,WAS,LAL,Ian Mahinmi,36,7.83333333333333,8,-0.166666666666666,22,17,5,5,0
21700064,101162,WAS,LAL,Marcin Gortat,167,37.1666666666667,37,0.166666666666664,67,73,-6,-8,2
21700064,201160,WAS,LAL,Jason Smith,35,7.61666666666667,8,-0.383333333333334,10,8,2,4,-2
21700064,201975,WAS,LAL,Jodie Meeks,75,16.0166666666667,16,0.0166666666666657,31,23,8,7,1
21700064,202322,WAS,LAL,John Wall,187,40.4666666666667,41,-0.533333333333331,72,82,-10,-12,2
21700064,203078,WAS,LAL,Bradley Beal,198,43.4166666666667,44,-0.583333333333329,77,86,-9,-8,-1
21700064,203118,WAS,LAL,Mike Scott,121,25.75,25,0.75,43,50,-7,-7,0
21700064,203490,WAS,LAL,Otto Porter Jr.,162,35.4,36,-0.599999999999994,73,65,8,5,3
21700064,204025,WAS,LAL,Tim Frazier,55,12.5166666666667,12,0.516666666666666,27,20,7,9,-2
21700064,1626162,WAS,LAL,Kelly Oubre Jr.,174,38.7333333333333,39,-0.266666666666666,73,86,-13,-10,-3
21700065,201158,ATL,CHI,Marco Belinelli,140,30.6833333333333,31,-0.316666666666666,67,55,12,11,1
21700065,202337,ATL,CHI,Luke Babbitt,66,14.2333333333333,14,0.233333333333334,26,28,-2,0,-2
21700065,203145,ATL,CHI,Kent Bazemore,135,31.65,33,-1.35,55,53,2,3,-1
21700065,203473,ATL,CHI,Dewayne Dedmon,98,22.6166666666667,23,-0.383333333333333,39,39,0,-3,3
21700065,203488,ATL,CHI,Mike Muscala,135,31.4,31,0.399999999999999,54,57,-3,-6,3
21700065,203705,ATL,CHI,Josh Magette,19,4.08333333333333,4,0.0833333333333339,4,10,-6,-6,0
21700065,1627098,ATL,CHI,Malcolm Delaney,153,35.2833333333333,35,0.283333333333331,58,68,-10,-15,5
21700065,1627752,ATL,CHI,Taurean Prince,127,28.6333333333333,28,0.633333333333333,48,55,-7,-9,2
21700065,1627819,ATL,CHI,Isaiah Taylor,73,15.9666666666667,16,-0.0333333333333332,32,34,-2,2,-4
21700065,1628381,ATL,CHI,John Collins,114,25.3666666666667,25,0.366666666666667,47,51,-4,-2,-2
21700065,201577,CHI,ATL,Robin Lopez,159,36.2833333333333,36,0.283333333333331,68,56,12,12,0
21700065,202347,CHI,ATL,Quincy Pondexter,79,17.45,17,0.449999999999999,34,32,2,1,1
21700065,203200,CHI,ATL,Justin Holiday,163,36.9833333333333,37,-0.0166666666666657,68,58,10,11,-1
21700065,1626170,CHI,ATL,Jerian Grant,158,35.8166666666667,36,-0.183333333333337,66,62,4,4,0
21700065,1626245,CHI,ATL,Cristiano Felicio,53,11.7,12,-0.300000000000001,22,30,-8,-7,-1
21700065,1627756,CHI,ATL,Denzel Valentine,152,35.6166666666667,36,-0.383333333333333,66,65,1,1,0
21700065,1627770,CHI,ATL,Kay Felder,54,12.1666666666667,12,0.166666666666666,24,24,0,1,-1
21700065,1628021,CHI,ATL,David Nwaba,109,23.3666666666667,23,0.366666666666667,46,49,-3,-2,-1
21700065,1628374,CHI,ATL,Lauri Markkanen,133,30.5333333333333,31,-0.466666666666669,56,54,2,4,-2
21700066,1717,DAL,MEM,Dirk Nowitzki,127,27.4833333333333,28,-0.516666666666666,55,62,-7,-9,2
21700066,200826,DAL,MEM,J.J. Barea,118,24.6,25,-0.399999999999999,46,55,-9,-8,-1
21700066,202083,DAL,MEM,Wesley Matthews,167,35.0166666666667,35,0.0166666666666657,70,76,-6,-8,2
21700066,203084,DAL,MEM,Harrison Barnes,184,37.8666666666667,37,0.86666666666666,73,77,-4,-2,-2
21700066,203457,DAL,MEM,Nerlens Noel,86,19.7666666666667,19,0.766666666666666,39,34,5,11,-6
21700066,203939,DAL,MEM,Dwight Powell,74,15.5166666666667,16,-0.483333333333333,25,21,4,3,1
21700066,1626257,DAL,MEM,Salah Mejri,50,9.85,10,-0.15,14,30,-16,-17,1
21700066,1627812,DAL,MEM,Yogi Ferrell,109,22.1166666666667,22,0.116666666666667,42,38,4,-2,6
21700066,1628372,DAL,MEM,Dennis Smith Jr.,153,32.65,33,-0.350000000000001,62,58,4,3,1
21700066,1628467,DAL,MEM,Maxi Kleber,59,12.4,12,0.399999999999999,21,17,4,6,-2
21700066,1628492,DAL,MEM,Gian Clavell,13,2.73333333333333,3,-0.266666666666667,8,12,-4,-2,-2
21700066,201144,MEM,DAL,Mike Conley,146,31.1166666666667,31,0.116666666666667,59,62,-3,-3,0
21700066,201148,MEM,DAL,Brandan Wright,57,12.2666666666667,12,0.266666666666666,27,23,4,6,-2
21700066,201188,MEM,DAL,Marc Gasol,161,33.8333333333333,34,-0.166666666666671,59,62,-3,-7,4
21700066,201596,MEM,DAL,Mario Chalmers,93,19.5666666666667,20,-0.433333333333334,39,32,7,4,3
21700066,201936,MEM,DAL,Tyreke Evans,106,22.5333333333333,22,0.533333333333331,49,38,11,9,2
21700066,202718,MEM,DAL,Chandler Parsons,73,15.7,16,-0.300000000000001,29,28,1,5,-4
21700066,203516,MEM,DAL,James Ennis III,131,27.1833333333333,27,0.18333333333333,61,55,6,7,-1
21700066,1626150,MEM,DAL,Andrew Harrison,96,19.9333333333333,20,-0.0666666666666664,33,43,-10,-9,-1
21700066,1626185,MEM,DAL,Jarell Martin,155,32.3,32,0.299999999999997,67,63,4,0,4
21700066,1628415,MEM,DAL,Dillon Brooks,122,25.5666666666667,25,0.56666666666667,57,49,8,13,-5
21700067,201143,BOS,MIL,Al Horford,152,34.5166666666667,34,0.516666666666666,69,63,6,2,4
21700067,202681,BOS,MIL,Kyrie Irving,143,34.6333333333333,35,-0.366666666666667,78,74,4,4,0
21700067,203382,BOS,MIL,Aron Baynes,96,22.75,24,-1.25,50,40,10,12,-2
21700067,203499,BOS,MIL,Shane Larkin,29,5,5,0,3,6,-3,-3,0
21700067,203935,BOS,MIL,Marcus Smart,105,26.3166666666667,27,-0.683333333333334,56,47,9,7,2
21700067,1626179,BOS,MIL,Terry Rozier,94,21.15,21,0.149999999999999,36,35,1,1,0
21700067,1627759,BOS,MIL,Jaylen Brown,152,33.4166666666667,34,-0.583333333333336,70,67,3,5,-2
21700067,1628369,BOS,MIL,Jayson Tatum,122,27.7333333333333,28,-0.266666666666666,58,52,6,8,-2
21700067,1628400,BOS,MIL,Semi Ojeleye,61,13.9333333333333,14,-0.0666666666666664,20,22,-2,-2,0
21700067,1628464,BOS,MIL,Daniel Theis,81,18.8,19,-0.200000000000003,40,39,1,1,0
21700067,202328,MIL,BOS,Greg Monroe,76,16.95,17,-0.0500000000000007,27,28,-1,-1,0
21700067,202732,MIL,BOS,DeAndre Liggins,74,16,16,0,29,39,-10,-7,-3
21700067,203089,MIL,BOS,John Henson,62,16.35,17,-0.649999999999999,36,29,7,7,0
21700067,203114,MIL,BOS,Khris Middleton,145,34.6,35,-0.399999999999999,76,77,-1,-3,2
21700067,203141,MIL,BOS,Mirza Teletovic,80,16.7833333333333,17,-0.216666666666669,29,29,0,0,0
21700067,203503,MIL,BOS,Tony Snell,102,24.9833333333333,25,-0.0166666666666657,50,51,-1,-2,1
21700067,203507,MIL,BOS,Giannis Antetokounmpo,181,41.8,42,-0.200000000000003,73,85,-12,-10,-2
21700067,203521,MIL,BOS,Matthew Dellavedova,98,21.65,21,0.649999999999999,31,42,-11,-11,0
21700067,1627748,MIL,BOS,Thon Maker,68,14.0333333333333,14,0.0333333333333332,26,37,-11,-11,0
21700067,1627763,MIL,BOS,Malcolm Brogdon,149,35.1,36,-0.899999999999999,68,63,5,3,2
21700068,101150,LAC,POR,Lou Williams,87,18.4166666666667,19,-0.583333333333336,48,42,6,6,0
21700068,201568,LAC,POR,Danilo Gallinari,173,38.3166666666667,38,0.316666666666663,80,80,0,1,-1
21700068,201599,LAC,POR,DeAndre Jordan,169,37.8333333333333,38,-0.166666666666671,85,79,6,6,0
21700068,201933,LAC,POR,Blake Griffin,175,40.3833333333333,40,0.383333333333333,89,89,0,3,-3
21700068,201976,LAC,POR,Patrick Beverley,147,33.8333333333333,34,-0.166666666666671,70,68,2,-2,4
21700068,202325,LAC,POR,Wesley Johnson,71,14.9333333333333,15,-0.0666666666666664,29,32,-3,-5,2
21700068,203085,LAC,POR,Austin Rivers,153,35.15,35,0.149999999999999,65,75,-10,-6,-4
21700068,203186,LAC,POR,Willie Reed,39,8.78333333333333,9,-0.216666666666667,18,19,-1,1,-2
21700068,1626155,LAC,POR,Sam Dekker,19,3.65,4,-0.35,8,11,-3,-2,-1
21700068,1628414,LAC,POR,Sindarius Thornwell,42,8.7,9,-0.300000000000001,23,20,3,3,0
21700068,202323,POR,LAC,Evan Turner,103,22.1,22,0.100000000000001,49,49,0,0,0
21700068,202329,POR,LAC,Al-Farouq Aminu,140,32.6166666666667,33,-0.383333333333333,71,62,9,7,2
21700068,202334,POR,LAC,Ed Davis,107,22.05,22,0.0499999999999972,45,48,-3,-4,1
21700068,203081,POR,LAC,Damian Lillard,166,38.55,38,0.549999999999997,80,80,0,1,-1
21700068,203090,POR,LAC,Maurice Harkless,154,35.1833333333333,36,-0.816666666666663,80,76,4,2,2
21700068,203468,POR,LAC,CJ McCollum,173,38.5166666666667,39,-0.483333333333334,85,79,6,3,3
21700068,203894,POR,LAC,Shabazz Napier,40,8.53333333333333,8,0.533333333333333,18,23,-5,-3,-2
21700068,203994,POR,LAC,Jusuf Nurkic,116,26.85,27,-0.149999999999999,53,63,-10,-10,0
21700068,1626192,POR,LAC,Pat Connaughton,53,10.9333333333333,11,-0.0666666666666664,23,24,-1,-1,0
21700068,1628403,POR,LAC,Caleb Swanigan,23,4.66666666666667,5,-0.333333333333334,11,11,0,0,0
21700069,2749,NOP,SAC,Jameer Nelson,169,35.5666666666667,36,-0.433333333333337,84,71,13,18,-5
21700069,2754,NOP,SAC,Tony Allen,68,11.7,12,-0.300000000000001,29,37,-8,-8,0
21700069,201950,NOP,SAC,Jrue Holiday,176,40.0166666666667,41,-0.983333333333334,97,80,17,14,3
21700069,201967,NOP,SAC,Dante Cunningham,155,34.7,34,0.700000000000003,82,69,13,13,0
21700069,202326,NOP,SAC,DeMarcus Cousins,205,43.3333333333333,44,-0.666666666666671,99,102,-3,1,-4
21700069,202734,NOP,SAC,E'Twaun Moore,172,38.1166666666667,38,0.11666666666666,92,81,11,11,0
21700069,203121,NOP,SAC,Darius Miller,26,5.76666666666667,6,-0.233333333333333,6,21,-15,-15,0
21700069,203546,NOP,SAC,Ian Clark,104,19.8833333333333,20,-0.116666666666667,57,46,11,9,2
21700069,1627767,NOP,SAC,Cheick Diallo,55,9.16666666666667,9,0.166666666666666,24,23,1,-3,4
21700069,1713,SAC,NOP,Vince Carter,36,7.28333333333333,7,0.283333333333333,18,19,-1,-1,0
21700069,2216,SAC,NOP,Zach Randolph,128,28.9833333333333,29,-0.0166666666666657,57,69,-12,-12,0
21700069,201585,SAC,NOP,Kosta Koufos,95,18.15,18,0.149999999999999,45,44,1,3,-2
21700069,201588,SAC,NOP,George Hill,131,30.0333333333333,30,0.0333333333333314,60,69,-9,-8,-1
21700069,202066,SAC,NOP,Garrett Temple,125,24.15,24,0.149999999999999,54,61,-7,-5,-2
21700069,203992,SAC,NOP,Bogdan Bogdanovic,125,25.3,25,0.299999999999997,63,63,0,-2,2
21700069,1626161,SAC,NOP,Willie Cauley-Stein,131,29.5,30,-0.5,61,70,-9,-11,2
21700069,1627741,SAC,NOP,Buddy Hield,84,19.3333333333333,20,-0.666666666666664,42,43,-1,-1,0
21700069,1627746,SAC,NOP,Skal Labissiere,85,15.4166666666667,15,0.416666666666668,40,39,1,1,0
21700069,1628368,SAC,NOP,De'Aaron Fox,122,24.5666666666667,25,-0.433333333333334,54,62,-8,-9,1
21700069,1628382,SAC,NOP,Justin Jackson,68,15.5333333333333,16,-0.466666666666667,36,31,5,5,0
21700070,200782,HOU,CHA,PJ Tucker,165,37.2833333333333,37,0.283333333333331,89,60,29,26,3
21700070,201569,HOU,CHA,Eric Gordon,183,38.5,39,-0.5,89,76,13,13,0
21700070,201583,HOU,CHA,Ryan Anderson,168,34.7166666666667,35,-0.283333333333331,75,72,3,-1,4
21700070,201601,HOU,CHA,Luc Mbah a Moute,188,40.0666666666667,41,-0.933333333333337,97,72,25,22,3
21700070,201628,HOU,CHA,Bobby Brown,116,26.0666666666667,26,0.06666666666667,62,46,16,15,1
21700070,201935,HOU,CHA,James Harden,177,36.9166666666667,37,-0.0833333333333357,79,79,0,-3,3
21700070,203991,HOU,CHA,Clint Capela,79,15.8,17,-1.2,33,37,-4,-6,2
21700070,204028,HOU,CHA,Tarik Black,39,8.98333333333333,9,-0.0166666666666657,21,18,3,4,-1
21700070,2730,CHA,HOU,Dwight Howard,153,32.0666666666667,32,0.0666666666666629,66,68,-2,-1,-1
21700070,101107,CHA,HOU,Marvin Williams,122,25.2,26,-0.800000000000001,56,55,1,-3,4
21700070,202689,CHA,HOU,Kemba Walker,176,38.1166666666667,39,-0.883333333333333,77,86,-9,-6,-3
21700070,203077,CHA,HOU,Michael Kidd-Gilchrist,71,13.3666666666667,14,-0.633333333333333,31,20,11,8,3
21700070,203087,CHA,HOU,Jeremy Lamb,144,29.8333333333333,30,-0.166666666666664,65,69,-4,-3,-1
21700070,203948,CHA,HOU,Johnny O'Bryant III,62,13.45,14,-0.550000000000001,22,36,-14,-14,0
21700070,1626163,CHA,HOU,Frank Kaminsky,130,29.1333333333333,30,-0.866666666666667,45,71,-26,-23,-3
21700070,1628370,CHA,HOU,Malik Monk,123,27.85,28,-0.149999999999999,45,65,-20,-19,-1
21700070,1628407,CHA,HOU,Dwayne Bacon,134,29.3166666666667,29,0.316666666666666,53,75,-22,-19,-3
21700071,201167,ORL,SAS,Arron Afflalo,29,5.76666666666667,6,-0.233333333333333,8,13,-5,-5,0
21700071,201571,ORL,SAS,D.J. Augustin,114,24.6833333333333,24,0.68333333333333,61,41,20,20,0
21700071,201578,ORL,SAS,Marreese Speights,29,5.76666666666667,6,-0.233333333333333,8,13,-5,-5,0
21700071,202687,ORL,SAS,Bismack Biyombo,95,19.0666666666667,19,0.0666666666666664,46,31,15,15,0
21700071,202696,ORL,SAS,Nikola Vucevic,107,22.7666666666667,23,-0.233333333333334,60,41,19,17,2
21700071,202714,ORL,SAS,Shelvin Mack,114,22.6166666666667,23,-0.383333333333333,51,44,7,5,2
21700071,203082,ORL,SAS,Terrence Ross,117,24.1333333333333,24,0.133333333333333,56,34,22,18,4
21700071,203095,ORL,SAS,Evan Fournier,129,26.8333333333333,27,-0.166666666666668,73,53,20,20,0
21700071,203613,ORL,SAS,Jonathon Simmons,112,22.2666666666667,23,-0.733333333333334,62,43,19,19,0
21700071,203932,ORL,SAS,Aaron Gordon,122,26.1,26,0.100000000000001,67,45,22,20,2
21700071,1626209,ORL,SAS,Mario Hezonja,55,11.6,12,-0.4,19,23,-4,-4,0
21700071,1628371,ORL,SAS,Jonathan Isaac,97,19.7166666666667,19,0.716666666666669,49,31,18,18,0
21700071,1628411,ORL,SAS,Wes Iwundu,35,6.68333333333333,7,-0.316666666666666,10,13,-3,-3,0
21700071,1938,SAS,ORL,Manu Ginobili,74,14.3,14,0.300000000000001,29,46,-17,-15,-2
21700071,2200,SAS,ORL,Pau Gasol,117,25.5,26,-0.5,41,55,-14,-14,0
21700071,200746,SAS,ORL,LaMarcus Aldridge,144,29.3333333333333,30,-0.666666666666668,55,77,-22,-20,-2
21700071,200752,SAS,ORL,Rudy Gay,118,23.8833333333333,24,-0.116666666666667,46,64,-18,-16,-2
21700071,201980,SAS,ORL,Danny Green,85,17.6333333333333,18,-0.366666666666667,28,39,-11,-9,-2
21700071,201988,SAS,ORL,Patty Mills,104,20.9333333333333,21,-0.0666666666666664,40,61,-21,-19,-2
21700071,202722,SAS,ORL,Davis Bertans,73,14.9666666666667,15,-0.0333333333333332,28,28,0,0,0
21700071,203464,SAS,ORL,Brandon Paul,109,20.9166666666667,21,-0.0833333333333322,42,49,-7,-7,0
21700071,203937,SAS,ORL,Kyle Anderson,101,21.35,22,-0.649999999999999,32,49,-17,-17,0
21700071,1627749,SAS,ORL,Dejounte Murray,94,19.5333333333333,20,-0.466666666666669,32,42,-10,-10,0
21700071,1627854,SAS,ORL,Bryn Forbes,81,18.05,17,1.05,29,41,-12,-12,0
21700071,1628401,SAS,ORL,Derrick White,55,11.6,12,-0.4,23,19,4,4,0
21700072,101141,ATL,DEN,Ersan Ilyasova,131,29.45,30,-0.550000000000001,65,64,1,3,-2
21700072,201158,ATL,DEN,Marco Belinelli,136,27.9833333333333,28,-0.0166666666666657,64,64,0,1,-1
21700072,202337,ATL,DEN,Luke Babbitt,2,0.45,0,0.45,2,0,2,0,2
21700072,203145,ATL,DEN,Kent Bazemore,117,26.5166666666667,27,-0.483333333333334,49,54,-5,-5,0
21700072,203471,ATL,DEN,Dennis Schroder,148,32.1333333333333,33,-0.866666666666667,72,67,5,4,1
21700072,203473,ATL,DEN,Dewayne Dedmon,137,30.5833333333333,31,-0.416666666666668,71,64,7,6,1
21700072,203488,ATL,DEN,Mike Muscala,99,20.65,21,-0.350000000000001,39,47,-8,-6,-2
21700072,1627098,ATL,DEN,Malcolm Delaney,90,19.1833333333333,19,0.183333333333334,32,47,-15,-9,-6
21700072,1627752,ATL,DEN,Taurean Prince,155,32.7833333333333,33,-0.216666666666669,68,70,-2,1,-3
21700072,1627819,ATL,DEN,Isaiah Taylor,24,5.15,5,0.15,11,15,-4,-5,1
21700072,1628381,ATL,DEN,John Collins,76,14.7833333333333,14,0.783333333333333,27,33,-6,-5,-1
21700072,200794,DEN,ATL,Paul Millsap,143,30.4833333333333,30,0.483333333333334,65,68,-3,-7,4
21700072,201163,DEN,ATL,Wilson Chandler,106,22.4333333333333,23,-0.566666666666666,44,47,-3,-4,1
21700072,202702,DEN,ATL,Kenneth Faried,49,11.2,12,-0.800000000000001,24,24,0,2,-2
21700072,203115,DEN,ATL,Will Barton,139,29.1,29,0.100000000000001,71,60,11,9,2
21700072,203486,DEN,ATL,Mason Plumlee,93,19.4333333333333,19,0.43333333333333,49,39,10,5,5
21700072,203914,DEN,ATL,Gary Harris,161,34.7333333333333,34,0.733333333333334,74,71,3,-3,6
21700072,203999,DEN,ATL,Nikola Jokic,155,34.1,34,0.100000000000001,71,67,4,8,-4
21700072,1626144,DEN,ATL,Emmanuel Mudiay,134,28.1666666666667,28,0.166666666666664,70,62,8,9,-1
21700072,1627736,DEN,ATL,Malik Beasley,45,10.1166666666667,11,-0.883333333333333,22,24,-2,2,-4
21700072,1627750,DEN,ATL,Jamal Murray,90,19.9,20,-0.100000000000001,35,38,-3,-6,3
21700073,201960,BKN,NYK,DeMarre Carroll,105,23.0833333333333,23,0.0833333333333357,41,51,-10,-9,-1
21700073,202344,BKN,NYK,Trevor Booker,81,18.1666666666667,18,0.166666666666664,38,48,-10,-11,1
21700073,202389,BKN,NYK,Timofey Mozgov,68,13.8666666666667,14,-0.133333333333333,21,30,-9,-11,2
21700073,203092,BKN,NYK,Tyler Zeller,50,9.46666666666667,10,-0.533333333333333,17,16,1,1,0
21700073,203112,BKN,NYK,Quincy Acy,82,18.8333333333333,19,-0.166666666666668,39,47,-8,-7,-1
21700073,203459,BKN,NYK,Allen Crabbe,91,20.4,20,0.399999999999999,36,44,-8,-9,1
21700073,203915,BKN,NYK,Spencer Dinwiddie,97,21.45,22,-0.550000000000001,52,54,-2,-1,-1
21700073,203925,BKN,NYK,Joe Harris,129,26.7333333333333,27,-0.266666666666666,51,63,-12,-13,1
21700073,203930,BKN,NYK,Sean Kilpatrick,50,9.46666666666667,10,-0.533333333333333,17,16,1,1,0
21700073,1626156,BKN,NYK,D'Angelo Russell,81,17.5833333333333,18,-0.416666666666668,23,40,-17,-17,0
21700073,1626178,BKN,NYK,Rondae Hollis-Jefferson,79,17.25,17,0.25,25,35,-10,-10,0
21700073,1627747,BKN,NYK,Caris LeVert,125,25.8666666666667,26,-0.133333333333333,42,56,-14,-16,2
21700073,1628386,BKN,NYK,Jarrett Allen,72,14.75,16,-1.25,23,25,-2,-3,1
21700073,101127,NYK,BKN,Jarrett Jack,116,25.5333333333333,26,-0.466666666666669,52,41,11,11,0
21700073,201563,NYK,BKN,Michael Beasley,69,14.55,15,-0.449999999999999,36,29,7,8,-1
21700073,201584,NYK,BKN,Courtney Lee,136,29.9833333333333,30,-0.0166666666666657,69,57,12,13,-1
21700073,202498,NYK,BKN,Lance Thomas,29,5.91666666666667,6,-0.083333333333333,14,10,4,4,0
21700073,202683,NYK,BKN,Enes Kanter,78,16.2666666666667,16,0.266666666666666,44,29,15,12,3
21700073,203124,NYK,BKN,Kyle O'Quinn,84,18.2833333333333,18,0.283333333333331,37,40,-3,1,-4
21700073,203501,NYK,BKN,Tim Hardaway Jr.,170,35.95,37,-1.05,82,67,15,14,1
21700073,203926,NYK,BKN,Doug McDermott,98,20.6833333333333,21,-0.316666666666666,42,36,6,8,-2
21700073,204001,NYK,BKN,Kristaps Porzingis,134,29.2833333333333,29,0.283333333333331,60,48,12,12,0
21700073,1626195,NYK,BKN,Willy Hernangomez,60,12.8333333333333,13,-0.166666666666668,24,16,8,8,0
21700073,1628373,NYK,BKN,Frank Ntilikina,106,21.85,23,-1.15,53,44,9,10,-1
21700073,1628422,NYK,BKN,Damyean Dotson,30,5.78333333333333,6,-0.216666666666667,12,8,4,4,0
21700074,2037,MIN,OKC,Jamal Crawford,60,13.35,13,0.350000000000001,26,36,-10,-7,-3
21700074,201952,MIN,OKC,Jeff Teague,185,36.8666666666667,37,-0.133333333333333,96,86,10,12,-2
21700074,201959,MIN,OKC,Taj Gibson,186,36.45,36,0.450000000000003,95,87,8,6,2
21700074,202357,MIN,OKC,Nemanja Bjelica,31,7.68333333333333,8,-0.316666666666666,13,19,-6,-4,-2
21700074,202710,MIN,OKC,Jimmy Butler,189,38.4166666666667,38,0.416666666666664,102,90,12,11,1
21700074,203476,MIN,OKC,Gorgui Dieng,53,11.8,12,-0.199999999999999,19,33,-14,-14,0
21700074,203498,MIN,OKC,Shabazz Muhammad,47,11.35,12,-0.65,25,30,-5,-5,0
21700074,203952,MIN,OKC,Andrew Wiggins,186,36.6,36,0.600000000000001,93,86,7,8,-1
21700074,1626145,MIN,OKC,Tyus Jones,44,10.3166666666667,10,0.316666666666666,20,28,-8,-9,1
21700074,1626157,MIN,OKC,Karl-Anthony Towns,180,36.15,36,0.149999999999999,99,83,16,17,-1
21700074,1627875,MIN,OKC,Marcus Georges-Hunt,4,0.766666666666667,1,-0.233333333333333,2,2,0,0,0
21700074,2546,OKC,MIN,Carmelo Anthony,175,37.0333333333333,37,0.0333333333333314,88,93,-5,-7,2
21700074,101109,OKC,MIN,Raymond Felton,56,13.6,14,-0.4,36,27,9,13,-4
21700074,201566,OKC,MIN,Russell Westbrook,187,36.7333333333333,37,-0.266666666666666,87,97,-10,-13,3
21700074,202331,OKC,MIN,Paul George,194,38.0333333333333,38,0.0333333333333314,91,97,-6,-5,-1
21700074,202335,OKC,MIN,Patrick Patterson,87,18.6333333333333,19,-0.366666666666667,51,36,15,17,-2
21700074,203460,OKC,MIN,Andre Roberson,48,9.76666666666667,10,-0.233333333333334,20,21,-1,-1,0
21700074,203500,OKC,MIN,Steven Adams,158,31.55,32,-0.449999999999999,69,85,-16,-19,3
21700074,203518,OKC,MIN,Alex Abrines,37,8.56666666666667,8,0.566666666666666,28,21,7,9,-2
21700074,203924,OKC,MIN,Jerami Grant,143,28.0833333333333,28,0.0833333333333357,70,78,-8,-11,3
21700074,203962,OKC,MIN,Josh Huestis,73,15.2833333333333,15,0.283333333333335,38,35,3,0,3
21700074,1628390,OKC,MIN,Terrance Ferguson,7,2.46666666666667,3,-0.533333333333333,2,0,2,2,0
21700075,2561,GSW,WAS,David West,78,15.4833333333333,15,0.483333333333334,41,34,7,7,0
21700075,2585,GSW,WAS,Zaza Pachulia,69,12.7833333333333,13,-0.216666666666667,27,36,-9,-9,0
21700075,2738,GSW,WAS,Andre Iguodala,162,31.15,31,0.149999999999999,80,73,7,9,-2
21700075,201142,GSW,WAS,Kevin Durant,203,38.75,39,-0.25,96,92,4,4,0
21700075,201156,GSW,WAS,Nick Young,42,7.73333333333333,8,-0.266666666666667,18,19,-1,-1,0
21700075,201580,GSW,WAS,JaVale McGee,49,9.45,9,0.449999999999999,29,26,3,5,-2
21700075,201939,GSW,WAS,Stephen Curry,195,36.4333333333333,36,0.433333333333337,89,97,-8,-8,0
21700075,201956,GSW,WAS,Omri Casspi,65,13.2833333333333,13,0.283333333333333,40,23,17,17,0
21700075,202691,GSW,WAS,Klay Thompson,162,30.8833333333333,31,-0.116666666666667,76,79,-3,-4,1
21700075,203110,GSW,WAS,Draymond Green,90,16.5333333333333,17,-0.466666666666669,32,46,-14,-14,0
21700075,1626172,GSW,WAS,Kevon Looney,62,11.5833333333333,12,-0.416666666666668,29,23,6,4,2
21700075,1627775,GSW,WAS,Patrick McCaw,83,15.9333333333333,16,-0.0666666666666664,43,37,6,5,1
21700075,101133,WAS,GSW,Ian Mahinmi,64,12.2666666666667,13,-0.733333333333334,23,32,-9,-9,0
21700075,101162,WAS,GSW,Marcin Gortat,173,33.1,33,0.0999999999999943,86,83,3,4,-1
21700075,201975,WAS,GSW,Jodie Meeks,136,27.0666666666667,27,0.0666666666666664,60,76,-16,-20,4
21700075,202322,WAS,GSW,John Wall,202,38.1,38,0.100000000000001,99,93,6,6,0
21700075,203078,WAS,GSW,Bradley Beal,86,15.55,15,0.549999999999999,45,29,16,16,0
21700075,203107,WAS,GSW,Tomas Satoransky,27,5.61666666666667,6,-0.383333333333334,13,24,-11,-9,-2
21700075,203118,WAS,GSW,Mike Scott,128,24.1666666666667,24,0.166666666666664,63,65,-2,-1,-1
21700075,203490,WAS,GSW,Otto Porter Jr.,179,33.4666666666667,34,-0.533333333333331,82,75,7,5,2
21700075,204025,WAS,GSW,Tim Frazier,64,12.2666666666667,13,-0.733333333333334,23,32,-9,-9,0
21700075,1626162,WAS,GSW,Kelly Oubre Jr.,201,38.4,39,-0.600000000000001,91,91,0,2,-2
21700076,201147,LAL,TOR,Corey Brewer,112,21.95,22,-0.0500000000000007,50,47,3,2,1
21700076,201572,LAL,TOR,Brook Lopez,112,24,24,0,33,55,-22,-21,-1
21700076,203484,LAL,TOR,Kentavious Caldwell-Pope,128,28.1,28,0.100000000000001,43,59,-16,-17,1
21700076,203898,LAL,TOR,Tyler Ennis,25,4.78333333333333,5,-0.216666666666667,13,6,7,6,1
21700076,203903,LAL,TOR,Jordan Clarkson,72,13.8666666666667,14,-0.133333333333333,31,26,5,4,1
21700076,203944,LAL,TOR,Julius Randle,116,23.3666666666667,24,-0.633333333333333,58,43,15,14,1
21700076,1626204,LAL,TOR,Larry Nance Jr.,75,17.0833333333333,17,0.0833333333333357,22,37,-15,-14,-1
21700076,1627742,LAL,TOR,Brandon Ingram,109,23.7166666666667,23,0.716666666666665,37,53,-16,-15,-1
21700076,1628366,LAL,TOR,Lonzo Ball,144,31.6833333333333,32,-0.316666666666666,51,68,-17,-15,-2
21700076,1628398,LAL,TOR,Kyle Kuzma,159,31.55,32,-0.450000000000003,69,65,4,3,1
21700076,1628404,LAL,TOR,Josh Hart,103,19.9,20,-0.100000000000001,48,41,7,8,-1
21700076,101139,TOR,LAL,CJ Miles,126,25.1666666666667,25,0.166666666666664,49,52,-3,-4,1
21700076,200768,TOR,LAL,Kyle Lowry,173,36.3833333333333,36,0.383333333333333,82,66,16,14,2
21700076,201586,TOR,LAL,Serge Ibaka,161,33.9,34,-0.100000000000001,78,58,20,21,-1
21700076,201942,TOR,LAL,DeMar DeRozan,176,37.1666666666667,37,0.166666666666671,80,65,15,14,1
21700076,1626153,TOR,LAL,Delon Wright,58,11.6166666666667,12,-0.383333333333333,18,25,-7,-5,-2
21700076,1626181,TOR,LAL,Norman Powell,97,20.7166666666667,21,-0.283333333333331,49,31,18,17,1
21700076,1627751,TOR,LAL,Jakob Poeltl,91,18.5333333333333,19,-0.466666666666669,31,43,-12,-13,1
21700076,1627783,TOR,LAL,Pascal Siakam,115,25.2,25,0.199999999999999,54,42,12,13,-1
21700076,1627832,TOR,LAL,Fred VanVleet,63,12.95,13,-0.0500000000000007,22,34,-12,-9,-3
21700076,1628384,TOR,LAL,OG Anunoby,95,18.3666666666667,19,-0.633333333333333,37,39,-2,-3,1
21700077,2544,CLE,NOP,LeBron James,139,30.4,31,-0.600000000000001,68,80,-12,-10,-2
21700077,2548,CLE,NOP,Dwyane Wade,112,23.6333333333333,23,0.633333333333333,50,56,-6,-8,2
21700077,2594,CLE,NOP,Kyle Korver,103,21.95,23,-1.05,45,55,-10,-10,0
21700077,2747,CLE,NOP,JR Smith,100,22.8666666666667,23,-0.133333333333333,55,64,-9,-7,-2
21700077,101112,CLE,NOP,Channing Frye,84,16.0666666666667,16,0.0666666666666664,33,33,0,0,0
21700077,101181,CLE,NOP,Jose Calderon,33,5.5,6,-0.5,7,13,-6,-6,0
21700077,201145,CLE,NOP,Jeff Green,76,16.9166666666667,16,0.916666666666664,30,46,-16,-18,2
21700077,201567,CLE,NOP,Kevin Love,122,27.2,27,0.199999999999999,64,76,-12,-12,0
21700077,202684,CLE,NOP,Tristan Thompson,97,22.25,22,0.25,53,62,-9,-9,0
21700077,202697,CLE,NOP,Iman Shumpert,96,20.7166666666667,21,-0.283333333333331,47,51,-4,-4,0
21700077,203109,CLE,NOP,Jae Crowder,97,21,21,0,39,53,-14,-14,0
21700077,1626224,CLE,NOP,Cedi Osman,33,5.5,6,-0.5,7,13,-6,-6,0
21700077,1627790,CLE,NOP,Ante Zizic,33,5.5,6,-0.5,7,13,-6,-6,0
21700077,2746,NOP,CLE,Josh Smith,37,6.81666666666667,7,-0.183333333333334,13,16,-3,-3,0
21700077,2749,NOP,CLE,Jameer Nelson,87,18.8,19,-0.199999999999999,45,35,10,10,0
21700077,2754,NOP,CLE,Tony Allen,34,5.66666666666667,6,-0.333333333333333,7,15,-8,-9,1
21700077,201950,NOP,CLE,Jrue Holiday,171,37,37,0,94,75,19,19,0
21700077,201967,NOP,CLE,Dante Cunningham,144,31.4666666666667,31,0.466666666666669,84,68,16,16,0
21700077,202326,NOP,CLE,DeMarcus Cousins,145,32.3,32,0.299999999999997,96,73,23,23,0
21700077,202734,NOP,CLE,E'Twaun Moore,149,33.1333333333333,33,0.133333333333333,87,74,13,13,0
21700077,203076,NOP,CLE,Anthony Davis,162,36.4666666666667,36,0.466666666666669,100,76,24,24,0
21700077,203121,NOP,CLE,Darius Miller,25,3.96666666666667,4,-0.0333333333333332,6,7,-1,-1,0
21700077,203546,NOP,CLE,Ian Clark,100,21.4333333333333,21,0.433333333333334,60,45,15,15,0
21700077,1627767,NOP,CLE,Cheick Diallo,33,6.78333333333333,7,-0.216666666666667,11,11,0,1,-1
21700077,1627883,NOP,CLE,Jalen Jones,19,2.83333333333333,3,-0.166666666666667,6,5,1,1,0
21700077,1628429,NOP,CLE,Charles Cooke,19,2.83333333333333,3,-0.166666666666667,6,5,1,1,0
21700078,201143,BOS,MIA,Al Horford,152,33.8833333333333,34,-0.116666666666667,67,62,5,5,0
21700078,202681,BOS,MIA,Kyrie Irving,152,33.7,34,-0.299999999999997,63,61,2,4,-2
21700078,203382,BOS,MIA,Aron Baynes,106,24.5166666666667,24,0.516666666666666,46,37,9,5,4
21700078,203499,BOS,MIA,Shane Larkin,43,10.1333333333333,11,-0.866666666666667,25,14,11,9,2
21700078,203935,BOS,MIA,Marcus Smart,125,26.8,27,-0.200000000000003,58,59,-1,-2,1
21700078,1626179,BOS,MIA,Terry Rozier,108,25.0166666666667,25,0.0166666666666657,45,46,-1,-1,0
21700078,1627759,BOS,MIA,Jaylen Brown,144,32.25,32,0.25,70,55,15,18,-3
21700078,1628369,BOS,MIA,Jayson Tatum,145,31.1333333333333,31,0.133333333333333,64,64,0,2,-2
21700078,1628400,BOS,MIA,Semi Ojeleye,32,7.06666666666667,7,0.0666666666666664,10,17,-7,-7,0
21700078,1628464,BOS,MIA,Daniel Theis,68,15.1666666666667,15,0.166666666666668,32,35,-3,-3,0
21700078,201609,MIA,BOS,Goran Dragic,169,36.4833333333333,36,0.483333333333334,72,80,-8,-8,0
21700078,201949,MIA,BOS,James Johnson,147,32.6,33,-0.400000000000006,56,66,-10,-8,-2
21700078,201961,MIA,BOS,Wayne Ellington,70,17.0666666666667,17,0.0666666666666664,25,35,-10,-10,0
21700078,203079,MIA,BOS,Dion Waiters,100,23.7333333333333,24,-0.266666666666666,37,44,-7,-5,-2
21700078,203482,MIA,BOS,Kelly Olynyk,109,24.0666666666667,24,0.0666666666666664,51,46,5,3,2
21700078,204020,MIA,BOS,Tyler Johnson,102,22.7333333333333,23,-0.266666666666666,46,43,3,1,2
21700078,1626159,MIA,BOS,Justise Winslow,109,23.35,23,0.350000000000001,52,47,5,3,2
21700078,1626196,MIA,BOS,Josh Richardson,163,35.7666666666667,36,-0.233333333333334,72,69,3,3,0
21700078,1628389,MIA,BOS,Bam Adebayo,106,23.8666666666667,24,-0.133333333333333,39,50,-11,-9,-2
21700079,201577,CHI,OKC,Robin Lopez,112,25.2333333333333,25,0.233333333333334,39,54,-15,-13,-2
21700079,202347,CHI,OKC,Quincy Pondexter,91,20.2666666666667,20,0.266666666666666,25,39,-14,-15,1
21700079,203200,CHI,OKC,Justin Holiday,145,31.6666666666667,32,-0.333333333333336,51,69,-18,-18,0
21700079,1626170,CHI,OKC,Jerian Grant,89,20.7833333333333,21,-0.216666666666669,31,48,-17,-17,0
21700079,1626245,CHI,OKC,Cristiano Felicio,104,22.6666666666667,23,-0.333333333333336,30,47,-17,-19,2
21700079,1627739,CHI,OKC,Kris Dunn,106,22.4166666666667,22,0.416666666666664,34,42,-8,-8,0
21700079,1627756,CHI,OKC,Denzel Valentine,147,31.3333333333333,31,0.333333333333336,47,59,-12,-14,2
21700079,1627770,CHI,OKC,Kay Felder,21,4.7,5,-0.300000000000001,4,11,-7,-7,0
21700079,1627835,CHI,OKC,Paul Zipser,69,16.5666666666667,17,-0.433333333333334,22,42,-20,-18,-2
21700079,1628021,CHI,OKC,David Nwaba,71,16.2333333333333,16,0.233333333333334,18,32,-14,-14,0
21700079,1628374,CHI,OKC,Lauri Markkanen,125,27.6333333333333,28,-0.366666666666667,44,62,-18,-17,-1
21700079,2546,OKC,CHI,Carmelo Anthony,124,27.7666666666667,28,-0.233333333333334,67,43,24,26,-2
21700079,2555,OKC,CHI,Nick Collison,21,4.7,5,-0.300000000000001,11,4,7,7,0
21700079,101109,OKC,CHI,Raymond Felton,93,20.1,20,0.100000000000001,33,29,4,7,-3
21700079,201566,OKC,CHI,Russell Westbrook,126,28.2166666666667,28,0.216666666666669,66,38,28,26,2
21700079,202331,OKC,CHI,Paul George,128,28.6833333333333,29,-0.316666666666663,64,41,23,20,3
21700079,202335,OKC,CHI,Patrick Patterson,70,15.2166666666667,15,0.216666666666667,26,27,-1,2,-3
21700079,203460,OKC,CHI,Andre Roberson,85,20.3333333333333,20,0.333333333333332,50,27,23,21,2
21700079,203500,OKC,CHI,Steven Adams,125,27.9833333333333,28,-0.0166666666666657,64,38,26,23,3
21700079,203518,OKC,CHI,Alex Abrines,86,18.45,18,0.449999999999999,31,34,-3,-1,-2
21700079,203924,OKC,CHI,Jerami Grant,107,22.9166666666667,23,-0.0833333333333357,42,39,3,2,1
21700079,203962,OKC,CHI,Josh Huestis,79,17.0666666666667,17,0.0666666666666664,31,17,14,13,1
21700079,1626177,OKC,CHI,Dakari Johnson,15,3.36666666666667,3,0.366666666666666,9,4,5,7,-2
21700079,1628390,OKC,CHI,Terrance Ferguson,21,4.7,5,-0.300000000000001,11,4,7,7,0
21700080,2403,HOU,MEM,Nene,63,15.0166666666667,15,0.0166666666666657,27,46,-19,-19,0
21700080,2772,HOU,MEM,Trevor Ariza,177,43.3166666666667,36,7.31666666666666,67,93,-26,-20,-6
21700080,200782,HOU,MEM,PJ Tucker,127,28.1833333333333,28,0.18333333333333,51,76,-25,-24,-1
21700080,201583,HOU,MEM,Ryan Anderson,156,36.9666666666667,37,-0.0333333333333314,64,70,-6,-4,-2
21700080,201601,HOU,MEM,Luc Mbah a Moute,139,33.2166666666667,34,-0.783333333333331,62,62,0,0,0
21700080,201628,HOU,MEM,Bobby Brown,105,22.0166666666667,22,0.0166666666666657,46,61,-15,-16,1
21700080,201935,HOU,MEM,James Harden,104,25.5166666666667,34,-8.48333333333333,49,54,-5,-13,8
21700080,203991,HOU,MEM,Clint Capela,92,21.2166666666667,22,-0.783333333333331,39,33,6,6,0
21700080,204028,HOU,MEM,Tarik Black,18,3.53333333333333,3,0.533333333333333,10,5,5,5,0
21700080,1627743,HOU,MEM,Demetrius Jackson,18,3.53333333333333,3,0.533333333333333,10,5,5,5,0
21700080,1627753,HOU,MEM,Zhou Qi,18,3.53333333333333,3,0.533333333333333,10,5,5,5,0
21700080,1627786,HOU,MEM,Troy Williams,18,3.53333333333333,3,0.533333333333333,10,5,5,5,0
21700080,201144,MEM,HOU,Mike Conley,106,26.3833333333333,26,0.383333333333333,43,50,-7,-9,2
21700080,201148,MEM,HOU,Brandan Wright,60,12.7333333333333,13,-0.266666666666666,30,18,12,12,0
21700080,201188,MEM,HOU,Marc Gasol,130,32.1166666666667,32,0.116666666666667,68,61,7,5,2
21700080,201596,MEM,HOU,Mario Chalmers,114,24.85,25,-0.149999999999999,66,39,27,27,0
21700080,201936,MEM,HOU,Tyreke Evans,110,24.5333333333333,24,0.533333333333331,63,43,20,22,-2
21700080,202718,MEM,HOU,Chandler Parsons,80,18.4333333333333,19,-0.566666666666666,56,36,20,19,1
21700080,203516,MEM,HOU,James Ennis III,134,31.4,32,-0.600000000000001,56,52,4,5,-1
21700080,1626150,MEM,HOU,Andrew Harrison,61,14.1,14,0.100000000000001,20,41,-21,-20,-1
21700080,1626185,MEM,HOU,Jarell Martin,85,21.8,22,-0.200000000000003,33,40,-7,-10,3
21700080,1627738,MEM,HOU,Deyonta Davis,17,3.06666666666667,3,0.0666666666666664,5,10,-5,-3,-2
21700080,1628397,MEM,HOU,Ivan Rabb,6,1.08333333333333,1,0.0833333333333333,3,6,-3,-2,-1
21700080,1628415,MEM,HOU,Dillon Brooks,132,29.0833333333333,29,0.0833333333333357,72,49,23,24,-1
21700081,1717,DAL,PHI,Dirk Nowitzki,124,27.8333333333333,28,-0.166666666666664,73,55,18,24,-6
21700081,2734,DAL,PHI,Devin Harris,73,16.6833333333333,17,-0.316666666666666,38,32,6,7,-1
21700081,200826,DAL,PHI,J.J. Barea,99,23.4,24,-0.600000000000001,50,44,6,8,-2
21700081,202083,DAL,PHI,Wesley Matthews,143,33.25,33,0.25,74,89,-15,-17,2
21700081,203084,DAL,PHI,Harrison Barnes,161,37.4166666666667,38,-0.583333333333329,85,101,-16,-18,2
21700081,203457,DAL,PHI,Nerlens Noel,85,19.6666666666667,20,-0.333333333333336,41,49,-8,-10,2
21700081,203939,DAL,PHI,Dwight Powell,79,18.1333333333333,18,0.133333333333333,40,36,4,4,0
21700081,1626257,DAL,PHI,Salah Mejri,1,0.1,0,0.1,0,,,0,
21700081,1627812,DAL,PHI,Yogi Ferrell,140,32.55,32,0.549999999999997,76,70,6,5,1
21700081,1628372,DAL,PHI,Dennis Smith Jr.,135,30.9666666666667,31,-0.033333333333335,73,84,-11,-13,2
21700081,101161,PHI,DAL,Amir Johnson,76,18.3333333333333,19,-0.666666666666664,45,41,4,6,-2
21700081,201573,PHI,DAL,Jerryd Bayless,140,32.3,32,0.299999999999997,72,82,-10,-13,3
21700081,203496,PHI,DAL,Robert Covington,147,34.55,35,-0.450000000000003,89,79,10,14,-4
21700081,203917,PHI,DAL,Nik Stauskas,28,5.93333333333333,6,-0.0666666666666664,11,15,-4,-4,0
21700081,203954,PHI,DAL,Joel Embiid,131,29.6333333333333,29,0.633333333333333,66,69,-3,-4,1
21700081,203967,PHI,DAL,Dario Saric,128,29.9833333333333,30,-0.0166666666666657,68,76,-8,-7,-1
21700081,204456,PHI,DAL,T.J. McConnell,136,31.65,31,0.649999999999999,76,66,10,11,-1
21700081,1626147,PHI,DAL,Justin Anderson,66,14.5,14,0.5,23,33,-10,-12,2
21700081,1627732,PHI,DAL,Ben Simmons,145,33.1833333333333,34,-0.816666666666663,80,77,3,-1,4
21700081,1627789,PHI,DAL,Timothe Luwawu-Cabarrot,43,9.93333333333333,10,-0.0666666666666664,30,12,18,20,-2
21700082,101106,LAL,UTA,Andrew Bogut,25,5.73333333333333,6,-0.266666666666668,7,9,-2,-3,1
21700082,201147,LAL,UTA,Corey Brewer,23,5.23333333333333,5,0.233333333333333,8,5,3,5,-2
21700082,201572,LAL,UTA,Brook Lopez,80,17.8,18,-0.199999999999999,30,41,-11,-9,-2
21700082,203484,LAL,UTA,Kentavious Caldwell-Pope,125,27.7,28,-0.300000000000001,41,61,-20,-20,0
21700082,203898,LAL,UTA,Tyler Ennis,21,4.43333333333333,4,0.433333333333334,11,7,4,4,0
21700082,203903,LAL,UTA,Jordan Clarkson,95,20.45,20,0.449999999999999,40,38,2,2,0
21700082,203944,LAL,UTA,Julius Randle,81,18.6333333333333,19,-0.366666666666667,33,32,1,3,-2
21700082,1626204,LAL,UTA,Larry Nance Jr.,144,31.5,32,-0.5,51,68,-17,-17,0
21700082,1627742,LAL,UTA,Brandon Ingram,155,33.6166666666667,34,-0.383333333333333,53,73,-20,-24,4
21700082,1628366,LAL,UTA,Lonzo Ball,160,35.1333333333333,36,-0.866666666666667,58,75,-17,-19,2
21700082,1628398,LAL,UTA,Kyle Kuzma,107,22.2666666666667,22,0.266666666666666,41,44,-3,-4,1
21700082,1628404,LAL,UTA,Josh Hart,74,16.5,16,0.5,32,27,5,7,-2
21700082,2207,UTA,LAL,Joe Johnson,82,18.5833333333333,18,0.583333333333332,41,34,7,7,0
21700082,200757,UTA,LAL,Thabo Sefolosha,63,14.1,14,0.0999999999999996,26,29,-3,-5,2
21700082,201937,UTA,LAL,Ricky Rubio,150,32.3166666666667,33,-0.683333333333337,70,60,10,8,2
21700082,202324,UTA,LAL,Derrick Favors,136,29.2166666666667,30,-0.783333333333331,55,47,8,8,0
21700082,202327,UTA,LAL,Ekpe Udoh,60,12.2666666666667,13,-0.733333333333334,19,26,-7,-7,0
21700082,202692,UTA,LAL,Alec Burks,46,9.36666666666667,9,0.366666666666667,16,20,-4,-4,0
21700082,203497,UTA,LAL,Rudy Gobert,158,35.5333333333333,35,0.533333333333331,77,55,22,22,0
21700082,203918,UTA,LAL,Rodney Hood,128,28.5333333333333,29,-0.466666666666669,50,48,2,4,-2
21700082,204060,UTA,LAL,Joe Ingles,144,31.7,32,-0.300000000000004,68,45,23,25,-2
21700082,1628378,UTA,LAL,Donovan Mitchell,123,27.3833333333333,27,0.383333333333333,58,41,17,17,0
21700083,2199,PHX,POR,Tyson Chandler,121,24.2833333333333,25,-0.716666666666669,60,58,2,2,0
21700083,203458,PHX,POR,Alex Len,116,22.7833333333333,22,0.783333333333331,43,54,-11,-11,0
21700083,203584,PHX,POR,Troy Daniels,71,13.7,14,-0.300000000000001,22,33,-11,-11,0
21700083,203933,PHX,POR,T.J. Warren,133,26.3333333333333,26,0.333333333333336,63,66,-3,-4,1
21700083,1626164,PHX,POR,Devin Booker,172,34.2166666666667,34,0.216666666666669,86,81,5,5,0
21700083,1627733,PHX,POR,Dragan Bender,133,27.65,28,-0.350000000000001,63,61,2,2,0
21700083,1627737,PHX,POR,Marquese Chriss,108,20.15,20,0.149999999999999,44,53,-9,-9,0
21700083,1627755,PHX,POR,Tyler Ulis,102,21.1833333333333,21,0.183333333333334,44,47,-3,-3,0
21700083,1628367,PHX,POR,Josh Jackson,112,22.2,23,-0.800000000000001,48,50,-2,-1,-1
21700083,1628455,PHX,POR,Mike James,137,26.5,27,-0.5,62,67,-5,-5,0
21700083,202323,POR,PHX,Evan Turner,120,23.7,23,0.699999999999999,48,45,3,5,-2
21700083,202329,POR,PHX,Al-Farouq Aminu,150,28.9,29,-0.100000000000001,74,67,7,7,0
21700083,202334,POR,PHX,Ed Davis,94,19.1333333333333,19,0.133333333333333,45,37,8,7,1
21700083,203081,POR,PHX,Damian Lillard,179,35.7166666666667,36,-0.283333333333331,82,80,2,2,0
21700083,203090,POR,PHX,Maurice Harkless,177,35.8,36,-0.200000000000003,86,85,1,0,1
21700083,203468,POR,PHX,CJ McCollum,174,33.5666666666667,34,-0.433333333333337,93,85,8,6,2
21700083,203994,POR,PHX,Jusuf Nurkic,141,27.9,28,-0.100000000000001,65,66,-1,0,-1
21700083,1626192,POR,PHX,Pat Connaughton,133,27.0166666666667,27,0.0166666666666657,55,52,3,5,-2
21700083,1628380,POR,PHX,Zach Collins,37,7.26666666666667,8,-0.733333333333333,22,18,4,3,1
21700084,101150,LAC,DET,Lou Williams,104,21.45,22,-0.550000000000001,39,46,-7,-7,0
21700084,201568,LAC,DET,Danilo Gallinari,174,37.55,38,-0.450000000000003,63,75,-12,-13,1
21700084,201599,LAC,DET,DeAndre Jordan,163,34.8666666666667,35,-0.133333333333333,64,65,-1,-2,1
21700084,201933,LAC,DET,Blake Griffin,175,38.2,39,-0.799999999999997,70,74,-4,-3,-1
21700084,201976,LAC,DET,Patrick Beverley,166,36.0833333333333,37,-0.916666666666664,72,73,-1,-1,0
21700084,202325,LAC,DET,Wesley Johnson,63,12.9833333333333,13,-0.0166666666666657,28,25,3,4,-1
21700084,203085,LAC,DET,Austin Rivers,155,33.45,33,0.450000000000003,60,58,2,0,2
21700084,203186,LAC,DET,Willie Reed,57,11.7166666666667,12,-0.283333333333333,20,28,-8,-7,-1
21700084,1626155,LAC,DET,Sam Dekker,17,2.76666666666667,3,-0.233333333333333,7,9,-2,-2,0
21700084,1628414,LAC,DET,Sindarius Thornwell,46,9.43333333333333,9,0.433333333333334,12,22,-10,-9,-1
21700084,201229,DET,LAC,Anthony Tolliver,115,25.3,26,-0.699999999999999,48,39,9,9,0
21700084,202340,DET,LAC,Avery Bradley,142,30.05,30,0.0499999999999972,60,52,8,10,-2
21700084,202397,DET,LAC,Ish Smith,79,15.8333333333333,16,-0.166666666666668,25,34,-9,-8,-1
21700084,202699,DET,LAC,Tobias Harris,87,19.9333333333333,20,-0.0666666666666664,45,36,9,7,2
21700084,202704,DET,LAC,Reggie Jackson,145,31.8666666666667,32,-0.133333333333333,70,53,17,16,1
21700084,202720,DET,LAC,Jon Leuer,71,14.25,14,0.25,27,28,-1,-1,0
21700084,203083,DET,LAC,Andre Drummond,150,33.1666666666667,34,-0.833333333333336,69,55,14,12,2
21700084,203493,DET,LAC,Reggie Bullock,35,6.41666666666667,7,-0.583333333333334,12,18,-6,-6,0
21700084,203961,DET,LAC,Eric Moreland,7,1.3,1,0.3,0,8,-8,-6,-2
21700084,204038,DET,LAC,Langston Galloway,82,17.65,18,-0.350000000000001,35,35,0,-2,2
21700084,1626169,DET,LAC,Stanley Johnson,145,30.7666666666667,31,-0.233333333333334,61,52,9,9,0
21700084,1627740,DET,LAC,Henry Ellenson,62,11.9666666666667,12,-0.033333333333335,23,25,-2,0,-2
21700085,201158,ATL,MIL,Marco Belinelli,116,25.65,25,0.649999999999999,60,54,6,7,-1
21700085,202337,ATL,MIL,Luke Babbitt,63,14.7,14,0.699999999999999,29,27,2,1,1
21700085,203145,ATL,MIL,Kent Bazemore,140,31.7333333333333,32,-0.266666666666666,76,79,-3,-2,-1
21700085,203471,ATL,MIL,Dennis Schroder,154,35.5166666666667,35,0.516666666666666,75,94,-19,-19,0
21700085,203473,ATL,MIL,Dewayne Dedmon,75,17.05,17,0.0499999999999972,31,49,-18,-20,2
21700085,203488,ATL,MIL,Mike Muscala,126,28.8833333333333,29,-0.116666666666667,61,76,-15,-14,-1
21700085,203705,ATL,MIL,Josh Magette,3,0.783333333333333,1,-0.216666666666667,3,0,3,2,1
21700085,1627098,ATL,MIL,Malcolm Delaney,34,7.16666666666667,7,0.166666666666667,9,20,-11,-11,0
21700085,1627752,ATL,MIL,Taurean Prince,172,37.3333333333333,38,-0.666666666666664,82,99,-17,-16,-1
21700085,1627819,ATL,MIL,Isaiah Taylor,72,16.2333333333333,16,0.233333333333334,47,38,9,8,1
21700085,1628381,ATL,MIL,John Collins,105,24.8666666666667,25,-0.133333333333333,57,49,8,9,-1
21700085,203089,MIL,ATL,John Henson,129,27.65,28,-0.350000000000001,71,63,8,4,4
21700085,203114,MIL,ATL,Khris Middleton,170,37.2333333333333,38,-0.766666666666666,103,79,24,26,-2
21700085,203141,MIL,ATL,Mirza Teletovic,52,12.8833333333333,12,0.883333333333333,27,29,-2,-2,0
21700085,203503,MIL,ATL,Tony Snell,139,31.5,32,-0.5,77,67,10,8,2
21700085,203507,MIL,ATL,Giannis Antetokounmpo,167,38.05,38,0.0499999999999972,92,83,9,8,1
21700085,203521,MIL,ATL,Matthew Dellavedova,83,18.8166666666667,19,-0.183333333333334,46,45,1,1,0
21700085,1626173,MIL,ATL,Rashad Vaughn,96,21.2666666666667,21,0.266666666666666,48,51,-3,1,-4
21700085,1627748,MIL,ATL,Thon Maker,82,20.0666666666667,20,0.0666666666666664,46,41,5,7,-2
21700085,1627763,MIL,ATL,Malcolm Brogdon,136,30.8833333333333,31,-0.116666666666667,75,66,9,6,3
21700085,1628391,MIL,ATL,D.J. Wilson,3,0.783333333333333,1,-0.216666666666667,0,3,-3,-2,-1
21700085,1628425,MIL,ATL,Sterling Brown,3,0.783333333333333,1,-0.216666666666667,0,3,-3,-2,-1
21700086,2744,IND,SAS,Al Jefferson,75,15.45,15,0.449999999999999,20,39,-19,-19,0
21700086,201152,IND,SAS,Thaddeus Young,168,36.95,37,-0.0499999999999972,81,69,12,12,0
21700086,201954,IND,SAS,Darren Collison,157,34.5833333333333,34,0.583333333333329,79,61,18,18,0
21700086,202362,IND,SAS,Lance Stephenson,78,16.4166666666667,16,0.416666666666668,24,41,-17,-15,-2
21700086,202709,IND,SAS,Cory Joseph,105,21.65,22,-0.350000000000001,30,51,-21,-21,0
21700086,202711,IND,SAS,Bojan Bogdanovic,149,33.3166666666667,33,0.316666666666663,72,56,16,14,2
21700086,203506,IND,SAS,Victor Oladipo,132,29.2166666666667,29,0.216666666666665,74,52,22,22,0
21700086,1626202,IND,SAS,Joe Young,45,8.81666666666667,9,-0.183333333333334,12,21,-9,-9,0
21700086,1627734,IND,SAS,Domantas Sabonis,147,32.55,33,-0.450000000000003,77,55,22,22,0
21700086,1628388,IND,SAS,TJ Leaf,54,11.05,11,0.0500000000000007,16,25,-9,-9,0
21700086,1938,SAS,IND,Manu Ginobili,100,21.9333333333333,21,0.93333333333333,42,40,2,7,-5
21700086,2200,SAS,IND,Pau Gasol,138,30.1666666666667,30,0.166666666666664,65,52,13,8,5
21700086,200746,SAS,IND,LaMarcus Aldridge,166,36.3833333333333,36,0.383333333333333,65,81,-16,-15,-1
21700086,200752,SAS,IND,Rudy Gay,114,23.65,24,-0.350000000000001,47,45,2,5,-3
21700086,201980,SAS,IND,Danny Green,131,28.75,29,-0.25,59,64,-5,-10,5
21700086,201988,SAS,IND,Patty Mills,133,27.9,28,-0.100000000000001,58,56,2,5,-3
21700086,202722,SAS,IND,Davis Bertans,16,3.36666666666667,3,0.366666666666667,6,5,1,1,0
21700086,203464,SAS,IND,Brandon Paul,96,21.2666666666667,21,0.266666666666666,38,40,-2,2,-4
21700086,203937,SAS,IND,Kyle Anderson,114,23.1833333333333,24,-0.816666666666666,43,57,-14,-15,1
21700086,1627749,SAS,IND,Dejounte Murray,89,20.1,20,0.100000000000001,36,41,-5,-8,3
21700086,1627854,SAS,IND,Bryn Forbes,13,3.3,3,0.3,11,4,7,5,2
21700087,2210,DEN,BKN,Richard Jefferson,9,1.86666666666667,2,-0.133333333333333,0,4,-4,-2,-2
21700087,200794,DEN,BKN,Paul Millsap,176,36.3,37,-0.700000000000003,106,70,36,34,2
21700087,201163,DEN,BKN,Wilson Chandler,172,33.7166666666667,34,-0.283333333333331,94,74,20,20,0
21700087,203115,DEN,BKN,Will Barton,105,21.7,22,-0.300000000000001,48,68,-20,-20,0
21700087,203486,DEN,BKN,Mason Plumlee,113,22.6833333333333,23,-0.31666666666667,62,71,-9,-9,0
21700087,203914,DEN,BKN,Gary Harris,168,33.9,34,-0.100000000000001,99,65,34,34,0
21700087,203999,DEN,BKN,Nikola Jokic,156,29.7666666666667,29,0.766666666666666,75,68,7,7,0
21700087,1626144,DEN,BKN,Emmanuel Mudiay,96,19.0666666666667,19,0.0666666666666664,37,57,-20,-23,3
21700087,1626168,DEN,BKN,Trey Lyles,12,2.35,2,0.35,0,4,-4,-4,0
21700087,1627736,DEN,BKN,Malik Beasley,33,7.03333333333333,7,0.0333333333333332,12,16,-4,-4,0
21700087,1627750,DEN,BKN,Jamal Murray,155,31.2,31,0.199999999999999,87,58,29,32,-3
21700087,202344,BKN,DEN,Trevor Booker,99,19.4333333333333,20,-0.566666666666666,65,47,18,12,6
21700087,202389,BKN,DEN,Timofey Mozgov,100,20.7833333333333,21,-0.216666666666669,36,55,-19,-19,0
21700087,203092,BKN,DEN,Tyler Zeller,23,4.73333333333333,5,-0.266666666666667,6,3,3,3,0
21700087,203459,BKN,DEN,Allen Crabbe,136,27.3333333333333,27,0.333333333333332,53,77,-24,-24,0
21700087,203915,BKN,DEN,Spencer Dinwiddie,147,29.5,30,-0.5,76,80,-4,-7,3
21700087,203925,BKN,DEN,Joe Harris,114,22.7333333333333,23,-0.266666666666666,60,51,9,1,8
21700087,203930,BKN,DEN,Sean Kilpatrick,54,10.7666666666667,11,-0.233333333333334,24,17,7,5,2
21700087,1626156,BKN,DEN,D'Angelo Russell,125,24.3333333333333,24,0.333333333333336,65,77,-12,-19,7
21700087,1626178,BKN,DEN,Rondae Hollis-Jefferson,150,29.7666666666667,30,-0.233333333333334,57,91,-34,-34,0
21700087,1627747,BKN,DEN,Caris LeVert,118,24.35,24,0.350000000000001,49,67,-18,-22,4
21700087,1627785,BKN,DEN,Isaiah Whitehead,23,4.73333333333333,5,-0.266666666666667,6,3,3,3,0
21700087,1628386,BKN,DEN,Jarrett Allen,83,16.3833333333333,16,0.383333333333333,52,49,3,-7,10
21700087,1628451,BKN,DEN,Jacob Wiley,23,4.73333333333333,5,-0.266666666666667,6,3,3,3,0
21700088,201571,ORL,CHA,D.J. Augustin,120,23.2833333333333,23,0.283333333333331,49,67,-18,-18,0
21700088,202687,ORL,CHA,Bismack Biyombo,82,15.5166666666667,15,0.516666666666666,40,31,9,6,3
21700088,202696,ORL,CHA,Nikola Vucevic,165,32.3666666666667,33,-0.633333333333333,73,89,-16,-13,-3
21700088,202714,ORL,CHA,Shelvin Mack,88,16.7666666666667,17,-0.233333333333334,45,33,12,11,1
21700088,203082,ORL,CHA,Terrence Ross,166,33.5166666666667,34,-0.483333333333334,77,86,-9,-9,0
21700088,203095,ORL,CHA,Evan Fournier,200,37.75,38,-0.25,90,96,-6,-4,-2
21700088,203613,ORL,CHA,Jonathon Simmons,167,32.3333333333333,32,0.333333333333336,78,78,0,-1,1
21700088,203932,ORL,CHA,Aaron Gordon,187,36.0333333333333,36,0.0333333333333314,83,96,-13,-11,-2
21700088,1626209,ORL,CHA,Mario Hezonja,60,11.85,12,-0.15,30,24,6,4,2
21700088,2730,CHA,ORL,Dwight Howard,158,30.7333333333333,31,-0.266666666666666,85,67,18,14,4
21700088,101107,CHA,ORL,Marvin Williams,150,30.3,31,-0.699999999999999,83,72,11,11,0
21700088,202689,CHA,ORL,Kemba Walker,177,35.4,36,-0.600000000000001,99,77,22,22,0
21700088,203077,CHA,ORL,Michael Kidd-Gilchrist,111,22.3833333333333,23,-0.616666666666667,62,58,4,2,2
21700088,203087,CHA,ORL,Jeremy Lamb,161,30.9,31,-0.100000000000001,84,80,4,4,0
21700088,203469,CHA,ORL,Cody Zeller,96,18.8,19,-0.200000000000003,38,48,-10,-7,-3
21700088,203948,CHA,ORL,Johnny O'Bryant III,21,4.26666666666667,4,0.266666666666667,7,11,-4,-3,-1
21700088,1626203,CHA,ORL,Treveon Graham,117,21.6333333333333,22,-0.366666666666667,44,49,-5,-4,-1
21700088,1628370,CHA,ORL,Malik Monk,101,17.95,18,-0.0500000000000007,38,46,-8,-8,0
21700088,1628407,CHA,ORL,Dwayne Bacon,143,27.05,27,0.0500000000000007,60,57,3,4,-1
21700089,1713,SAC,WAS,Vince Carter,68,14.6833333333333,15,-0.316666666666666,19,31,-12,-11,-1
21700089,201585,SAC,WAS,Kosta Koufos,75,16.65,17,-0.350000000000001,26,33,-7,-7,0
21700089,202066,SAC,WAS,Garrett Temple,78,17.2666666666667,17,0.266666666666666,28,37,-9,-11,2
21700089,203960,SAC,WAS,JaKarr Sampson,32,6.73333333333333,7,-0.266666666666668,20,13,7,7,0
21700089,203992,SAC,WAS,Bogdan Bogdanovic,105,23.05,23,0.0500000000000007,37,58,-21,-22,1
21700089,1626161,SAC,WAS,Willie Cauley-Stein,112,24.6166666666667,24,0.616666666666667,37,63,-26,-27,1
21700089,1627741,SAC,WAS,Buddy Hield,121,27.0833333333333,27,0.0833333333333357,42,65,-23,-24,1
21700089,1627746,SAC,WAS,Skal Labissiere,99,22.6333333333333,22,0.633333333333333,38,54,-16,-18,2
21700089,1627781,SAC,WAS,Malachi Richardson,92,19.8666666666667,20,-0.133333333333333,37,42,-5,-3,-2
21700089,1627834,SAC,WAS,Georgios Papagiannis,32,6.73333333333333,7,-0.266666666666668,20,13,7,7,0
21700089,1628368,SAC,WAS,De'Aaron Fox,120,26.6,26,0.600000000000001,44,65,-21,-21,0
21700089,1628382,SAC,WAS,Justin Jackson,62,12.6833333333333,13,-0.316666666666666,28,27,1,1,0
21700089,1628412,SAC,WAS,Frank Mason,99,21.4,22,-0.600000000000001,39,44,-5,-6,1
21700089,101133,WAS,SAC,Ian Mahinmi,60,13.6166666666667,14,-0.383333333333333,28,24,4,6,-2
21700089,101162,WAS,SAC,Marcin Gortat,79,18.05,18,0.0500000000000007,45,27,18,17,1
21700089,201160,WAS,SAC,Jason Smith,77,15.85,16,-0.15,34,32,2,4,-2
21700089,201975,WAS,SAC,Jodie Meeks,95,20.3166666666667,21,-0.683333333333334,39,37,2,1,1
21700089,202322,WAS,SAC,John Wall,122,26.6,26,0.600000000000001,68,43,25,26,-1
21700089,203078,WAS,SAC,Bradley Beal,131,29.3333333333333,29,0.333333333333332,74,50,24,24,0
21700089,203107,WAS,SAC,Tomas Satoransky,84,17.6166666666667,18,-0.383333333333333,35,31,4,2,2
21700089,203118,WAS,SAC,Mike Scott,70,15.0666666666667,15,0.0666666666666664,32,17,15,18,-3
21700089,203490,WAS,SAC,Otto Porter Jr.,124,27.7333333333333,28,-0.266666666666666,66,48,18,17,1
21700089,204025,WAS,SAC,Tim Frazier,97,21.4,22,-0.600000000000001,41,40,1,1,0
21700089,1626162,WAS,SAC,Kelly Oubre Jr.,124,27.6833333333333,28,-0.316666666666666,70,46,24,26,-2
21700089,1626191,WAS,SAC,Chris McCullough,32,6.73333333333333,7,-0.266666666666668,13,20,-7,-7,0
21700090,2544,CLE,NYK,LeBron James,183,39.4333333333333,39,0.433333333333337,79,92,-13,-17,4
21700090,2548,CLE,NYK,Dwyane Wade,113,24.1333333333333,24,0.133333333333333,56,54,2,0,2
21700090,2594,CLE,NYK,Kyle Korver,106,23.6166666666667,24,-0.383333333333333,48,46,2,0,2
21700090,2747,CLE,NYK,JR Smith,138,28.55,29,-0.450000000000003,52,78,-26,-24,-2
21700090,101112,CLE,NYK,Channing Frye,7,1.83333333333333,2,-0.166666666666667,2,3,-1,-1,0
21700090,101181,CLE,NYK,Jose Calderon,7,1.83333333333333,2,-0.166666666666667,2,3,-1,-1,0
21700090,201145,CLE,NYK,Jeff Green,66,14.3333333333333,14,0.333333333333332,26,37,-11,-9,-2
21700090,201565,CLE,NYK,Derrick Rose,149,30.7333333333333,31,-0.266666666666666,58,82,-24,-22,-2
21700090,201567,CLE,NYK,Kevin Love,164,34.1166666666667,35,-0.883333333333333,67,82,-15,-15,0
21700090,202684,CLE,NYK,Tristan Thompson,98,19.1333333333333,19,0.133333333333333,40,48,-8,-6,-2
21700090,203109,CLE,NYK,Jae Crowder,92,20.2,20,0.200000000000003,43,42,1,1,0
21700090,1626224,CLE,NYK,Cedi Osman,7,1.83333333333333,2,-0.166666666666667,2,3,-1,-1,0
21700090,101127,NYK,CLE,Jarrett Jack,160,33.1,34,-0.899999999999999,84,66,18,22,-4
21700090,201584,NYK,CLE,Courtney Lee,182,37.4333333333333,38,-0.566666666666663,96,73,23,21,2
21700090,202498,NYK,CLE,Lance Thomas,73,16.55,16,0.550000000000001,30,38,-8,-2,-6
21700090,202683,NYK,CLE,Enes Kanter,157,32.45,33,-0.549999999999997,77,69,8,6,2
21700090,203124,NYK,CLE,Kyle O'Quinn,55,12.2833333333333,12,0.283333333333333,32,19,13,13,0
21700090,203501,NYK,CLE,Tim Hardaway Jr.,197,41.1333333333333,41,0.133333333333333,101,77,24,22,2
21700090,203926,NYK,CLE,Doug McDermott,63,14.6,14,0.6,27,35,-8,-6,-2
21700090,204001,NYK,CLE,Kristaps Porzingis,170,35.5166666666667,36,-0.483333333333334,90,67,23,21,2
21700090,1628373,NYK,CLE,Frank Ntilikina,73,16.6833333333333,16,0.683333333333334,33,31,2,-2,4
21700091,2561,GSW,DET,David West,57,12.3666666666667,12,0.366666666666667,15,33,-18,-18,0
21700091,2585,GSW,DET,Zaza Pachulia,81,18.7333333333333,19,-0.266666666666666,48,35,13,11,2
21700091,2733,GSW,DET,Shaun Livingston,81,14.6666666666667,15,-0.333333333333334,39,38,1,1,0
21700091,2738,GSW,DET,Andre Iguodala,134,25.5666666666667,25,0.566666666666666,48,72,-24,-26,2
21700091,201142,GSW,DET,Kevin Durant,173,36.2,36,0.200000000000003,93,81,12,11,1
21700091,201156,GSW,DET,Nick Young,60,12.7833333333333,13,-0.216666666666667,17,33,-16,-16,0
21700091,201580,GSW,DET,JaVale McGee,57,9.7,10,-0.300000000000001,25,30,-5,-3,-2
21700091,201939,GSW,DET,Stephen Curry,171,35.1,35,0.0999999999999943,92,80,12,12,0
21700091,201956,GSW,DET,Omri Casspi,38,8.6,9,-0.4,25,16,9,11,-2
21700091,202691,GSW,DET,Klay Thompson,149,33.25,33,0.25,68,77,-9,-9,0
21700091,203110,GSW,DET,Draymond Green,147,32.1666666666667,32,0.166666666666664,65,78,-13,-12,-1
21700091,1627775,GSW,DET,Patrick McCaw,2,0.45,0,0.45,,2,,-2,
21700091,201229,DET,GSW,Anthony Tolliver,82,17.5833333333333,17,0.583333333333332,45,24,21,21,0
21700091,202340,DET,GSW,Avery Bradley,173,35.55,36,-0.450000000000003,82,92,-10,-10,0
21700091,202397,DET,GSW,Ish Smith,99,18.2666666666667,18,0.266666666666666,52,41,11,11,0
21700091,202699,DET,GSW,Tobias Harris,148,30.3333333333333,31,-0.666666666666664,70,83,-13,-13,0
21700091,202704,DET,GSW,Reggie Jackson,131,29.65,30,-0.350000000000001,63,66,-3,-3,0
21700091,202720,DET,GSW,Jon Leuer,36,7.58333333333333,7,0.583333333333332,16,9,7,7,0
21700091,203083,DET,GSW,Andre Drummond,194,40.3333333333333,41,-0.666666666666664,99,98,1,1,0
21700091,203493,DET,GSW,Reggie Bullock,67,14.5166666666667,14,0.516666666666666,43,17,26,26,0
21700091,204038,DET,GSW,Langston Galloway,21,4.68333333333333,5,-0.316666666666666,10,4,6,5,1
21700091,1626169,DET,GSW,Stanley Johnson,199,41.0833333333333,41,0.0833333333333357,95,101,-6,-5,-1
21700092,201143,BOS,SAS,Al Horford,133,29.7,30,-0.299999999999997,69,51,18,19,-1
21700092,202681,BOS,SAS,Kyrie Irving,139,30.05,30,0.0500000000000007,72,50,22,25,-3
21700092,203382,BOS,SAS,Aron Baynes,73,16.2833333333333,16,0.283333333333335,32,29,3,6,-3
21700092,203499,BOS,SAS,Shane Larkin,30,5.71666666666667,6,-0.283333333333333,7,18,-11,-11,0
21700092,203935,BOS,SAS,Marcus Smart,144,30.2333333333333,30,0.233333333333334,74,66,8,7,1
21700092,1626179,BOS,SAS,Terry Rozier,85,18.2,18,0.199999999999999,42,44,-2,-3,1
21700092,1627759,BOS,SAS,Jaylen Brown,137,30.5,30,0.5,72,54,18,19,-1
21700092,1627824,BOS,SAS,Guerschon Yabusele,12,2.36666666666667,3,-0.633333333333333,6,7,-1,-1,0
21700092,1627846,BOS,SAS,Abdel Nader,21,4.5,5,-0.5,9,9,0,0,0
21700092,1628369,BOS,SAS,Jayson Tatum,162,35.0166666666667,35,0.0166666666666657,73,65,8,10,-2
21700092,1628400,BOS,SAS,Semi Ojeleye,97,21.3333333333333,22,-0.666666666666664,54,46,8,1,7
21700092,1628464,BOS,SAS,Daniel Theis,62,13.5166666666667,14,-0.483333333333334,30,31,-1,-2,1
21700092,2200,SAS,BOS,Pau Gasol,110,24.35,25,-0.649999999999999,44,56,-12,-11,-1
21700092,200746,SAS,BOS,LaMarcus Aldridge,116,25.8333333333333,26,-0.166666666666668,42,59,-17,-19,2
21700092,200752,SAS,BOS,Rudy Gay,96,21.5333333333333,21,0.533333333333331,43,46,-3,2,-5
21700092,201980,SAS,BOS,Danny Green,139,30.7333333333333,31,-0.266666666666666,53,81,-28,-28,0
21700092,201988,SAS,BOS,Patty Mills,84,17.4833333333333,18,-0.516666666666666,41,38,3,4,-1
21700092,202722,SAS,BOS,Davis Bertans,35,7.36666666666667,8,-0.633333333333333,20,15,5,5,0
21700092,203464,SAS,BOS,Brandon Paul,139,29.4166666666667,30,-0.583333333333332,62,66,-4,-4,0
21700092,203937,SAS,BOS,Kyle Anderson,108,23,24,-1,47,58,-11,-16,5
21700092,1627749,SAS,BOS,Dejounte Murray,131,29.3666666666667,29,0.366666666666667,49,71,-22,-23,1
21700092,1627854,SAS,BOS,Bryn Forbes,113,23.7833333333333,24,-0.216666666666669,58,42,16,17,-1
21700092,1628401,SAS,BOS,Derrick White,24,4.55,5,-0.449999999999999,11,8,3,3,0
21700093,201609,MIA,MIN,Goran Dragic,196,38.95,39,-0.0499999999999972,96,82,14,11,3
21700093,201949,MIA,MIN,James Johnson,117,23.5833333333333,24,-0.416666666666668,48,56,-8,-5,-3
21700093,201961,MIA,MIN,Wayne Ellington,20,3.98333333333333,4,-0.0166666666666666,13,10,3,0,3
21700093,203079,MIA,MIN,Dion Waiters,192,38.9833333333333,39,-0.0166666666666657,84,96,-12,-10,-2
21700093,203482,MIA,MIN,Kelly Olynyk,141,29.9666666666667,29,0.966666666666669,73,72,1,6,-5
21700093,204020,MIA,MIN,Tyler Johnson,105,22.7,23,-0.299999999999997,56,52,4,8,-4
21700093,1626159,MIA,MIN,Justise Winslow,131,27.15,27,0.149999999999999,67,71,-4,-13,9
21700093,1626196,MIA,MIN,Josh Richardson,162,32.2333333333333,32,0.233333333333334,70,77,-7,-2,-5
21700093,1627855,MIA,MIN,Okaro White,80,16.8166666666667,17,-0.183333333333334,44,36,8,6,2
21700093,1628389,MIA,MIN,Bam Adebayo,151,30.6333333333333,31,-0.366666666666667,59,73,-14,-16,2
21700093,2037,MIN,MIA,Jamal Crawford,108,21.7,22,-0.300000000000001,56,57,-1,1,-2
21700093,201952,MIN,MIA,Jeff Teague,187,37.6166666666667,37,0.616666666666667,96,76,20,17,3
21700093,201959,MIN,MIA,Taj Gibson,151,31.3,31,0.299999999999997,69,65,4,2,2
21700093,202357,MIN,MIA,Nemanja Bjelica,72,15.0166666666667,15,0.0166666666666657,36,39,-3,1,-4
21700093,202710,MIN,MIA,Jimmy Butler,193,39.4666666666667,40,-0.533333333333331,94,85,9,5,4
21700093,203476,MIN,MIA,Gorgui Dieng,69,14.3333333333333,14,0.333333333333332,26,38,-12,-9,-3
21700093,203498,MIN,MIA,Shabazz Muhammad,53,11.1,11,0.0999999999999996,27,30,-3,1,-4
21700093,203952,MIN,MIA,Andrew Wiggins,200,40.4166666666667,40,0.416666666666664,93,90,3,-1,4
21700093,1626145,MIN,MIA,Tyus Jones,72,15.3833333333333,16,-0.616666666666667,29,46,-17,-14,-3
21700093,1626157,MIN,MIA,Karl-Anthony Towns,190,38.6666666666667,39,-0.333333333333329,99,84,15,12,3
21700094,200794,DEN,NYK,Paul Millsap,153,33.9,34,-0.100000000000001,75,70,5,0,5
21700094,201163,DEN,NYK,Wilson Chandler,126,27.4666666666667,27,0.466666666666669,67,60,7,5,2
21700094,201589,DEN,NYK,Darrell Arthur,62,12.0166666666667,12,0.0166666666666657,28,34,-6,-6,0
21700094,202702,DEN,NYK,Kenneth Faried,18,3.31666666666667,3,0.316666666666666,3,12,-9,-8,-1
21700094,203115,DEN,NYK,Will Barton,121,24,24,0,53,69,-16,-12,-4
21700094,203486,DEN,NYK,Mason Plumlee,81,16.2333333333333,16,0.233333333333334,39,42,-3,-3,0
21700094,203914,DEN,NYK,Gary Harris,163,34.9666666666667,35,-0.0333333333333314,76,79,-3,1,-4
21700094,203999,DEN,NYK,Nikola Jokic,139,30.0333333333333,30,0.0333333333333314,71,68,3,5,-2
21700094,1626144,DEN,NYK,Emmanuel Mudiay,98,19.35,20,-0.649999999999999,43,54,-11,-11,0
21700094,1627736,DEN,NYK,Malik Beasley,32,6.05,6,0.0499999999999998,16,14,2,0,2
21700094,1627750,DEN,NYK,Jamal Murray,152,32.5,32,0.5,79,78,1,-1,2
21700094,101127,NYK,DEN,Jarrett Jack,149,32.2666666666667,32,0.266666666666666,75,74,1,1,0
21700094,201563,NYK,DEN,Michael Beasley,72,13.7166666666667,14,-0.283333333333335,40,32,8,6,2
21700094,201584,NYK,DEN,Courtney Lee,160,34.6,35,-0.399999999999999,78,79,-1,1,-2
21700094,202683,NYK,DEN,Enes Kanter,103,23.5833333333333,24,-0.416666666666664,50,53,-3,-8,5
21700094,203124,NYK,DEN,Kyle O'Quinn,107,20.95,21,-0.0499999999999972,57,49,8,14,-6
21700094,203501,NYK,DEN,Tim Hardaway Jr.,158,33.1666666666667,33,0.166666666666664,82,79,3,-1,4
21700094,203926,NYK,DEN,Doug McDermott,107,21.7666666666667,22,-0.233333333333334,56,49,7,7,0
21700094,204001,NYK,DEN,Kristaps Porzingis,157,34.25,34,0.25,76,78,-2,0,-2
21700094,1626195,NYK,DEN,Willy Hernangomez,17,3.13333333333333,3,0.133333333333333,7,5,2,4,-2
21700094,1628373,NYK,DEN,Frank Ntilikina,82,16,16,0,43,39,4,1,3
21700094,1628422,NYK,DEN,Damyean Dotson,33,6.4,6,0.4,16,13,3,5,-2
21700095,2403,HOU,PHI,Nene,53,10.45,10,0.449999999999999,23,34,-11,-9,-2
21700095,2772,HOU,PHI,Trevor Ariza,181,37.2333333333333,37,0.233333333333334,83,79,4,0,4
21700095,200782,HOU,PHI,PJ Tucker,152,30.6166666666667,31,-0.383333333333333,70,71,-1,-7,6
21700095,201569,HOU,PHI,Eric Gordon,180,36.8666666666667,37,-0.133333333333333,83,77,6,4,2
21700095,201583,HOU,PHI,Ryan Anderson,172,34.8833333333333,35,-0.116666666666667,77,89,-12,-14,2
21700095,201601,HOU,PHI,Luc Mbah a Moute,99,20.6166666666667,21,-0.383333333333333,49,53,-4,-8,4
21700095,201935,HOU,PHI,James Harden,191,38.5166666666667,38,0.516666666666666,86,96,-10,-12,2
21700095,203991,HOU,PHI,Clint Capela,147,30.8166666666667,31,-0.183333333333334,74,66,8,6,2
21700095,101161,PHI,HOU,Amir Johnson,100,21.5333333333333,21,0.533333333333331,49,53,-4,-6,2
21700095,201573,PHI,HOU,Jerryd Bayless,199,40.35,40,0.349999999999994,95,87,8,14,-6
21700095,203496,PHI,HOU,Robert Covington,172,34.6166666666667,34,0.61666666666666,77,76,1,5,-4
21700095,203954,PHI,HOU,Joel Embiid,121,24.3,25,-0.700000000000003,62,51,11,17,-6
21700095,203967,PHI,HOU,Dario Saric,148,30.8666666666667,31,-0.133333333333333,72,72,0,0,0
21700095,204456,PHI,HOU,T.J. McConnell,132,26.1333333333333,26,0.133333333333333,69,64,5,6,-1
21700095,1626147,PHI,HOU,Justin Anderson,30,6.61666666666667,7,-0.383333333333333,12,16,-4,-6,2
21700095,1627732,PHI,HOU,Ben Simmons,190,39,39,0,85,82,3,10,-7
21700095,1627789,PHI,HOU,Timothe Luwawu-Cabarrot,83,16.5833333333333,17,-0.416666666666664,44,44,0,0,0
21700096,201144,MEM,CHA,Mike Conley,152,31.85,32,-0.149999999999999,66,76,-10,-10,0
21700096,201148,MEM,CHA,Brandan Wright,79,15.3333333333333,15,0.333333333333332,36,24,12,9,3
21700096,201188,MEM,CHA,Marc Gasol,156,32.6666666666667,33,-0.333333333333336,63,80,-17,-14,-3
21700096,201596,MEM,CHA,Mario Chalmers,81,15.5333333333333,16,-0.466666666666667,31,28,3,5,-2
21700096,201936,MEM,CHA,Tyreke Evans,157,30.7,30,0.699999999999999,62,61,1,-3,4
21700096,202718,MEM,CHA,Chandler Parsons,99,19.6166666666667,19,0.616666666666667,40,37,3,3,0
21700096,203516,MEM,CHA,James Ennis III,113,25.1166666666667,25,0.116666666666667,49,64,-15,-15,0
21700096,1626150,MEM,CHA,Andrew Harrison,71,16.0333333333333,17,-0.966666666666669,34,37,-3,1,-4
21700096,1626185,MEM,CHA,Jarell Martin,105,21.8166666666667,22,-0.183333333333334,51,46,5,3,2
21700096,1628415,MEM,CHA,Dillon Brooks,162,31.3333333333333,31,0.333333333333332,63,67,-4,-4,0
21700096,2730,CHA,MEM,Dwight Howard,139,29.0666666666667,29,0.0666666666666664,69,57,12,9,3
21700096,101107,CHA,MEM,Marvin Williams,121,25.1166666666667,25,0.116666666666667,58,53,5,5,0
21700096,202689,CHA,MEM,Kemba Walker,139,29.0833333333333,29,0.0833333333333322,72,56,16,11,5
21700096,203077,CHA,MEM,Michael Kidd-Gilchrist,129,27.4166666666667,27,0.416666666666664,69,53,16,16,0
21700096,203087,CHA,MEM,Jeremy Lamb,133,28.1333333333333,28,0.133333333333333,66,56,10,10,0
21700096,203469,CHA,MEM,Cody Zeller,96,18.9333333333333,19,-0.0666666666666664,35,42,-7,-4,-3
21700096,1626163,CHA,MEM,Frank Kaminsky,114,22.8833333333333,23,-0.116666666666667,46,46,0,0,0
21700096,1626203,CHA,MEM,Treveon Graham,82,15.3166666666667,15,0.316666666666666,23,39,-16,-17,1
21700096,1628370,CHA,MEM,Malik Monk,120,24.1666666666667,24,0.166666666666664,47,50,-3,3,-6
21700096,1628407,CHA,MEM,Dwayne Bacon,102,19.8833333333333,20,-0.116666666666667,35,43,-8,-8,0
21700097,2746,NOP,ORL,Josh Smith,12,2.56666666666667,3,-0.433333333333334,5,4,1,0,1
21700097,2749,NOP,ORL,Jameer Nelson,115,24.6833333333333,25,-0.316666666666666,52,67,-15,-4,-11
21700097,2754,NOP,ORL,Tony Allen,75,16.5166666666667,16,0.516666666666666,41,45,-4,10,-14
21700097,201950,NOP,ORL,Jrue Holiday,168,35.05,35,0.0499999999999972,73,79,-6,-5,-1
21700097,201967,NOP,ORL,Dante Cunningham,115,25.0833333333333,25,0.0833333333333357,41,61,-20,-14,-6
21700097,202326,NOP,ORL,DeMarcus Cousins,181,38.4333333333333,39,-0.566666666666663,78,87,-9,5,-14
21700097,202734,NOP,ORL,E'Twaun Moore,143,31.15,32,-0.850000000000001,51,77,-26,-10,-16
21700097,203076,NOP,ORL,Anthony Davis,195,41.0166666666667,41,0.0166666666666657,90,97,-7,0,-7
21700097,203121,NOP,ORL,Darius Miller,4,0.783333333333333,1,-0.216666666666667,0,0,0,0,0
21700097,203546,NOP,ORL,Ian Clark,73,14.35,14,0.35,45,30,15,13,2
21700097,1627767,NOP,ORL,Cheick Diallo,44,8.86666666666667,9,-0.133333333333333,19,28,-9,-10,1
21700097,201167,ORL,NOP,Arron Afflalo,4,0.783333333333333,1,-0.216666666666667,0,0,0,0,0
21700097,201571,ORL,NOP,D.J. Augustin,112,23.0333333333333,23,0.0333333333333314,54,50,4,4,0
21700097,201578,ORL,NOP,Marreese Speights,103,21.6166666666667,21,0.616666666666667,63,46,17,8,9
21700097,202687,ORL,NOP,Bismack Biyombo,39,8.06666666666667,8,0.0666666666666664,22,24,-2,-4,2
21700097,202696,ORL,NOP,Nikola Vucevic,152,31.85,32,-0.149999999999999,69,64,5,3,2
21700097,202714,ORL,NOP,Shelvin Mack,91,19.6166666666667,20,-0.383333333333333,52,44,8,-1,9
21700097,203082,ORL,NOP,Terrence Ross,143,31.1,31,0.0999999999999979,71,59,12,-1,13
21700097,203095,ORL,NOP,Evan Fournier,162,33.9666666666667,34,-0.0333333333333314,82,67,15,11,4
21700097,203613,ORL,NOP,Jonathon Simmons,133,28.5,28,0.5,74,59,15,2,13
21700097,203920,ORL,NOP,Khem Birch,4,0.783333333333333,1,-0.216666666666667,0,0,0,0,0
21700097,203932,ORL,NOP,Aaron Gordon,82,18.0333333333333,18,0.0333333333333314,40,38,2,0,2
21700097,1626209,ORL,NOP,Mario Hezonja,31,6.2,7,-0.800000000000001,12,18,-6,-6,0
21700097,1628371,ORL,NOP,Jonathan Isaac,69,14.95,15,-0.0500000000000007,36,26,10,-1,11
21700098,1717,DAL,UTA,Dirk Nowitzki,107,24.7333333333333,25,-0.266666666666666,47,60,-13,-13,0
21700098,2734,DAL,UTA,Devin Harris,112,24.65,25,-0.350000000000001,55,39,16,16,0
21700098,200826,DAL,UTA,J.J. Barea,113,25.85,26,-0.149999999999999,44,55,-11,-13,2
21700098,202083,DAL,UTA,Wesley Matthews,147,33.7,34,-0.299999999999997,62,84,-22,-20,-2
21700098,203084,DAL,UTA,Harrison Barnes,132,30,31,-1,42,68,-26,-28,2
21700098,203457,DAL,UTA,Nerlens Noel,99,21.8166666666667,22,-0.183333333333334,34,50,-16,-16,0
21700098,203481,DAL,UTA,Jeff Withey,9,1.96666666666667,2,-0.0333333333333334,5,4,1,1,0
21700098,203939,DAL,UTA,Dwight Powell,111,24.85,25,-0.150000000000002,54,47,7,7,0
21700098,1626257,DAL,UTA,Salah Mejri,39,9.16666666666667,9,0.166666666666666,17,21,-4,-4,0
21700098,1627812,DAL,UTA,Yogi Ferrell,90,20.5666666666667,21,-0.433333333333334,44,32,12,14,-2
21700098,1628372,DAL,UTA,Dennis Smith Jr.,72,16.9,17,-0.100000000000001,31,52,-21,-21,0
21700098,1628467,DAL,UTA,Maxi Kleber,9,1.96666666666667,2,-0.0333333333333334,5,4,1,1,0
21700098,1628492,DAL,UTA,Gian Clavell,10,2.16666666666667,3,-0.833333333333334,5,4,1,1,0
21700098,2207,UTA,DAL,Joe Johnson,74,16.3833333333333,16,0.383333333333333,25,35,-10,-12,2
21700098,200757,UTA,DAL,Thabo Sefolosha,85,19.55,20,-0.449999999999999,38,44,-6,-6,0
21700098,201937,UTA,DAL,Ricky Rubio,146,33.2666666666667,34,-0.733333333333334,78,61,17,19,-2
21700098,201973,UTA,DAL,Jonas Jerebko,9,1.96666666666667,2,-0.0333333333333334,4,5,-1,-1,0
21700098,202324,UTA,DAL,Derrick Favors,108,25.1,26,-0.899999999999999,64,47,17,19,-2
21700098,202327,UTA,DAL,Ekpe Udoh,63,14.5833333333333,15,-0.416666666666668,28,45,-17,-17,0
21700098,202692,UTA,DAL,Alec Burks,52,11.8833333333333,12,-0.116666666666667,25,30,-5,-7,2
21700098,203497,UTA,DAL,Rudy Gobert,147,33.0833333333333,33,0.0833333333333286,76,44,32,32,0
21700098,203526,UTA,DAL,Raul Neto,9,1.96666666666667,2,-0.0333333333333334,4,5,-1,-1,0
21700098,203918,UTA,DAL,Rodney Hood,129,28.7166666666667,29,-0.283333333333331,71,41,30,30,0
21700098,204060,UTA,DAL,Joe Ingles,143,32.4666666666667,33,-0.533333333333331,77,47,30,30,0
21700098,1626220,UTA,DAL,Royce O'Neale,9,1.96666666666667,2,-0.0333333333333334,4,5,-1,-1,0
21700098,1628378,UTA,DAL,Donovan Mitchell,76,17.4,17,0.399999999999999,26,36,-10,-10,0
21700099,202323,POR,TOR,Evan Turner,128,28.3333333333333,28,0.333333333333332,49,49,0,1,-1
21700099,202329,POR,TOR,Al-Farouq Aminu,149,34.35,35,-0.650000000000006,69,77,-8,-6,-2
21700099,202334,POR,TOR,Ed Davis,96,21.3,22,-0.700000000000003,34,31,3,3,0
21700099,203081,POR,TOR,Damian Lillard,177,40.5166666666667,41,-0.483333333333334,82,89,-7,-7,0
21700099,203090,POR,TOR,Maurice Harkless,107,25.3333333333333,26,-0.666666666666668,50,57,-7,-10,3
21700099,203468,POR,TOR,CJ McCollum,138,31.6833333333333,32,-0.316666666666666,53,63,-10,-10,0
21700099,203894,POR,TOR,Shabazz Napier,15,3.71666666666667,3,0.716666666666667,2,11,-9,-7,-2
21700099,203994,POR,TOR,Jusuf Nurkic,113,26.6,26,0.600000000000001,51,68,-17,-17,0
21700099,1626192,POR,TOR,Pat Connaughton,88,19.8833333333333,20,-0.116666666666667,33,35,-2,-4,2
21700099,1628403,POR,TOR,Caleb Swanigan,34,7.78333333333333,7,0.783333333333333,2,15,-13,-13,0
21700099,101139,TOR,POR,CJ Miles,80,17.8,18,-0.200000000000003,33,31,2,2,0
21700099,200768,TOR,POR,Kyle Lowry,148,34.2166666666667,34,0.216666666666669,77,65,12,12,0
21700099,201942,TOR,POR,DeMar DeRozan,161,35.9666666666667,37,-1.03333333333333,78,69,9,9,0
21700099,203512,TOR,POR,Lucas Nogueira,129,30.1166666666667,30,0.116666666666667,67,56,11,13,-2
21700099,203998,TOR,POR,Bruno Caboclo,3,0.866666666666667,1,-0.133333333333333,2,0,2,2,0
21700099,1626153,TOR,POR,Delon Wright,99,21.7333333333333,22,-0.266666666666666,34,36,-2,-2,0
21700099,1626181,TOR,POR,Norman Powell,93,22.1833333333333,22,0.18333333333333,53,42,11,11,0
21700099,1627751,TOR,POR,Jakob Poeltl,80,17.7833333333333,18,-0.216666666666669,32,29,3,1,2
21700099,1627783,TOR,POR,Pascal Siakam,116,26.4833333333333,26,0.483333333333334,61,55,6,9,-3
21700099,1627832,TOR,POR,Fred VanVleet,40,10.0666666666667,9,1.06666666666667,18,12,6,6,0
21700099,1628035,TOR,POR,Alfonzo McKinnie,3,0.866666666666667,1,-0.133333333333333,2,0,2,2,0
21700099,1628384,TOR,POR,OG Anunoby,93,21.4166666666667,22,-0.583333333333336,38,30,8,5,3
21700100,2561,GSW,LAC,David West,55,11.85,12,-0.15,31,28,3,3,0
21700100,2585,GSW,LAC,Zaza Pachulia,56,12.7166666666667,13,-0.283333333333333,27,32,-5,-5,0
21700100,2733,GSW,LAC,Shaun Livingston,74,14.1666666666667,14,0.166666666666668,52,24,28,26,2
21700100,2738,GSW,LAC,Andre Iguodala,120,23.2166666666667,23,0.216666666666669,75,54,21,23,-2
21700100,201142,GSW,LAC,Kevin Durant,140,29.3,29,0.300000000000001,88,70,18,18,0
21700100,201156,GSW,LAC,Nick Young,33,6.38333333333333,7,-0.616666666666667,18,16,2,2,0
21700100,201580,GSW,LAC,JaVale McGee,84,15.3333333333333,15,0.333333333333334,51,35,16,16,0
21700100,201939,GSW,LAC,Stephen Curry,149,29.8833333333333,30,-0.116666666666667,94,71,23,23,0
21700100,201956,GSW,LAC,Omri Casspi,33,6.38333333333333,7,-0.616666666666667,18,16,2,2,0
21700100,202691,GSW,LAC,Klay Thompson,138,29.75,30,-0.25,78,77,1,1,0
21700100,203110,GSW,LAC,Draymond Green,150,30.7833333333333,31,-0.216666666666669,89,73,16,16,0
21700100,1627775,GSW,LAC,Patrick McCaw,86,17.9833333333333,18,-0.0166666666666657,47,42,5,5,0
21700100,1628395,GSW,LAC,Jordan Bell,57,11.5833333333333,12,-0.416666666666668,37,27,10,10,0
21700100,101150,LAC,GSW,Lou Williams,134,25.8166666666667,26,-0.183333333333334,58,87,-29,-31,2
21700100,201568,LAC,GSW,Danilo Gallinari,165,33.7166666666667,34,-0.283333333333331,87,102,-15,-13,-2
21700100,201599,LAC,GSW,DeAndre Jordan,124,26.7666666666667,27,-0.233333333333334,65,71,-6,-6,0
21700100,201933,LAC,GSW,Blake Griffin,137,29.7333333333333,30,-0.266666666666666,63,86,-23,-23,0
21700100,201976,LAC,GSW,Patrick Beverley,115,26.05,26,0.0499999999999972,56,66,-10,-13,3
21700100,202325,LAC,GSW,Wesley Johnson,91,16.85,17,-0.149999999999999,42,50,-8,-12,4
21700100,203085,LAC,GSW,Austin Rivers,133,27.1166666666667,27,0.116666666666667,70,81,-11,-5,-6
21700100,203186,LAC,GSW,Willie Reed,60,10.8333333333333,11,-0.166666666666668,26,38,-12,-12,0
21700100,1626149,LAC,GSW,Montrezl Harrell,33,6.38333333333333,7,-0.616666666666667,16,18,-2,-2,0
21700100,1626155,LAC,GSW,Sam Dekker,33,6.38333333333333,7,-0.616666666666667,16,18,-2,-2,0
21700100,1627744,LAC,GSW,Brice Johnson,33,6.38333333333333,7,-0.616666666666667,16,18,-2,-2,0
21700100,1628393,LAC,GSW,Jawun Evans,33,6.38333333333333,7,-0.616666666666667,16,18,-2,-2,0
21700100,1628414,LAC,GSW,Sindarius Thornwell,84,16.9166666666667,17,-0.0833333333333357,34,52,-18,-17,-1
21700101,2744,IND,SAC,Al Jefferson,82,17.7333333333333,18,-0.266666666666666,28,32,-4,-2,-2
21700101,2863,IND,SAC,Damien Wilkins,27,4.86666666666667,5,-0.133333333333333,13,20,-7,-7,0
21700101,201152,IND,SAC,Thaddeus Young,121,27.6666666666667,27,0.666666666666664,56,37,19,22,-3
21700101,201954,IND,SAC,Darren Collison,111,24.6166666666667,25,-0.383333333333333,48,30,18,19,-1
21700101,202362,IND,SAC,Lance Stephenson,114,24.2,24,0.199999999999999,46,53,-7,-7,0
21700101,202709,IND,SAC,Cory Joseph,105,22.3666666666667,23,-0.633333333333333,47,39,8,6,2
21700101,202711,IND,SAC,Bojan Bogdanovic,124,27.2333333333333,27,0.233333333333334,62,37,25,26,-1
21700101,203506,IND,SAC,Victor Oladipo,124,28.2333333333333,28,0.233333333333334,55,36,19,22,-3
21700101,1626202,IND,SAC,Joe Young,53,10.1666666666667,10,0.166666666666668,21,27,-6,-6,0
21700101,1627734,IND,SAC,Domantas Sabonis,114,25.3,25,0.299999999999997,59,31,28,27,1
21700101,1627816,IND,SAC,Alex Poythress,11,2.01666666666667,2,0.0166666666666666,8,7,1,1,0
21700101,1628387,IND,SAC,Ike Anigbogu,27,4.86666666666667,5,-0.133333333333333,13,20,-7,-7,0
21700101,1628388,IND,SAC,TJ Leaf,102,20.2333333333333,21,-0.766666666666666,44,46,-2,-4,2
21700101,2216,SAC,IND,Zach Randolph,102,23.1333333333333,23,0.133333333333333,33,48,-15,-20,5
21700101,201585,SAC,IND,Kosta Koufos,95,20.2166666666667,20,0.216666666666665,34,37,-3,-3,0
21700101,201588,SAC,IND,George Hill,121,27.4166666666667,27,0.416666666666664,35,52,-17,-18,1
21700101,203992,SAC,IND,Bogdan Bogdanovic,125,28.3,28,0.299999999999997,37,56,-19,-22,3
21700101,1626161,SAC,IND,Willie Cauley-Stein,101,22.8166666666667,23,-0.183333333333334,29,50,-21,-22,1
21700101,1627741,SAC,IND,Buddy Hield,87,19.4166666666667,19,0.416666666666668,23,42,-19,-20,1
21700101,1627746,SAC,IND,Skal Labissiere,121,24.7666666666667,25,-0.233333333333334,50,52,-2,2,-4
21700101,1627781,SAC,IND,Malachi Richardson,98,19.1166666666667,19,0.116666666666667,48,44,4,4,0
21700101,1627834,SAC,IND,Georgios Papagiannis,27,4.86666666666667,5,-0.133333333333333,20,13,7,7,0
21700101,1628368,SAC,IND,De'Aaron Fox,130,27.4,28,-0.600000000000001,56,56,0,0,0
21700101,1628382,SAC,IND,Justin Jackson,81,17.1833333333333,17,0.18333333333333,30,37,-7,-5,-2
21700101,1628412,SAC,IND,Frank Mason,27,4.86666666666667,5,-0.133333333333333,20,13,7,7,0
21700102,201960,BKN,PHX,DeMarre Carroll,176,32.2666666666667,32,0.266666666666666,80,90,-10,-10,0
21700102,202344,BKN,PHX,Trevor Booker,94,18.45,19,-0.550000000000001,37,36,1,3,-2
21700102,202389,BKN,PHX,Timofey Mozgov,76,15.15,15,0.149999999999999,33,43,-10,-6,-4
21700102,203092,BKN,PHX,Tyler Zeller,91,16.2833333333333,17,-0.716666666666669,40,34,6,3,3
21700102,203459,BKN,PHX,Allen Crabbe,154,28.5333333333333,29,-0.466666666666669,61,70,-9,-9,0
21700102,203915,BKN,PHX,Spencer Dinwiddie,121,22.3166666666667,22,0.316666666666663,58,48,10,6,4
21700102,203925,BKN,PHX,Joe Harris,97,18.9666666666667,19,-0.0333333333333314,59,44,15,19,-4
21700102,1626156,BKN,PHX,D'Angelo Russell,158,28.3666666666667,29,-0.633333333333333,63,88,-25,-22,-3
21700102,1626178,BKN,PHX,Rondae Hollis-Jefferson,167,30.7166666666667,31,-0.283333333333335,76,87,-11,-14,3
21700102,1627747,BKN,PHX,Caris LeVert,141,27.7833333333333,28,-0.216666666666669,58,70,-12,-10,-2
21700102,2199,PHX,BKN,Tyson Chandler,115,21.7333333333333,22,-0.266666666666666,61,39,22,26,-4
21700102,203458,PHX,BKN,Alex Len,135,25.65,25,0.649999999999999,57,74,-17,-18,1
21700102,203584,PHX,BKN,Troy Daniels,63,12.7166666666667,13,-0.283333333333335,29,24,5,5,0
21700102,203933,PHX,BKN,T.J. Warren,130,24.4,25,-0.600000000000001,63,55,8,8,0
21700102,1626164,PHX,BKN,Devin Booker,192,35.05,35,0.0499999999999972,93,89,4,3,1
21700102,1627733,PHX,BKN,Dragan Bender,146,26.7166666666667,27,-0.283333333333331,82,61,21,20,1
21700102,1627737,PHX,BKN,Marquese Chriss,108,20.9833333333333,21,-0.0166666666666657,40,50,-10,-12,2
21700102,1627755,PHX,BKN,Tyler Ulis,91,18.7333333333333,19,-0.266666666666666,29,41,-12,-9,-3
21700102,1628367,PHX,BKN,Josh Jackson,131,23.8166666666667,23,0.816666666666666,63,60,3,0,3
21700102,1628455,PHX,BKN,Mike James,164,29.0333333333333,29,0.0333333333333314,93,72,21,17,4
21700103,202732,MIL,OKC,DeAndre Liggins,32,6.51666666666667,7,-0.483333333333333,19,13,6,6,0
21700103,203089,MIL,OKC,John Henson,98,22.05,22,0.0500000000000007,37,49,-12,-14,2
21700103,203114,MIL,OKC,Khris Middleton,144,31.9666666666667,32,-0.0333333333333314,53,70,-17,-19,2
21700103,203141,MIL,OKC,Mirza Teletovic,91,20.25,21,-0.75,42,45,-3,-5,2
21700103,203503,MIL,OKC,Tony Snell,134,29.7666666666667,30,-0.233333333333334,50,66,-16,-22,6
21700103,203507,MIL,OKC,Giannis Antetokounmpo,129,27.9166666666667,28,-0.0833333333333357,51,64,-13,-15,2
21700103,203521,MIL,OKC,Matthew Dellavedova,91,20.6166666666667,21,-0.383333333333333,35,51,-16,-18,2
21700103,1626173,MIL,OKC,Rashad Vaughn,82,17.8666666666667,18,-0.133333333333333,41,42,-1,3,-4
21700103,1627748,MIL,OKC,Thon Maker,86,19.0666666666667,19,0.0666666666666664,35,46,-11,-11,0
21700103,1627763,MIL,OKC,Malcolm Brogdon,93,20.5,21,-0.5,37,44,-7,-7,0
21700103,1628391,MIL,OKC,D.J. Wilson,57,12.1333333333333,13,-0.866666666666667,28,30,-2,-2,0
21700103,1628425,MIL,OKC,Sterling Brown,43,9.51666666666667,10,-0.483333333333334,27,20,7,9,-2
21700103,2546,OKC,MIL,Carmelo Anthony,125,28.4833333333333,29,-0.516666666666666,68,54,14,14,0
21700103,101109,OKC,MIL,Raymond Felton,83,18.8333333333333,19,-0.166666666666664,47,39,8,10,-2
21700103,201566,OKC,MIL,Russell Westbrook,122,26.5833333333333,27,-0.416666666666664,55,44,11,13,-2
21700103,202331,OKC,MIL,Paul George,133,29,29,0,63,49,14,16,-2
21700103,202335,OKC,MIL,Patrick Patterson,107,23.7166666666667,24,-0.283333333333331,61,48,13,14,-1
21700103,203460,OKC,MIL,Andre Roberson,92,20.7333333333333,21,-0.266666666666666,45,37,8,8,0
21700103,203500,OKC,MIL,Steven Adams,122,26.5833333333333,27,-0.416666666666664,55,44,11,13,-2
21700103,203518,OKC,MIL,Alex Abrines,124,26.9,27,-0.100000000000001,63,54,9,11,-2
21700103,203924,OKC,MIL,Jerami Grant,126,27.8,28,-0.200000000000003,60,56,4,6,-2
21700103,203962,OKC,MIL,Josh Huestis,28,5.66666666666667,6,-0.333333333333334,13,17,-4,-4,0
21700103,1626177,OKC,MIL,Dakari Johnson,7,1.65,2,-0.35,4,5,-1,-2,1
21700103,1628390,OKC,MIL,Terrance Ferguson,11,2.21666666666667,2,0.216666666666667,6,8,-2,-4,2
21700104,101106,LAL,DET,Andrew Bogut,34,7.86666666666667,8,-0.133333333333334,21,17,4,2,2
21700104,201147,LAL,DET,Corey Brewer,62,13.85,14,-0.149999999999999,31,27,4,3,1
21700104,201572,LAL,DET,Brook Lopez,103,20.9333333333333,21,-0.06666666666667,49,40,9,11,-2
21700104,203484,LAL,DET,Kentavious Caldwell-Pope,131,27.7333333333333,28,-0.266666666666666,63,52,11,12,-1
21700104,203898,LAL,DET,Tyler Ennis,11,2.61666666666667,2,0.616666666666667,3,5,-2,-3,1
21700104,203903,LAL,DET,Jordan Clarkson,92,20.4666666666667,21,-0.533333333333335,52,38,14,15,-1
21700104,203944,LAL,DET,Julius Randle,79,17.65,17,0.649999999999999,41,31,10,10,0
21700104,1626204,LAL,DET,Larry Nance Jr.,128,27.1166666666667,27,0.116666666666667,67,55,12,12,0
21700104,1627742,LAL,DET,Brandon Ingram,161,34.0666666666667,34,0.0666666666666629,82,66,16,17,-1
21700104,1627826,LAL,DET,Ivica Zubac,11,2.61666666666667,2,0.616666666666667,3,5,-2,-3,1
21700104,1628366,LAL,DET,Lonzo Ball,131,28,28,0,67,59,8,8,0
21700104,1628398,LAL,DET,Kyle Kuzma,91,19.65,20,-0.350000000000001,45,38,7,8,-1
21700104,1628404,LAL,DET,Josh Hart,81,17.0166666666667,17,0.0166666666666657,41,32,9,8,1
21700104,201229,DET,LAL,Anthony Tolliver,47,10.3333333333333,10,0.333333333333332,23,24,-1,-1,0
21700104,202340,DET,LAL,Avery Bradley,158,34.2333333333333,34,0.233333333333334,66,74,-8,-10,2
21700104,202397,DET,LAL,Ish Smith,102,22.9333333333333,23,-0.0666666666666664,46,53,-7,-7,0
21700104,202699,DET,LAL,Tobias Harris,156,32.75,33,-0.25,65,78,-13,-13,0
21700104,202704,DET,LAL,Reggie Jackson,133,26.9333333333333,27,-0.0666666666666664,52,68,-16,-16,0
21700104,202720,DET,LAL,Jon Leuer,45,9.71666666666667,10,-0.283333333333335,15,27,-12,-12,0
21700104,203083,DET,LAL,Andre Drummond,166,35.25,35,0.25,73,83,-10,-10,0
21700104,203493,DET,LAL,Reggie Bullock,69,14.9,15,-0.100000000000001,25,41,-16,-16,0
21700104,203961,DET,LAL,Eric Moreland,12,2.95,3,-0.0499999999999998,5,3,2,2,0
21700104,204038,DET,LAL,Langston Galloway,53,11.7333333333333,12,-0.266666666666666,22,31,-9,-7,-2
21700104,1626169,DET,LAL,Stanley Johnson,132,28.4666666666667,28,0.466666666666669,58,63,-5,-5,0
21700104,1627740,DET,LAL,Henry Ellenson,42,9.38333333333333,9,0.383333333333333,15,20,-5,-5,0
21700105,202732,MIL,CHA,DeAndre Liggins,32,6.63333333333333,7,-0.366666666666667,16,11,5,4,1
21700105,203089,MIL,CHA,John Henson,147,29.1833333333333,29,0.183333333333334,78,68,10,12,-2
21700105,203114,MIL,CHA,Khris Middleton,189,39.5833333333333,40,-0.416666666666671,105,104,1,1,0
21700105,203141,MIL,CHA,Mirza Teletovic,96,20.7333333333333,21,-0.266666666666666,41,63,-22,-20,-2
21700105,203503,MIL,CHA,Tony Snell,182,37.4,37,0.399999999999999,98,99,-1,0,-1
21700105,203507,MIL,CHA,Giannis Antetokounmpo,160,31.9666666666667,32,-0.0333333333333314,87,73,14,14,0
21700105,203521,MIL,CHA,Matthew Dellavedova,82,18.6166666666667,18,0.616666666666667,49,52,-3,-3,0
21700105,1627748,MIL,CHA,Thon Maker,83,18.8166666666667,19,-0.183333333333334,43,58,-15,-17,2
21700105,1627763,MIL,CHA,Malcolm Brogdon,179,37.0666666666667,37,0.0666666666666629,88,102,-14,-16,2
21700105,2730,CHA,MIL,Dwight Howard,142,29.2666666666667,29,0.266666666666666,72,79,-7,-11,4
21700105,101107,CHA,MIL,Marvin Williams,147,29.5833333333333,29,0.583333333333332,74,87,-13,-11,-2
21700105,202689,CHA,MIL,Kemba Walker,163,34.3,34,0.299999999999997,87,95,-8,-8,0
21700105,203077,CHA,MIL,Michael Kidd-Gilchrist,31,7.21666666666667,7,0.216666666666667,15,19,-4,-2,-2
21700105,203087,CHA,MIL,Jeremy Lamb,112,23.3666666666667,23,0.366666666666667,60,64,-4,-2,-2
21700105,203469,CHA,MIL,Cody Zeller,88,18.7333333333333,19,-0.266666666666666,54,42,12,14,-2
21700105,1626163,CHA,MIL,Frank Kaminsky,117,25.8,26,-0.200000000000003,71,55,16,18,-2
21700105,1626203,CHA,MIL,Treveon Graham,115,24.6666666666667,25,-0.333333333333336,72,53,19,16,3
21700105,1628370,CHA,MIL,Malik Monk,109,22.3833333333333,23,-0.616666666666667,57,49,8,6,2
21700105,1628407,CHA,MIL,Dwayne Bacon,126,24.6833333333333,24,0.683333333333334,68,62,6,5,1
21700106,2544,CLE,IND,LeBron James,175,37.4333333333333,37,0.43333333333333,84,96,-12,-12,0
21700106,2548,CLE,IND,Dwyane Wade,73,16.7833333333333,17,-0.216666666666665,35,36,-1,0,-1
21700106,2594,CLE,IND,Kyle Korver,72,16.3,16,0.300000000000001,36,40,-4,-3,-1
21700106,2747,CLE,IND,JR Smith,160,33.2166666666667,33,0.216666666666669,78,90,-12,-13,1
21700106,101112,CLE,IND,Channing Frye,2,0.566666666666667,1,-0.433333333333333,0,3,-3,-3,0
21700106,101181,CLE,IND,Jose Calderon,2,0.566666666666667,1,-0.433333333333333,0,3,-3,-3,0
21700106,201145,CLE,IND,Jeff Green,96,20.1666666666667,20,0.166666666666664,51,44,7,7,0
21700106,201565,CLE,IND,Derrick Rose,139,28.7666666666667,29,-0.233333333333334,67,76,-9,-10,1
21700106,201567,CLE,IND,Kevin Love,171,36.1666666666667,36,0.166666666666664,82,93,-11,-11,0
21700106,202684,CLE,IND,Tristan Thompson,72,14.75,15,-0.25,34,42,-8,-8,0
21700106,203109,CLE,IND,Jae Crowder,149,33.4,34,-0.600000000000001,68,91,-23,-23,0
21700106,1626224,CLE,IND,Cedi Osman,2,0.566666666666667,1,-0.433333333333333,0,3,-3,-3,0
21700106,1627790,CLE,IND,Ante Zizic,2,0.566666666666667,1,-0.433333333333333,0,3,-3,-3,0
21700106,2744,IND,CLE,Al Jefferson,24,4.8,5,-0.2,18,14,4,4,0
21700106,2863,IND,CLE,Damien Wilkins,54,12.3666666666667,12,0.366666666666667,27,21,6,5,1
21700106,201152,IND,CLE,Thaddeus Young,175,37.8,38,-0.200000000000003,97,84,13,22,-9
21700106,201954,IND,CLE,Darren Collison,140,29.4666666666667,30,-0.533333333333331,83,69,14,24,-10
21700106,202362,IND,CLE,Lance Stephenson,77,17.45,17,0.449999999999999,35,33,2,1,1
21700106,202709,IND,CLE,Cory Joseph,107,23.6333333333333,23,0.633333333333333,59,47,12,12,0
21700106,202711,IND,CLE,Bojan Bogdanovic,148,32.1666666666667,32,0.166666666666664,81,73,8,16,-8
21700106,203506,IND,CLE,Victor Oladipo,162,33.75,34,-0.25,94,82,12,23,-11
21700106,1627734,IND,CLE,Domantas Sabonis,163,34.95,35,-0.0499999999999972,96,76,20,20,0
21700106,1628388,IND,CLE,TJ Leaf,65,12.8666666666667,13,-0.133333333333333,30,36,-6,3,-9
21700107,201158,ATL,PHI,Marco Belinelli,165,29.25,29,0.25,73,78,-5,-4,-1
21700107,202337,ATL,PHI,Luke Babbitt,144,25.4166666666667,25,0.416666666666664,68,61,7,4,3
21700107,203145,ATL,PHI,Kent Bazemore,138,27.05,27,0.0500000000000007,49,67,-18,-16,-2
21700107,203471,ATL,PHI,Dennis Schroder,170,32.9166666666667,33,-0.0833333333333357,77,91,-14,-15,1
21700107,203473,ATL,PHI,Dewayne Dedmon,105,21.4666666666667,22,-0.533333333333331,40,48,-8,-8,0
21700107,203488,ATL,PHI,Mike Muscala,115,21.0333333333333,22,-0.966666666666669,41,53,-12,-13,1
21700107,1627098,ATL,PHI,Malcolm Delaney,46,9.28333333333333,9,0.283333333333333,25,19,6,6,0
21700107,1627752,ATL,PHI,Taurean Prince,212,39.4666666666667,40,-0.533333333333331,86,100,-14,-16,2
21700107,1627819,ATL,PHI,Isaiah Taylor,105,17.9166666666667,18,-0.0833333333333357,46,37,9,8,1
21700107,1627852,ATL,PHI,Nicolas Brussino,4,0.75,1,-0.25,2,0,2,2,0
21700107,1628381,ATL,PHI,John Collins,77,13.7,14,-0.300000000000001,36,36,0,0,0
21700107,1628416,ATL,PHI,Tyler Dorsey,4,0.75,1,-0.25,2,0,2,2,0
21700107,101161,PHI,ATL,Amir Johnson,93,17.1666666666667,17,0.166666666666664,53,43,10,10,0
21700107,200755,PHI,ATL,JJ Redick,168,31.6833333333333,32,-0.316666666666666,79,80,-1,0,-1
21700107,201573,PHI,ATL,Jerryd Bayless,165,31.4,31,0.399999999999999,79,68,11,11,0
21700107,203496,PHI,ATL,Robert Covington,174,33.7166666666667,34,-0.283333333333331,92,80,12,12,0
21700107,203954,PHI,ATL,Joel Embiid,160,29.8833333333333,30,-0.116666666666667,65,64,1,2,-1
21700107,203967,PHI,ATL,Dario Saric,106,19.8333333333333,20,-0.166666666666668,43,41,2,1,1
21700107,204456,PHI,ATL,T.J. McConnell,147,26.95,26,0.949999999999999,70,64,6,7,-1
21700107,1627732,PHI,ATL,Ben Simmons,178,32.9333333333333,34,-1.06666666666667,83,71,12,14,-2
21700107,1627789,PHI,ATL,Timothe Luwawu-Cabarrot,94,15.4333333333333,16,-0.566666666666666,26,34,-8,-7,-1
21700108,2199,PHX,WAS,Tyson Chandler,163,33.2833333333333,33,0.283333333333331,85,85,0,6,-6
21700108,203458,PHX,WAS,Alex Len,71,14.7,15,-0.300000000000001,37,31,6,0,6
21700108,203584,PHX,WAS,Troy Daniels,69,14.0833333333333,14,0.0833333333333322,41,32,9,9,0
21700108,203933,PHX,WAS,T.J. Warren,175,35.3,35,0.299999999999997,97,86,11,12,-1
21700108,1626164,PHX,WAS,Devin Booker,165,33.9,34,-0.100000000000001,81,84,-3,-3,0
21700108,1627733,PHX,WAS,Dragan Bender,112,23.6166666666667,24,-0.383333333333333,57,56,1,3,-2
21700108,1627737,PHX,WAS,Marquese Chriss,122,24.3666666666667,25,-0.633333333333333,65,60,5,3,2
21700108,1627755,PHX,WAS,Tyler Ulis,91,18.95,19,-0.0499999999999972,46,40,6,5,1
21700108,1628367,PHX,WAS,Josh Jackson,59,12.6833333333333,13,-0.316666666666666,25,30,-5,-6,1
21700108,1628455,PHX,WAS,Mike James,143,29.0333333333333,29,0.0333333333333314,76,76,0,1,-1
21700108,101133,WAS,PHX,Ian Mahinmi,71,14.8166666666667,15,-0.183333333333334,27,36,-9,-8,-1
21700108,101162,WAS,PHX,Marcin Gortat,163,33.1666666666667,33,0.166666666666664,89,86,3,2,1
21700108,201160,WAS,PHX,Jason Smith,69,15,16,-1,32,37,-5,-5,0
21700108,201975,WAS,PHX,Jodie Meeks,59,12.0666666666667,12,0.0666666666666664,23,33,-10,-8,-2
21700108,202322,WAS,PHX,John Wall,171,35.5666666666667,36,-0.433333333333337,91,89,2,4,-2
21700108,203078,WAS,PHX,Bradley Beal,184,38.05,38,0.0499999999999972,99,91,8,6,2
21700108,203107,WAS,PHX,Tomas Satoransky,114,24.35,24,0.350000000000001,56,53,3,6,-3
21700108,203118,WAS,PHX,Mike Scott,165,32.9833333333333,33,-0.0166666666666657,84,85,-1,-1,0
21700108,204025,WAS,PHX,Tim Frazier,63,12.4166666666667,12,0.416666666666666,25,33,-8,-10,2
21700108,1626162,WAS,PHX,Kelly Oubre Jr.,111,21.5,22,-0.5,54,67,-13,-16,3
21700109,201143,BOS,SAC,Al Horford,111,25.5,26,-0.5,59,40,19,19,0
21700109,202681,BOS,SAC,Kyrie Irving,121,27.3833333333333,27,0.383333333333333,62,42,20,22,-2
21700109,203382,BOS,SAC,Aron Baynes,99,22.7666666666667,23,-0.233333333333334,53,40,13,13,0
21700109,203499,BOS,SAC,Shane Larkin,40,7.9,8,-0.0999999999999996,19,19,0,-2,2
21700109,203935,BOS,SAC,Marcus Smart,114,25.2,26,-0.800000000000001,62,43,19,20,-1
21700109,1626179,BOS,SAC,Terry Rozier,82,19,19,0,45,39,6,6,0
21700109,1627759,BOS,SAC,Jaylen Brown,107,24.5333333333333,25,-0.466666666666669,56,40,16,16,0
21700109,1627824,BOS,SAC,Guerschon Yabusele,35,6.68333333333333,7,-0.316666666666666,17,14,3,3,0
21700109,1627846,BOS,SAC,Abdel Nader,63,12.65,13,-0.35,28,30,-2,-4,2
21700109,1628369,BOS,SAC,Jayson Tatum,112,25.9833333333333,26,-0.0166666666666657,67,45,22,23,-1
21700109,1628400,BOS,SAC,Semi Ojeleye,102,22.05,22,0.0499999999999972,54,46,8,8,0
21700109,1628464,BOS,SAC,Daniel Theis,79,18.1,18,0.100000000000001,43,32,11,11,0
21700109,1713,SAC,BOS,Vince Carter,38,9.15,9,0.15,16,26,-10,-10,0
21700109,2216,SAC,BOS,Zach Randolph,99,22.7666666666667,23,-0.233333333333334,38,52,-14,-14,0
21700109,201585,SAC,BOS,Kosta Koufos,87,20.1,21,-0.899999999999999,32,54,-22,-22,0
21700109,201588,SAC,BOS,George Hill,104,23.3166666666667,23,0.316666666666666,40,52,-12,-14,2
21700109,202066,SAC,BOS,Garrett Temple,87,20.0333333333333,20,0.0333333333333314,33,47,-14,-14,0
21700109,203992,SAC,BOS,Bogdan Bogdanovic,86,19.55,19,0.550000000000001,35,40,-5,-7,2
21700109,1626161,SAC,BOS,Willie Cauley-Stein,86,19.55,19,0.550000000000001,35,40,-5,-7,2
21700109,1627741,SAC,BOS,Buddy Hield,118,26.8333333333333,27,-0.166666666666664,48,66,-18,-18,0
21700109,1627746,SAC,BOS,Skal Labissiere,76,15.6333333333333,16,-0.366666666666667,32,35,-3,-3,0
21700109,1627781,SAC,BOS,Malachi Richardson,40,7.9,8,-0.0999999999999996,19,19,0,2,-2
21700109,1628368,SAC,BOS,De'Aaron Fox,123,27.5166666666667,28,-0.483333333333334,51,68,-17,-13,-4
21700109,1628382,SAC,BOS,Justin Jackson,86,18.7166666666667,19,-0.283333333333331,37,49,-12,-12,0
21700109,1628412,SAC,BOS,Frank Mason,35,6.68333333333333,7,-0.316666666666666,14,17,-3,-3,0
21700110,201577,CHI,MIA,Robin Lopez,152,33.85,34,-0.149999999999999,72,66,6,4,2
21700110,202347,CHI,MIA,Quincy Pondexter,28,6.15,6,0.15,9,12,-3,-2,-1
21700110,203200,CHI,MIA,Justin Holiday,171,37.4166666666667,38,-0.583333333333336,78,77,1,0,1
21700110,1626170,CHI,MIA,Jerian Grant,117,25.8666666666667,25,0.866666666666667,60,56,4,2,2
21700110,1626245,CHI,MIA,Cristiano Felicio,57,13.0833333333333,13,0.0833333333333322,14,28,-14,-13,-1
21700110,1627739,CHI,MIA,Kris Dunn,135,29.2,29,0.199999999999999,54,63,-9,-7,-2
21700110,1627756,CHI,MIA,Denzel Valentine,70,16.2833333333333,16,0.283333333333331,21,33,-12,-11,-1
21700110,1627835,CHI,MIA,Paul Zipser,67,14.6833333333333,15,-0.316666666666666,19,31,-12,-10,-2
21700110,1628021,CHI,MIA,David Nwaba,127,29.0833333333333,29,0.0833333333333322,51,50,1,0,1
21700110,1628374,CHI,MIA,Lauri Markkanen,156,34.3833333333333,34,0.383333333333333,77,69,8,7,1
21700110,201609,MIA,CHI,Goran Dragic,151,34.3166666666667,34,0.316666666666663,70,64,6,8,-2
21700110,201961,MIA,CHI,Wayne Ellington,106,23.0666666666667,23,0.0666666666666664,49,40,9,7,2
21700110,202355,MIA,CHI,Hassan Whiteside,113,26.25,26,0.25,44,49,-5,-3,-2
21700110,203079,MIA,CHI,Dion Waiters,146,32.4166666666667,33,-0.583333333333336,69,76,-7,-7,0
21700110,203482,MIA,CHI,Kelly Olynyk,41,8.33333333333333,9,-0.666666666666668,18,14,4,1,3
21700110,204020,MIA,CHI,Tyler Johnson,147,31.8166666666667,32,-0.183333333333334,67,63,4,4,0
21700110,1626159,MIA,CHI,Justise Winslow,114,24.05,24,0.0499999999999972,57,49,8,6,2
21700110,1626196,MIA,CHI,Josh Richardson,98,22.3833333333333,22,0.383333333333333,36,30,6,6,0
21700110,1627855,MIA,CHI,Okaro White,102,23.95,24,-0.0500000000000007,40,42,-2,0,-2
21700110,1628389,MIA,CHI,Bam Adebayo,62,13.4166666666667,13,0.416666666666666,35,28,7,8,-1
21700111,2403,HOU,NYK,Nene,64,13.45,14,-0.550000000000001,33,28,5,5,0
21700111,2772,HOU,NYK,Trevor Ariza,174,34.9166666666667,35,-0.0833333333333357,88,73,15,17,-2
21700111,200782,HOU,NYK,PJ Tucker,126,26.2,26,0.199999999999999,63,59,4,4,0
21700111,201569,HOU,NYK,Eric Gordon,140,28.3333333333333,29,-0.666666666666668,75,52,23,23,0
21700111,201583,HOU,NYK,Ryan Anderson,149,30.7666666666667,31,-0.233333333333334,79,61,18,16,2
21700111,201601,HOU,NYK,Luc Mbah a Moute,118,23.95,24,-0.0500000000000007,60,45,15,15,0
21700111,201628,HOU,NYK,Bobby Brown,19,4.03333333333333,4,0.0333333333333332,5,7,-2,-2,0
21700111,201935,HOU,NYK,James Harden,170,34.6166666666667,35,-0.38333333333334,96,75,21,21,0
21700111,203991,HOU,NYK,Clint Capela,134,27.4833333333333,28,-0.516666666666666,73,57,16,16,0
21700111,204028,HOU,NYK,Tarik Black,36,6.9,7,-0.0999999999999996,13,12,1,1,0
21700111,1627743,HOU,NYK,Demetrius Jackson,19,4.03333333333333,4,0.0333333333333332,5,7,-2,-2,0
21700111,1627753,HOU,NYK,Zhou Qi,21,4.48333333333333,5,-0.516666666666668,5,9,-4,-4,0
21700111,101127,NYK,HOU,Jarrett Jack,100,20.25,20,0.25,42,53,-11,-9,-2
21700111,201196,NYK,HOU,Ramon Sessions,26,5.61666666666667,6,-0.383333333333334,11,8,3,3,0
21700111,201563,NYK,HOU,Michael Beasley,24,5.73333333333333,6,-0.266666666666667,7,17,-10,-10,0
21700111,201584,NYK,HOU,Courtney Lee,114,23.4666666666667,24,-0.533333333333331,53,64,-11,-11,0
21700111,202498,NYK,HOU,Lance Thomas,74,14.3166666666667,14,0.316666666666666,31,38,-7,-8,1
21700111,202683,NYK,HOU,Enes Kanter,87,18,18,0,37,48,-11,-8,-3
21700111,203124,NYK,HOU,Kyle O'Quinn,62,12.1,12,0.0999999999999996,31,32,-1,-1,0
21700111,203501,NYK,HOU,Tim Hardaway Jr.,151,30.7,31,-0.299999999999997,63,83,-20,-18,-2
21700111,203926,NYK,HOU,Doug McDermott,107,22.0833333333333,22,0.0833333333333322,38,55,-17,-19,2
21700111,204001,NYK,HOU,Kristaps Porzingis,135,27.4166666666667,28,-0.583333333333336,58,65,-7,-7,0
21700111,1626195,NYK,HOU,Willy Hernangomez,77,16.4166666666667,17,-0.583333333333336,28,34,-6,-8,2
21700111,1628373,NYK,HOU,Frank Ntilikina,127,26,26,0,51,63,-12,-14,2
21700111,1628422,NYK,HOU,Damyean Dotson,86,17.0666666666667,17,0.0666666666666664,35,35,0,0,0
21700112,201167,ORL,MEM,Arron Afflalo,25,7.1,7,0.0999999999999996,13,15,-2,-2,0
21700112,201571,ORL,MEM,D.J. Augustin,62,13.8833333333333,14,-0.116666666666667,34,27,7,7,0
21700112,201578,ORL,MEM,Marreese Speights,13,4.18333333333333,4,0.183333333333334,12,5,7,7,0
21700112,202687,ORL,MEM,Bismack Biyombo,56,12.0333333333333,12,0.0333333333333332,18,32,-14,-14,0
21700112,202696,ORL,MEM,Nikola Vucevic,145,31.7833333333333,32,-0.216666666666665,71,61,10,9,1
21700112,202714,ORL,MEM,Shelvin Mack,111,25,25,0,50,55,-5,-4,-1
21700112,203082,ORL,MEM,Terrence Ross,101,22.5666666666667,23,-0.433333333333334,57,45,12,13,-1
21700112,203095,ORL,MEM,Evan Fournier,169,37.8333333333333,37,0.833333333333336,80,70,10,10,0
21700112,203613,ORL,MEM,Jonathon Simmons,123,26.8,26,0.800000000000001,49,61,-12,-13,1
21700112,203932,ORL,MEM,Aaron Gordon,156,34.9166666666667,34,0.916666666666664,75,60,15,14,1
21700112,1626209,ORL,MEM,Mario Hezonja,27,5.23333333333333,5,0.233333333333333,10,15,-5,-6,1
21700112,1628371,ORL,MEM,Jonathan Isaac,82,18.6666666666667,19,-0.333333333333336,36,44,-8,-11,3
21700112,201148,MEM,ORL,Brandan Wright,51,11.3666666666667,12,-0.633333333333333,24,17,7,7,0
21700112,201188,MEM,ORL,Marc Gasol,163,36.6333333333333,36,0.633333333333333,74,84,-10,-9,-1
21700112,201596,MEM,ORL,Mario Chalmers,119,26.65,26,0.649999999999999,48,55,-7,-8,1
21700112,201936,MEM,ORL,Tyreke Evans,148,34.4,34,0.399999999999999,74,66,8,9,-1
21700112,202718,MEM,ORL,Chandler Parsons,81,19.1,19,0.100000000000001,44,29,15,17,-2
21700112,203516,MEM,ORL,James Ennis III,158,34.7166666666667,35,-0.283333333333331,80,76,4,3,1
21700112,1626150,MEM,ORL,Andrew Harrison,98,20.2333333333333,20,0.233333333333334,39,55,-16,-18,2
21700112,1626185,MEM,ORL,Jarell Martin,87,19.35,19,0.350000000000001,27,52,-25,-23,-2
21700112,1628415,MEM,ORL,Dillon Brooks,165,37.55,38,-0.450000000000003,80,71,9,12,-3
21700113,2749,NOP,MIN,Jameer Nelson,101,19.7333333333333,20,-0.266666666666666,41,43,-2,-4,2
21700113,2754,NOP,MIN,Tony Allen,87,18.8,19,-0.199999999999999,38,40,-2,0,-2
21700113,201950,NOP,MIN,Jrue Holiday,186,38.3333333333333,38,0.333333333333329,83,75,8,10,-2
21700113,201967,NOP,MIN,Dante Cunningham,134,27.2,27,0.199999999999999,59,58,1,3,-2
21700113,202326,NOP,MIN,DeMarcus Cousins,192,40.7,41,-0.299999999999997,81,87,-6,-8,2
21700113,202734,NOP,MIN,E'Twaun Moore,138,29.7,29,0.699999999999999,58,64,-6,-8,2
21700113,203076,NOP,MIN,Anthony Davis,209,43.2166666666667,43,0.216666666666669,90,90,0,0,0
21700113,203121,NOP,MIN,Darius Miller,14,3.1,3,0.1,0,7,-7,-7,0
21700113,203546,NOP,MIN,Ian Clark,63,12.1,12,0.0999999999999996,20,38,-18,-18,0
21700113,1627767,NOP,MIN,Cheick Diallo,41,7.11666666666667,7,0.116666666666667,20,18,2,2,0
21700113,2037,MIN,NOP,Jamal Crawford,82,15.7833333333333,16,-0.216666666666667,39,29,10,12,-2
21700113,201952,MIN,NOP,Jeff Teague,172,35.55,36,-0.450000000000003,67,78,-11,-9,-2
21700113,201959,MIN,NOP,Taj Gibson,161,34.3,34,0.299999999999997,72,71,1,1,0
21700113,202357,MIN,NOP,Nemanja Bjelica,72,13.7,14,-0.300000000000001,32,27,5,5,0
21700113,202710,MIN,NOP,Jimmy Butler,157,33.35,33,0.350000000000001,65,73,-8,-8,0
21700113,203476,MIN,NOP,Gorgui Dieng,125,25.4,25,0.399999999999999,62,56,6,7,-1
21700113,203498,MIN,NOP,Shabazz Muhammad,44,8.93333333333333,9,-0.0666666666666664,23,13,10,10,0
21700113,203952,MIN,NOP,Andrew Wiggins,183,37.9333333333333,38,-0.0666666666666629,81,81,0,-2,2
21700113,1626145,MIN,NOP,Tyus Jones,61,12.45,12,0.449999999999999,37,20,17,15,2
21700113,1626157,MIN,NOP,Karl-Anthony Towns,108,22.6,23,-0.399999999999999,42,42,0,-1,1
21700114,2210,DEN,TOR,Richard Jefferson,25,4.66666666666667,5,-0.333333333333333,10,24,-14,-14,0
21700114,200794,DEN,TOR,Paul Millsap,120,26.25,26,0.25,76,47,29,29,0
21700114,201163,DEN,TOR,Wilson Chandler,138,30.55,30,0.550000000000001,89,58,31,31,0
21700114,202702,DEN,TOR,Kenneth Faried,76,15.1333333333333,15,0.133333333333333,33,49,-16,-14,-2
21700114,203115,DEN,TOR,Will Barton,124,25,25,0,64,54,10,11,-1
21700114,203486,DEN,TOR,Mason Plumlee,85,17.5166666666667,17,0.516666666666666,48,33,15,16,-1
21700114,203914,DEN,TOR,Gary Harris,107,24,24,0,68,41,27,27,0
21700114,203999,DEN,TOR,Nikola Jokic,138,30.0666666666667,31,-0.933333333333334,84,64,20,20,0
21700114,1626144,DEN,TOR,Emmanuel Mudiay,129,26.75,27,-0.25,56,74,-18,-17,-1
21700114,1626168,DEN,TOR,Trey Lyles,35,6.26666666666667,6,0.266666666666667,14,29,-15,-15,0
21700114,1627736,DEN,TOR,Malik Beasley,64,12.15,12,0.15,26,45,-19,-19,0
21700114,1627750,DEN,TOR,Jamal Murray,99,21.15,21,0.149999999999999,72,37,35,35,0
21700114,101139,TOR,DEN,CJ Miles,66,14.05,14,0.0500000000000007,30,39,-9,-9,0
21700114,200768,TOR,DEN,Kyle Lowry,112,24.5,25,-0.5,46,68,-22,-21,-1
21700114,201586,TOR,DEN,Serge Ibaka,78,18.2166666666667,18,0.216666666666669,39,52,-13,-14,1
21700114,201942,TOR,DEN,DeMar DeRozan,118,25.8833333333333,26,-0.116666666666667,51,68,-17,-16,-1
21700114,202685,TOR,DEN,Jonas Valanciunas,60,13.65,14,-0.35,32,38,-6,-7,1
21700114,203512,TOR,DEN,Lucas Nogueira,71,15.55,16,-0.449999999999999,21,44,-23,-22,-1
21700114,1626153,TOR,DEN,Delon Wright,127,25.75,26,-0.25,69,66,3,0,3
21700114,1626181,TOR,DEN,Norman Powell,137,28.75,29,-0.25,60,87,-27,-26,-1
21700114,1627751,TOR,DEN,Jakob Poeltl,62,12.4333333333333,12,0.433333333333334,29,32,-3,-4,1
21700114,1627783,TOR,DEN,Pascal Siakam,105,20.0333333333333,20,0.0333333333333314,53,49,4,4,0
21700114,1627832,TOR,DEN,Fred VanVleet,73,14.9666666666667,15,-0.033333333333335,43,35,8,7,1
21700114,1628035,TOR,DEN,Alfonzo McKinnie,48,8.86666666666667,9,-0.133333333333333,35,21,14,14,0
21700114,1628384,TOR,DEN,OG Anunoby,83,16.85,17,-0.149999999999999,47,41,6,4,2
21700115,202323,POR,UTA,Evan Turner,177,37.0333333333333,37,0.0333333333333314,65,87,-22,-21,-1
21700115,202329,POR,UTA,Al-Farouq Aminu,147,30.6833333333333,31,-0.316666666666666,73,59,14,14,0
21700115,202334,POR,UTA,Ed Davis,82,17.85,18,-0.149999999999999,33,39,-6,-9,3
21700115,203081,POR,UTA,Damian Lillard,205,42.7,43,-0.299999999999997,92,94,-2,1,-3
21700115,203090,POR,UTA,Maurice Harkless,131,27.4166666666667,28,-0.583333333333336,51,59,-8,-6,-2
21700115,203468,POR,UTA,CJ McCollum,203,41.5,42,-0.5,85,81,4,2,2
21700115,203943,POR,UTA,Noah Vonleh,59,13.35,13,0.350000000000001,17,23,-6,-8,2
21700115,203994,POR,UTA,Jusuf Nurkic,165,34.6333333333333,35,-0.366666666666667,70,71,-1,2,-3
21700115,1626192,POR,UTA,Pat Connaughton,86,18.8333333333333,19,-0.166666666666668,29,47,-18,-20,2
21700115,200757,UTA,POR,Thabo Sefolosha,134,28.3166666666667,28,0.316666666666666,68,44,24,24,0
21700115,201937,UTA,POR,Ricky Rubio,178,36.3666666666667,37,-0.633333333333333,78,72,6,4,2
21700115,201973,UTA,POR,Jonas Jerebko,91,20.7666666666667,20,0.766666666666666,51,36,15,17,-2
21700115,202324,UTA,POR,Derrick Favors,128,26.9666666666667,27,-0.0333333333333314,47,57,-10,-11,1
21700115,202327,UTA,POR,Ekpe Udoh,43,9.16666666666667,9,0.166666666666668,14,12,2,1,1
21700115,202692,UTA,POR,Alec Burks,64,14.4,14,0.399999999999999,30,27,3,4,-1
21700115,203497,UTA,POR,Rudy Gobert,186,38.3333333333333,38,0.333333333333329,82,82,0,0,0
21700115,203918,UTA,POR,Rodney Hood,94,19.5166666666667,20,-0.483333333333334,31,36,-5,-4,-1
21700115,204060,UTA,POR,Joe Ingles,171,34.85,35,-0.149999999999999,74,78,-4,-4,0
21700115,1628378,UTA,POR,Donovan Mitchell,166,35.3166666666667,35,0.316666666666663,85,71,14,14,0
21700116,1717,DAL,LAC,Dirk Nowitzki,97,20.9833333333333,21,-0.0166666666666657,51,53,-2,-4,2
21700116,2734,DAL,LAC,Devin Harris,87,19.0333333333333,19,0.033333333333335,53,51,2,2,0
21700116,200826,DAL,LAC,J.J. Barea,88,19.0333333333333,19,0.0333333333333314,30,54,-24,-24,0
21700116,202083,DAL,LAC,Wesley Matthews,129,27.35,27,0.350000000000001,65,71,-6,-8,2
21700116,203084,DAL,LAC,Harrison Barnes,144,30.7666666666667,31,-0.233333333333334,70,84,-14,-12,-2
21700116,203457,DAL,LAC,Nerlens Noel,80,17.1666666666667,17,0.166666666666664,28,52,-24,-22,-2
21700116,203481,DAL,LAC,Jeff Withey,24,4.66666666666667,5,-0.333333333333334,10,10,0,0,0
21700116,203939,DAL,LAC,Dwight Powell,83,17.1166666666667,17,0.116666666666667,28,35,-7,-9,2
21700116,1626257,DAL,LAC,Salah Mejri,50,9.73333333333333,10,-0.266666666666666,19,14,5,5,0
21700116,1627812,DAL,LAC,Yogi Ferrell,124,25.1666666666667,25,0.166666666666664,47,61,-14,-13,-1
21700116,1628372,DAL,LAC,Dennis Smith Jr.,131,27.8666666666667,28,-0.133333333333333,56,62,-6,-7,1
21700116,1628467,DAL,LAC,Maxi Kleber,98,20.5333333333333,21,-0.466666666666669,33,48,-15,-13,-2
21700116,101150,LAC,DAL,Lou Williams,85,18.3,18,0.299999999999997,43,28,15,13,2
21700116,201568,LAC,DAL,Danilo Gallinari,117,25.6166666666667,26,-0.383333333333333,71,51,20,20,0
21700116,201599,LAC,DAL,DeAndre Jordan,115,24.3,24,0.300000000000001,72,61,11,9,2
21700116,201933,LAC,DAL,Blake Griffin,134,28.3166666666667,28,0.316666666666666,78,70,8,8,0
21700116,201976,LAC,DAL,Patrick Beverley,107,23.0833333333333,23,0.0833333333333357,66,58,8,10,-2
21700116,202325,LAC,DAL,Wesley Johnson,122,26.0166666666667,26,0.0166666666666657,63,44,19,19,0
21700116,203085,LAC,DAL,Austin Rivers,117,24.6166666666667,25,-0.383333333333333,72,61,11,8,3
21700116,203186,LAC,DAL,Willie Reed,50,10.7833333333333,11,-0.216666666666669,24,16,8,8,0
21700116,1626149,LAC,DAL,Montrezl Harrell,62,12.8,13,-0.199999999999999,23,21,2,4,-2
21700116,1626155,LAC,DAL,Sam Dekker,50,9.73333333333333,10,-0.266666666666666,14,19,-5,-5,0
21700116,1627744,LAC,DAL,Brice Johnson,26,4.98333333333333,5,-0.0166666666666666,10,10,0,0,0
21700116,1628393,LAC,DAL,Jawun Evans,38,7.5,8,-0.5,12,14,-2,-2,0
21700116,1628414,LAC,DAL,Sindarius Thornwell,112,23.3666666666667,23,0.366666666666667,47,37,10,13,-3
21700117,2561,GSW,SAS,David West,51,12.5666666666667,13,-0.433333333333334,23,21,2,1,1
21700117,2585,GSW,SAS,Zaza Pachulia,57,13,13,0,34,34,0,-1,1
21700117,2733,GSW,SAS,Shaun Livingston,97,18.9666666666667,20,-1.03333333333333,46,26,20,19,1
21700117,2738,GSW,SAS,Andre Iguodala,114,23.95,24,-0.0500000000000007,54,44,10,12,-2
21700117,201142,GSW,SAS,Kevin Durant,170,34.55,35,-0.450000000000003,86,72,14,14,0
21700117,201156,GSW,SAS,Nick Young,15,3.15,3,0.15,4,1,3,3,0
21700117,201580,GSW,SAS,JaVale McGee,38,7.28333333333333,7,0.283333333333333,12,16,-4,-1,-3
21700117,201939,GSW,SAS,Stephen Curry,156,31.9666666666667,32,-0.033333333333335,85,70,15,16,-1
21700117,201956,GSW,SAS,Omri Casspi,15,3.15,3,0.15,4,1,3,3,0
21700117,202691,GSW,SAS,Klay Thompson,134,30.6333333333333,31,-0.366666666666667,66,68,-2,-2,0
21700117,203110,GSW,SAS,Draymond Green,126,29.25,29,0.25,77,60,17,15,2
21700117,1627775,GSW,SAS,Patrick McCaw,79,18.5333333333333,19,-0.466666666666669,39,29,10,9,1
21700117,1628395,GSW,SAS,Jordan Bell,58,11.4166666666667,12,-0.583333333333334,30,18,12,12,0
21700117,1938,SAS,GSW,Manu Ginobili,94,19.2333333333333,19,0.233333333333334,31,44,-13,-14,1
21700117,2200,SAS,GSW,Pau Gasol,114,25.5,26,-0.5,60,58,2,3,-1
21700117,200746,SAS,GSW,LaMarcus Aldridge,169,35.7833333333333,36,-0.216666666666669,72,87,-15,-15,0
21700117,200752,SAS,GSW,Rudy Gay,90,18.5666666666667,18,0.566666666666666,31,46,-15,-16,1
21700117,201980,SAS,GSW,Danny Green,135,30.1833333333333,30,0.18333333333333,65,64,1,-1,2
21700117,201988,SAS,GSW,Patty Mills,121,28.6,28,0.600000000000001,55,67,-12,-13,1
21700117,202722,SAS,GSW,Davis Bertans,15,3.15,3,0.15,1,4,-3,-3,0
21700117,203464,SAS,GSW,Brandon Paul,99,20.5,21,-0.5,35,55,-20,-18,-2
21700117,203937,SAS,GSW,Kyle Anderson,115,25.6666666666667,26,-0.333333333333336,58,62,-4,-3,-1
21700117,1627749,SAS,GSW,Dejounte Murray,101,19.0833333333333,20,-0.916666666666668,37,45,-8,-7,-1
21700117,1627854,SAS,GSW,Bryn Forbes,42,9,9,0,14,24,-10,-10,0
21700117,1628401,SAS,GSW,Derrick White,15,3.15,3,0.15,1,4,-3,-3,0
21700118,201147,LAL,POR,Corey Brewer,62,13.6166666666667,14,-0.383333333333333,29,28,1,0,1
21700118,201572,LAL,POR,Brook Lopez,132,29.3166666666667,29,0.316666666666666,73,65,8,9,-1
21700118,203484,LAL,POR,Kentavious Caldwell-Pope,154,34.1666666666667,34,0.166666666666664,84,80,4,4,0
21700118,203903,LAL,POR,Jordan Clarkson,100,21.8333333333333,22,-0.166666666666668,45,57,-12,-8,-4
21700118,203944,LAL,POR,Julius Randle,85,18.6833333333333,19,-0.316666666666666,36,48,-12,-12,0
21700118,1626204,LAL,POR,Larry Nance Jr.,88,19.6833333333333,19,0.68333333333333,48,41,7,8,-1
21700118,1627742,LAL,POR,Brandon Ingram,145,32.3166666666667,32,0.316666666666663,73,79,-6,-8,2
21700118,1628366,LAL,POR,Lonzo Ball,127,28.2333333333333,28,0.233333333333334,71,62,9,10,-1
21700118,1628398,LAL,POR,Kyle Kuzma,129,28.3166666666667,29,-0.683333333333334,61,72,-11,-11,0
21700118,1628404,LAL,POR,Josh Hart,63,13.8333333333333,14,-0.166666666666668,25,33,-8,-7,-1
21700118,202323,POR,LAL,Evan Turner,123,26.4,26,0.399999999999999,66,63,3,6,-3
21700118,202334,POR,LAL,Ed Davis,84,18.9,19,-0.100000000000001,45,38,7,5,2
21700118,203081,POR,LAL,Damian Lillard,175,38.7166666666667,39,-0.283333333333331,93,90,3,6,-3
21700118,203090,POR,LAL,Maurice Harkless,130,28.95,29,-0.0499999999999972,66,71,-5,-4,-1
21700118,203468,POR,LAL,CJ McCollum,174,38.6333333333333,38,0.633333333333333,87,87,0,-6,6
21700118,203943,POR,LAL,Noah Vonleh,66,15.1166666666667,15,0.116666666666667,38,36,2,-4,6
21700118,203994,POR,LAL,Jusuf Nurkic,133,29.1,29,0.100000000000001,68,71,-3,-2,-1
21700118,1626192,POR,LAL,Pat Connaughton,90,19.4833333333333,20,-0.516666666666666,46,43,3,6,-3
21700118,1628380,POR,LAL,Zach Collins,47,10.9166666666667,11,-0.0833333333333322,24,20,4,2,2
21700118,1628403,POR,LAL,Caleb Swanigan,63,13.7833333333333,14,-0.216666666666667,32,26,6,6,0
21700119,1891,MIL,DET,Jason Terry,20,5.2,5,0.2,7,13,-6,-6,0
21700119,202732,MIL,DET,DeAndre Liggins,23,5.51666666666667,5,0.516666666666667,9,16,-7,-7,0
21700119,203089,MIL,DET,John Henson,111,26.5333333333333,27,-0.466666666666669,61,59,2,0,2
21700119,203114,MIL,DET,Khris Middleton,170,39.4,39,0.400000000000006,83,92,-9,-7,-2
21700119,203141,MIL,DET,Mirza Teletovic,45,10.9,11,-0.0999999999999996,14,24,-10,-8,-2
21700119,203503,MIL,DET,Tony Snell,166,38.35,38,0.350000000000001,82,82,0,0,0
21700119,203507,MIL,DET,Giannis Antetokounmpo,159,37.4333333333333,38,-0.566666666666663,83,72,11,9,2
21700119,203521,MIL,DET,Matthew Dellavedova,75,16.9833333333333,17,-0.0166666666666657,24,39,-15,-15,0
21700119,1626173,MIL,DET,Rashad Vaughn,36,8.06666666666667,8,0.0666666666666664,11,18,-7,-7,0
21700119,1627748,MIL,DET,Thon Maker,72,15.7666666666667,16,-0.233333333333333,28,36,-8,-8,0
21700119,1627763,MIL,DET,Malcolm Brogdon,148,34.35,35,-0.649999999999999,78,74,4,4,0
21700119,201229,DET,MIL,Anthony Tolliver,81,18.6166666666667,19,-0.383333333333333,41,30,11,10,1
21700119,202340,DET,MIL,Avery Bradley,151,34.8666666666667,35,-0.133333333333333,79,78,1,1,0
21700119,202397,DET,MIL,Ish Smith,81,18.6833333333333,18,0.68333333333333,37,34,3,3,0
21700119,202699,DET,MIL,Tobias Harris,151,34.65,35,-0.349999999999994,79,74,5,7,-2
21700119,202704,DET,MIL,Reggie Jackson,124,29.0166666666667,30,-0.983333333333334,68,62,6,6,0
21700119,203083,DET,MIL,Andre Drummond,117,27.4166666666667,28,-0.583333333333336,53,62,-9,-8,-1
21700119,203493,DET,MIL,Reggie Bullock,18,4.38333333333333,4,0.383333333333334,6,7,-1,-1,0
21700119,203961,DET,MIL,Eric Moreland,88,20.2833333333333,20,0.283333333333331,52,34,18,17,1
21700119,204038,DET,MIL,Langston Galloway,54,12.8333333333333,13,-0.166666666666666,26,18,8,8,0
21700119,1626169,DET,MIL,Stanley Johnson,160,37.75,38,-0.25,84,81,3,2,1
21700120,201577,CHI,ORL,Robin Lopez,127,28.9333333333333,29,-0.0666666666666664,63,49,14,14,0
21700120,202347,CHI,ORL,Quincy Pondexter,25,5.88333333333333,6,-0.116666666666667,13,14,-1,-1,0
21700120,203200,CHI,ORL,Justin Holiday,127,28.9333333333333,29,-0.0666666666666664,63,49,14,14,0
21700120,1626170,CHI,ORL,Jerian Grant,96,21.9666666666667,22,-0.033333333333335,46,32,14,14,0
21700120,1626245,CHI,ORL,Cristiano Felicio,84,19,19,0,42,34,8,8,0
21700120,1627739,CHI,ORL,Kris Dunn,107,24.1,24,0.100000000000001,53,48,5,5,0
21700120,1627756,CHI,ORL,Denzel Valentine,103,23.3166666666667,23,0.316666666666666,55,46,9,7,2
21700120,1627770,CHI,ORL,Kay Felder,8,1.86666666666667,2,-0.133333333333333,6,3,3,3,0
21700120,1627835,CHI,ORL,Paul Zipser,96,21.5333333333333,22,-0.466666666666669,44,31,13,13,0
21700120,1628021,CHI,ORL,David Nwaba,156,35.2833333333333,35,0.283333333333331,76,57,19,21,-2
21700120,1628374,CHI,ORL,Lauri Markkanen,126,28.85,29,-0.149999999999999,64,52,12,12,0
21700120,201167,ORL,CHI,Arron Afflalo,80,18.0833333333333,18,0.0833333333333322,30,43,-13,-11,-2
21700120,201578,ORL,CHI,Marreese Speights,32,7.25,7,0.25,15,21,-6,-6,0
21700120,202687,ORL,CHI,Bismack Biyombo,53,12,12,0,17,24,-7,-5,-2
21700120,202696,ORL,CHI,Nikola Vucevic,126,28.6833333333333,29,-0.316666666666666,51,60,-9,-11,2
21700120,202714,ORL,CHI,Shelvin Mack,93,20.4833333333333,21,-0.516666666666666,34,45,-11,-14,3
21700120,203082,ORL,CHI,Terrence Ross,118,26.7,27,-0.300000000000001,42,55,-13,-15,2
21700120,203095,ORL,CHI,Evan Fournier,149,33.6166666666667,34,-0.383333333333333,57,74,-17,-17,0
21700120,203613,ORL,CHI,Jonathon Simmons,110,25.3666666666667,25,0.366666666666667,41,52,-11,-8,-3
21700120,203932,ORL,CHI,Aaron Gordon,129,29.2333333333333,29,0.233333333333334,51,62,-11,-13,2
21700120,1626209,ORL,CHI,Mario Hezonja,41,9.91666666666667,10,-0.0833333333333339,24,21,3,3,0
21700120,1628371,ORL,CHI,Jonathan Isaac,92,21.0833333333333,21,0.0833333333333322,38,47,-9,-7,-2
21700120,1628411,ORL,CHI,Wes Iwundu,32,7.25,7,0.25,15,21,-6,-6,0
21700121,201152,IND,PHI,Thaddeus Young,182,37.2666666666667,38,-0.733333333333334,80,107,-27,-24,-3
21700121,201954,IND,PHI,Darren Collison,147,28.9,30,-1.1,59,88,-29,-29,0
21700121,202362,IND,PHI,Lance Stephenson,97,18.3666666666667,19,-0.633333333333333,43,30,13,13,0
21700121,202709,IND,PHI,Cory Joseph,111,22.4666666666667,22,0.466666666666669,60,39,21,21,0
21700121,202711,IND,PHI,Bojan Bogdanovic,165,34.75,35,-0.25,81,106,-25,-27,2
21700121,203506,IND,PHI,Victor Oladipo,178,36.55,37,-0.450000000000003,81,99,-18,-19,1
21700121,1626167,IND,PHI,Myles Turner,125,24.25,24,0.25,54,49,5,6,-1
21700121,1626202,IND,PHI,Joe Young,31,5.55,6,-0.45,18,12,6,6,0
21700121,1627734,IND,PHI,Domantas Sabonis,112,23.1166666666667,24,-0.883333333333333,56,72,-16,-17,1
21700121,1628388,IND,PHI,TJ Leaf,37,5.61666666666667,6,-0.383333333333333,18,3,15,15,0
21700121,101161,PHI,IND,Amir Johnson,52,10.1,10,0.0999999999999996,24,25,-1,-1,0
21700121,200755,PHI,IND,JJ Redick,160,31.9833333333333,33,-1.01666666666667,92,72,20,20,0
21700121,201573,PHI,IND,Jerryd Bayless,141,27.5833333333333,28,-0.416666666666668,60,68,-8,-8,0
21700121,203496,PHI,IND,Robert Covington,150,31.55,32,-0.449999999999999,92,71,21,21,0
21700121,203954,PHI,IND,Joel Embiid,135,26.6666666666667,28,-1.33333333333333,74,60,14,12,2
21700121,203967,PHI,IND,Dario Saric,117,21.25,21,0.25,61,57,4,4,0
21700121,204456,PHI,IND,T.J. McConnell,127,25.6166666666667,26,-0.383333333333333,56,54,2,3,-1
21700121,1626158,PHI,IND,Richaun Holmes,50,10.6,10,0.6,23,25,-2,0,-2
21700121,1627732,PHI,IND,Ben Simmons,187,38.1166666666667,39,-0.883333333333333,98,85,13,12,1
21700121,1627789,PHI,IND,Timothe Luwawu-Cabarrot,66,13.3666666666667,13,0.366666666666667,25,33,-8,-8,0
21700122,2544,CLE,WAS,LeBron James,205,42.3166666666667,43,-0.683333333333337,118,112,6,6,0
21700122,2548,CLE,WAS,Dwyane Wade,63,14.4,14,0.4,31,34,-3,-3,0
21700122,2594,CLE,WAS,Kyle Korver,100,20.85,21,-0.149999999999999,57,47,10,15,-5
21700122,2747,CLE,WAS,JR Smith,142,29.1666666666667,30,-0.833333333333336,78,77,1,-1,2
21700122,101112,CLE,WAS,Channing Frye,53,11.3833333333333,11,0.383333333333333,28,27,1,3,-2
21700122,201145,CLE,WAS,Jeff Green,115,24.9333333333333,25,-0.0666666666666664,64,65,-1,-4,3
21700122,201565,CLE,WAS,Derrick Rose,142,28.4,29,-0.600000000000001,84,77,7,5,2
21700122,201567,CLE,WAS,Kevin Love,133,26.6,27,-0.399999999999999,74,71,3,1,2
21700122,203109,CLE,WAS,Jae Crowder,167,33.5166666666667,34,-0.483333333333334,98,83,15,15,0
21700122,1627790,CLE,WAS,Ante Zizic,30,6.51666666666667,7,-0.483333333333333,18,17,1,3,-2
21700122,101133,WAS,CLE,Ian Mahinmi,52,11.3,12,-0.699999999999999,26,26,0,-1,1
21700122,101162,WAS,CLE,Marcin Gortat,142,28.3333333333333,28,0.333333333333332,74,84,-10,-10,0
21700122,201975,WAS,CLE,Jodie Meeks,98,21.8,22,-0.200000000000003,56,57,-1,-1,0
21700122,202322,WAS,CLE,John Wall,187,38.2666666666667,38,0.266666666666666,104,114,-10,-8,-2
21700122,202693,WAS,CLE,Markieff Morris,72,14.3166666666667,14,0.316666666666666,38,44,-6,-1,-5
21700122,203078,WAS,CLE,Bradley Beal,179,36.1333333333333,37,-0.86666666666666,95,97,-2,-1,-1
21700122,203118,WAS,CLE,Mike Scott,79,17.1,17,0.100000000000001,39,42,-3,-5,2
21700122,203490,WAS,CLE,Otto Porter Jr.,154,31.0333333333333,31,0.0333333333333314,84,90,-6,-5,-1
21700122,204025,WAS,CLE,Tim Frazier,29,6.5,6,0.5,10,10,0,-1,1
21700122,1626162,WAS,CLE,Kelly Oubre Jr.,158,33.3,34,-0.700000000000003,84,86,-2,-7,5
21700123,201158,ATL,HOU,Marco Belinelli,88,17.45,18,-0.549999999999997,32,51,-19,-19,0
21700123,202337,ATL,HOU,Luke Babbitt,120,25.8333333333333,27,-1.16666666666667,62,56,6,5,1
21700123,203145,ATL,HOU,Kent Bazemore,126,27.2333333333333,27,0.233333333333334,58,74,-16,-14,-2
21700123,203471,ATL,HOU,Dennis Schroder,129,26.3166666666667,26,0.316666666666666,54,77,-23,-24,1
21700123,203473,ATL,HOU,Dewayne Dedmon,108,22.5,22,0.5,48,57,-9,-10,1
21700123,203488,ATL,HOU,Mike Muscala,94,19.35,19,0.350000000000001,38,55,-17,-17,0
21700123,1627752,ATL,HOU,Taurean Prince,120,24.1833333333333,24,0.183333333333334,52,61,-9,-10,1
21700123,1627819,ATL,HOU,Isaiah Taylor,113,24.8,25,-0.200000000000003,58,52,6,6,0
21700123,1627852,ATL,HOU,Nicolas Brussino,27,6.38333333333333,6,0.383333333333333,19,6,13,13,0
21700123,1628381,ATL,HOU,John Collins,135,27.8833333333333,28,-0.116666666666667,60,67,-7,-5,-2
21700123,1628416,ATL,HOU,Tyler Dorsey,85,17.9,18,-0.100000000000001,39,39,0,0,0
21700123,2403,HOU,ATL,Nene,82,16.5,17,-0.5,43,29,14,15,-1
21700123,2772,HOU,ATL,Trevor Ariza,160,32.1333333333333,32,0.133333333333333,86,66,20,22,-2
21700123,200782,HOU,ATL,PJ Tucker,112,23.1166666666667,23,0.116666666666667,59,42,17,19,-2
21700123,201569,HOU,ATL,Eric Gordon,143,29.4666666666667,30,-0.533333333333331,79,71,8,8,0
21700123,201583,HOU,ATL,Ryan Anderson,120,25.35,25,0.349999999999998,72,58,14,14,0
21700123,201601,HOU,ATL,Luc Mbah a Moute,162,34.3166666666667,34,0.316666666666663,80,70,10,10,0
21700123,201628,HOU,ATL,Bobby Brown,22,5.38333333333333,5,0.383333333333333,6,15,-9,-11,2
21700123,201935,HOU,ATL,James Harden,149,31.05,31,0.0499999999999972,84,65,19,19,0
21700123,203991,HOU,ATL,Clint Capela,110,22.6,22,0.600000000000001,61,56,5,4,1
21700123,204028,HOU,ATL,Tarik Black,37,8.86666666666667,9,-0.133333333333333,15,19,-4,-4,0
21700123,1627743,HOU,ATL,Demetrius Jackson,16,3.91666666666667,4,-0.083333333333333,2,8,-6,-6,0
21700123,1627753,HOU,ATL,Zhou Qi,32,7.13333333333333,7,0.133333333333333,8,21,-13,-15,2
21700124,101127,NYK,PHX,Jarrett Jack,156,29.65,30,-0.350000000000001,72,73,-1,-1,0
21700124,201563,NYK,PHX,Michael Beasley,76,16.7333333333333,17,-0.266666666666666,36,35,1,0,1
21700124,201584,NYK,PHX,Courtney Lee,169,34.8,35,-0.200000000000003,83,80,3,7,-4
21700124,202498,NYK,PHX,Lance Thomas,65,14.0166666666667,14,0.0166666666666657,35,21,14,12,2
21700124,202683,NYK,PHX,Enes Kanter,164,31.75,32,-0.25,77,72,5,2,3
21700124,203124,NYK,PHX,Kyle O'Quinn,76,16.25,16,0.25,43,35,8,11,-3
21700124,203501,NYK,PHX,Tim Hardaway Jr.,167,32.3666666666667,32,0.366666666666667,78,74,4,2,2
21700124,203926,NYK,PHX,Doug McDermott,79,14.8166666666667,15,-0.183333333333334,44,39,5,5,0
21700124,204001,NYK,PHX,Kristaps Porzingis,164,31.2666666666667,31,0.266666666666666,84,72,12,13,-1
21700124,1628373,NYK,PHX,Frank Ntilikina,84,18.35,18,0.350000000000001,48,34,14,14,0
21700124,2199,PHX,NYK,Tyson Chandler,120,24.6833333333333,25,-0.316666666666666,54,56,-2,-2,0
21700124,203458,PHX,NYK,Alex Len,120,23.3166666666667,23,0.316666666666666,53,64,-11,-11,0
21700124,203584,PHX,NYK,Troy Daniels,125,26.65,27,-0.350000000000001,56,64,-8,-8,0
21700124,203933,PHX,NYK,T.J. Warren,51,9.96666666666667,10,-0.0333333333333332,17,28,-11,-11,0
21700124,1626164,PHX,NYK,Devin Booker,174,33.35,33,0.349999999999994,82,84,-2,-2,0
21700124,1627733,PHX,NYK,Dragan Bender,135,26.6166666666667,26,0.616666666666667,50,81,-31,-29,-2
21700124,1627737,PHX,NYK,Marquese Chriss,79,15.95,17,-1.05,45,29,16,14,2
21700124,1627755,PHX,NYK,Tyler Ulis,108,22.95,23,-0.0500000000000007,41,59,-18,-20,2
21700124,1627884,PHX,NYK,Derrick Jones Jr.,12,2.05,2,0.0499999999999998,7,7,0,0,0
21700124,1628367,PHX,NYK,Josh Jackson,144,29.4166666666667,29,0.416666666666664,64,67,-3,-3,0
21700124,1628455,PHX,NYK,Mike James,132,25.05,25,0.0499999999999972,66,61,5,7,-2
21700125,2746,NOP,DAL,Josh Smith,10,2.25,2,0.25,0,9,-9,-7,-2
21700125,2749,NOP,DAL,Jameer Nelson,137,28.0166666666667,28,0.0166666666666657,54,73,-19,-19,0
21700125,2754,NOP,DAL,Tony Allen,88,18.55,18,0.550000000000001,36,43,-7,-9,2
21700125,201950,NOP,DAL,Jrue Holiday,187,38.1333333333333,38,0.133333333333333,78,74,4,2,2
21700125,201967,NOP,DAL,Dante Cunningham,78,16.25,16,0.25,36,24,12,10,2
21700125,202326,NOP,DAL,DeMarcus Cousins,181,38.4166666666667,39,-0.583333333333329,77,73,4,6,-2
21700125,202734,NOP,DAL,E'Twaun Moore,165,33.4,34,-0.600000000000001,76,62,14,14,0
21700125,203076,NOP,DAL,Anthony Davis,197,40.1,40,0.0999999999999943,90,69,21,21,0
21700125,203121,NOP,DAL,Darius Miller,58,12.6833333333333,13,-0.316666666666666,23,27,-4,-4,0
21700125,203546,NOP,DAL,Ian Clark,59,12.2,12,0.199999999999999,25,16,9,11,-2
21700125,1717,DAL,NOP,Dirk Nowitzki,99,21.6333333333333,22,-0.366666666666667,41,42,-1,-4,3
21700125,2734,DAL,NOP,Devin Harris,96,21.3166666666667,21,0.316666666666666,45,33,12,14,-2
21700125,200826,DAL,NOP,J.J. Barea,109,23.1166666666667,23,0.116666666666667,48,40,8,9,-1
21700125,202083,DAL,NOP,Wesley Matthews,186,37.9666666666667,38,-0.0333333333333314,69,86,-17,-17,0
21700125,203084,DAL,NOP,Harrison Barnes,186,38.4333333333333,39,-0.566666666666663,68,85,-17,-17,0
21700125,203457,DAL,NOP,Nerlens Noel,65,13.1833333333333,13,0.183333333333334,17,34,-17,-18,1
21700125,203939,DAL,NOP,Dwight Powell,63,12.0833333333333,12,0.0833333333333322,31,28,3,3,0
21700125,1626257,DAL,NOP,Salah Mejri,105,22.2333333333333,22,0.233333333333334,45,40,5,6,-1
21700125,1627812,DAL,NOP,Yogi Ferrell,110,21.6166666666667,22,-0.383333333333333,51,41,10,11,-1
21700125,1628372,DAL,NOP,Dennis Smith Jr.,141,28.4166666666667,29,-0.583333333333336,55,66,-11,-12,1
21700126,1938,SAS,CHA,Manu Ginobili,129,27.1833333333333,27,0.183333333333334,68,55,13,14,-1
21700126,2200,SAS,CHA,Pau Gasol,130,27.0166666666667,27,0.0166666666666657,59,51,8,10,-2
21700126,200746,SAS,CHA,LaMarcus Aldridge,151,31.7166666666667,32,-0.283333333333335,68,76,-8,-9,1
21700126,200752,SAS,CHA,Rudy Gay,137,27.5833333333333,27,0.583333333333336,68,51,17,20,-3
21700126,201980,SAS,CHA,Danny Green,128,27.8,28,-0.199999999999999,47,61,-14,-15,1
21700126,201988,SAS,CHA,Patty Mills,139,28.4,28,0.399999999999999,65,73,-8,-5,-3
21700126,203464,SAS,CHA,Brandon Paul,30,6.78333333333333,6,0.783333333333333,12,11,1,2,-1
21700126,203937,SAS,CHA,Kyle Anderson,101,21.6833333333333,22,-0.316666666666666,41,51,-10,-12,2
21700126,1627749,SAS,CHA,Dejounte Murray,91,19.5,20,-0.5,42,28,14,12,2
21700126,1627854,SAS,CHA,Bryn Forbes,114,21.8333333333333,22,-0.166666666666668,65,48,17,18,-1
21700126,2730,CHA,SAS,Dwight Howard,145,30.95,31,-0.0499999999999972,72,67,5,3,2
21700126,101107,CHA,SAS,Marvin Williams,129,25.4,26,-0.600000000000001,62,52,10,10,0
21700126,202689,CHA,SAS,Kemba Walker,160,33.3833333333333,33,0.383333333333333,79,70,9,7,2
21700126,203087,CHA,SAS,Jeremy Lamb,161,34.5166666666667,35,-0.483333333333334,79,69,10,14,-4
21700126,203469,CHA,SAS,Cody Zeller,80,16.2666666666667,16,0.266666666666666,27,38,-11,-10,-1
21700126,1626163,CHA,SAS,Frank Kaminsky,113,25.1333333333333,25,0.133333333333333,46,62,-16,-19,3
21700126,1626203,CHA,SAS,Treveon Graham,114,23.8666666666667,24,-0.133333333333333,41,53,-12,-15,3
21700126,1628370,CHA,SAS,Malik Monk,83,17.5833333333333,18,-0.416666666666668,29,48,-19,-18,-1
21700126,1628407,CHA,SAS,Dwayne Bacon,165,32.4,32,0.399999999999999,70,76,-6,-7,1
21700127,200794,DEN,MIA,Paul Millsap,152,34.1833333333333,34,0.18333333333333,72,74,-2,-2,0
21700127,201163,DEN,MIA,Wilson Chandler,160,35.6666666666667,36,-0.333333333333329,72,73,-1,-3,2
21700127,202702,DEN,MIA,Kenneth Faried,28,5.76666666666667,6,-0.233333333333333,8,6,2,2,0
21700127,203115,DEN,MIA,Will Barton,136,27.6666666666667,28,-0.333333333333336,53,45,8,10,-2
21700127,203486,DEN,MIA,Mason Plumlee,56,11.6,11,0.6,24,27,-3,-1,-2
21700127,203914,DEN,MIA,Gary Harris,161,36.2,36,0.200000000000003,75,74,1,1,0
21700127,203999,DEN,MIA,Nikola Jokic,150,33.8333333333333,34,-0.166666666666671,66,69,-3,-5,2
21700127,1626144,DEN,MIA,Emmanuel Mudiay,122,25.3833333333333,25,0.383333333333333,46,44,2,3,-1
21700127,1627736,DEN,MIA,Malik Beasley,44,9.1,9,0.100000000000001,16,11,5,5,0
21700127,1627750,DEN,MIA,Jamal Murray,86,20.6,21,-0.399999999999999,43,47,-4,-5,1
21700127,201609,MIA,DEN,Goran Dragic,153,34.4,34,0.399999999999999,74,73,1,1,0
21700127,201949,MIA,DEN,James Johnson,144,30.6333333333333,30,0.633333333333333,61,54,7,3,4
21700127,201961,MIA,DEN,Wayne Ellington,58,12.3166666666667,12,0.316666666666666,22,24,-2,-1,-1
21700127,202355,MIA,DEN,Hassan Whiteside,101,23.6666666666667,24,-0.333333333333336,50,54,-4,-2,-2
21700127,203079,MIA,DEN,Dion Waiters,136,30.8166666666667,31,-0.183333333333334,68,69,-1,-1,0
21700127,203482,MIA,DEN,Kelly Olynyk,100,20.3666666666667,20,0.366666666666667,33,36,-3,-3,0
21700127,204020,MIA,DEN,Tyler Johnson,121,25.2666666666667,26,-0.733333333333334,38,45,-7,-10,3
21700127,1626159,MIA,DEN,Justise Winslow,64,13.4,14,-0.600000000000001,18,23,-5,-5,0
21700127,1626196,MIA,DEN,Josh Richardson,149,32.6333333333333,33,-0.366666666666667,68,60,8,8,0
21700127,1627855,MIA,DEN,Okaro White,51,12.3833333333333,13,-0.616666666666667,28,29,-1,-1,0
21700127,1628389,MIA,DEN,Bam Adebayo,18,4.11666666666667,4,0.116666666666667,10,8,2,6,-4
21700128,200768,TOR,UTA,Kyle Lowry,156,35.1333333333333,35,0.133333333333333,81,70,11,13,-2
21700128,201586,TOR,UTA,Serge Ibaka,116,26.2,27,-0.799999999999997,61,61,0,-1,1
21700128,201942,TOR,UTA,DeMar DeRozan,169,37.7666666666667,38,-0.233333333333334,92,85,7,5,2
21700128,202685,TOR,UTA,Jonas Valanciunas,93,20.5833333333333,21,-0.416666666666668,51,41,10,9,1
21700128,203512,TOR,UTA,Lucas Nogueira,64,14.9,15,-0.100000000000001,38,42,-4,-4,0
21700128,1626153,TOR,UTA,Delon Wright,55,12.6333333333333,13,-0.366666666666667,28,30,-2,-4,2
21700128,1626181,TOR,UTA,Norman Powell,134,29.35,30,-0.649999999999999,63,62,1,4,-3
21700128,1627751,TOR,UTA,Jakob Poeltl,54,12.2833333333333,12,0.283333333333333,20,17,3,4,-1
21700128,1627783,TOR,UTA,Pascal Siakam,95,21.5666666666667,21,0.566666666666666,48,39,9,10,-1
21700128,1627832,TOR,UTA,Fred VanVleet,42,10,10,0,17,15,2,4,-2
21700128,1628384,TOR,UTA,OG Anunoby,77,18.4166666666667,18,0.416666666666664,46,38,8,5,3
21700128,200757,UTA,TOR,Thabo Sefolosha,65,13.9666666666667,14,-0.033333333333335,32,34,-2,-5,3
21700128,201937,UTA,TOR,Ricky Rubio,137,30.2333333333333,30,0.233333333333334,62,70,-8,-10,2
21700128,201973,UTA,TOR,Jonas Jerebko,51,12.25,12,0.25,30,35,-5,-4,-1
21700128,202324,UTA,TOR,Derrick Favors,116,26.7666666666667,27,-0.233333333333334,50,57,-7,-6,-1
21700128,202327,UTA,TOR,Ekpe Udoh,60,13.4833333333333,13,0.483333333333334,25,31,-6,-4,-2
21700128,202692,UTA,TOR,Alec Burks,47,10.1333333333333,10,0.133333333333333,26,28,-2,-2,0
21700128,203497,UTA,TOR,Rudy Gobert,151,34.2833333333333,35,-0.716666666666669,75,78,-3,-5,2
21700128,203918,UTA,TOR,Rodney Hood,151,34.4833333333333,35,-0.516666666666666,68,74,-6,-8,2
21700128,204060,UTA,TOR,Joe Ingles,136,31.4833333333333,32,-0.516666666666666,61,71,-10,-7,-3
21700128,1628378,UTA,TOR,Donovan Mitchell,141,31.75,32,-0.25,71,67,4,6,-2
21700129,201143,BOS,OKC,Al Horford,157,34.55,34,0.549999999999997,77,68,9,10,-1
21700129,202681,BOS,OKC,Kyrie Irving,155,34.4333333333333,34,0.433333333333337,77,65,12,15,-3
21700129,202694,BOS,OKC,Marcus Morris,91,18.2,18,0.199999999999999,46,38,8,11,-3
21700129,203382,BOS,OKC,Aron Baynes,87,20.3666666666667,21,-0.633333333333333,27,34,-7,-7,0
21700129,203935,BOS,OKC,Marcus Smart,130,28.1333333333333,27,1.13333333333333,51,48,3,6,-3
21700129,1626179,BOS,OKC,Terry Rozier,96,22.9666666666667,23,-0.033333333333335,50,51,-1,-5,4
21700129,1627759,BOS,OKC,Jaylen Brown,145,30.9166666666667,31,-0.0833333333333357,66,63,3,4,-1
21700129,1628369,BOS,OKC,Jayson Tatum,127,29.2333333333333,30,-0.766666666666666,58,56,2,4,-2
21700129,1628400,BOS,OKC,Semi Ojeleye,55,13.7833333333333,14,-0.216666666666667,32,30,2,-2,4
21700129,1628464,BOS,OKC,Daniel Theis,32,7.41666666666667,7,0.416666666666666,16,17,-1,-1,0
21700129,2546,OKC,BOS,Carmelo Anthony,154,33.2666666666667,33,0.266666666666666,67,69,-2,-1,-1
21700129,101109,OKC,BOS,Raymond Felton,70,16.6833333333333,17,-0.316666666666666,30,38,-8,-8,0
21700129,201566,OKC,BOS,Russell Westbrook,172,37.8333333333333,38,-0.166666666666671,78,84,-6,-7,1
21700129,202331,OKC,BOS,Paul George,177,39.1166666666667,39,0.116666666666667,79,86,-7,-8,1
21700129,202335,OKC,BOS,Patrick Patterson,64,15.2166666666667,15,0.216666666666665,27,36,-9,-9,0
21700129,203460,OKC,BOS,Andre Roberson,124,27.2166666666667,28,-0.783333333333331,49,53,-4,-5,1
21700129,203500,OKC,BOS,Steven Adams,150,32.7166666666667,33,-0.283333333333331,66,70,-4,-7,3
21700129,203518,OKC,BOS,Alex Abrines,59,12.95,13,-0.0500000000000007,29,23,6,6,0
21700129,203924,OKC,BOS,Jerami Grant,99,23.5,23,0.5,41,39,2,2,0
21700129,1628390,OKC,BOS,Terrance Ferguson,6,1.5,2,-0.5,4,2,2,2,0
21700130,201147,LAL,BKN,Corey Brewer,47,9.08333333333333,9,0.0833333333333322,23,27,-4,-7,3
21700130,201572,LAL,BKN,Brook Lopez,156,30.3,30,0.299999999999997,82,69,13,13,0
21700130,203484,LAL,BKN,Kentavious Caldwell-Pope,177,33.1333333333333,33,0.133333333333333,88,84,4,5,-1
21700130,203898,LAL,BKN,Tyler Ennis,57,11.2333333333333,11,0.233333333333334,25,25,0,1,-1
21700130,203903,LAL,BKN,Jordan Clarkson,139,24.9833333333333,25,-0.0166666666666657,60,62,-2,-3,1
21700130,203944,LAL,BKN,Julius Randle,90,16.1833333333333,16,0.183333333333334,38,36,2,1,1
21700130,1627742,LAL,BKN,Brandon Ingram,185,35.1666666666667,36,-0.833333333333336,96,78,18,17,1
21700130,1628366,LAL,BKN,Lonzo Ball,145,28.25,29,-0.75,80,60,20,21,-1
21700130,1628398,LAL,BKN,Kyle Kuzma,203,38.6,39,-0.400000000000006,104,89,15,13,2
21700130,1628404,LAL,BKN,Josh Hart,66,11.65,12,-0.35,24,30,-6,-1,-5
21700130,201960,BKN,LAL,DeMarre Carroll,186,33.9166666666667,34,-0.0833333333333286,90,81,9,9,0
21700130,202389,BKN,LAL,Timofey Mozgov,76,15.5,16,-0.5,32,37,-5,-5,0
21700130,203092,BKN,LAL,Tyler Zeller,94,18,19,-1,38,51,-13,-14,1
21700130,203459,BKN,LAL,Allen Crabbe,163,29.3833333333333,29,0.383333333333333,72,80,-8,-5,-3
21700130,203915,BKN,LAL,Spencer Dinwiddie,76,14.85,15,-0.15,31,32,-1,-4,3
21700130,203925,BKN,LAL,Joe Harris,119,22.85,23,-0.149999999999999,55,61,-6,-4,-2
21700130,203930,BKN,LAL,Sean Kilpatrick,5,1.26666666666667,1,0.266666666666667,2,4,-2,-1,-1
21700130,1626156,BKN,LAL,D'Angelo Russell,189,35.1333333333333,35,0.133333333333333,87,96,-9,-6,-3
21700130,1626178,BKN,LAL,Rondae Hollis-Jefferson,195,37.0166666666667,37,0.0166666666666657,84,100,-16,-18,2
21700130,1627747,BKN,LAL,Caris LeVert,157,29.4,30,-0.600000000000001,67,74,-7,-11,4
21700130,1628451,BKN,LAL,Jacob Wiley,5,1.26666666666667,1,0.266666666666667,2,4,-2,-1,-1
21700131,101150,LAC,MEM,Lou Williams,118,23.7,23,0.700000000000003,55,56,-1,-3,2
21700131,201568,LAC,MEM,Danilo Gallinari,161,34.8666666666667,36,-1.13333333333333,69,80,-11,-12,1
21700131,201599,LAC,MEM,DeAndre Jordan,153,34.4833333333333,35,-0.516666666666666,78,81,-3,-5,2
21700131,201933,LAC,MEM,Blake Griffin,167,36.15,37,-0.850000000000001,82,83,-1,-3,2
21700131,201976,LAC,MEM,Patrick Beverley,171,37.65,38,-0.350000000000001,84,89,-5,-5,0
21700131,202325,LAC,MEM,Wesley Johnson,69,13.9,14,-0.0999999999999996,33,40,-7,-4,-3
21700131,203085,LAC,MEM,Austin Rivers,176,38.3166666666667,38,0.316666666666663,91,93,-2,-2,0
21700131,203186,LAC,MEM,Willie Reed,30,5.96666666666667,6,-0.0333333333333332,11,15,-4,-2,-2
21700131,1626149,LAC,MEM,Montrezl Harrell,18,4.11666666666667,4,0.116666666666666,4,7,-3,-1,-2
21700131,1628414,LAC,MEM,Sindarius Thornwell,47,9.6,10,-0.4,13,21,-8,-8,0
21700131,201144,MEM,LAC,Mike Conley,148,32.5166666666667,33,-0.483333333333334,80,71,9,11,-2
21700131,201148,MEM,LAC,Brandan Wright,115,24.9333333333333,25,-0.0666666666666664,60,50,10,11,-1
21700131,201188,MEM,LAC,Marc Gasol,147,31.9333333333333,32,-0.06666666666667,74,75,-1,-2,1
21700131,201596,MEM,LAC,Mario Chalmers,136,26.95,27,-0.0499999999999972,70,60,10,9,1
21700131,201936,MEM,LAC,Tyreke Evans,146,30.8166666666667,31,-0.183333333333334,74,76,-2,0,-2
21700131,202718,MEM,LAC,Chandler Parsons,95,19.6833333333333,20,-0.31666666666667,50,38,12,10,2
21700131,203516,MEM,LAC,James Ennis III,132,30.1,30,0.100000000000001,75,64,11,9,2
21700131,1626185,MEM,LAC,Jarell Martin,53,12.3,12,0.300000000000001,22,27,-5,-1,-4
21700131,1628415,MEM,LAC,Dillon Brooks,138,29.5166666666667,29,0.516666666666666,60,59,1,-2,3
21700132,1713,SAC,DET,Vince Carter,77,17.7166666666667,18,-0.283333333333331,30,36,-6,-6,0
21700132,2216,SAC,DET,Zach Randolph,129,29.4166666666667,30,-0.583333333333336,66,77,-11,-11,0
21700132,201585,SAC,DET,Kosta Koufos,80,18.4,18,0.399999999999999,33,31,2,2,0
21700132,202066,SAC,DET,Garrett Temple,117,26.9833333333333,27,-0.0166666666666657,60,72,-12,-11,-1
21700132,203992,SAC,DET,Bogdan Bogdanovic,119,27.1,27,0.100000000000001,63,70,-7,-7,0
21700132,1626161,SAC,DET,Willie Cauley-Stein,83,19.1,19,0.100000000000001,46,55,-9,-9,0
21700132,1627741,SAC,DET,Buddy Hield,92,20.8333333333333,21,-0.166666666666664,39,36,3,2,1
21700132,1627746,SAC,DET,Skal Labissiere,28,6,6,0,11,10,1,1,0
21700132,1627781,SAC,DET,Malachi Richardson,42,9.83333333333333,10,-0.166666666666668,23,19,4,4,0
21700132,1628368,SAC,DET,De'Aaron Fox,117,26.9833333333333,27,-0.0166666666666657,60,72,-12,-11,-1
21700132,1628382,SAC,DET,Justin Jackson,69,15.8833333333333,16,-0.116666666666667,25,26,-1,-1,0
21700132,1628412,SAC,DET,Frank Mason,92,20.8333333333333,21,-0.166666666666664,39,36,3,2,1
21700132,201229,DET,SAC,Anthony Tolliver,85,19.4333333333333,19,0.43333333333333,40,39,1,0,1
21700132,202340,DET,SAC,Avery Bradley,146,32.7666666666667,33,-0.233333333333334,82,72,10,10,0
21700132,202397,DET,SAC,Ish Smith,88,19.4666666666667,20,-0.533333333333335,35,33,2,2,0
21700132,202699,DET,SAC,Tobias Harris,150,34.8,35,-0.200000000000003,81,73,8,9,-1
21700132,202704,DET,SAC,Reggie Jackson,121,28.35,28,0.350000000000001,73,66,7,7,0
21700132,203083,DET,SAC,Andre Drummond,161,35.9333333333333,36,-0.06666666666667,91,83,8,8,0
21700132,203493,DET,SAC,Reggie Bullock,82,19.4166666666667,20,-0.583333333333336,32,35,-3,-3,0
21700132,203961,DET,SAC,Eric Moreland,40,9.41666666666667,9,0.416666666666666,12,15,-3,-3,0
21700132,204038,DET,SAC,Langston Galloway,31,6.86666666666667,7,-0.133333333333333,12,15,-3,-3,0
21700132,1626169,DET,SAC,Stanley Johnson,96,22.7833333333333,23,-0.216666666666669,62,46,16,16,0
21700132,1628379,DET,SAC,Luke Kennard,45,9.85,10,-0.15,20,18,2,2,0
21700133,2749,NOP,CHI,Jameer Nelson,152,35.25,35,0.25,70,59,11,11,0
21700133,2754,NOP,CHI,Tony Allen,56,11.95,12,-0.0500000000000007,18,16,2,2,0
21700133,201950,NOP,CHI,Jrue Holiday,182,41.5,41,0.5,74,69,5,4,1
21700133,201967,NOP,CHI,Dante Cunningham,104,22.2166666666667,22,0.216666666666669,37,45,-8,-8,0
21700133,202326,NOP,CHI,DeMarcus Cousins,185,42.7833333333333,43,-0.216666666666669,78,75,3,5,-2
21700133,202734,NOP,CHI,E'Twaun Moore,118,29.8166666666667,30,-0.183333333333334,50,53,-3,-1,-2
21700133,203076,NOP,CHI,Anthony Davis,182,41.3833333333333,41,0.383333333333333,68,72,-4,-2,-2
21700133,203121,NOP,CHI,Darius Miller,132,27.9,28,-0.100000000000001,61,41,20,16,4
21700133,203546,NOP,CHI,Ian Clark,59,11.7,12,-0.300000000000001,24,20,4,3,1
21700133,201577,CHI,NOP,Robin Lopez,189,42.45,43,-0.549999999999997,83,76,7,9,-2
21700133,202347,CHI,NOP,Quincy Pondexter,13,3.38333333333333,4,-0.616666666666667,3,6,-3,-3,0
21700133,203200,CHI,NOP,Justin Holiday,193,43.2166666666667,43,0.216666666666669,83,76,7,9,-2
21700133,1626170,CHI,NOP,Jerian Grant,158,36.0666666666667,36,0.0666666666666629,72,70,2,4,-2
21700133,1626245,CHI,NOP,Cristiano Felicio,45,10.45,10,0.449999999999999,7,20,-13,-15,2
21700133,1627739,CHI,NOP,Kris Dunn,76,16.8333333333333,17,-0.166666666666664,18,26,-8,-10,2
21700133,1627756,CHI,NOP,Denzel Valentine,149,34.85,35,-0.149999999999999,56,68,-12,-14,2
21700133,1627835,CHI,NOP,Paul Zipser,77,17.8,18,-0.199999999999999,21,34,-13,-15,2
21700133,1628021,CHI,NOP,David Nwaba,95,19.8833333333333,20,-0.116666666666667,36,30,6,8,-2
21700133,1628374,CHI,NOP,Lauri Markkanen,175,39.5666666666667,40,-0.433333333333337,71,74,-3,-3,0
21700134,1717,DAL,MIN,Dirk Nowitzki,96,21.7333333333333,21,0.733333333333334,42,54,-12,-12,0
21700134,2734,DAL,MIN,Devin Harris,101,21,21,0,45,61,-16,-12,-4
21700134,200826,DAL,MIN,J.J. Barea,91,19.3333333333333,19,0.333333333333336,37,54,-17,-16,-1
21700134,202083,DAL,MIN,Wesley Matthews,114,25.9666666666667,26,-0.0333333333333314,45,64,-19,-20,1
21700134,203084,DAL,MIN,Harrison Barnes,133,29.4333333333333,30,-0.56666666666667,52,74,-22,-21,-1
21700134,203457,DAL,MIN,Nerlens Noel,70,14.5666666666667,14,0.566666666666666,26,37,-11,-11,0
21700134,203481,DAL,MIN,Jeff Withey,10,2.03333333333333,2,0.0333333333333332,7,4,3,3,0
21700134,203939,DAL,MIN,Dwight Powell,85,19.2333333333333,19,0.233333333333334,47,42,5,5,0
21700134,1626257,DAL,MIN,Salah Mejri,36,8.46666666666667,9,-0.533333333333333,9,17,-8,-10,2
21700134,1627812,DAL,MIN,Yogi Ferrell,94,20.9333333333333,21,-0.0666666666666664,53,42,11,8,3
21700134,1628372,DAL,MIN,Dennis Smith Jr.,110,25.2333333333333,26,-0.766666666666666,47,49,-2,-2,0
21700134,1628467,DAL,MIN,Maxi Kleber,104,22.1166666666667,22,0.116666666666667,61,43,18,18,0
21700134,1628492,DAL,MIN,Gian Clavell,46,9.86666666666667,10,-0.133333333333333,24,19,5,5,0
21700134,2037,MIN,DAL,Jamal Crawford,81,18.3833333333333,18,0.383333333333333,44,41,3,3,0
21700134,201166,MIN,DAL,Aaron Brooks,4,0.683333333333333,1,-0.316666666666667,,3,,-3,
21700134,201952,MIN,DAL,Jeff Teague,159,34.0833333333333,34,0.0833333333333357,80,63,17,16,1
21700134,201959,MIN,DAL,Taj Gibson,141,30.3333333333333,31,-0.666666666666668,69,61,8,10,-2
21700134,202332,MIN,DAL,Cole Aldrich,8,1.66666666666667,2,-0.333333333333334,4,5,-1,-1,0
21700134,202357,MIN,DAL,Nemanja Bjelica,67,15.2166666666667,15,0.216666666666667,37,33,4,2,2
21700134,202710,MIN,DAL,Jimmy Butler,153,33.8666666666667,34,-0.133333333333333,78,65,13,13,0
21700134,203476,MIN,DAL,Gorgui Dieng,65,14.2666666666667,14,0.266666666666666,35,31,4,4,0
21700134,203498,MIN,DAL,Shabazz Muhammad,42,10,10,0,23,23,0,0,0
21700134,203952,MIN,DAL,Andrew Wiggins,166,35.4666666666667,35,0.466666666666669,85,71,14,14,0
21700134,1626145,MIN,DAL,Tyus Jones,55,13.2166666666667,13,0.216666666666667,32,33,-1,0,-1
21700134,1626157,MIN,DAL,Karl-Anthony Towns,145,32.05,32,0.0499999999999972,73,63,10,10,0
21700134,1627875,MIN,DAL,Marcus Georges-Hunt,4,0.683333333333333,1,-0.316666666666667,,3,,-3,
21700135,2210,DEN,GSW,Richard Jefferson,27,5.78333333333333,6,-0.216666666666667,14,12,2,2,0
21700135,200794,DEN,GSW,Paul Millsap,78,15.9333333333333,16,-0.0666666666666664,26,54,-28,-28,0
21700135,201163,DEN,GSW,Wilson Chandler,97,20.0833333333333,20,0.0833333333333322,35,71,-36,-37,1
21700135,201589,DEN,GSW,Darrell Arthur,39,7.45,7,0.449999999999999,22,18,4,4,0
21700135,202702,DEN,GSW,Kenneth Faried,67,13.6666666666667,14,-0.333333333333334,37,26,11,12,-1
21700135,203115,DEN,GSW,Will Barton,168,33.75,34,-0.25,87,74,13,12,1
21700135,203486,DEN,GSW,Mason Plumlee,62,11.7666666666667,12,-0.233333333333334,27,34,-7,-8,1
21700135,203914,DEN,GSW,Gary Harris,95,19.8333333333333,20,-0.166666666666664,33,69,-36,-36,0
21700135,203999,DEN,GSW,Nikola Jokic,92,19.6666666666667,20,-0.333333333333336,38,55,-17,-16,-1
21700135,1626144,DEN,GSW,Emmanuel Mudiay,157,31.7,32,-0.300000000000001,82,72,10,9,1
21700135,1626168,DEN,GSW,Trey Lyles,75,14.8,15,-0.199999999999999,38,34,4,2,2
21700135,1627736,DEN,GSW,Malik Beasley,127,25.25,26,-0.75,69,52,17,14,3
21700135,1627750,DEN,GSW,Jamal Murray,91,18.4833333333333,19,-0.516666666666666,32,59,-27,-25,-2
21700135,2561,GSW,DEN,David West,39,8.41666666666667,9,-0.583333333333334,10,24,-14,-16,2
21700135,2585,GSW,DEN,Zaza Pachulia,71,14.2833333333333,14,0.283333333333335,51,24,27,27,0
21700135,2738,GSW,DEN,Andre Iguodala,98,20.0333333333333,20,0.0333333333333314,42,49,-7,-6,-1
21700135,201142,GSW,DEN,Kevin Durant,148,29.4166666666667,29,0.416666666666668,94,66,28,28,0
21700135,201156,GSW,DEN,Nick Young,92,18.2166666666667,18,0.216666666666669,42,41,1,1,0
21700135,201580,GSW,DEN,JaVale McGee,46,8.6,9,-0.4,24,18,6,10,-4
21700135,201939,GSW,DEN,Stephen Curry,151,29.6,30,-0.399999999999999,99,57,42,44,-2
21700135,201956,GSW,DEN,Omri Casspi,63,12.7666666666667,13,-0.233333333333334,24,33,-9,-9,0
21700135,202691,GSW,DEN,Klay Thompson,140,29,29,0,83,64,19,17,2
21700135,203110,GSW,DEN,Draymond Green,130,26.4166666666667,27,-0.583333333333336,80,50,30,31,-1
21700135,1626172,GSW,DEN,Kevon Looney,70,14.3666666666667,14,0.366666666666667,38,36,2,2,0
21700135,1627775,GSW,DEN,Patrick McCaw,87,18.45,19,-0.549999999999997,28,54,-26,-24,-2
21700135,1628395,GSW,DEN,Jordan Bell,40,8.6,9,-0.399999999999999,15,24,-9,-10,1
21700136,201158,ATL,CLE,Marco Belinelli,95,19.6,19,0.600000000000001,33,44,-11,-14,3
21700136,202337,ATL,CLE,Luke Babbitt,202,41.6833333333333,42,-0.316666666666663,94,90,4,5,-1
21700136,203145,ATL,CLE,Kent Bazemore,186,35.5166666666667,35,0.516666666666666,99,96,3,8,-5
21700136,203471,ATL,CLE,Dennis Schroder,157,30.7666666666667,31,-0.233333333333334,87,79,8,9,-1
21700136,203473,ATL,CLE,Dewayne Dedmon,113,22.2,23,-0.799999999999997,58,60,-2,-3,1
21700136,1627752,ATL,CLE,Taurean Prince,182,36.3333333333333,36,0.333333333333329,94,85,9,3,6
21700136,1627819,ATL,CLE,Isaiah Taylor,142,26.25,26,0.25,53,64,-11,-10,-1
21700136,1628381,ATL,CLE,John Collins,127,24.5333333333333,24,0.533333333333331,60,45,15,15,0
21700136,1628463,ATL,CLE,Tyler Cavanaugh,16,2.86666666666667,3,-0.133333333333333,7,12,-5,-3,-2
21700136,2544,CLE,ATL,LeBron James,209,40.7666666666667,41,-0.233333333333334,105,109,-4,-4,0
21700136,2548,CLE,ATL,Dwyane Wade,164,32.5333333333333,32,0.533333333333331,85,67,18,23,-5
21700136,2594,CLE,ATL,Kyle Korver,122,24.3833333333333,24,0.383333333333333,68,46,22,23,-1
21700136,2747,CLE,ATL,JR Smith,173,33.2666666666667,34,-0.733333333333334,82,94,-12,-13,1
21700136,101112,CLE,ATL,Channing Frye,62,10.2833333333333,10,0.283333333333333,34,29,5,5,0
21700136,201145,CLE,ATL,Jeff Green,124,25.9333333333333,26,-0.0666666666666664,69,51,18,16,2
21700136,201565,CLE,ATL,Derrick Rose,100,19.4833333333333,20,-0.516666666666666,32,56,-24,-27,3
21700136,201567,CLE,ATL,Kevin Love,91,18.3333333333333,18,0.333333333333336,34,47,-13,-15,2
21700136,203109,CLE,ATL,Jae Crowder,118,23.2333333333333,23,0.233333333333334,41,67,-26,-22,-4
21700136,1626224,CLE,ATL,Cedi Osman,47,9.81666666666667,10,-0.183333333333334,25,15,10,8,2
21700136,1627790,CLE,ATL,Ante Zizic,10,1.71666666666667,2,-0.283333333333333,0,4,-4,-4,0
21700137,101150,LAC,MIA,Lou Williams,141,29.75,30,-0.25,66,65,1,4,-3
21700137,201568,LAC,MIA,Danilo Gallinari,62,13.6166666666667,13,0.616666666666667,23,30,-7,-5,-2
21700137,201599,LAC,MIA,DeAndre Jordan,162,33.3166666666667,34,-0.683333333333337,63,68,-5,-3,-2
21700137,201933,LAC,MIA,Blake Griffin,180,36.9,37,-0.100000000000001,85,84,1,-1,2
21700137,201976,LAC,MIA,Patrick Beverley,145,30.3666666666667,31,-0.633333333333333,60,59,1,2,-1
21700137,202325,LAC,MIA,Wesley Johnson,161,33.1,33,0.100000000000001,77,74,3,1,2
21700137,203085,LAC,MIA,Austin Rivers,150,31.6666666666667,32,-0.333333333333332,61,70,-9,-9,0
21700137,203186,LAC,MIA,Willie Reed,67,13.8666666666667,14,-0.133333333333333,35,36,-1,-3,2
21700137,1626155,LAC,MIA,Sam Dekker,25,5.33333333333333,5,0.333333333333334,13,8,5,3,2
21700137,1628414,LAC,MIA,Sindarius Thornwell,62,12.0833333333333,12,0.0833333333333322,22,26,-4,-4,0
21700137,201609,MIA,LAC,Goran Dragic,154,32.15,32,0.149999999999999,65,72,-7,-9,2
21700137,201949,MIA,LAC,James Johnson,140,28.85,29,-0.149999999999999,64,63,1,-1,2
21700137,201961,MIA,LAC,Wayne Ellington,128,27.1333333333333,27,0.133333333333333,58,61,-3,-3,0
21700137,202355,MIA,LAC,Hassan Whiteside,153,31.25,31,0.25,68,58,10,8,2
21700137,203482,MIA,LAC,Kelly Olynyk,72,15.6333333333333,16,-0.366666666666667,33,35,-2,0,-2
21700137,204020,MIA,LAC,Tyler Johnson,164,33.85,33,0.850000000000001,70,73,-3,1,-4
21700137,1626159,MIA,LAC,Justise Winslow,81,16.9166666666667,17,-0.0833333333333322,35,31,4,2,2
21700137,1626196,MIA,LAC,Josh Richardson,173,35.5333333333333,35,0.533333333333331,84,69,15,15,0
21700137,1627855,MIA,LAC,Okaro White,84,17.5666666666667,18,-0.433333333333334,40,35,5,7,-2
21700137,1628389,MIA,LAC,Bam Adebayo,6,1.11666666666667,1,0.116666666666667,3,8,-5,-5,0
21700138,201143,BOS,ORL,Al Horford,130,28.6833333333333,29,-0.316666666666666,66,58,8,9,-1
21700138,202681,BOS,ORL,Kyrie Irving,131,27.55,28,-0.450000000000003,65,58,7,8,-1
21700138,202694,BOS,ORL,Marcus Morris,111,22.95,23,-0.0500000000000007,47,45,2,2,0
21700138,203382,BOS,ORL,Aron Baynes,79,15.8333333333333,16,-0.166666666666668,29,19,10,10,0
21700138,203499,BOS,ORL,Shane Larkin,47,9.91666666666667,10,-0.0833333333333339,21,19,2,1,1
21700138,203935,BOS,ORL,Marcus Smart,135,28.4333333333333,29,-0.566666666666666,72,42,30,32,-2
21700138,1626179,BOS,ORL,Terry Rozier,125,26.75,27,-0.25,51,31,20,22,-2
21700138,1627759,BOS,ORL,Jaylen Brown,135,28.2333333333333,28,0.233333333333334,62,59,3,1,2
21700138,1627824,BOS,ORL,Guerschon Yabusele,12,2.33333333333333,2,0.333333333333333,4,8,-4,-6,2
21700138,1627846,BOS,ORL,Abdel Nader,12,2.33333333333333,2,0.333333333333333,4,8,-4,-6,2
21700138,1628369,BOS,ORL,Jayson Tatum,134,26.85,27,-0.149999999999999,54,52,2,6,-4
21700138,1628400,BOS,ORL,Semi Ojeleye,78,17.05,17,0.0500000000000007,38,30,8,6,2
21700138,1628464,BOS,ORL,Daniel Theis,16,3,3,0,7,11,-4,-5,1
21700138,201167,ORL,BOS,Arron Afflalo,16,3,3,0,11,7,4,5,-1
21700138,201578,ORL,BOS,Marreese Speights,16,3,3,0,11,7,4,5,-1
21700138,202687,ORL,BOS,Bismack Biyombo,63,12.6,13,-0.399999999999999,13,29,-16,-16,0
21700138,202696,ORL,BOS,Nikola Vucevic,150,32.3833333333333,32,0.383333333333333,64,68,-4,-5,1
21700138,202714,ORL,BOS,Shelvin Mack,119,24.1666666666667,24,0.166666666666664,34,53,-19,-19,0
21700138,203082,ORL,BOS,Terrence Ross,142,29.1166666666667,29,0.116666666666667,56,66,-10,-11,1
21700138,203095,ORL,BOS,Evan Fournier,168,35.6,36,-0.399999999999999,67,81,-14,-15,1
21700138,203613,ORL,BOS,Jonathon Simmons,94,20.8166666666667,21,-0.183333333333334,43,44,-1,-2,1
21700138,203932,ORL,BOS,Aaron Gordon,157,34.0666666666667,34,0.0666666666666629,67,65,2,2,0
21700138,1626209,ORL,BOS,Mario Hezonja,67,13.0166666666667,13,0.0166666666666657,21,32,-11,-10,-1
21700138,1628371,ORL,BOS,Jonathan Isaac,137,29.15,29,0.149999999999999,42,61,-19,-19,0
21700138,1628411,ORL,BOS,Wes Iwundu,16,3,3,0,11,7,4,5,-1
21700139,101139,TOR,WAS,CJ Miles,68,13.85,13,0.85,29,27,2,0,2
21700139,200768,TOR,WAS,Kyle Lowry,56,11.4166666666667,12,-0.583333333333334,16,31,-15,-16,1
21700139,201586,TOR,WAS,Serge Ibaka,129,28.5333333333333,29,-0.466666666666669,59,71,-12,-12,0
21700139,201942,TOR,WAS,DeMar DeRozan,169,37.0166666666667,37,0.0166666666666657,75,92,-17,-17,0
21700139,202685,TOR,WAS,Jonas Valanciunas,82,18.45,19,-0.550000000000001,35,51,-16,-16,0
21700139,203512,TOR,WAS,Lucas Nogueira,64,13.9,14,-0.100000000000001,26,20,6,9,-3
21700139,1626153,TOR,WAS,Delon Wright,126,26.1666666666667,27,-0.833333333333336,53,59,-6,-5,-1
21700139,1626181,TOR,WAS,Norman Powell,156,33.8666666666667,34,-0.13333333333334,70,82,-12,-12,0
21700139,1627751,TOR,WAS,Jakob Poeltl,34,5.93333333333333,6,-0.0666666666666664,11,14,-3,-3,0
21700139,1627783,TOR,WAS,Pascal Siakam,78,16.45,16,0.449999999999999,31,31,0,-1,1
21700139,1627832,TOR,WAS,Fred VanVleet,84,19.6,20,-0.399999999999999,47,33,14,14,0
21700139,1628384,TOR,WAS,OG Anunoby,64,14.0666666666667,14,0.0666666666666664,28,24,4,4,0
21700139,101133,WAS,TOR,Ian Mahinmi,49,9.8,10,-0.199999999999999,15,19,-4,-4,0
21700139,101162,WAS,TOR,Marcin Gortat,162,36.0333333333333,36,0.0333333333333314,87,75,12,16,-4
21700139,201975,WAS,TOR,Jodie Meeks,42,8.33333333333333,8,0.333333333333332,14,17,-3,-3,0
21700139,202693,WAS,TOR,Markieff Morris,78,17.4333333333333,18,-0.566666666666666,42,32,10,5,5
21700139,203078,WAS,TOR,Bradley Beal,180,39.5166666666667,40,-0.483333333333334,93,79,14,14,0
21700139,203107,WAS,TOR,Tomas Satoransky,103,23.0333333333333,22,1.03333333333333,48,49,-1,0,-1
21700139,203118,WAS,TOR,Mike Scott,88,17.0833333333333,17,0.0833333333333322,31,32,-1,0,-1
21700139,203490,WAS,TOR,Otto Porter Jr.,150,33,33,0,85,68,17,17,0
21700139,204025,WAS,TOR,Tim Frazier,141,30.7166666666667,31,-0.283333333333331,75,65,10,10,0
21700139,1626162,WAS,TOR,Kelly Oubre Jr.,117,24.3,24,0.299999999999997,45,44,1,0,1
21700140,2403,HOU,UTA,Nene,92,18.65,19,-0.350000000000001,60,38,22,20,2
21700140,2772,HOU,UTA,Trevor Ariza,164,33.4833333333333,34,-0.516666666666666,115,87,28,30,-2
21700140,200782,HOU,UTA,PJ Tucker,150,29.7166666666667,30,-0.283333333333331,88,68,20,20,0
21700140,201569,HOU,UTA,Eric Gordon,167,33.9,34,-0.100000000000001,86,68,18,14,4
21700140,201583,HOU,UTA,Ryan Anderson,152,31.8666666666667,32,-0.133333333333333,69,67,2,2,0
21700140,201601,HOU,UTA,Luc Mbah a Moute,70,14.5666666666667,14,0.566666666666666,46,37,9,11,-2
21700140,201628,HOU,UTA,Bobby Brown,23,4.58333333333333,5,-0.416666666666667,14,12,2,4,-2
21700140,201935,HOU,UTA,James Harden,167,35.1166666666667,35,0.116666666666667,108,83,25,25,0
21700140,203991,HOU,UTA,Clint Capela,104,22.3666666666667,22,0.366666666666667,54,53,1,1,0
21700140,204028,HOU,UTA,Tarik Black,35,6.68333333333333,7,-0.316666666666666,20,17,3,3,0
21700140,1627743,HOU,UTA,Demetrius Jackson,18,3.65,4,-0.35,11,8,3,1,2
21700140,1627753,HOU,UTA,Zhou Qi,23,4.58333333333333,5,-0.416666666666667,14,12,2,4,-2
21700140,200757,UTA,HOU,Thabo Sefolosha,82,17.05,17,0.0500000000000007,46,70,-24,-26,2
21700140,201937,UTA,HOU,Ricky Rubio,118,23.6833333333333,24,-0.316666666666666,51,74,-23,-23,0
21700140,201973,UTA,HOU,Jonas Jerebko,40,7.75,8,-0.25,20,20,0,0,0
21700140,202324,UTA,HOU,Derrick Favors,121,24.9166666666667,26,-1.08333333333334,53,57,-4,-2,-2
21700140,202327,UTA,HOU,Ekpe Udoh,86,17.4333333333333,17,0.433333333333334,36,42,-6,-6,0
21700140,202692,UTA,HOU,Alec Burks,125,24.1833333333333,24,0.183333333333334,55,88,-33,-34,1
21700140,203497,UTA,HOU,Rudy Gobert,118,24.7833333333333,25,-0.216666666666669,60,78,-18,-16,-2
21700140,203526,UTA,HOU,Raul Neto,54,10.6666666666667,11,-0.333333333333332,25,20,5,5,0
21700140,203918,UTA,HOU,Rodney Hood,122,25.8166666666667,26,-0.183333333333334,55,64,-9,-9,0
21700140,204060,UTA,HOU,Joe Ingles,93,20.3666666666667,21,-0.633333333333333,46,54,-8,-8,0
21700140,1626220,UTA,HOU,Royce O'Neale,58,11.8333333333333,12,-0.166666666666668,25,22,3,3,0
21700140,1628378,UTA,HOU,Donovan Mitchell,119,25.0666666666667,25,0.0666666666666664,64,79,-15,-14,-1
21700140,1628396,UTA,HOU,Tony Bradley,29,5.61666666666667,6,-0.383333333333333,14,17,-3,-5,2
21700141,2199,PHX,SAS,Tyson Chandler,126,28.3666666666667,29,-0.633333333333333,50,73,-23,-21,-2
21700141,201162,PHX,SAS,Jared Dudley,27,5.66666666666667,6,-0.333333333333333,16,6,10,10,0
21700141,203458,PHX,SAS,Alex Len,83,17.9166666666667,18,-0.0833333333333357,43,35,8,6,2
21700141,203584,PHX,SAS,Troy Daniels,69,15.7666666666667,16,-0.233333333333334,36,36,0,0,0
21700141,203933,PHX,SAS,T.J. Warren,131,29.2166666666667,29,0.216666666666669,49,74,-25,-22,-3
21700141,1626164,PHX,SAS,Devin Booker,121,26.25,26,0.25,43,70,-27,-27,0
21700141,1627733,PHX,SAS,Dragan Bender,91,20.3666666666667,20,0.366666666666667,36,53,-17,-19,2
21700141,1627737,PHX,SAS,Marquese Chriss,85,18.8833333333333,19,-0.116666666666667,36,42,-6,-3,-3
21700141,1627755,PHX,SAS,Tyler Ulis,124,27.4666666666667,28,-0.533333333333331,56,59,-3,-3,0
21700141,1627884,PHX,SAS,Derrick Jones Jr.,27,5.66666666666667,6,-0.333333333333333,16,6,10,10,0
21700141,1628367,PHX,SAS,Josh Jackson,108,22.6333333333333,23,-0.366666666666667,55,53,2,-2,4
21700141,1628455,PHX,SAS,Mike James,93,20.2166666666667,20,0.216666666666669,39,53,-14,-14,0
21700141,2200,SAS,PHX,Pau Gasol,118,25.8666666666667,26,-0.133333333333333,66,48,18,15,3
21700141,200746,SAS,PHX,LaMarcus Aldridge,129,29.75,30,-0.25,74,52,22,24,-2
21700141,200752,SAS,PHX,Rudy Gay,103,23.1166666666667,23,0.116666666666667,62,42,20,22,-2
21700141,201980,SAS,PHX,Danny Green,101,22.9666666666667,23,-0.0333333333333314,53,47,6,8,-2
21700141,201988,SAS,PHX,Patty Mills,115,25.9833333333333,26,-0.0166666666666657,67,49,18,19,-1
21700141,202722,SAS,PHX,Davis Bertans,32,6.31666666666667,7,-0.683333333333334,10,16,-6,-8,2
21700141,203464,SAS,PHX,Brandon Paul,126,27.1166666666667,27,0.116666666666667,64,60,4,6,-2
21700141,203937,SAS,PHX,Kyle Anderson,99,21.1166666666667,21,0.116666666666667,49,39,10,8,2
21700141,1626199,SAS,PHX,Darrun Hilliard,35,7.73333333333333,8,-0.266666666666667,9,22,-13,-12,-1
21700141,1627749,SAS,PHX,Dejounte Murray,102,21.7,22,-0.300000000000001,45,46,-1,-2,1
21700141,1627854,SAS,PHX,Bryn Forbes,125,26.75,27,-0.25,61,54,7,5,2
21700142,101127,NYK,IND,Jarrett Jack,115,24.3,24,0.299999999999997,49,53,-4,-5,1
21700142,201563,NYK,IND,Michael Beasley,29,6.71666666666667,7,-0.283333333333333,10,20,-10,-10,0
21700142,201584,NYK,IND,Courtney Lee,132,27.8,28,-0.200000000000003,57,66,-9,-9,0
21700142,202498,NYK,IND,Lance Thomas,69,16.8333333333333,17,-0.166666666666664,47,26,21,23,-2
21700142,202683,NYK,IND,Enes Kanter,142,31.3333333333333,31,0.333333333333332,77,54,23,20,3
21700142,203124,NYK,IND,Kyle O'Quinn,72,16.5666666666667,17,-0.433333333333334,31,47,-16,-15,-1
21700142,203501,NYK,IND,Tim Hardaway Jr.,159,35.7333333333333,36,-0.266666666666666,74,73,1,-1,2
21700142,203926,NYK,IND,Doug McDermott,84,18.8,19,-0.199999999999999,44,44,0,0,0
21700142,204001,NYK,IND,Kristaps Porzingis,173,38.0166666666667,38,0.0166666666666657,92,74,18,20,-2
21700142,1628373,NYK,IND,Frank Ntilikina,100,23.65,24,-0.350000000000001,59,48,11,12,-1
21700142,201152,IND,NYK,Thaddeus Young,162,35.8,36,-0.200000000000003,71,85,-14,-14,0
21700142,201954,IND,NYK,Darren Collison,172,38.2166666666667,38,0.216666666666669,82,82,0,0,0
21700142,202362,IND,NYK,Lance Stephenson,91,19.35,19,0.350000000000001,48,47,1,1,0
21700142,202709,IND,NYK,Cory Joseph,88,19.5666666666667,20,-0.433333333333334,41,46,-5,-5,0
21700142,202711,IND,NYK,Bojan Bogdanovic,124,28.6,29,-0.399999999999999,53,61,-8,-8,0
21700142,203506,IND,NYK,Victor Oladipo,170,38.1166666666667,38,0.11666666666666,79,88,-9,-9,0
21700142,1626167,IND,NYK,Myles Turner,108,23.2666666666667,24,-0.733333333333334,44,58,-14,-14,0
21700142,1627734,IND,NYK,Domantas Sabonis,131,30.1166666666667,29,1.11666666666667,67,63,4,4,0
21700142,1627816,IND,NYK,Alex Poythress,29,6.71666666666667,7,-0.283333333333333,20,10,10,10,0
21700143,2037,MIN,CHA,Jamal Crawford,101,19.8333333333333,20,-0.166666666666668,40,39,1,3,-2
21700143,201166,MIN,CHA,Aaron Brooks,4,0.566666666666667,1,-0.433333333333333,2,2,0,0,0
21700143,201952,MIN,CHA,Jeff Teague,155,33.9833333333333,34,-0.0166666666666657,85,67,18,17,1
21700143,201959,MIN,CHA,Taj Gibson,132,29.1,29,0.100000000000001,72,58,14,15,-1
21700143,202332,MIN,CHA,Cole Aldrich,4,0.566666666666667,1,-0.433333333333333,2,2,0,0,0
21700143,202357,MIN,CHA,Nemanja Bjelica,96,18.75,19,-0.25,40,36,4,3,1
21700143,202710,MIN,CHA,Jimmy Butler,138,30.35,30,0.350000000000001,74,62,12,12,0
21700143,203476,MIN,CHA,Gorgui Dieng,96,18.7166666666667,19,-0.283333333333331,40,33,7,8,-1
21700143,203498,MIN,CHA,Shabazz Muhammad,47,9.45,10,-0.550000000000001,20,14,6,6,0
21700143,203952,MIN,CHA,Andrew Wiggins,166,35.5,35,0.5,88,71,17,15,2
21700143,1626145,MIN,CHA,Tyus Jones,69,13.3,13,0.300000000000001,25,25,0,1,-1
21700143,1626157,MIN,CHA,Karl-Anthony Towns,128,28.5666666666667,29,-0.433333333333334,70,59,11,10,1
21700143,1627875,MIN,CHA,Marcus Georges-Hunt,4,0.566666666666667,1,-0.433333333333333,2,2,0,0,0
21700143,2730,CHA,MIN,Dwight Howard,128,28.1666666666667,28,0.166666666666664,56,71,-15,-13,-2
21700143,101107,CHA,MIN,Marvin Williams,97,21.4666666666667,21,0.466666666666669,44,56,-12,-10,-2
21700143,202689,CHA,MIN,Kemba Walker,141,31.0666666666667,31,0.0666666666666664,61,81,-20,-18,-2
21700143,203087,CHA,MIN,Jeremy Lamb,128,28.5333333333333,29,-0.466666666666669,64,61,3,2,1
21700143,203469,CHA,MIN,Cody Zeller,114,22.0166666666667,22,0.0166666666666657,44,42,2,0,2
21700143,203487,CHA,MIN,Michael Carter-Williams,48,8.21666666666667,8,0.216666666666667,15,17,-2,-3,1
21700143,203948,CHA,MIN,Johnny O'Bryant III,26,4.53333333333333,5,-0.466666666666667,7,3,4,4,0
21700143,1626163,CHA,MIN,Frank Kaminsky,124,25.5333333333333,26,-0.466666666666669,47,78,-31,-31,0
21700143,1626203,CHA,MIN,Treveon Graham,114,23.2166666666667,24,-0.783333333333335,40,52,-12,-15,3
21700143,1628370,CHA,MIN,Malik Monk,102,19.9666666666667,20,-0.033333333333335,40,39,1,0,1
21700143,1628407,CHA,MIN,Dwayne Bacon,118,26.5333333333333,26,0.533333333333331,52,60,-8,-6,-2
21700144,202323,POR,OKC,Evan Turner,142,30.6833333333333,31,-0.316666666666663,55,68,-13,-15,2
21700144,202334,POR,OKC,Ed Davis,66,14.95,15,-0.0500000000000007,19,32,-13,-15,2
21700144,203081,POR,OKC,Damian Lillard,180,37.55,37,0.549999999999997,90,77,13,14,-1
21700144,203090,POR,OKC,Maurice Harkless,145,30.0666666666667,30,0.0666666666666664,76,67,9,10,-1
21700144,203468,POR,OKC,CJ McCollum,164,35.6333333333333,36,-0.366666666666667,81,77,4,8,-4
21700144,203943,POR,OKC,Noah Vonleh,112,23.5833333333333,24,-0.416666666666668,58,39,19,22,-3
21700144,203994,POR,OKC,Jusuf Nurkic,152,32.7166666666667,33,-0.283333333333331,78,62,16,21,-5
21700144,1626192,POR,OKC,Pat Connaughton,100,20.4833333333333,21,-0.516666666666666,34,43,-9,-12,3
21700144,1628403,POR,OKC,Caleb Swanigan,59,14.25,14,0.25,19,30,-11,-13,2
21700144,2546,OKC,POR,Carmelo Anthony,105,22.9,23,-0.100000000000001,43,51,-8,-9,1
21700144,101109,OKC,POR,Raymond Felton,110,23.95,24,-0.0499999999999972,58,44,14,16,-2
21700144,201566,OKC,POR,Russell Westbrook,173,35.7166666666667,36,-0.283333333333331,74,86,-12,-15,3
21700144,202331,OKC,POR,Paul George,192,39.6833333333333,40,-0.316666666666663,85,95,-10,-11,1
21700144,202335,OKC,POR,Patrick Patterson,79,18.3666666666667,18,0.366666666666667,31,25,6,6,0
21700144,203460,OKC,POR,Andre Roberson,115,25.4166666666667,26,-0.583333333333336,43,58,-15,-16,1
21700144,203500,OKC,POR,Steven Adams,145,31.1833333333333,31,0.18333333333333,64,75,-11,-12,1
21700144,203518,OKC,POR,Alex Abrines,68,14.45,15,-0.550000000000001,34,23,11,11,0
21700144,203924,OKC,POR,Jerami Grant,133,28.25,28,0.25,63,53,10,10,0
21700145,201147,LAL,MEM,Corey Brewer,65,13.45,13,0.449999999999999,26,32,-6,-7,1
21700145,201572,LAL,MEM,Brook Lopez,137,30.5666666666667,31,-0.433333333333334,71,63,8,11,-3
21700145,203484,LAL,MEM,Kentavious Caldwell-Pope,160,34.9333333333333,35,-0.0666666666666629,81,72,9,10,-1
21700145,203903,LAL,MEM,Jordan Clarkson,94,20.65,20,0.649999999999999,43,42,1,3,-2
21700145,203944,LAL,MEM,Julius Randle,86,17.4166666666667,17,0.416666666666668,36,39,-3,-6,3
21700145,1627742,LAL,MEM,Brandon Ingram,178,38.2833333333333,38,0.283333333333331,85,79,6,6,0
21700145,1628366,LAL,MEM,Lonzo Ball,161,34.9833333333333,35,-0.0166666666666657,79,70,9,10,-1
21700145,1628398,LAL,MEM,Kyle Kuzma,175,37.45,38,-0.549999999999997,89,83,6,4,2
21700145,1628404,LAL,MEM,Josh Hart,59,12.1833333333333,12,0.183333333333334,25,30,-5,-6,1
21700145,201144,MEM,LAL,Mike Conley,143,31.3666666666667,32,-0.633333333333333,64,69,-5,-6,1
21700145,201148,MEM,LAL,Brandan Wright,82,16.7833333333333,17,-0.216666666666669,38,33,5,7,-2
21700145,201188,MEM,LAL,Marc Gasol,161,35.5833333333333,36,-0.416666666666664,72,82,-10,-11,1
21700145,201596,MEM,LAL,Mario Chalmers,111,24.2,24,0.199999999999999,51,49,2,2,0
21700145,201936,MEM,LAL,Tyreke Evans,159,32.5333333333333,32,0.533333333333331,73,76,-3,-4,1
21700145,203516,MEM,LAL,James Ennis III,188,41.05,41,0.0499999999999972,83,94,-11,-11,0
21700145,1626150,MEM,LAL,Andrew Harrison,38,9.05,9,0.0500000000000007,13,24,-11,-11,0
21700145,1626185,MEM,LAL,Jarell Martin,107,23.4666666666667,23,0.466666666666669,49,61,-12,-10,-2
21700145,1628415,MEM,LAL,Dillon Brooks,126,25.8833333333333,26,-0.116666666666667,67,47,20,19,1
21700146,201158,ATL,BOS,Marco Belinelli,114,25.9666666666667,26,-0.0333333333333314,66,65,1,3,-2
21700146,202337,ATL,BOS,Luke Babbitt,106,23.6833333333333,25,-1.31666666666667,42,54,-12,-6,-6
21700146,203145,ATL,BOS,Kent Bazemore,119,26.1833333333333,26,0.183333333333334,57,58,-1,-5,4
21700146,203471,ATL,BOS,Dennis Schroder,157,35.6833333333333,36,-0.316666666666663,81,74,7,7,0
21700146,203473,ATL,BOS,Dewayne Dedmon,161,35.2,36,-0.799999999999997,83,80,3,4,-1
21700146,1627098,ATL,BOS,Malcolm Delaney,129,27.85,28,-0.149999999999999,63,66,-3,-3,0
21700146,1627752,ATL,BOS,Taurean Prince,124,28.25,28,0.25,62,66,-4,-6,2
21700146,1627819,ATL,BOS,Isaiah Taylor,93,20.5166666666667,20,0.516666666666666,49,48,1,-1,2
21700146,1628381,ATL,BOS,John Collins,70,16.1,16,0.100000000000001,32,37,-5,-6,1
21700146,1628463,ATL,BOS,Tyler Cavanaugh,2,0.483333333333333,0,0.483333333333333,0,2,-2,-2,0
21700146,201143,BOS,ATL,Al Horford,145,33.0666666666667,33,0.0666666666666629,79,69,10,10,0
21700146,202681,BOS,ATL,Kyrie Irving,160,37.15,37,0.150000000000006,84,83,1,5,-4
21700146,203382,BOS,ATL,Aron Baynes,66,14.5,15,-0.5,27,33,-6,-6,0
21700146,203499,BOS,ATL,Shane Larkin,26,6.23333333333333,7,-0.766666666666667,13,14,-1,-1,0
21700146,203935,BOS,ATL,Marcus Smart,134,29.1166666666667,29,0.116666666666667,76,64,12,12,0
21700146,1626179,BOS,ATL,Terry Rozier,103,21.7333333333333,21,0.733333333333334,50,56,-6,-12,6
21700146,1627759,BOS,ATL,Jaylen Brown,130,30.3,31,-0.699999999999999,65,69,-4,-2,-2
21700146,1627846,BOS,ATL,Abdel Nader,31,5.23333333333333,5,0.233333333333333,13,13,0,0,0
21700146,1628369,BOS,ATL,Jayson Tatum,139,32.1833333333333,32,0.183333333333337,73,60,13,15,-2
21700146,1628400,BOS,ATL,Semi Ojeleye,74,16.1333333333333,16,0.133333333333333,36,38,-2,-4,2
21700146,1628464,BOS,ATL,Daniel Theis,67,14.2666666666667,14,0.266666666666666,34,36,-2,-2,0
21700147,201960,BKN,PHX,DeMarre Carroll,172,33.45,33,0.450000000000003,61,73,-12,-12,0
21700147,202389,BKN,PHX,Timofey Mozgov,81,16.5333333333333,16,0.533333333333331,27,35,-8,-9,1
21700147,203092,BKN,PHX,Tyler Zeller,89,17.3166666666667,17,0.316666666666666,47,32,15,15,0
21700147,203112,BKN,PHX,Quincy Acy,107,20.95,21,-0.0499999999999972,43,41,2,3,-1
21700147,203459,BKN,PHX,Allen Crabbe,110,22.45,23,-0.549999999999997,54,44,10,10,0
21700147,203915,BKN,PHX,Spencer Dinwiddie,131,26.45,27,-0.550000000000001,52,45,7,8,-1
21700147,203925,BKN,PHX,Joe Harris,129,25.1833333333333,25,0.183333333333334,50,45,5,5,0
21700147,203930,BKN,PHX,Sean Kilpatrick,43,7.56666666666667,8,-0.433333333333334,17,15,2,2,0
21700147,1626156,BKN,PHX,D'Angelo Russell,154,30.1833333333333,30,0.183333333333334,60,58,2,0,2
21700147,1626178,BKN,PHX,Rondae Hollis-Jefferson,86,16.5333333333333,17,-0.466666666666669,34,29,5,5,0
21700147,1627747,BKN,PHX,Caris LeVert,113,22.8,23,-0.200000000000003,45,43,2,3,-1
21700147,2199,PHX,BKN,Tyson Chandler,117,23.1166666666667,23,0.116666666666667,46,47,-1,1,-2
21700147,201162,PHX,BKN,Jared Dudley,103,20.5166666666667,21,-0.483333333333334,46,37,9,7,2
21700147,203458,PHX,BKN,Alex Len,126,24.7666666666667,25,-0.233333333333334,46,51,-5,-7,2
21700147,203584,PHX,BKN,Troy Daniels,55,11.1833333333333,11,0.183333333333334,19,28,-9,-9,0
21700147,203933,PHX,BKN,T.J. Warren,186,36.1166666666667,36,0.116666666666667,73,70,3,1,2
21700147,1626164,PHX,BKN,Devin Booker,176,34.4833333333333,35,-0.516666666666666,67,63,4,3,1
21700147,1627733,PHX,BKN,Dragan Bender,52,10.2166666666667,10,0.216666666666665,13,28,-15,-15,0
21700147,1627737,PHX,BKN,Marquese Chriss,79,15.2,15,0.199999999999999,33,28,5,5,0
21700147,1627755,PHX,BKN,Tyler Ulis,126,24.6666666666667,25,-0.333333333333336,54,50,4,5,-1
21700147,1628367,PHX,BKN,Josh Jackson,64,13.3166666666667,13,0.316666666666666,19,33,-14,-10,-4
21700147,1628455,PHX,BKN,Mike James,131,25.8333333333333,26,-0.166666666666664,44,55,-11,-11,0
21700148,2585,GSW,MIA,Zaza Pachulia,56,10.8166666666667,11,-0.183333333333334,20,16,4,4,0
21700148,2733,GSW,MIA,Shaun Livingston,77,14.6666666666667,15,-0.333333333333332,30,26,4,3,1
21700148,2738,GSW,MIA,Andre Iguodala,128,27.1833333333333,27,0.183333333333334,56,44,12,13,-1
21700148,201142,GSW,MIA,Kevin Durant,162,32.7166666666667,33,-0.283333333333331,71,51,20,23,-3
21700148,201156,GSW,MIA,Nick Young,15,3.91666666666667,4,-0.0833333333333339,9,10,-1,0,-1
21700148,201580,GSW,MIA,JaVale McGee,19,3.2,3,0.2,4,14,-10,-10,0
21700148,201939,GSW,MIA,Stephen Curry,178,33.8666666666667,34,-0.133333333333333,76,52,24,25,-1
21700148,201956,GSW,MIA,Omri Casspi,46,9.9,10,-0.100000000000001,20,16,4,4,0
21700148,202691,GSW,MIA,Klay Thompson,152,32.2333333333333,32,0.233333333333334,60,52,8,10,-2
21700148,203110,GSW,MIA,Draymond Green,130,27.3,27,0.300000000000001,52,43,9,9,0
21700148,1626172,GSW,MIA,Kevon Looney,75,16.6333333333333,17,-0.366666666666667,30,27,3,0,3
21700148,1627775,GSW,MIA,Patrick McCaw,62,14.1,14,0.100000000000001,25,28,-3,-3,0
21700148,1628395,GSW,MIA,Jordan Bell,60,11.3833333333333,12,-0.616666666666667,27,21,6,7,-1
21700148,201609,MIA,GSW,Goran Dragic,153,30.7166666666667,31,-0.283333333333335,55,61,-6,-11,5
21700148,201949,MIA,GSW,James Johnson,153,32.6,32,0.600000000000001,59,53,6,3,3
21700148,201961,MIA,GSW,Wayne Ellington,127,27.7,28,-0.300000000000001,46,57,-11,-7,-4
21700148,202355,MIA,GSW,Hassan Whiteside,89,16.15,16,0.149999999999999,24,37,-13,-15,2
21700148,203482,MIA,GSW,Kelly Olynyk,80,18.6,18,0.600000000000001,32,33,-1,1,-2
21700148,204020,MIA,GSW,Tyler Johnson,144,28.6,29,-0.399999999999999,42,58,-16,-15,-1
21700148,1626159,MIA,GSW,Justise Winslow,149,29.3833333333333,30,-0.616666666666667,53,64,-11,-12,1
21700148,1626196,MIA,GSW,Josh Richardson,157,32.15,32,0.150000000000006,47,66,-19,-18,-1
21700148,1627855,MIA,GSW,Okaro White,41,8.05,8,0.0499999999999989,12,22,-10,-11,1
21700148,1628389,MIA,GSW,Bam Adebayo,63,12.8333333333333,13,-0.166666666666668,24,26,-2,-3,1
21700148,1628476,MIA,GSW,Derrick Walton Jr.,4,1.13333333333333,1,0.133333333333333,6,3,3,3,0
21700149,2544,CLE,MIL,LeBron James,176,36.6,37,-0.399999999999999,97,92,5,6,-1
21700149,2548,CLE,MIL,Dwyane Wade,127,27,27,0,74,68,6,2,4
21700149,2594,CLE,MIL,Kyle Korver,82,18.1666666666667,18,0.166666666666664,43,41,2,3,-1
21700149,2747,CLE,MIL,JR Smith,168,36.4333333333333,37,-0.566666666666663,96,91,5,5,0
21700149,201145,CLE,MIL,Jeff Green,75,16.7333333333333,17,-0.266666666666666,41,38,3,2,1
21700149,201565,CLE,MIL,Derrick Rose,119,25.5,25,0.5,62,65,-3,0,-3
21700149,201567,CLE,MIL,Kevin Love,163,34.6666666666667,35,-0.333333333333336,89,88,1,2,-1
21700149,202697,CLE,MIL,Iman Shumpert,87,19.4166666666667,19,0.416666666666668,49,48,1,0,1
21700149,203109,CLE,MIL,Jae Crowder,123,24.9833333333333,25,-0.0166666666666657,69,64,5,5,0
21700149,1891,MIL,CLE,Jason Terry,36,7.23333333333333,7,0.233333333333333,16,24,-8,-8,0
21700149,202732,MIL,CLE,DeAndre Liggins,39,8.2,8,0.199999999999999,21,16,5,5,0
21700149,203089,MIL,CLE,John Henson,79,16.9666666666667,18,-1.03333333333333,40,41,-1,-5,4
21700149,203114,MIL,CLE,Khris Middleton,192,40.85,41,-0.149999999999999,103,103,0,0,0
21700149,203141,MIL,CLE,Mirza Teletovic,77,16.55,17,-0.449999999999999,42,43,-1,0,-1
21700149,203503,MIL,CLE,Tony Snell,185,40.4833333333333,40,0.483333333333334,105,107,-2,-2,0
21700149,203507,MIL,CLE,Giannis Antetokounmpo,188,40.15,40,0.150000000000006,97,104,-7,-7,0
21700149,203521,MIL,CLE,Matthew Dellavedova,78,16.35,16,0.350000000000001,33,45,-12,-10,-2
21700149,1627748,MIL,CLE,Thon Maker,78,15.6,15,0.6,42,43,-1,1,-2
21700149,1627763,MIL,CLE,Malcolm Brogdon,168,37.1166666666667,37,0.116666666666667,96,94,2,1,1
21700150,2749,NOP,IND,Jameer Nelson,138,28.5,29,-0.5,66,64,2,4,-2
21700150,2754,NOP,IND,Tony Allen,116,24.15,24,0.149999999999999,53,55,-2,-1,-1
21700150,201950,NOP,IND,Jrue Holiday,137,29.5833333333333,30,-0.416666666666668,69,59,10,6,4
21700150,201967,NOP,IND,Dante Cunningham,75,16.3833333333333,17,-0.616666666666667,47,39,8,11,-3
21700150,202326,NOP,IND,DeMarcus Cousins,171,37.9666666666667,38,-0.0333333333333314,89,83,6,6,0
21700150,202734,NOP,IND,E'Twaun Moore,130,27.15,27,0.149999999999999,75,71,4,6,-2
21700150,203076,NOP,IND,Anthony Davis,192,41.1666666666667,41,0.166666666666664,102,97,5,5,0
21700150,203121,NOP,IND,Darius Miller,93,19.5,19,0.5,44,45,-1,-1,0
21700150,203546,NOP,IND,Ian Clark,68,15.0166666666667,15,0.0166666666666657,35,47,-12,-11,-1
21700150,2744,IND,NOP,Al Jefferson,60,12.5166666666667,12,0.516666666666666,32,29,3,1,2
21700150,201152,IND,NOP,Thaddeus Young,176,38.2666666666667,38,0.266666666666666,89,93,-4,-8,4
21700150,201954,IND,NOP,Darren Collison,141,30.7333333333333,31,-0.266666666666666,78,80,-2,-3,1
21700150,202362,IND,NOP,Lance Stephenson,132,28.15,28,0.149999999999999,68,63,5,3,2
21700150,202709,IND,NOP,Cory Joseph,110,22.9166666666667,23,-0.0833333333333357,56,53,3,3,0
21700150,202711,IND,NOP,Bojan Bogdanovic,102,22.6333333333333,23,-0.366666666666667,52,53,-1,-1,0
21700150,203506,IND,NOP,Victor Oladipo,133,28.5166666666667,29,-0.483333333333334,57,70,-13,-15,2
21700150,1626167,IND,NOP,Myles Turner,161,35.0666666666667,35,0.0666666666666629,80,85,-5,-4,-1
21700150,1626202,IND,NOP,Joe Young,52,10.6166666666667,11,-0.383333333333333,25,26,-1,0,-1
21700150,1627816,IND,NOP,Alex Poythress,2,0.0833333333333333,0,0.0833333333333333,,3,,-2,
21700150,1628388,IND,NOP,TJ Leaf,51,9.91666666666667,10,-0.0833333333333322,23,25,-2,1,-3
21700151,1717,DAL,WAS,Dirk Nowitzki,89,18.9666666666667,19,-0.033333333333335,40,51,-11,-8,-3
21700151,2734,DAL,WAS,Devin Harris,84,18.7,19,-0.300000000000001,41,37,4,2,2
21700151,200826,DAL,WAS,J.J. Barea,74,16.3,16,0.300000000000001,36,35,1,-1,2
21700151,202083,DAL,WAS,Wesley Matthews,176,37.45,37,0.450000000000003,92,82,10,10,0
21700151,203084,DAL,WAS,Harrison Barnes,185,39.0833333333333,39,0.0833333333333286,93,81,12,12,0
21700151,203457,DAL,WAS,Nerlens Noel,23,5.65,6,-0.35,17,12,5,5,0
21700151,203939,DAL,WAS,Dwight Powell,8,1.8,2,-0.2,5,2,3,3,0
21700151,1626257,DAL,WAS,Salah Mejri,118,25.0833333333333,25,0.0833333333333357,64,46,18,15,3
21700151,1627812,DAL,WAS,Yogi Ferrell,138,28.9666666666667,29,-0.0333333333333314,72,62,10,12,-2
21700151,1627827,DAL,WAS,Dorian Finney-Smith,67,14.9666666666667,16,-1.03333333333334,28,23,5,5,0
21700151,1628372,DAL,WAS,Dennis Smith Jr.,148,31.3666666666667,32,-0.633333333333333,77,64,13,15,-2
21700151,101133,WAS,DAL,Ian Mahinmi,27,6.25,6,0.25,14,17,-3,-6,3
21700151,101162,WAS,DAL,Marcin Gortat,110,24.4333333333333,25,-0.56666666666667,51,63,-12,-8,-4
21700151,201160,WAS,DAL,Jason Smith,50,9.83333333333333,10,-0.166666666666668,21,17,4,3,1
21700151,201975,WAS,DAL,Jodie Meeks,62,13.3333333333333,13,0.333333333333332,31,28,3,2,1
21700151,202322,WAS,DAL,John Wall,172,37.1,37,0.0999999999999943,81,94,-13,-12,-1
21700151,202693,WAS,DAL,Markieff Morris,126,27.3,27,0.299999999999997,57,70,-13,-11,-2
21700151,203078,WAS,DAL,Bradley Beal,173,37.05,37,0.0499999999999972,73,91,-18,-15,-3
21700151,203118,WAS,DAL,Mike Scott,35,7.48333333333333,8,-0.516666666666668,9,16,-7,-9,2
21700151,203490,WAS,DAL,Otto Porter Jr.,171,36.45,37,-0.549999999999997,75,87,-12,-12,0
21700151,204025,WAS,DAL,Tim Frazier,60,12.8166666666667,13,-0.183333333333334,30,27,3,0,3
21700151,1626162,WAS,DAL,Kelly Oubre Jr.,124,26.2833333333333,26,0.283333333333331,53,55,-2,-2,0
21700152,101127,NYK,CHA,Jarrett Jack,100,22.0166666666667,22,0.0166666666666657,52,60,-8,-6,-2
21700152,201584,NYK,CHA,Courtney Lee,161,35.2166666666667,36,-0.783333333333331,88,89,-1,1,-2
21700152,202498,NYK,CHA,Lance Thomas,109,24.8833333333333,25,-0.116666666666667,64,46,18,18,0
21700152,202683,NYK,CHA,Enes Kanter,109,24.35,25,-0.649999999999999,54,66,-12,-11,-1
21700152,203124,NYK,CHA,Kyle O'Quinn,83,18.0833333333333,18,0.0833333333333357,46,43,3,2,1
21700152,203501,NYK,CHA,Tim Hardaway Jr.,149,33.2666666666667,33,0.266666666666666,82,77,5,5,0
21700152,203926,NYK,CHA,Doug McDermott,123,27.5333333333333,27,0.533333333333331,68,60,8,6,2
21700152,204001,NYK,CHA,Kristaps Porzingis,130,28.6666666666667,29,-0.333333333333336,70,71,-1,-1,0
21700152,1628373,NYK,CHA,Frank Ntilikina,116,25.9833333333333,26,-0.0166666666666657,66,53,13,11,2
21700152,2730,CHA,NYK,Dwight Howard,135,29.9833333333333,30,-0.0166666666666657,75,68,7,6,1
21700152,101107,CHA,NYK,Marvin Williams,122,27.4166666666667,28,-0.583333333333336,64,70,-6,-8,2
21700152,202689,CHA,NYK,Kemba Walker,146,32.95,33,-0.0499999999999972,79,76,3,3,0
21700152,203087,CHA,NYK,Jeremy Lamb,121,26.85,27,-0.149999999999999,57,71,-14,-14,0
21700152,203469,CHA,NYK,Cody Zeller,80,17.5833333333333,17,0.583333333333336,38,48,-10,-9,-1
21700152,203487,CHA,NYK,Michael Carter-Williams,95,20.9166666666667,20,0.916666666666664,58,50,8,9,-1
21700152,1626163,CHA,NYK,Frank Kaminsky,94,20.5833333333333,20,0.583333333333336,49,48,1,3,-2
21700152,1626203,CHA,NYK,Treveon Graham,86,18.95,19,-0.0500000000000007,49,48,1,-1,2
21700152,1628370,CHA,NYK,Malik Monk,124,26.8,27,-0.200000000000003,56,69,-13,-12,-1
21700152,1628407,CHA,NYK,Dwayne Bacon,77,17.9666666666667,19,-1.03333333333333,40,42,-2,-2,0
21700153,201577,CHI,TOR,Robin Lopez,110,25.1333333333333,26,-0.866666666666667,55,67,-12,-14,2
21700153,203200,CHI,TOR,Justin Holiday,143,31.5833333333333,32,-0.416666666666668,74,81,-7,-8,1
21700153,1626170,CHI,TOR,Jerian Grant,95,21.7166666666667,22,-0.283333333333331,47,59,-12,-12,0
21700153,1626171,CHI,TOR,Bobby Portis,119,24.6666666666667,24,0.666666666666668,67,54,13,10,3
21700153,1626245,CHI,TOR,Cristiano Felicio,76,17.1166666666667,17,0.116666666666667,40,41,-1,1,-2
21700153,1627739,CHI,TOR,Kris Dunn,125,26.2666666666667,26,0.266666666666666,66,60,6,7,-1
21700153,1627756,CHI,TOR,Denzel Valentine,130,27.7,27,0.699999999999999,68,67,1,0,1
21700153,1627770,CHI,TOR,Kay Felder,77,16.4,16,0.399999999999999,39,38,1,3,-2
21700153,1627835,CHI,TOR,Paul Zipser,90,20.2833333333333,21,-0.716666666666669,45,52,-7,-5,-2
21700153,1628374,CHI,TOR,Lauri Markkanen,135,29.05,29,0.0499999999999972,64,76,-12,-7,-5
21700153,101139,TOR,CHI,CJ Miles,83,18.85,18,0.850000000000001,47,47,0,2,-2
21700153,200768,TOR,CHI,Kyle Lowry,152,32.9333333333333,33,-0.0666666666666629,79,74,5,3,2
21700153,201586,TOR,CHI,Serge Ibaka,133,28.7666666666667,29,-0.233333333333334,69,67,2,1,1
21700153,201942,TOR,CHI,DeMar DeRozan,163,35.9,36,-0.100000000000001,91,86,5,4,1
21700153,202685,TOR,CHI,Jonas Valanciunas,105,23.7166666666667,24,-0.283333333333331,64,52,12,9,3
21700153,203512,TOR,CHI,Lucas Nogueira,42,10.2833333333333,10,0.283333333333333,26,27,-1,2,-3
21700153,1626153,TOR,CHI,Delon Wright,78,17.2,17,0.200000000000003,45,43,2,3,-1
21700153,1626181,TOR,CHI,Norman Powell,125,26.6666666666667,27,-0.333333333333336,70,61,9,6,3
21700153,1627751,TOR,CHI,Jakob Poeltl,54,11.1666666666667,11,0.166666666666668,23,26,-3,-3,0
21700153,1627783,TOR,CHI,Pascal Siakam,60,12.45,12,0.449999999999999,32,29,3,2,1
21700153,1627832,TOR,CHI,Fred VanVleet,47,9.93333333333333,10,-0.0666666666666664,23,23,0,0,0
21700153,1628384,TOR,CHI,OG Anunoby,58,12.05,12,0.0500000000000007,26,30,-4,-4,0
21700154,101150,LAC,SAS,Lou Williams,127,26.7166666666667,27,-0.283333333333331,65,67,-2,-2,0
21700154,201599,LAC,SAS,DeAndre Jordan,122,28.7,29,-0.300000000000001,56,75,-19,-21,2
21700154,201933,LAC,SAS,Blake Griffin,150,34.2833333333333,34,0.283333333333331,68,86,-18,-19,1
21700154,201976,LAC,SAS,Patrick Beverley,128,29.8,30,-0.200000000000003,53,77,-24,-25,1
21700154,202325,LAC,SAS,Wesley Johnson,152,32.85,33,-0.149999999999999,82,86,-4,-3,-1
21700154,203085,LAC,SAS,Austin Rivers,158,36.1,36,0.0999999999999943,80,92,-12,-13,1
21700154,203186,LAC,SAS,Willie Reed,59,11.7166666666667,12,-0.283333333333335,29,28,1,2,-1
21700154,1626149,LAC,SAS,Montrezl Harrell,35,7.41666666666667,8,-0.583333333333334,22,17,5,6,-1
21700154,1626155,LAC,SAS,Sam Dekker,28,6.88333333333333,7,-0.116666666666667,15,13,2,2,0
21700154,1627744,LAC,SAS,Brice Johnson,9,2.16666666666667,2,0.166666666666667,6,3,3,3,0
21700154,1628393,LAC,SAS,Jawun Evans,31,5.93333333333333,6,-0.0666666666666664,18,17,1,2,-1
21700154,1628414,LAC,SAS,Sindarius Thornwell,81,16.6,17,-0.399999999999999,41,39,2,3,-1
21700154,1938,SAS,LAC,Manu Ginobili,92,18.9666666666667,19,-0.0333333333333314,49,47,2,1,1
21700154,2200,SAS,LAC,Pau Gasol,125,27.7166666666667,28,-0.283333333333331,74,65,9,9,0
21700154,200746,SAS,LAC,LaMarcus Aldridge,144,32.7833333333333,33,-0.216666666666669,83,65,18,18,0
21700154,200752,SAS,LAC,Rudy Gay,110,23.65,24,-0.350000000000001,66,55,11,11,0
21700154,201980,SAS,LAC,Danny Green,124,28.25,28,0.25,75,58,17,18,-1
21700154,201988,SAS,LAC,Patty Mills,124,29.6,29,0.600000000000001,64,64,0,0,0
21700154,202722,SAS,LAC,Davis Bertans,9,2.16666666666667,2,0.166666666666667,3,6,-3,-3,0
21700154,203464,SAS,LAC,Brandon Paul,49,11.7333333333333,12,-0.266666666666666,22,31,-9,-9,0
21700154,203937,SAS,LAC,Kyle Anderson,137,31.8333333333333,32,-0.166666666666668,74,66,8,9,-1
21700154,1626199,SAS,LAC,Darrun Hilliard,9,2.16666666666667,2,0.166666666666667,3,6,-3,-3,0
21700154,1627749,SAS,LAC,Dejounte Murray,92,18.2333333333333,19,-0.766666666666666,56,43,13,13,0
21700154,1627854,SAS,LAC,Bryn Forbes,65,12.0666666666667,12,0.0666666666666664,31,29,2,1,1
21700155,200794,DEN,BKN,Paul Millsap,138,25.5,26,-0.5,70,54,16,16,0
21700155,201163,DEN,BKN,Wilson Chandler,185,34.7666666666667,35,-0.233333333333334,84,65,19,18,1
21700155,202702,DEN,BKN,Kenneth Faried,26,5.81666666666667,6,-0.183333333333334,11,11,0,0,0
21700155,203115,DEN,BKN,Will Barton,160,31,31,0,64,74,-10,-10,0
21700155,203486,DEN,BKN,Mason Plumlee,82,14.65,15,-0.35,29,34,-5,-4,-1
21700155,203914,DEN,BKN,Gary Harris,155,29.7833333333333,30,-0.216666666666669,79,57,22,20,2
21700155,203999,DEN,BKN,Nikola Jokic,165,30.85,31,-0.149999999999999,84,58,26,25,1
21700155,1626144,DEN,BKN,Emmanuel Mudiay,115,21.5166666666667,22,-0.483333333333334,42,52,-10,-6,-4
21700155,1626168,DEN,BKN,Trey Lyles,14,3.01666666666667,3,0.0166666666666666,4,13,-9,-7,-2
21700155,1627736,DEN,BKN,Malik Beasley,88,16.3166666666667,16,0.316666666666666,28,47,-19,-16,-3
21700155,1627750,DEN,BKN,Jamal Murray,132,25.45,25,0.449999999999999,60,55,5,4,1
21700155,201960,BKN,DEN,DeMarre Carroll,99,17.95,18,-0.0500000000000007,35,49,-14,-10,-4
21700155,202389,BKN,DEN,Timofey Mozgov,84,15.7666666666667,16,-0.233333333333334,28,33,-5,-2,-3
21700155,203092,BKN,DEN,Tyler Zeller,144,27.5,28,-0.5,70,71,-1,-2,1
21700155,203112,BKN,DEN,Quincy Acy,94,17.4666666666667,18,-0.533333333333335,34,43,-9,-10,1
21700155,203459,BKN,DEN,Allen Crabbe,105,18.9333333333333,19,-0.0666666666666664,37,49,-12,-9,-3
21700155,203915,BKN,DEN,Spencer Dinwiddie,77,17.0666666666667,17,0.0666666666666664,32,38,-6,-5,-1
21700155,203925,BKN,DEN,Joe Harris,119,21.7833333333333,22,-0.216666666666669,47,55,-8,-5,-3
21700155,203930,BKN,DEN,Sean Kilpatrick,108,20.2166666666667,20,0.216666666666669,51,41,10,9,1
21700155,1626156,BKN,DEN,D'Angelo Russell,116,21.0666666666667,21,0.0666666666666664,41,54,-13,-11,-2
21700155,1627747,BKN,DEN,Caris LeVert,128,25.25,26,-0.75,60,62,-2,-3,1
21700155,1627785,BKN,DEN,Isaiah Whitehead,82,14.7833333333333,15,-0.216666666666667,38,25,13,12,1
21700155,1628451,BKN,DEN,Jacob Wiley,104,20.8833333333333,21,-0.116666666666667,47,35,12,11,1
21700156,101161,PHI,UTA,Amir Johnson,109,21.6833333333333,22,-0.31666666666667,46,29,17,20,-3
21700156,200755,PHI,UTA,JJ Redick,187,34.65,35,-0.350000000000001,78,75,3,6,-3
21700156,203496,PHI,UTA,Robert Covington,143,27.7833333333333,28,-0.216666666666669,56,46,10,13,-3
21700156,203917,PHI,UTA,Nik Stauskas,21,4.51666666666667,4,0.516666666666667,5,12,-7,-7,0
21700156,203967,PHI,UTA,Dario Saric,183,35.8166666666667,36,-0.183333333333337,74,74,0,-2,2
21700156,204456,PHI,UTA,T.J. McConnell,170,30.1333333333333,30,0.133333333333333,67,62,5,6,-1
21700156,1626143,PHI,UTA,Jahlil Okafor,19,3.25,3,0.25,9,11,-2,-5,3
21700156,1626147,PHI,UTA,Justin Anderson,72,13.5166666666667,13,0.516666666666666,34,36,-2,-4,2
21700156,1626158,PHI,UTA,Richaun Holmes,71,14.7,15,-0.300000000000001,27,27,0,-1,1
21700156,1627732,PHI,UTA,Ben Simmons,193,35.9333333333333,36,-0.0666666666666629,82,81,1,2,-1
21700156,1627789,PHI,UTA,Timothe Luwawu-Cabarrot,97,18.0166666666667,18,0.0166666666666657,42,32,10,7,3
21700156,200757,UTA,PHI,Thabo Sefolosha,126,24.0833333333333,24,0.0833333333333357,56,45,11,9,2
21700156,201937,UTA,PHI,Ricky Rubio,146,28.1166666666667,28,0.116666666666667,67,63,4,2,2
21700156,201973,UTA,PHI,Jonas Jerebko,51,10.0166666666667,9,1.01666666666667,18,26,-8,-7,-1
21700156,202324,UTA,PHI,Derrick Favors,100,19.0833333333333,20,-0.916666666666664,31,41,-10,-9,-1
21700156,202327,UTA,PHI,Ekpe Udoh,66,12.2,12,0.199999999999999,33,25,8,11,-3
21700156,202692,UTA,PHI,Alec Burks,48,8.98333333333333,9,-0.0166666666666657,20,26,-6,-7,1
21700156,203497,UTA,PHI,Rudy Gobert,187,35.8,36,-0.200000000000003,64,79,-15,-18,3
21700156,203526,UTA,PHI,Raul Neto,56,10.75,10,0.75,19,18,1,3,-2
21700156,203918,UTA,PHI,Rodney Hood,141,26.9666666666667,28,-1.03333333333334,62,57,5,3,2
21700156,204060,UTA,PHI,Joe Ingles,173,33.0166666666667,33,0.0166666666666657,59,71,-12,-11,-1
21700156,1628378,UTA,PHI,Donovan Mitchell,171,30.9833333333333,31,-0.0166666666666657,56,69,-13,-11,-2
21700157,202323,POR,MEM,Evan Turner,148,33.4166666666667,33,0.416666666666664,80,69,11,12,-1
21700157,202334,POR,MEM,Ed Davis,106,23.2666666666667,24,-0.733333333333334,50,44,6,13,-7
21700157,203081,POR,MEM,Damian Lillard,152,34.45,34,0.450000000000003,59,69,-10,-10,0
21700157,203090,POR,MEM,Maurice Harkless,109,24.5333333333333,25,-0.466666666666669,40,49,-9,-10,1
21700157,203468,POR,MEM,CJ McCollum,162,38.1,38,0.100000000000001,80,79,1,0,1
21700157,203894,POR,MEM,Shabazz Napier,91,20.0333333333333,20,0.0333333333333314,53,43,10,8,2
21700157,203943,POR,MEM,Noah Vonleh,95,22.2833333333333,22,0.283333333333331,31,44,-13,-15,2
21700157,203994,POR,MEM,Jusuf Nurkic,88,20.4166666666667,20,0.416666666666664,35,44,-9,-12,3
21700157,1626192,POR,MEM,Pat Connaughton,99,23.25,23,0.25,57,49,8,9,-1
21700157,201144,MEM,POR,Mike Conley,139,30.9666666666667,31,-0.033333333333335,62,58,4,6,-2
21700157,201148,MEM,POR,Brandan Wright,55,12.5833333333333,13,-0.416666666666668,27,34,-7,-9,2
21700157,201188,MEM,POR,Marc Gasol,153,34.9,35,-0.100000000000001,68,61,7,7,0
21700157,201596,MEM,POR,Mario Chalmers,70,16.8666666666667,17,-0.133333333333333,35,39,-4,-3,-1
21700157,201936,MEM,POR,Tyreke Evans,142,32.2333333333333,32,0.233333333333334,68,78,-10,-8,-2
21700157,202718,MEM,POR,Chandler Parsons,100,22.2333333333333,23,-0.766666666666666,53,57,-4,-6,2
21700157,203516,MEM,POR,James Ennis III,134,31.4833333333333,31,0.483333333333334,66,51,15,14,1
21700157,1626185,MEM,POR,Jarell Martin,89,20.7,20,0.699999999999999,35,30,5,7,-2
21700157,1628415,MEM,POR,Dillon Brooks,168,37.7833333333333,38,-0.216666666666669,76,77,-1,-3,2
21700158,1713,SAC,OKC,Vince Carter,59,14.6,15,-0.4,33,22,11,9,2
21700158,2216,SAC,OKC,Zach Randolph,122,26.05,27,-0.949999999999999,44,48,-4,-3,-1
21700158,201585,SAC,OKC,Kosta Koufos,46,9.51666666666667,9,0.516666666666666,13,22,-9,-7,-2
21700158,201588,SAC,OKC,George Hill,113,24.05,24,0.0500000000000007,45,41,4,4,0
21700158,202066,SAC,OKC,Garrett Temple,147,30.4666666666667,31,-0.533333333333331,64,53,11,9,2
21700158,203992,SAC,OKC,Bogdan Bogdanovic,100,21.1666666666667,21,0.166666666666664,33,34,-1,-1,0
21700158,1626161,SAC,OKC,Willie Cauley-Stein,97,21.0833333333333,21,0.0833333333333357,37,34,3,0,3
21700158,1627741,SAC,OKC,Buddy Hield,128,27.8,28,-0.199999999999999,61,54,7,7,0
21700158,1627746,SAC,OKC,Skal Labissiere,50,10.6666666666667,11,-0.333333333333332,22,20,2,4,-2
21700158,1628368,SAC,OKC,De'Aaron Fox,111,23.9333333333333,24,-0.06666666666667,49,45,4,4,0
21700158,1628382,SAC,OKC,Justin Jackson,147,30.5833333333333,30,0.583333333333336,69,57,12,14,-2
21700158,2546,OKC,SAC,Carmelo Anthony,160,33.9833333333333,34,-0.0166666666666657,54,70,-16,-17,1
21700158,101109,OKC,SAC,Raymond Felton,64,13.9666666666667,14,-0.033333333333335,25,30,-5,-5,0
21700158,201566,OKC,SAC,Russell Westbrook,172,36.5,37,-0.5,70,68,2,2,0
21700158,202331,OKC,SAC,Paul George,180,37.0166666666667,37,0.0166666666666657,67,69,-2,-2,0
21700158,202335,OKC,SAC,Patrick Patterson,61,14.85,15,-0.15,26,33,-7,-9,2
21700158,203460,OKC,SAC,Andre Roberson,131,28.3833333333333,29,-0.616666666666667,45,54,-9,-8,-1
21700158,203500,OKC,SAC,Steven Adams,140,29.3166666666667,29,0.316666666666666,56,55,1,4,-3
21700158,203518,OKC,SAC,Alex Abrines,32,5.51666666666667,5,0.516666666666667,13,18,-5,-6,1
21700158,203924,OKC,SAC,Jerami Grant,124,26.7333333333333,27,-0.266666666666666,53,48,5,5,0
21700158,203962,OKC,SAC,Josh Huestis,38,8.96666666666667,9,-0.0333333333333332,18,16,2,2,0
21700158,1628390,OKC,SAC,Terrance Ferguson,18,4.68333333333333,5,-0.316666666666666,3,9,-6,-6,0
21700159,2744,IND,DET,Al Jefferson,111,22.4666666666667,22,0.466666666666669,51,57,-6,-4,-2
21700159,201152,IND,DET,Thaddeus Young,168,35.1833333333333,35,0.183333333333337,70,78,-8,-6,-2
21700159,201954,IND,DET,Darren Collison,137,28.7333333333333,29,-0.266666666666666,57,63,-6,-5,-1
21700159,202362,IND,DET,Lance Stephenson,110,22.5833333333333,23,-0.416666666666664,51,54,-3,-3,0
21700159,202709,IND,DET,Cory Joseph,144,29.3666666666667,29,0.366666666666667,68,76,-8,-9,1
21700159,202711,IND,DET,Bojan Bogdanovic,147,30.85,31,-0.149999999999999,58,75,-17,-17,0
21700159,203506,IND,DET,Victor Oladipo,177,37.3666666666667,38,-0.633333333333333,69,89,-20,-20,0
21700159,1626167,IND,DET,Myles Turner,118,25.2666666666667,26,-0.733333333333334,46,57,-11,-13,2
21700159,1628388,IND,DET,TJ Leaf,33,6.85,7,-0.15,15,21,-6,-8,2
21700159,201229,DET,IND,Anthony Tolliver,68,13.9833333333333,14,-0.0166666666666657,40,27,13,13,0
21700159,202340,DET,IND,Avery Bradley,142,28.35,29,-0.649999999999999,63,49,14,14,0
21700159,202397,DET,IND,Ish Smith,102,20.8833333333333,21,-0.116666666666667,49,51,-2,-2,0
21700159,202699,DET,IND,Tobias Harris,161,33.75,34,-0.25,74,70,4,4,0
21700159,202704,DET,IND,Reggie Jackson,127,26.85,27,-0.149999999999999,65,46,19,19,0
21700159,203083,DET,IND,Andre Drummond,162,33.35,34,-0.650000000000006,83,55,28,28,0
21700159,203493,DET,IND,Reggie Bullock,154,32.75,33,-0.25,74,65,9,9,0
21700159,203961,DET,IND,Eric Moreland,25,5.68333333333333,6,-0.316666666666666,9,16,-7,-7,0
21700159,204038,DET,IND,Langston Galloway,107,21.9833333333333,22,-0.0166666666666657,59,46,13,13,0
21700159,1626246,DET,IND,Boban Marjanovic,42,8.7,9,-0.300000000000001,22,26,-4,-4,0
21700159,1628379,DET,IND,Luke Kennard,55,12.3833333333333,12,0.383333333333333,32,34,-2,-2,0
21700160,101127,NYK,ORL,Jarrett Jack,120,24.5666666666667,25,-0.433333333333334,55,64,-9,-10,1
21700160,201563,NYK,ORL,Michael Beasley,96,20.2833333333333,20,0.283333333333331,43,60,-17,-17,0
21700160,201584,NYK,ORL,Courtney Lee,139,29.7333333333333,30,-0.266666666666666,61,81,-20,-20,0
21700160,202498,NYK,ORL,Lance Thomas,96,22.4,22,0.399999999999999,48,43,5,5,0
21700160,202683,NYK,ORL,Enes Kanter,96,20.2833333333333,20,0.283333333333331,43,60,-17,-17,0
21700160,203124,NYK,ORL,Kyle O'Quinn,87,20.0333333333333,20,0.0333333333333314,41,35,6,6,0
21700160,203501,NYK,ORL,Tim Hardaway Jr.,174,37.5333333333333,38,-0.466666666666669,82,97,-15,-15,0
21700160,203926,NYK,ORL,Doug McDermott,132,30.25,30,0.25,63,55,8,8,0
21700160,1626195,NYK,ORL,Willy Hernangomez,34,7.58333333333333,8,-0.416666666666667,15,17,-2,-2,0
21700160,1627851,NYK,ORL,Mindaugas Kuzminskas,7,1.75,2,-0.25,0,0,0,0,0
21700160,1628373,NYK,ORL,Frank Ntilikina,97,23.3333333333333,23,0.333333333333336,44,48,-4,-3,-1
21700160,1628422,NYK,ORL,Damyean Dotson,7,1.75,2,-0.25,0,0,0,0,0
21700160,202687,ORL,NYK,Bismack Biyombo,69,15.2333333333333,15,0.233333333333333,34,38,-4,-3,-1
21700160,202696,ORL,NYK,Nikola Vucevic,148,32.6666666666667,33,-0.333333333333329,78,61,17,16,1
21700160,202714,ORL,NYK,Shelvin Mack,86,19.9,20,-0.100000000000001,33,40,-7,-7,0
21700160,203082,ORL,NYK,Terrence Ross,106,23.55,24,-0.450000000000003,58,50,8,4,4
21700160,203095,ORL,NYK,Evan Fournier,154,33.75,34,-0.25,85,68,17,17,0
21700160,203613,ORL,NYK,Jonathon Simmons,108,24.2333333333333,24,0.233333333333334,46,55,-9,-7,-2
21700160,203901,ORL,NYK,Elfrid Payton,136,29.15,29,0.149999999999999,81,63,18,20,-2
21700160,203932,ORL,NYK,Aaron Gordon,169,36.5666666666667,37,-0.433333333333337,99,75,24,23,1
21700160,1628371,ORL,NYK,Jonathan Isaac,102,22.7,23,-0.300000000000001,46,45,1,2,-1
21700160,1628411,ORL,NYK,Wes Iwundu,7,1.75,2,-0.25,0,0,0,0,0
21700161,202681,BOS,LAL,Kyrie Irving,170,32.9666666666667,33,-0.0333333333333314,77,72,5,2,3
21700161,202694,BOS,LAL,Marcus Morris,125,24.0833333333333,25,-0.916666666666664,66,62,4,6,-2
21700161,203382,BOS,LAL,Aron Baynes,113,22.65,23,-0.350000000000001,49,50,-1,-3,2
21700161,203499,BOS,LAL,Shane Larkin,29,5.71666666666667,6,-0.283333333333333,9,9,0,0,0
21700161,203935,BOS,LAL,Marcus Smart,183,34.5333333333333,35,-0.466666666666669,74,63,11,16,-5
21700161,1626179,BOS,LAL,Terry Rozier,146,27.8666666666667,28,-0.133333333333333,58,57,1,0,1
21700161,1627759,BOS,LAL,Jaylen Brown,171,32.4333333333333,33,-0.56666666666667,73,64,9,11,-2
21700161,1628369,BOS,LAL,Jayson Tatum,44,9.35,9,0.35,25,25,0,-1,1
21700161,1628400,BOS,LAL,Semi Ojeleye,138,26.0666666666667,26,0.0666666666666664,50,43,7,10,-3
21700161,1628464,BOS,LAL,Daniel Theis,121,22.3333333333333,22,0.333333333333336,49,35,14,14,0
21700161,101106,LAL,BOS,Andrew Bogut,34,5.68333333333333,6,-0.316666666666666,5,16,-11,-12,1
21700161,201147,LAL,BOS,Corey Brewer,59,11.1166666666667,11,0.116666666666667,12,25,-13,-14,1
21700161,201572,LAL,BOS,Brook Lopez,90,17.75,18,-0.25,39,42,-3,-2,-1
21700161,203484,LAL,BOS,Kentavious Caldwell-Pope,184,35.5166666666667,36,-0.483333333333334,76,79,-3,-1,-2
21700161,203903,LAL,BOS,Jordan Clarkson,144,27.2,27,0.199999999999999,51,57,-6,-6,0
21700161,203944,LAL,BOS,Julius Randle,112,21.4333333333333,21,0.433333333333334,50,44,6,5,1
21700161,1627742,LAL,BOS,Brandon Ingram,191,36.1666666666667,37,-0.833333333333336,72,83,-11,-12,1
21700161,1628366,LAL,BOS,Lonzo Ball,195,37.8166666666667,39,-1.18333333333334,84,87,-3,-5,2
21700161,1628398,LAL,BOS,Kyle Kuzma,170,33.6166666666667,34,-0.383333333333333,73,73,0,0,0
21700161,1628404,LAL,BOS,Josh Hart,61,11.7,12,-0.300000000000001,18,24,-6,-8,2
21700162,201609,MIA,PHX,Goran Dragic,184,38.15,38,0.149999999999999,104,98,6,6,0
21700162,201949,MIA,PHX,James Johnson,139,29.1166666666667,29,0.116666666666667,77,73,4,5,-1
21700162,201961,MIA,PHX,Wayne Ellington,165,34.1333333333333,34,0.133333333333333,90,86,4,6,-2
21700162,202355,MIA,PHX,Hassan Whiteside,135,27.7,28,-0.300000000000001,73,70,3,5,-2
21700162,203079,MIA,PHX,Dion Waiters,125,26.8166666666667,26,0.816666666666666,70,53,17,12,5
21700162,203482,MIA,PHX,Kelly Olynyk,86,18.1333333333333,18,0.133333333333333,46,45,1,0,1
21700162,1626159,MIA,PHX,Justise Winslow,173,36.3166666666667,37,-0.68333333333333,98,92,6,8,-2
21700162,1626196,MIA,PHX,Josh Richardson,133,28.7166666666667,29,-0.283333333333331,72,58,14,13,1
21700162,201162,PHX,MIA,Jared Dudley,115,23.4166666666667,23,0.416666666666664,60,64,-4,-2,-2
21700162,203458,PHX,MIA,Alex Len,92,19.4,19,0.399999999999999,51,45,6,6,0
21700162,203584,PHX,MIA,Troy Daniels,78,17.3833333333333,17,0.383333333333333,35,48,-13,-11,-2
21700162,203933,PHX,MIA,T.J. Warren,153,31.3333333333333,32,-0.666666666666668,84,79,5,3,2
21700162,1626164,PHX,MIA,Devin Booker,181,37.0666666666667,37,0.0666666666666629,92,100,-8,-10,2
21700162,1627733,PHX,MIA,Dragan Bender,124,26.8333333333333,27,-0.166666666666664,56,71,-15,-15,0
21700162,1627737,PHX,MIA,Marquese Chriss,115,25.05,25,0.0499999999999972,58,64,-6,-8,2
21700162,1627755,PHX,MIA,Tyler Ulis,80,16.6166666666667,17,-0.383333333333333,34,47,-13,-11,-2
21700162,1628367,PHX,MIA,Josh Jackson,54,10.7833333333333,11,-0.216666666666667,24,33,-9,-7,-2
21700162,1628455,PHX,MIA,Mike James,148,31.2,31,0.200000000000003,81,79,2,0,2
21700163,2561,GSW,MIN,David West,55,12.5666666666667,13,-0.433333333333334,33,24,9,7,2
21700163,2585,GSW,MIN,Zaza Pachulia,77,14.8333333333333,15,-0.166666666666668,33,30,3,3,0
21700163,2733,GSW,MIN,Shaun Livingston,92,18.45,19,-0.549999999999997,53,34,19,17,2
21700163,2738,GSW,MIN,Andre Iguodala,102,20.2333333333333,20,0.233333333333334,46,43,3,3,0
21700163,201156,GSW,MIN,Nick Young,104,20.8666666666667,21,-0.133333333333333,60,53,7,9,-2
21700163,201580,GSW,MIN,JaVale McGee,51,9.2,9,0.199999999999999,33,18,15,15,0
21700163,201939,GSW,MIN,Stephen Curry,155,29.9166666666667,30,-0.0833333333333322,79,63,16,16,0
21700163,201956,GSW,MIN,Omri Casspi,94,19.8166666666667,20,-0.183333333333334,54,45,9,9,0
21700163,202691,GSW,MIN,Klay Thompson,158,33.0166666666667,33,0.0166666666666657,83,69,14,14,0
21700163,203110,GSW,MIN,Draymond Green,139,27.3,27,0.300000000000001,68,53,15,15,0
21700163,1626172,GSW,MIN,Kevon Looney,50,10.5666666666667,11,-0.433333333333334,26,27,-1,-1,0
21700163,1627775,GSW,MIN,Patrick McCaw,73,16.3166666666667,17,-0.683333333333334,44,32,12,12,0
21700163,1628395,GSW,MIN,Jordan Bell,25,5.16666666666667,6,-0.833333333333334,13,14,-1,1,-2
21700163,2037,MIN,GSW,Jamal Crawford,89,18.7,19,-0.300000000000001,36,56,-20,-18,-2
21700163,201166,MIN,GSW,Aaron Brooks,15,2.61666666666667,3,-0.383333333333333,7,6,1,1,0
21700163,201952,MIN,GSW,Jeff Teague,172,34.6833333333333,35,-0.31666666666667,73,93,-20,-20,0
21700163,201959,MIN,GSW,Taj Gibson,134,26.6333333333333,27,-0.366666666666667,59,60,-1,-3,2
21700163,202357,MIN,GSW,Nemanja Bjelica,71,14.2833333333333,14,0.283333333333333,35,44,-9,-9,0
21700163,202710,MIN,GSW,Jimmy Butler,152,31.4,31,0.400000000000002,61,77,-16,-16,0
21700163,203476,MIN,GSW,Gorgui Dieng,103,20.4166666666667,21,-0.583333333333332,44,61,-17,-19,2
21700163,203498,MIN,GSW,Shabazz Muhammad,66,14.7333333333333,15,-0.266666666666666,28,39,-11,-9,-2
21700163,203952,MIN,GSW,Andrew Wiggins,167,32.4166666666667,32,0.416666666666664,73,87,-14,-16,2
21700163,1626145,MIN,GSW,Tyus Jones,63,12.9666666666667,13,-0.033333333333335,28,32,-4,-4,0
21700163,1626157,MIN,GSW,Karl-Anthony Towns,132,27.2333333333333,27,0.233333333333334,57,64,-7,-5,-2
21700163,1627875,MIN,GSW,Marcus Georges-Hunt,11,2.16666666666667,3,-0.833333333333333,4,6,-2,-2,0
21700164,201147,LAL,WAS,Corey Brewer,48,9.8,10,-0.199999999999999,26,28,-2,-2,0
21700164,201572,LAL,WAS,Brook Lopez,117,21.7666666666667,22,-0.233333333333334,48,56,-8,-8,0
21700164,203484,LAL,WAS,Kentavious Caldwell-Pope,182,33.9833333333333,34,-0.0166666666666657,74,84,-10,-7,-3
21700164,203505,LAL,WAS,Vander Blue,14,2.76666666666667,3,-0.233333333333333,7,3,4,4,0
21700164,203898,LAL,WAS,Tyler Ennis,50,10.7833333333333,11,-0.216666666666667,22,12,10,8,2
21700164,203903,LAL,WAS,Jordan Clarkson,101,20.0833333333333,20,0.0833333333333357,38,50,-12,-13,1
21700164,203944,LAL,WAS,Julius Randle,111,23.1333333333333,23,0.133333333333333,40,52,-12,-12,0
21700164,1627742,LAL,WAS,Brandon Ingram,180,35.6166666666667,35,0.61666666666666,61,81,-20,-20,0
21700164,1627826,LAL,WAS,Ivica Zubac,14,2.76666666666667,3,-0.233333333333333,7,3,4,4,0
21700164,1628366,LAL,WAS,Lonzo Ball,154,28.6833333333333,29,-0.316666666666666,56,75,-19,-18,-1
21700164,1628398,LAL,WAS,Kyle Kuzma,174,34.1833333333333,35,-0.81666666666667,68,76,-8,-10,2
21700164,1628404,LAL,WAS,Josh Hart,65,14.7666666666667,14,0.766666666666666,28,35,-7,-6,-1
21700164,101133,WAS,LAL,Ian Mahinmi,67,13.7,14,-0.300000000000001,29,21,8,8,0
21700164,101162,WAS,LAL,Marcin Gortat,150,29.5666666666667,30,-0.433333333333337,75,61,14,12,2
21700164,201160,WAS,LAL,Jason Smith,11,1.63333333333333,2,-0.366666666666667,4,6,-2,0,-2
21700164,201975,WAS,LAL,Jodie Meeks,83,17.9666666666667,18,-0.033333333333335,36,31,5,6,-1
21700164,202322,WAS,LAL,John Wall,164,31.4833333333333,32,-0.516666666666666,78,58,20,21,-1
21700164,202693,WAS,LAL,Markieff Morris,86,17.3,17,0.299999999999997,41,34,7,7,0
21700164,203078,WAS,LAL,Bradley Beal,196,37.2,37,0.200000000000003,98,79,19,21,-2
21700164,203107,WAS,LAL,Tomas Satoransky,14,2.76666666666667,3,-0.233333333333333,3,7,-4,-4,0
21700164,203118,WAS,LAL,Mike Scott,39,7.93333333333333,8,-0.0666666666666664,21,14,7,7,0
21700164,203490,WAS,LAL,Otto Porter Jr.,197,38.4833333333333,38,0.483333333333334,90,78,12,10,2
21700164,204025,WAS,LAL,Tim Frazier,78,16.1833333333333,17,-0.816666666666666,33,37,-4,-5,1
21700164,1626162,WAS,LAL,Kelly Oubre Jr.,125,24.1166666666667,25,-0.883333333333333,47,49,-2,-3,1
21700165,2749,NOP,TOR,Jameer Nelson,142,27.8,28,-0.200000000000003,74,71,3,4,-1
21700165,2754,NOP,TOR,Tony Allen,71,14.1333333333333,14,0.133333333333333,36,34,2,4,-2
21700165,201950,NOP,TOR,Jrue Holiday,207,41.85,42,-0.149999999999999,106,110,-4,-4,0
21700165,201967,NOP,TOR,Dante Cunningham,146,30.0833333333333,30,0.0833333333333322,75,75,0,-6,6
21700165,202326,NOP,TOR,DeMarcus Cousins,182,38.6,39,-0.400000000000006,86,95,-9,-7,-2
21700165,202734,NOP,TOR,E'Twaun Moore,134,29.5,29,0.5,60,71,-11,-10,-1
21700165,203076,NOP,TOR,Anthony Davis,184,38.2166666666667,38,0.216666666666669,92,102,-10,-10,0
21700165,203121,NOP,TOR,Darius Miller,104,18.9,19,-0.100000000000001,56,47,9,9,0
21700165,101139,TOR,NOP,CJ Miles,93,17.5,17,0.5,39,50,-11,-6,-5
21700165,200768,TOR,NOP,Kyle Lowry,159,34.0833333333333,34,0.0833333333333357,90,77,13,12,1
21700165,201586,TOR,NOP,Serge Ibaka,143,30.5666666666667,31,-0.433333333333334,82,69,13,12,1
21700165,201942,TOR,NOP,DeMar DeRozan,175,36.9,37,-0.100000000000001,99,91,8,7,1
21700165,202685,TOR,NOP,Jonas Valanciunas,126,27.2666666666667,27,0.266666666666666,72,62,10,10,0
21700165,203512,TOR,NOP,Lucas Nogueira,7,1.58333333333333,1,0.583333333333333,5,1,4,4,0
21700165,1626153,TOR,NOP,Delon Wright,72,13.2166666666667,13,0.216666666666667,28,40,-12,-11,-1
21700165,1626181,TOR,NOP,Norman Powell,83,18.1333333333333,18,0.133333333333333,45,42,3,2,1
21700165,1627751,TOR,NOP,Jakob Poeltl,101,18.9666666666667,19,-0.033333333333335,44,54,-10,-10,0
21700165,1627783,TOR,NOP,Pascal Siakam,72,13.2166666666667,13,0.216666666666667,28,40,-12,-11,-1
21700165,1627832,TOR,NOP,Fred VanVleet,73,13.65,14,-0.35,32,30,2,3,-1
21700165,1628384,TOR,NOP,OG Anunoby,66,14,14,0,41,29,12,8,4
21700166,2544,CLE,HOU,LeBron James,193,40.0333333333333,40,0.0333333333333314,97,92,5,5,0
21700166,2548,CLE,HOU,Dwyane Wade,99,20.2,20,0.200000000000003,38,57,-19,-21,2
21700166,2594,CLE,HOU,Kyle Korver,89,18.2,18,0.199999999999999,41,46,-5,-5,0
21700166,2747,CLE,HOU,JR Smith,155,32.6333333333333,32,0.633333333333333,70,78,-8,-6,-2
21700166,101112,CLE,HOU,Channing Frye,35,6.81666666666667,7,-0.183333333333334,20,24,-4,-4,0
21700166,201145,CLE,HOU,Jeff Green,182,37.7666666666667,38,-0.233333333333334,92,85,7,8,-1
21700166,201567,CLE,HOU,Kevin Love,142,28.2666666666667,29,-0.733333333333334,62,60,2,1,1
21700166,202697,CLE,HOU,Iman Shumpert,154,32.15,33,-0.850000000000001,83,83,0,0,0
21700166,203109,CLE,HOU,Jae Crowder,111,23.9333333333333,24,-0.0666666666666664,62,60,2,2,0
21700166,2403,HOU,CLE,Nene,77,15.6166666666667,15,0.616666666666667,39,30,9,9,0
21700166,2772,HOU,CLE,Trevor Ariza,205,42.6666666666667,43,-0.333333333333329,102,100,2,3,-1
21700166,200782,HOU,CLE,PJ Tucker,141,28.7833333333333,29,-0.216666666666669,67,59,8,9,-1
21700166,201569,HOU,CLE,Eric Gordon,192,39.5833333333333,40,-0.416666666666664,97,102,-5,-5,0
21700166,201583,HOU,CLE,Ryan Anderson,161,33.9,34,-0.100000000000001,85,80,5,3,2
21700166,201628,HOU,CLE,Bobby Brown,26,5.3,5,0.3,19,18,1,1,0
21700166,201935,HOU,CLE,James Harden,206,42.7,43,-0.299999999999997,98,95,3,3,0
21700166,203991,HOU,CLE,Clint Capela,152,31.45,31,0.450000000000003,78,81,-3,-3,0
21700167,101161,PHI,SAC,Amir Johnson,35,6.7,7,-0.3,8,16,-8,-6,-2
21700167,200755,PHI,SAC,JJ Redick,162,33.4666666666667,34,-0.533333333333331,70,73,-3,0,-3
21700167,203496,PHI,SAC,Robert Covington,171,34.9833333333333,35,-0.0166666666666657,85,79,6,5,1
21700167,203954,PHI,SAC,Joel Embiid,155,32.7333333333333,32,0.733333333333334,69,60,9,9,0
21700167,203967,PHI,SAC,Dario Saric,166,34.25,35,-0.75,70,74,-4,0,-4
21700167,204456,PHI,SAC,T.J. McConnell,144,28.7166666666667,29,-0.283333333333331,67,72,-5,-7,2
21700167,1626147,PHI,SAC,Justin Anderson,84,16.9666666666667,17,-0.0333333333333314,33,32,1,0,1
21700167,1626158,PHI,SAC,Richaun Holmes,47,8.55,9,-0.449999999999999,31,33,-2,-2,0
21700167,1627732,PHI,SAC,Ben Simmons,137,27.0833333333333,27,0.0833333333333357,67,63,4,6,-2
21700167,1627789,PHI,SAC,Timothe Luwawu-Cabarrot,84,16.4666666666667,17,-0.533333333333331,40,43,-3,0,-3
21700167,2216,SAC,PHI,Zach Randolph,139,29.1,29,0.100000000000001,61,62,-1,-1,0
21700167,201585,SAC,PHI,Kosta Koufos,107,20.85,21,-0.149999999999999,52,50,2,-1,3
21700167,201588,SAC,PHI,George Hill,91,19.4333333333333,19,0.433333333333334,38,44,-6,-6,0
21700167,202066,SAC,PHI,Garrett Temple,125,26.15,26,0.149999999999999,55,57,-2,-2,0
21700167,203992,SAC,PHI,Bogdan Bogdanovic,110,22.65,23,-0.350000000000001,47,47,0,0,0
21700167,1626161,SAC,PHI,Willie Cauley-Stein,119,24.8666666666667,24,0.866666666666667,53,55,-2,-1,-1
21700167,1627741,SAC,PHI,Buddy Hield,104,20.4,20,0.399999999999999,52,48,4,1,3
21700167,1627746,SAC,PHI,Skal Labissiere,53,10.5833333333333,11,-0.416666666666668,22,28,-6,-6,0
21700167,1627781,SAC,PHI,Malachi Richardson,39,7.11666666666667,7,0.116666666666667,23,17,6,5,1
21700167,1628368,SAC,PHI,De'Aaron Fox,149,29.3833333333333,30,-0.616666666666667,71,66,5,3,2
21700167,1628382,SAC,PHI,Justin Jackson,149,29.3833333333333,30,-0.616666666666667,71,66,5,3,2
21700168,200794,DEN,OKC,Paul Millsap,191,39.8,40,-0.200000000000003,82,79,3,3,0
21700168,201163,DEN,OKC,Wilson Chandler,132,26.7333333333333,27,-0.266666666666666,55,56,-1,1,-2
21700168,203115,DEN,OKC,Will Barton,150,30.95,31,-0.0500000000000007,72,52,20,20,0
21700168,203486,DEN,OKC,Mason Plumlee,115,24.6666666666667,25,-0.333333333333336,51,47,4,4,0
21700168,203914,DEN,OKC,Gary Harris,171,35.7666666666667,36,-0.233333333333334,75,74,1,-1,2
21700168,203999,DEN,OKC,Nikola Jokic,139,28.0333333333333,28,0.0333333333333314,60,55,5,5,0
21700168,1626144,DEN,OKC,Emmanuel Mudiay,150,29.7833333333333,30,-0.216666666666669,68,51,17,17,0
21700168,1627736,DEN,OKC,Malik Beasley,34,5.98333333333333,6,-0.0166666666666675,13,13,0,0,0
21700168,1627750,DEN,OKC,Jamal Murray,83,18.2,18,0.199999999999999,34,43,-9,-9,0
21700168,2546,OKC,DEN,Carmelo Anthony,160,33.4333333333333,33,0.433333333333337,65,69,-4,-4,0
21700168,101109,OKC,DEN,Raymond Felton,104,19.55,20,-0.450000000000003,40,47,-7,-9,2
21700168,201566,OKC,DEN,Russell Westbrook,171,35.4,35,0.399999999999999,68,77,-9,-9,0
21700168,202331,OKC,DEN,Paul George,209,42.8333333333333,43,-0.166666666666671,82,93,-11,-8,-3
21700168,202335,OKC,DEN,Patrick Patterson,65,12.6833333333333,13,-0.316666666666666,27,32,-5,-5,0
21700168,203460,OKC,DEN,Andre Roberson,163,33.7666666666667,34,-0.233333333333334,68,65,3,3,0
21700168,203500,OKC,DEN,Steven Adams,141,30.2,30,0.200000000000003,56,58,-2,-2,0
21700168,203518,OKC,DEN,Alex Abrines,52,12.4,12,0.4,24,24,0,-1,1
21700168,203924,OKC,DEN,Jerami Grant,100,19.65,20,-0.350000000000001,40,45,-5,-5,0
21700169,201158,ATL,DET,Marco Belinelli,148,29.8833333333333,30,-0.116666666666667,64,75,-11,-10,-1
21700169,202337,ATL,DET,Luke Babbitt,132,27.25,27,0.25,63,56,7,5,2
21700169,203145,ATL,DET,Kent Bazemore,154,32.4666666666667,32,0.466666666666669,71,75,-4,-3,-1
21700169,203471,ATL,DET,Dennis Schroder,171,36.1,36,0.0999999999999943,76,84,-8,-10,2
21700169,203473,ATL,DET,Dewayne Dedmon,100,22.1833333333333,22,0.183333333333334,48,58,-10,-13,3
21700169,1627098,ATL,DET,Malcolm Delaney,70,14.8166666666667,15,-0.183333333333334,33,32,1,1,0
21700169,1627752,ATL,DET,Taurean Prince,165,34.5,34,0.5,74,84,-10,-9,-1
21700169,1627819,ATL,DET,Isaiah Taylor,72,14.7166666666667,15,-0.283333333333333,31,33,-2,-1,-1
21700169,1628381,ATL,DET,John Collins,130,26.5166666666667,27,-0.483333333333334,56,56,0,5,-5
21700169,1628463,ATL,DET,Tyler Cavanaugh,8,1.15,1,0.15,4,2,2,0,2
21700169,201229,DET,ATL,Anthony Tolliver,79,16.0333333333333,17,-0.966666666666665,38,36,2,2,0
21700169,202340,DET,ATL,Avery Bradley,165,34.5833333333333,35,-0.416666666666671,83,76,7,10,-3
21700169,202397,DET,ATL,Ish Smith,87,18.3166666666667,19,-0.683333333333334,38,40,-2,-1,-1
21700169,202699,DET,ATL,Tobias Harris,155,32.0833333333333,32,0.0833333333333357,77,69,8,6,2
21700169,202704,DET,ATL,Reggie Jackson,143,29.6,29,0.600000000000001,73,64,9,8,1
21700169,203083,DET,ATL,Andre Drummond,179,37.9666666666667,37,0.966666666666669,88,83,5,6,-1
21700169,203493,DET,ATL,Reggie Bullock,143,29.7166666666667,29,0.716666666666669,71,65,6,3,3
21700169,203961,DET,ATL,Eric Moreland,47,9.75,10,-0.25,19,20,-1,0,-1
21700169,204038,DET,ATL,Langston Galloway,73,15.1,15,0.0999999999999996,33,34,-1,-4,3
21700169,1628379,DET,ATL,Luke Kennard,79,16.4333333333333,17,-0.566666666666666,35,33,2,5,-3
21700170,202681,BOS,CHA,Kyrie Irving,6,1.75,2,-0.25,0,4,-4,-6,2
21700170,202694,BOS,CHA,Marcus Morris,107,23.1833333333333,23,0.183333333333334,40,43,-3,-3,0
21700170,203382,BOS,CHA,Aron Baynes,120,25.9833333333333,26,-0.0166666666666657,49,48,1,-1,2
21700170,203499,BOS,CHA,Shane Larkin,83,17.45,17,0.449999999999999,42,27,15,15,0
21700170,203935,BOS,CHA,Marcus Smart,163,34.4833333333333,34,0.483333333333334,60,68,-8,-6,-2
21700170,1626179,BOS,CHA,Terry Rozier,138,28.6333333333333,29,-0.366666666666667,59,53,6,6,0
21700170,1627759,BOS,CHA,Jaylen Brown,165,35.65,36,-0.350000000000001,66,53,13,9,4
21700170,1627824,BOS,CHA,Guerschon Yabusele,38,7.78333333333333,8,-0.216666666666667,15,8,7,9,-2
21700170,1627846,BOS,CHA,Abdel Nader,41,8.63333333333333,8,0.633333333333333,19,27,-8,-7,-1
21700170,1628369,BOS,CHA,Jayson Tatum,137,30.2833333333333,31,-0.716666666666665,57,54,3,5,-2
21700170,1628400,BOS,CHA,Semi Ojeleye,44,9.51666666666667,9,0.516666666666666,15,21,-6,-10,4
21700170,1628464,BOS,CHA,Daniel Theis,78,16.65,17,-0.350000000000001,28,29,-1,4,-5
21700170,2730,CHA,BOS,Dwight Howard,128,27.0666666666667,27,0.0666666666666664,46,58,-12,-11,-1
21700170,101107,CHA,BOS,Marvin Williams,112,24.1833333333333,24,0.18333333333333,47,39,8,8,0
21700170,202689,CHA,BOS,Kemba Walker,173,37.5,37,0.5,67,64,3,4,-1
21700170,203077,CHA,BOS,Michael Kidd-Gilchrist,126,27.6833333333333,27,0.68333333333333,47,44,3,0,3
21700170,203087,CHA,BOS,Jeremy Lamb,140,30.05,30,0.0499999999999972,51,51,0,0,0
21700170,203469,CHA,BOS,Cody Zeller,95,20.2666666666667,20,0.266666666666666,35,38,-3,-4,1
21700170,203487,CHA,BOS,Michael Carter-Williams,54,11.05,11,0.0500000000000007,20,29,-9,-10,1
21700170,1626163,CHA,BOS,Frank Kaminsky,113,24.4833333333333,24,0.483333333333334,46,45,1,1,0
21700170,1628370,CHA,BOS,Malik Monk,85,17.7666666666667,18,-0.233333333333334,38,38,0,3,-3
21700170,1628407,CHA,BOS,Dwayne Bacon,94,19.95,20,-0.0500000000000007,38,44,-6,-6,0
21700171,201577,CHI,IND,Robin Lopez,117,27,28,-1,42,61,-19,-15,-4
21700171,202347,CHI,IND,Quincy Pondexter,45,8.9,9,-0.100000000000001,23,18,5,5,0
21700171,203200,CHI,IND,Justin Holiday,134,30.5833333333333,30,0.583333333333336,51,72,-21,-19,-2
21700171,1626170,CHI,IND,Jerian Grant,73,17.1166666666667,17,0.116666666666667,27,41,-14,-14,0
21700171,1626171,CHI,IND,Bobby Portis,124,25.3833333333333,25,0.383333333333333,49,55,-6,-6,0
21700171,1626245,CHI,IND,Cristiano Felicio,75,15.1,15,0.100000000000001,35,31,4,0,4
21700171,1627739,CHI,IND,Kris Dunn,160,33.65,34,-0.350000000000001,66,66,0,0,0
21700171,1627756,CHI,IND,Denzel Valentine,102,21.7666666666667,22,-0.233333333333334,34,44,-10,-10,0
21700171,1627770,CHI,IND,Kay Felder,91,18.5333333333333,19,-0.466666666666669,39,37,2,0,2
21700171,1627835,CHI,IND,Paul Zipser,55,13.1,13,0.100000000000001,21,37,-16,-16,0
21700171,1628374,CHI,IND,Lauri Markkanen,124,28.2833333333333,28,0.283333333333331,48,63,-15,-15,0
21700171,2744,IND,CHI,Al Jefferson,5,1.06666666666667,1,0.0666666666666667,4,2,2,2,0
21700171,2863,IND,CHI,Damien Wilkins,10,1.65,2,-0.35,5,6,-1,-1,0
21700171,201152,IND,CHI,Thaddeus Young,147,33.4666666666667,33,0.466666666666669,68,49,19,19,0
21700171,201954,IND,CHI,Darren Collison,131,29.3833333333333,29,0.383333333333333,71,54,17,17,0
21700171,202362,IND,CHI,Lance Stephenson,79,16.8166666666667,16,0.816666666666666,31,28,3,5,-2
21700171,202709,IND,CHI,Cory Joseph,135,29.0666666666667,29,0.0666666666666664,58,52,6,6,0
21700171,202711,IND,CHI,Bojan Bogdanovic,156,33.95,34,-0.0499999999999972,73,62,11,11,0
21700171,203506,IND,CHI,Victor Oladipo,135,30.2833333333333,31,-0.716666666666669,70,51,19,17,2
21700171,1626167,IND,CHI,Myles Turner,121,26.5666666666667,27,-0.433333333333334,64,53,11,11,0
21700171,1626202,IND,CHI,Joe Young,14,2.5,3,-0.5,7,8,-1,-1,0
21700171,1627734,IND,CHI,Domantas Sabonis,123,26.4333333333333,26,0.433333333333334,54,46,8,8,0
21700171,1628387,IND,CHI,Ike Anigbogu,10,1.65,2,-0.35,5,6,-1,-1,0
21700171,1628388,IND,CHI,TJ Leaf,34,6.58333333333333,7,-0.416666666666667,15,18,-3,-3,0
21700172,101150,LAC,OKC,Lou Williams,187,39.05,39,0.0499999999999972,92,95,-3,-1,-2
21700172,201599,LAC,OKC,DeAndre Jordan,127,26.6666666666667,27,-0.333333333333336,52,74,-22,-18,-4
21700172,201933,LAC,OKC,Blake Griffin,194,39.6333333333333,40,-0.366666666666667,95,102,-7,-3,-4
21700172,202325,LAC,OKC,Wesley Johnson,146,28.3333333333333,29,-0.666666666666664,59,77,-18,-17,-1
21700172,203085,LAC,OKC,Austin Rivers,152,31.3,32,-0.700000000000003,68,84,-16,-16,0
21700172,203186,LAC,OKC,Willie Reed,106,21.0833333333333,21,0.0833333333333357,58,46,12,9,3
21700172,203710,LAC,OKC,C.J. Williams,2,0.116666666666667,0,0.116666666666667,1,0,1,0,1
21700172,1626149,LAC,OKC,Montrezl Harrell,41,8.4,9,-0.6,15,20,-5,-8,3
21700172,1626155,LAC,OKC,Sam Dekker,18,4.23333333333333,4,0.233333333333333,9,7,2,0,2
21700172,1628393,LAC,OKC,Jawun Evans,79,16.7666666666667,17,-0.233333333333334,47,27,20,20,0
21700172,1628414,LAC,OKC,Sindarius Thornwell,113,23.1666666666667,23,0.166666666666668,54,68,-14,-11,-3
21700172,2546,OKC,LAC,Carmelo Anthony,150,30.1666666666667,31,-0.833333333333336,87,63,24,22,2
21700172,101109,OKC,LAC,Raymond Felton,67,14.2666666666667,14,0.266666666666666,24,39,-15,-10,-5
21700172,201566,OKC,LAC,Russell Westbrook,166,33.4833333333333,34,-0.516666666666666,96,71,25,19,6
21700172,202331,OKC,LAC,Paul George,197,40.8666666666667,42,-1.13333333333333,107,82,25,27,-2
21700172,202335,OKC,LAC,Patrick Patterson,47,11.4833333333333,11,0.483333333333334,16,39,-23,-24,1
21700172,203460,OKC,LAC,Andre Roberson,118,24.7166666666667,26,-1.28333333333333,62,48,14,7,7
21700172,203518,OKC,LAC,Alex Abrines,110,21.7833333333333,21,0.783333333333331,57,61,-4,-2,-2
21700172,203924,OKC,LAC,Jerami Grant,119,22.5833333333333,23,-0.416666666666664,54,60,-6,-4,-2
21700172,203962,OKC,LAC,Josh Huestis,79,16.1,16,0.100000000000001,32,49,-17,-16,-1
21700172,1626177,OKC,LAC,Dakari Johnson,112,23.3,23,0.300000000000001,65,38,27,26,1
21700173,202339,MIL,SAS,Eric Bledsoe,130,28.3833333333333,29,-0.616666666666667,54,42,12,10,2
21700173,202732,MIL,SAS,DeAndre Liggins,14,3.1,3,0.0999999999999996,10,4,6,6,0
21700173,203089,MIL,SAS,John Henson,144,32.1833333333333,32,0.18333333333333,61,51,10,10,0
21700173,203114,MIL,SAS,Khris Middleton,173,38.05,38,0.0499999999999972,72,78,-6,-6,0
21700173,203503,MIL,SAS,Tony Snell,146,31.6833333333333,32,-0.31666666666667,67,65,2,2,0
21700173,203507,MIL,SAS,Giannis Antetokounmpo,158,35.45,36,-0.549999999999997,69,56,13,13,0
21700173,203521,MIL,SAS,Matthew Dellavedova,90,20.5333333333333,20,0.533333333333331,46,41,5,5,0
21700173,1626173,MIL,SAS,Rashad Vaughn,1,0.116666666666667,0,0.116666666666667,,0,,0,
21700173,1627748,MIL,SAS,Thon Maker,72,15.7,16,-0.300000000000001,33,36,-3,-3,0
21700173,1627763,MIL,SAS,Malcolm Brogdon,151,34.1,34,0.100000000000001,58,62,-4,-2,-2
21700173,1628391,MIL,SAS,D.J. Wilson,1,0.116666666666667,0,0.116666666666667,,0,,0,
21700173,1938,SAS,MIL,Manu Ginobili,112,25.1,25,0.100000000000001,41,47,-6,-8,2
21700173,2200,SAS,MIL,Pau Gasol,95,20.6666666666667,20,0.666666666666664,38,44,-6,-4,-2
21700173,200746,SAS,MIL,LaMarcus Aldridge,161,36.0333333333333,36,0.0333333333333314,71,69,2,0,2
21700173,200752,SAS,MIL,Rudy Gay,121,26.9666666666667,27,-0.0333333333333314,37,55,-18,-18,0
21700173,201980,SAS,MIL,Danny Green,133,29.8833333333333,30,-0.116666666666667,54,52,2,2,0
21700173,201988,SAS,MIL,Patty Mills,164,36.6333333333333,37,-0.366666666666667,71,71,0,0,0
21700173,202722,SAS,MIL,Davis Bertans,1,0.116666666666667,0,0.116666666666667,0,,,0,
21700173,203464,SAS,MIL,Brandon Paul,46,9.31666666666667,9,0.316666666666666,14,19,-5,-7,2
21700173,203937,SAS,MIL,Kyle Anderson,144,32.1666666666667,33,-0.833333333333329,69,63,6,6,0
21700173,1627749,SAS,MIL,Dejounte Murray,42,9,9,0,14,19,-5,-7,2
21700173,1627854,SAS,MIL,Bryn Forbes,61,13.5333333333333,13,0.533333333333333,26,31,-5,1,-6
21700174,201167,ORL,PHX,Arron Afflalo,38,7.36666666666667,8,-0.633333333333333,15,24,-9,-9,0
21700174,201578,ORL,PHX,Marreese Speights,31,6.08333333333333,6,0.083333333333333,15,18,-3,-3,0
21700174,202687,ORL,PHX,Bismack Biyombo,79,15.4,15,0.399999999999999,36,32,4,3,1
21700174,202696,ORL,PHX,Nikola Vucevic,136,26.2166666666667,26,0.216666666666669,77,61,16,16,0
21700174,202714,ORL,PHX,Shelvin Mack,162,31.3666666666667,31,0.366666666666667,85,71,14,15,-1
21700174,203082,ORL,PHX,Terrence Ross,119,23.6166666666667,24,-0.383333333333333,64,52,12,10,2
21700174,203095,ORL,PHX,Evan Fournier,139,26.7166666666667,27,-0.283333333333331,77,64,13,13,0
21700174,203613,ORL,PHX,Jonathon Simmons,138,26.3666666666667,26,0.366666666666667,75,50,25,26,-1
21700174,203901,ORL,PHX,Elfrid Payton,82,16.1333333333333,17,-0.866666666666667,43,38,5,3,2
21700174,203932,ORL,PHX,Aaron Gordon,159,30.6833333333333,31,-0.316666666666666,87,72,15,14,1
21700174,1626209,ORL,PHX,Mario Hezonja,38,7.36666666666667,8,-0.633333333333333,15,24,-9,-9,0
21700174,1628371,ORL,PHX,Jonathan Isaac,109,21.1833333333333,21,0.183333333333334,51,49,2,1,1
21700174,201162,PHX,ORL,Jared Dudley,84,16.45,17,-0.550000000000001,37,36,1,0,1
21700174,203458,PHX,ORL,Alex Len,198,39.2833333333333,40,-0.716666666666669,90,105,-15,-11,-4
21700174,203584,PHX,ORL,Troy Daniels,48,9.86666666666667,10,-0.133333333333333,20,23,-3,-5,2
21700174,203933,PHX,ORL,T.J. Warren,146,28.3,28,0.300000000000001,71,79,-8,-4,-4
21700174,1626164,PHX,ORL,Devin Booker,175,33.5166666666667,34,-0.483333333333334,80,90,-10,-7,-3
21700174,1627733,PHX,ORL,Dragan Bender,96,18.4666666666667,19,-0.533333333333331,42,55,-13,-13,0
21700174,1627737,PHX,ORL,Marquese Chriss,112,21,21,0,51,60,-9,-10,1
21700174,1627755,PHX,ORL,Tyler Ulis,106,19.7666666666667,20,-0.233333333333334,42,57,-15,-12,-3
21700174,1627884,PHX,ORL,Derrick Jones Jr.,10,1.91666666666667,2,-0.0833333333333333,6,5,1,-1,2
21700174,1628367,PHX,ORL,Josh Jackson,115,22,22,0,47,59,-12,-13,1
21700174,1628455,PHX,ORL,Mike James,140,27.9333333333333,29,-1.06666666666667,69,71,-2,-4,2
21700175,201609,MIA,UTA,Goran Dragic,143,32.2333333333333,33,-0.766666666666666,63,38,25,21,4
21700175,201949,MIA,UTA,James Johnson,97,22.8,23,-0.199999999999999,39,38,1,0,1
21700175,201961,MIA,UTA,Wayne Ellington,66,15.25,15,0.25,21,38,-17,-15,-2
21700175,202355,MIA,UTA,Hassan Whiteside,142,30.45,31,-0.550000000000001,52,50,2,5,-3
21700175,203079,MIA,UTA,Dion Waiters,147,31.95,32,-0.0500000000000043,63,38,25,24,1
21700175,203482,MIA,UTA,Kelly Olynyk,69,17.0833333333333,17,0.0833333333333357,32,24,8,5,3
21700175,204020,MIA,UTA,Tyler Johnson,139,32.5833333333333,33,-0.416666666666664,55,49,6,9,-3
21700175,1626159,MIA,UTA,Justise Winslow,100,21.8,22,-0.200000000000003,32,35,-3,-3,0
21700175,1626196,MIA,UTA,Josh Richardson,152,33.5166666666667,34,-0.483333333333334,63,60,3,4,-1
21700175,200757,UTA,MIA,Thabo Sefolosha,69,15.5,16,-0.5,24,22,2,2,0
21700175,201937,UTA,MIA,Ricky Rubio,106,22.8333333333333,23,-0.166666666666668,36,37,-1,-2,1
21700175,201973,UTA,MIA,Jonas Jerebko,32,7.78333333333333,8,-0.216666666666667,8,17,-9,-9,0
21700175,202324,UTA,MIA,Derrick Favors,108,24.3,24,0.299999999999997,35,44,-9,-7,-2
21700175,202327,UTA,MIA,Ekpe Udoh,47,10.2833333333333,10,0.283333333333333,16,14,2,3,-1
21700175,202692,UTA,MIA,Alec Burks,93,21.6666666666667,22,-0.333333333333332,45,37,8,8,0
21700175,203497,UTA,MIA,Rudy Gobert,154,34.7666666666667,35,-0.233333333333334,56,65,-9,-12,3
21700175,203918,UTA,MIA,Rodney Hood,150,34.2166666666667,35,-0.783333333333331,48,61,-13,-12,-1
21700175,204060,UTA,MIA,Joe Ingles,138,30.9,31,-0.100000000000001,50,57,-7,-7,0
21700175,1628378,UTA,MIA,Donovan Mitchell,158,35.4166666666667,36,-0.583333333333329,52,66,-14,-14,0
21700176,201960,BKN,POR,DeMarre Carroll,147,30.5666666666667,30,0.566666666666663,69,59,10,10,0
21700176,202389,BKN,POR,Timofey Mozgov,87,17.8666666666667,18,-0.133333333333333,37,44,-7,-9,2
21700176,203112,BKN,POR,Quincy Acy,110,24.6,25,-0.399999999999999,50,41,9,11,-2
21700176,203459,BKN,POR,Allen Crabbe,147,30.3333333333333,30,0.333333333333332,66,59,7,7,0
21700176,203915,BKN,POR,Spencer Dinwiddie,109,24.9833333333333,25,-0.0166666666666657,46,49,-3,-3,0
21700176,203925,BKN,POR,Joe Harris,89,21.2833333333333,21,0.283333333333331,37,40,-3,-3,0
21700176,1626156,BKN,POR,D'Angelo Russell,140,28.55,28,0.550000000000001,69,60,9,9,0
21700176,1626178,BKN,POR,Rondae Hollis-Jefferson,184,38.25,39,-0.75,85,84,1,1,0
21700176,1627747,BKN,POR,Caris LeVert,81,18.5666666666667,19,-0.433333333333334,35,38,-3,-3,0
21700176,1628451,BKN,POR,Jacob Wiley,21,5,5,0,11,11,0,0,0
21700176,202323,POR,BKN,Evan Turner,147,32.9833333333333,33,-0.0166666666666657,60,61,-1,-1,0
21700176,202334,POR,BKN,Ed Davis,108,23.4333333333333,23,0.43333333333333,48,53,-5,-7,2
21700176,203081,POR,BKN,Damian Lillard,171,35.9166666666667,36,-0.0833333333333357,70,82,-12,-12,0
21700176,203090,POR,BKN,Maurice Harkless,150,31.5166666666667,32,-0.483333333333334,72,68,4,4,0
21700176,203468,POR,BKN,CJ McCollum,161,34.1166666666667,34,0.116666666666667,80,75,5,5,0
21700176,203894,POR,BKN,Shabazz Napier,85,19.4,20,-0.600000000000001,36,38,-2,-1,-1
21700176,203943,POR,BKN,Noah Vonleh,79,15.1666666666667,16,-0.833333333333332,34,40,-6,-6,0
21700176,203994,POR,BKN,Jusuf Nurkic,114,24.4666666666667,25,-0.533333333333331,49,48,1,3,-2
21700176,1626192,POR,BKN,Pat Connaughton,77,17.2666666666667,17,0.266666666666666,26,36,-10,-10,0
21700176,1628403,POR,BKN,Caleb Swanigan,23,5.73333333333333,6,-0.266666666666667,10,4,6,5,1
21700177,201158,ATL,WAS,Marco Belinelli,124,24.1166666666667,24,0.116666666666667,36,54,-18,-16,-2
21700177,202337,ATL,WAS,Luke Babbitt,155,31.5166666666667,32,-0.483333333333334,59,78,-19,-15,-4
21700177,203145,ATL,WAS,Kent Bazemore,122,24.6833333333333,24,0.683333333333334,45,59,-14,-20,6
21700177,203471,ATL,WAS,Dennis Schroder,157,30.8666666666667,31,-0.133333333333333,57,73,-16,-18,2
21700177,203473,ATL,WAS,Dewayne Dedmon,143,27.15,27,0.149999999999999,53,59,-6,-10,4
21700177,1627098,ATL,WAS,Malcolm Delaney,77,15.2333333333333,15,0.233333333333334,30,37,-7,-3,-4
21700177,1627752,ATL,WAS,Taurean Prince,170,33.5166666666667,34,-0.483333333333334,66,84,-18,-20,2
21700177,1627819,ATL,WAS,Isaiah Taylor,72,15.8166666666667,16,-0.183333333333334,35,32,3,3,0
21700177,1628381,ATL,WAS,John Collins,105,22.1666666666667,22,0.166666666666664,46,55,-9,-5,-4
21700177,1628416,ATL,WAS,Tyler Dorsey,30,6.31666666666667,7,-0.683333333333334,20,17,3,3,0
21700177,1628463,ATL,WAS,Tyler Cavanaugh,35,7.2,8,-0.8,23,17,6,6,0
21700177,101133,WAS,ATL,Ian Mahinmi,78,15,15,0,35,29,6,3,3
21700177,101162,WAS,ATL,Marcin Gortat,123,25.5833333333333,26,-0.416666666666664,55,45,10,13,-3
21700177,201975,WAS,ATL,Jodie Meeks,103,20.2666666666667,20,0.266666666666666,51,49,2,0,2
21700177,202322,WAS,ATL,John Wall,118,23.85,24,-0.149999999999999,56,47,9,9,0
21700177,202693,WAS,ATL,Markieff Morris,98,20.0333333333333,20,0.0333333333333314,50,34,16,16,0
21700177,203078,WAS,ATL,Bradley Beal,135,27.45,28,-0.550000000000001,62,45,17,19,-2
21700177,203107,WAS,ATL,Tomas Satoransky,20,3.85,4,-0.15,6,9,-3,-4,1
21700177,203118,WAS,ATL,Mike Scott,130,25.3333333333333,25,0.333333333333332,57,50,7,7,0
21700177,203490,WAS,ATL,Otto Porter Jr.,121,24.5666666666667,25,-0.433333333333334,61,46,15,16,-1
21700177,204025,WAS,ATL,Tim Frazier,120,23.8666666666667,24,-0.133333333333333,57,47,10,10,0
21700177,1626162,WAS,ATL,Kelly Oubre Jr.,114,22.4666666666667,23,-0.533333333333331,58,49,9,9,0
21700177,1626191,WAS,ATL,Chris McCullough,30,6.31666666666667,7,-0.683333333333334,17,20,-3,-3,0
21700178,2749,NOP,LAC,Jameer Nelson,142,28.7833333333333,29,-0.216666666666669,74,64,10,13,-3
21700178,201950,NOP,LAC,Jrue Holiday,164,34.3333333333333,35,-0.666666666666671,73,72,1,0,1
21700178,201967,NOP,LAC,Dante Cunningham,99,21.3833333333333,21,0.383333333333333,51,43,8,6,2
21700178,202326,NOP,LAC,DeMarcus Cousins,174,37.1166666666667,37,0.11666666666666,80,75,5,5,0
21700178,202734,NOP,LAC,E'Twaun Moore,158,32.65,33,-0.349999999999994,79,71,8,8,0
21700178,203076,NOP,LAC,Anthony Davis,190,39.5,40,-0.5,95,89,6,11,-5
21700178,203121,NOP,LAC,Darius Miller,45,8.8,9,-0.199999999999999,21,22,-1,-5,4
21700178,203546,NOP,LAC,Ian Clark,87,17.9,18,-0.100000000000001,37,37,0,2,-2
21700178,1627767,NOP,LAC,Cheick Diallo,96,18.8666666666667,19,-0.133333333333333,45,42,3,0,3
21700178,101150,LAC,NOP,Lou Williams,179,36.3,36,0.299999999999997,79,89,-10,-9,-1
21700178,201599,LAC,NOP,DeAndre Jordan,177,37.1833333333333,37,0.183333333333337,80,85,-5,-5,0
21700178,201933,LAC,NOP,Blake Griffin,182,38.5166666666667,38,0.516666666666666,80,92,-12,-13,1
21700178,202325,LAC,NOP,Wesley Johnson,87,18.05,18,0.0499999999999972,44,37,7,4,3
21700178,203085,LAC,NOP,Austin Rivers,158,34.1833333333333,34,0.183333333333337,69,74,-5,-3,-2
21700178,203186,LAC,NOP,Willie Reed,54,10.6833333333333,11,-0.316666666666666,23,26,-3,-3,0
21700178,1626149,LAC,NOP,Montrezl Harrell,47,9.1,9,0.0999999999999996,23,17,6,5,1
21700178,1627744,LAC,NOP,Brice Johnson,2,0.25,0,0.25,0,2,-2,0,-2
21700178,1628393,LAC,NOP,Jawun Evans,115,23.0166666666667,23,0.0166666666666657,51,60,-9,-7,-2
21700178,1628414,LAC,NOP,Sindarius Thornwell,154,32.05,32,0.0499999999999972,66,73,-7,-9,2
21700179,101127,NYK,SAC,Jarrett Jack,109,24.6833333333333,25,-0.316666666666666,56,43,13,17,-4
21700179,201563,NYK,SAC,Michael Beasley,99,21.1333333333333,21,0.133333333333333,46,50,-4,-4,0
21700179,201584,NYK,SAC,Courtney Lee,130,29.4,30,-0.600000000000001,73,53,20,20,0
21700179,202683,NYK,SAC,Enes Kanter,119,26.3666666666667,26,0.366666666666667,59,42,17,19,-2
21700179,203124,NYK,SAC,Kyle O'Quinn,61,12.9333333333333,13,-0.0666666666666664,41,28,13,11,2
21700179,203501,NYK,SAC,Tim Hardaway Jr.,109,23.8666666666667,24,-0.133333333333333,63,41,22,22,0
21700179,203926,NYK,SAC,Doug McDermott,135,28.1666666666667,28,0.166666666666664,72,58,14,14,0
21700179,204001,NYK,SAC,Kristaps Porzingis,123,26.6166666666667,27,-0.383333333333333,72,41,31,31,0
21700179,1626195,NYK,SAC,Willy Hernangomez,42,8.45,9,-0.550000000000001,18,21,-3,-3,0
21700179,1628373,NYK,SAC,Frank Ntilikina,113,23.0666666666667,23,0.0666666666666664,62,48,14,10,4
21700179,1628422,NYK,SAC,Damyean Dotson,70,14.0666666666667,14,0.0666666666666664,28,30,-2,-2,0
21700179,2216,SAC,NYK,Zach Randolph,86,19.8333333333333,20,-0.166666666666664,28,49,-21,-21,0
21700179,201585,SAC,NYK,Kosta Koufos,123,25.5666666666667,26,-0.433333333333334,50,66,-16,-16,0
21700179,201588,SAC,NYK,George Hill,94,20.9833333333333,21,-0.0166666666666657,35,53,-18,-20,2
21700179,202066,SAC,NYK,Garrett Temple,97,21.75,22,-0.25,35,53,-18,-18,0
21700179,203992,SAC,NYK,Bogdan Bogdanovic,94,21.0333333333333,21,0.0333333333333314,33,50,-17,-17,0
21700179,1626161,SAC,NYK,Willie Cauley-Stein,73,16.7333333333333,17,-0.266666666666666,26,39,-13,-13,0
21700179,1627741,SAC,NYK,Buddy Hield,128,26.7166666666667,27,-0.283333333333331,58,68,-10,-10,0
21700179,1627746,SAC,NYK,Skal Labissiere,118,24.5833333333333,25,-0.416666666666668,58,59,-1,0,-1
21700179,1628368,SAC,NYK,De'Aaron Fox,117,24.7,25,-0.300000000000001,50,62,-12,-10,-2
21700179,1628382,SAC,NYK,Justin Jackson,120,25.0666666666667,25,0.0666666666666664,56,63,-7,-7,0
21700179,1628412,SAC,NYK,Frank Mason,60,11.7833333333333,12,-0.216666666666667,26,28,-2,-3,1
21700180,2403,HOU,MEM,Nene,37,7.31666666666667,7,0.316666666666666,15,20,-5,-4,-1
21700180,2772,HOU,MEM,Trevor Ariza,164,34.8833333333333,34,0.883333333333333,85,67,18,18,0
21700180,200782,HOU,MEM,PJ Tucker,137,28.4833333333333,28,0.483333333333334,69,63,6,6,0
21700180,201569,HOU,MEM,Eric Gordon,150,32.4833333333333,33,-0.516666666666666,77,70,7,8,-1
21700180,201583,HOU,MEM,Ryan Anderson,117,26.5833333333333,27,-0.416666666666664,70,49,21,17,4
21700180,201601,HOU,MEM,Luc Mbah a Moute,129,27.55,28,-0.450000000000003,60,62,-2,-3,1
21700180,201628,HOU,MEM,Bobby Brown,9,2.36666666666667,3,-0.633333333333333,2,2,0,0,0
21700180,201935,HOU,MEM,James Harden,178,37.8833333333333,38,-0.116666666666667,92,71,21,23,-2
21700180,203991,HOU,MEM,Clint Capela,157,34.2666666666667,35,-0.733333333333334,79,70,9,10,-1
21700180,204028,HOU,MEM,Tarik Black,9,2.36666666666667,3,-0.633333333333333,2,2,0,0,0
21700180,1627743,HOU,MEM,Demetrius Jackson,9,2.36666666666667,3,-0.633333333333333,2,2,0,0,0
21700180,1627753,HOU,MEM,Zhou Qi,9,2.36666666666667,3,-0.633333333333333,2,2,0,0,0
21700180,201144,MEM,HOU,Mike Conley,126,27.3166666666667,28,-0.683333333333334,50,61,-11,-14,3
21700180,201148,MEM,HOU,Brandan Wright,68,14.4166666666667,14,0.416666666666668,34,30,4,4,0
21700180,201188,MEM,HOU,Marc Gasol,131,28.3833333333333,28,0.383333333333333,51,73,-22,-22,0
21700180,201596,MEM,HOU,Mario Chalmers,92,18.8333333333333,19,-0.166666666666668,39,55,-16,-13,-3
21700180,201936,MEM,HOU,Tyreke Evans,141,28.8166666666667,29,-0.183333333333334,66,64,2,1,1
21700180,202718,MEM,HOU,Chandler Parsons,95,20.3666666666667,20,0.366666666666667,43,58,-15,-12,-3
21700180,203463,MEM,HOU,Ben McLemore,88,18.6166666666667,18,0.616666666666667,38,33,5,4,1
21700180,203516,MEM,HOU,James Ennis III,120,26.3333333333333,26,0.333333333333332,48,61,-13,-10,-3
21700180,1626150,MEM,HOU,Andrew Harrison,22,4.98333333333333,5,-0.0166666666666666,11,8,3,3,0
21700180,1626185,MEM,HOU,Jarell Martin,63,14.55,15,-0.449999999999999,25,38,-13,-14,1
21700180,1627738,MEM,HOU,Deyonta Davis,22,4.98333333333333,5,-0.0166666666666666,11,8,3,3,0
21700180,1627782,MEM,HOU,Wayne Selden,18,4.35,4,0.35,11,5,6,4,2
21700180,1628415,MEM,HOU,Dillon Brooks,119,26.9666666666667,28,-1.03333333333333,53,61,-8,-9,1
21700181,2544,CLE,DAL,LeBron James,201,41.7166666666667,42,-0.283333333333331,100,95,5,5,0
21700181,2548,CLE,DAL,Dwyane Wade,71,14.55,15,-0.449999999999999,28,30,-2,-2,0
21700181,2594,CLE,DAL,Kyle Korver,94,19.5166666666667,20,-0.483333333333334,35,42,-7,-5,-2
21700181,2747,CLE,DAL,JR Smith,185,38.4,38,0.399999999999999,96,86,10,8,2
21700181,101112,CLE,DAL,Channing Frye,14,2.75,3,-0.25,2,6,-4,-2,-2
21700181,201145,CLE,DAL,Jeff Green,77,14.9666666666667,15,-0.033333333333335,33,31,2,2,0
21700181,201567,CLE,DAL,Kevin Love,162,35.4166666666667,36,-0.583333333333336,83,70,13,13,0
21700181,202697,CLE,DAL,Iman Shumpert,176,37.25,37,0.25,87,80,7,7,0
21700181,203109,CLE,DAL,Jae Crowder,170,35.1,35,0.100000000000001,91,80,11,9,2
21700181,1717,DAL,CLE,Dirk Nowitzki,123,24.7166666666667,25,-0.283333333333335,57,62,-5,-3,-2
21700181,2734,DAL,CLE,Devin Harris,60,12.3666666666667,12,0.366666666666667,21,22,-1,-3,2
21700181,200826,DAL,CLE,J.J. Barea,103,21.8,22,-0.200000000000003,36,40,-4,-2,-2
21700181,202083,DAL,CLE,Wesley Matthews,199,41.25,41,0.25,92,99,-7,-7,0
21700181,203084,DAL,CLE,Harrison Barnes,190,39.6333333333333,39,0.633333333333333,92,93,-1,-3,2
21700181,203939,DAL,CLE,Dwight Powell,76,15.7833333333333,16,-0.216666666666667,23,36,-13,-11,-2
21700181,1626257,DAL,CLE,Salah Mejri,45,9.88333333333333,10,-0.116666666666667,25,23,2,2,0
21700181,1627812,DAL,CLE,Yogi Ferrell,169,35.5166666666667,36,-0.483333333333334,83,87,-4,-4,0
21700181,1627827,DAL,CLE,Dorian Finney-Smith,30,6.63333333333333,7,-0.366666666666667,12,10,2,0,2
21700181,1628372,DAL,CLE,Dennis Smith Jr.,144,29.9,30,-0.100000000000001,75,77,-2,-4,2
21700181,1628467,DAL,CLE,Maxi Kleber,11,2.18333333333333,2,0.183333333333333,4,6,-2,0,-2
21700182,201147,LAL,MIL,Corey Brewer,29,6.35,6,0.35,7,15,-8,-8,0
21700182,201572,LAL,MIL,Brook Lopez,103,21,21,0,41,35,6,8,-2
21700182,203484,LAL,MIL,Kentavious Caldwell-Pope,172,34.8333333333333,35,-0.166666666666671,63,75,-12,-14,2
21700182,203505,LAL,MIL,Vander Blue,59,14.3333333333333,14,0.333333333333332,31,25,6,6,0
21700182,203903,LAL,MIL,Jordan Clarkson,88,20.0333333333333,20,0.0333333333333314,35,43,-8,-6,-2
21700182,203944,LAL,MIL,Julius Randle,123,26.7833333333333,27,-0.216666666666669,49,63,-14,-16,2
21700182,1627742,LAL,MIL,Brandon Ingram,175,35.5666666666667,36,-0.433333333333337,59,79,-20,-20,0
21700182,1628366,LAL,MIL,Lonzo Ball,184,38.5833333333333,39,-0.416666666666671,82,72,10,10,0
21700182,1628398,LAL,MIL,Kyle Kuzma,197,41.4333333333333,42,-0.566666666666663,83,83,0,0,0
21700182,202339,MIL,LAL,Eric Bledsoe,153,31.1666666666667,31,0.166666666666664,60,68,-8,-8,0
21700182,202732,MIL,LAL,DeAndre Liggins,61,14.4833333333333,15,-0.516666666666666,26,22,4,1,3
21700182,203089,MIL,LAL,John Henson,129,25.8166666666667,26,-0.183333333333334,49,59,-10,-9,-1
21700182,203114,MIL,LAL,Khris Middleton,186,38.05,38,0.0499999999999972,77,80,-3,-2,-1
21700182,203503,MIL,LAL,Tony Snell,90,18.6833333333333,19,-0.316666666666666,30,44,-14,-15,1
21700182,203507,MIL,LAL,Giannis Antetokounmpo,191,39.9,40,-0.100000000000001,86,74,12,13,-1
21700182,203521,MIL,LAL,Matthew Dellavedova,70,15.85,15,0.85,37,19,18,20,-2
21700182,1627748,MIL,LAL,Thon Maker,97,21.9666666666667,22,-0.0333333333333314,49,31,18,17,1
21700182,1627763,MIL,LAL,Malcolm Brogdon,153,33,33,0,76,53,23,23,0
21700183,201577,CHI,SAS,Robin Lopez,120,27.5333333333333,28,-0.466666666666669,55,78,-23,-23,0
21700183,202347,CHI,SAS,Quincy Pondexter,64,13.35,13,0.35,27,41,-14,-12,-2
21700183,203200,CHI,SAS,Justin Holiday,109,24.5833333333333,25,-0.416666666666664,50,65,-15,-15,0
21700183,1626170,CHI,SAS,Jerian Grant,143,31.9833333333333,32,-0.0166666666666657,70,93,-23,-21,-2
21700183,1626171,CHI,SAS,Bobby Portis,135,29.3,30,-0.699999999999999,61,86,-25,-23,-2
21700183,1626245,CHI,SAS,Cristiano Felicio,87,18.5333333333333,19,-0.466666666666669,37,52,-15,-15,0
21700183,1627739,CHI,SAS,Kris Dunn,116,25.65,26,-0.350000000000001,53,66,-13,-15,2
21700183,1627756,CHI,SAS,Denzel Valentine,136,30.3166666666667,30,0.316666666666666,52,85,-33,-33,0
21700183,1627770,CHI,SAS,Kay Felder,65,14.3666666666667,15,-0.633333333333333,24,41,-17,-19,2
21700183,1627835,CHI,SAS,Paul Zipser,34,7.53333333333333,8,-0.466666666666667,11,22,-11,-11,0
21700183,1628374,CHI,SAS,Lauri Markkanen,66,14.9333333333333,15,-0.0666666666666664,30,36,-6,-8,2
21700183,2200,SAS,CHI,Pau Gasol,119,27.0666666666667,27,0.0666666666666664,72,52,20,22,-2
21700183,200746,SAS,CHI,LaMarcus Aldridge,90,20.95,21,-0.0500000000000007,61,45,16,16,0
21700183,200752,SAS,CHI,Rudy Gay,87,18.4833333333333,18,0.483333333333334,45,23,22,22,0
21700183,201988,SAS,CHI,Patty Mills,83,19.9,20,-0.100000000000001,60,50,10,10,0
21700183,202722,SAS,CHI,Davis Bertans,85,18.55,19,-0.449999999999999,57,44,13,11,2
21700183,203464,SAS,CHI,Brandon Paul,119,25.3666666666667,25,0.366666666666667,66,39,27,23,4
21700183,203937,SAS,CHI,Kyle Anderson,109,24.8,25,-0.200000000000003,68,52,16,16,0
21700183,1626199,SAS,CHI,Darrun Hilliard,69,14.7,15,-0.300000000000001,44,31,13,13,0
21700183,1627749,SAS,CHI,Dejounte Murray,116,24.3666666666667,25,-0.633333333333333,67,37,30,32,-2
21700183,1627854,SAS,CHI,Bryn Forbes,149,33.7166666666667,34,-0.283333333333331,94,73,21,23,-2
21700183,1627856,SAS,CHI,Matt Costello,49,10.1833333333333,11,-0.816666666666666,31,24,7,7,0
21700184,2561,GSW,PHI,David West,47,9.48333333333333,9,0.483333333333334,25,27,-2,-2,0
21700184,2585,GSW,PHI,Zaza Pachulia,59,11.1666666666667,12,-0.833333333333334,23,24,-1,1,-2
21700184,2733,GSW,PHI,Shaun Livingston,88,18.1,19,-0.899999999999999,49,47,2,2,0
21700184,201142,GSW,PHI,Kevin Durant,150,28.3,28,0.299999999999997,84,62,22,24,-2
21700184,201156,GSW,PHI,Nick Young,105,20.8833333333333,21,-0.116666666666667,72,46,26,22,4
21700184,201580,GSW,PHI,JaVale McGee,47,8.65,9,-0.35,31,22,9,7,2
21700184,201939,GSW,PHI,Stephen Curry,154,29.6666666666667,30,-0.333333333333336,90,61,29,29,0
21700184,201956,GSW,PHI,Omri Casspi,71,13.1,13,0.0999999999999996,36,37,-1,-2,1
21700184,202691,GSW,PHI,Klay Thompson,159,29.95,30,-0.0499999999999972,82,68,14,14,0
21700184,203110,GSW,PHI,Draymond Green,158,30.9666666666667,31,-0.0333333333333314,79,71,8,8,0
21700184,1626172,GSW,PHI,Kevon Looney,73,15.2333333333333,15,0.233333333333333,46,29,17,14,3
21700184,1627775,GSW,PHI,Patrick McCaw,84,15.7333333333333,16,-0.266666666666666,38,51,-13,-13,0
21700184,1628395,GSW,PHI,Jordan Bell,40,7.35,8,-0.65,20,15,5,1,4
21700184,200755,PHI,GSW,JJ Redick,151,29.2333333333333,30,-0.766666666666666,71,93,-22,-22,0
21700184,203496,PHI,GSW,Robert Covington,156,29.55,30,-0.450000000000003,59,88,-29,-27,-2
21700184,203949,PHI,GSW,James Michael McAdoo,36,6.58333333333333,7,-0.416666666666666,15,18,-3,-1,-2
21700184,203954,PHI,GSW,Joel Embiid,123,24.7833333333333,25,-0.216666666666669,56,62,-6,-9,3
21700184,203967,PHI,GSW,Dario Saric,133,26.3666666666667,27,-0.633333333333333,69,69,0,-4,4
21700184,204456,PHI,GSW,T.J. McConnell,152,29.4,29,0.399999999999999,64,89,-25,-19,-6
21700184,1626147,PHI,GSW,Justin Anderson,79,15.75,16,-0.25,48,37,11,8,3
21700184,1626158,PHI,GSW,Richaun Holmes,115,21.4666666666667,21,0.466666666666669,54,68,-14,-10,-4
21700184,1627732,PHI,GSW,Ben Simmons,151,28.8833333333333,29,-0.116666666666667,68,76,-8,-10,2
21700184,1627788,PHI,GSW,Furkan Korkmaz,17,3.11666666666667,3,0.116666666666667,5,11,-6,-2,-4
21700184,1627789,PHI,GSW,Timothe Luwawu-Cabarrot,122,23.45,23,0.449999999999999,51,64,-13,-9,-4
21700185,200794,DEN,ORL,Paul Millsap,164,36,36,0,95,86,9,9,0
21700185,201163,DEN,ORL,Wilson Chandler,195,41.2666666666667,41,0.266666666666666,102,89,13,13,0
21700185,202702,DEN,ORL,Kenneth Faried,43,8.51666666666667,9,-0.483333333333334,20,11,9,9,0
21700185,203115,DEN,ORL,Will Barton,169,37.8333333333333,38,-0.166666666666671,108,90,18,18,0
21700185,203486,DEN,ORL,Mason Plumlee,48,10.1333333333333,10,0.133333333333333,28,25,3,3,0
21700185,203999,DEN,ORL,Nikola Jokic,181,37.75,38,-0.25,99,74,25,25,0
21700185,1626144,DEN,ORL,Emmanuel Mudiay,115,22.8333333333333,23,-0.166666666666664,53,54,-1,1,-2
21700185,1626168,DEN,ORL,Trey Lyles,7,1.75,2,-0.25,4,9,-5,-5,0
21700185,1627736,DEN,ORL,Malik Beasley,42,8.06666666666667,8,0.0666666666666664,18,14,4,4,0
21700185,1627750,DEN,ORL,Jamal Murray,154,33.85,34,-0.149999999999999,94,74,20,18,2
21700185,1627823,DEN,ORL,Juancho Hernangomez,7,1.75,2,-0.25,4,9,-5,-5,0
21700185,201167,ORL,DEN,Arron Afflalo,108,21.4333333333333,21,0.433333333333334,48,47,1,5,-4
21700185,201578,ORL,DEN,Marreese Speights,86,17.7166666666667,18,-0.283333333333331,46,36,10,10,0
21700185,202687,ORL,DEN,Bismack Biyombo,108,21.4333333333333,21,0.433333333333334,48,47,1,5,-4
21700185,202696,ORL,DEN,Nikola Vucevic,106,24.15,24,0.149999999999999,54,72,-18,-18,0
21700185,202714,ORL,DEN,Shelvin Mack,107,24.4166666666667,24,0.416666666666664,68,71,-3,-5,2
21700185,203082,ORL,DEN,Terrence Ross,119,25.45,26,-0.550000000000001,42,69,-27,-31,4
21700185,203095,ORL,DEN,Evan Fournier,117,26.5166666666667,27,-0.483333333333334,59,78,-19,-23,4
21700185,203613,ORL,DEN,Jonathon Simmons,134,27.2333333333333,27,0.233333333333334,57,62,-5,-3,-2
21700185,203932,ORL,DEN,Aaron Gordon,135,30.0333333333333,30,0.0333333333333314,66,89,-23,-24,1
21700185,1626209,ORL,DEN,Mario Hezonja,24,5.35,5,0.35,16,13,3,3,0
21700185,1628371,ORL,DEN,Jonathan Isaac,81,16.0166666666667,16,0.0166666666666657,31,41,-10,-9,-1
21700186,2037,MIN,PHX,Jamal Crawford,45,9.16666666666667,9,0.166666666666666,19,26,-7,-5,-2
21700186,201952,MIN,PHX,Jeff Teague,161,30.9666666666667,31,-0.0333333333333314,67,89,-22,-23,1
21700186,201959,MIN,PHX,Taj Gibson,189,37,37,0,87,90,-3,-5,2
21700186,202357,MIN,PHX,Nemanja Bjelica,92,19.4666666666667,20,-0.533333333333331,49,31,18,17,1
21700186,202710,MIN,PHX,Jimmy Butler,204,40.6166666666667,40,0.61666666666666,94,102,-8,-9,1
21700186,203498,MIN,PHX,Shabazz Muhammad,44,8.8,9,-0.199999999999999,21,21,0,0,0
21700186,203952,MIN,PHX,Andrew Wiggins,195,38.35,38,0.349999999999994,89,92,-3,-3,0
21700186,1626145,MIN,PHX,Tyus Jones,81,17.0333333333333,17,0.0333333333333314,43,29,14,15,-1
21700186,1626157,MIN,PHX,Karl-Anthony Towns,199,38.6,39,-0.399999999999999,81,110,-29,-27,-2
21700186,2199,PHX,MIN,Tyson Chandler,141,27.6333333333333,28,-0.366666666666667,73,53,20,22,-2
21700186,203458,PHX,MIN,Alex Len,93,19.7333333333333,20,-0.266666666666666,38,53,-15,-17,2
21700186,203584,PHX,MIN,Troy Daniels,36,6.85,7,-0.15,10,19,-9,-6,-3
21700186,203933,PHX,MIN,T.J. Warren,197,39.3,39,0.299999999999997,109,81,28,26,2
21700186,1626164,PHX,MIN,Devin Booker,193,38.85,39,-0.150000000000006,102,85,17,16,1
21700186,1627733,PHX,MIN,Dragan Bender,92,18.7333333333333,19,-0.266666666666666,32,45,-13,-12,-1
21700186,1627737,PHX,MIN,Marquese Chriss,131,25.65,26,-0.350000000000001,78,60,18,15,3
21700186,1627755,PHX,MIN,Tyler Ulis,132,25.6333333333333,26,-0.366666666666667,74,51,23,24,-1
21700186,1628367,PHX,MIN,Josh Jackson,105,18.7166666666667,19,-0.283333333333331,43,58,-15,-13,-2
21700186,1628455,PHX,MIN,Mike James,90,18.9,19,-0.100000000000001,31,45,-14,-15,1
21700187,201960,BKN,UTA,DeMarre Carroll,158,31.95,32,-0.0500000000000007,73,68,5,2,3
21700187,202344,BKN,UTA,Trevor Booker,94,20.15,20,0.149999999999999,49,49,0,1,-1
21700187,202389,BKN,UTA,Timofey Mozgov,51,10.6333333333333,11,-0.366666666666667,12,30,-18,-20,2
21700187,203112,BKN,UTA,Quincy Acy,103,23.0666666666667,23,0.0666666666666664,56,50,6,9,-3
21700187,203459,BKN,UTA,Allen Crabbe,152,30.8333333333333,31,-0.166666666666668,68,68,0,-7,7
21700187,203925,BKN,UTA,Joe Harris,119,23.5,24,-0.5,54,61,-7,-9,2
21700187,203930,BKN,UTA,Sean Kilpatrick,9,1.78333333333333,2,-0.216666666666667,8,4,4,7,-3
21700187,1626156,BKN,UTA,D'Angelo Russell,150,32.1833333333333,33,-0.816666666666663,76,69,7,1,6
21700187,1626178,BKN,UTA,Rondae Hollis-Jefferson,150,30.9,31,-0.100000000000001,63,74,-11,-16,5
21700187,1627747,BKN,UTA,Caris LeVert,102,21.15,21,0.149999999999999,45,58,-13,-10,-3
21700187,1627785,BKN,UTA,Isaiah Whitehead,62,13.1,13,0.0999999999999996,26,39,-13,-11,-2
21700187,200757,UTA,BKN,Thabo Sefolosha,157,32.1166666666667,32,0.116666666666667,81,62,19,21,-2
21700187,201937,UTA,BKN,Ricky Rubio,170,36.3666666666667,36,0.36666666666666,77,76,1,11,-10
21700187,201973,UTA,BKN,Jonas Jerebko,53,11.5166666666667,11,0.516666666666666,28,34,-6,-8,2
21700187,202324,UTA,BKN,Derrick Favors,175,35.4,36,-0.600000000000001,82,77,5,11,-6
21700187,202327,UTA,BKN,Ekpe Udoh,55,12.45,12,0.449999999999999,32,29,3,1,2
21700187,202692,UTA,BKN,Alec Burks,65,13.6166666666667,14,-0.383333333333333,35,33,2,3,-1
21700187,203526,UTA,BKN,Raul Neto,25,5.91666666666667,6,-0.0833333333333339,14,19,-5,-7,2
21700187,203918,UTA,BKN,Rodney Hood,146,30.1833333333333,30,0.18333333333333,74,72,2,11,-9
21700187,204060,UTA,BKN,Joe Ingles,166,34.3,34,0.299999999999997,74,76,-2,3,-5
21700187,1626220,UTA,BKN,Royce O'Neale,10,2.1,2,0.1,10,3,7,5,2
21700187,1628378,UTA,BKN,Donovan Mitchell,128,25.2833333333333,26,-0.716666666666669,63,49,14,9,5
21700188,201143,BOS,TOR,Al Horford,146,33.2,33,0.200000000000003,75,71,4,4,0
21700188,202694,BOS,TOR,Marcus Morris,103,21.6833333333333,22,-0.316666666666666,43,43,0,-2,2
21700188,203382,BOS,TOR,Aron Baynes,92,20.3833333333333,20,0.383333333333333,53,43,10,9,1
21700188,203499,BOS,TOR,Shane Larkin,64,13.65,14,-0.350000000000001,20,21,-1,-4,3
21700188,203935,BOS,TOR,Marcus Smart,145,32.4333333333333,32,0.43333333333333,77,66,11,11,0
21700188,1626179,BOS,TOR,Terry Rozier,127,28.2333333333333,28,0.233333333333334,44,49,-5,-2,-3
21700188,1627759,BOS,TOR,Jaylen Brown,150,32.8333333333333,33,-0.166666666666671,73,68,5,6,-1
21700188,1628369,BOS,TOR,Jayson Tatum,142,33,33,0,63,62,1,2,-1
21700188,1628400,BOS,TOR,Semi Ojeleye,33,7.01666666666667,7,0.0166666666666666,7,19,-12,-13,1
21700188,1628464,BOS,TOR,Daniel Theis,78,17.4,17,0.399999999999999,20,28,-8,-6,-2
21700188,101139,TOR,BOS,CJ Miles,98,21.0333333333333,21,0.0333333333333314,41,25,16,17,-1
21700188,200768,TOR,BOS,Kyle Lowry,136,30.6833333333333,31,-0.31666666666667,60,63,-3,-4,1
21700188,201586,TOR,BOS,Serge Ibaka,133,30.2,30,0.200000000000003,61,73,-12,-14,2
21700188,201942,TOR,BOS,DeMar DeRozan,157,35.0833333333333,35,0.0833333333333286,74,77,-3,-3,0
21700188,202685,TOR,BOS,Jonas Valanciunas,83,18.3166666666667,18,0.316666666666666,42,46,-4,-6,2
21700188,203512,TOR,BOS,Lucas Nogueira,90,19.0666666666667,19,0.0666666666666664,35,30,5,9,-4
21700188,1626153,TOR,BOS,Delon Wright,81,17.4833333333333,18,-0.516666666666666,34,32,2,3,-1
21700188,1626181,TOR,BOS,Norman Powell,35,7.1,7,0.0999999999999996,16,18,-2,-2,0
21700188,1627751,TOR,BOS,Jakob Poeltl,17,3.58333333333333,4,-0.416666666666667,5,9,-4,-4,0
21700188,1627783,TOR,BOS,Pascal Siakam,90,19.5666666666667,19,0.566666666666666,35,32,3,7,-4
21700188,1627832,TOR,BOS,Fred VanVleet,72,16.2333333333333,16,0.233333333333334,26,24,2,2,0
21700188,1628384,TOR,BOS,OG Anunoby,88,21.4833333333333,22,-0.516666666666666,41,46,-5,-10,5
21700189,201609,MIA,DET,Goran Dragic,163,34.4666666666667,35,-0.533333333333331,77,79,-2,-3,1
21700189,201949,MIA,DET,James Johnson,124,25.8166666666667,26,-0.183333333333334,49,74,-25,-23,-2
21700189,201961,MIA,DET,Wayne Ellington,43,9.41666666666667,9,0.416666666666666,18,22,-4,-3,-1
21700189,202355,MIA,DET,Hassan Whiteside,133,29.3166666666667,29,0.316666666666666,64,64,0,-2,2
21700189,203079,MIA,DET,Dion Waiters,146,31.2,32,-0.800000000000004,65,62,3,3,0
21700189,203482,MIA,DET,Kelly Olynyk,76,16.2833333333333,16,0.283333333333331,33,43,-10,-8,-2
21700189,204020,MIA,DET,Tyler Johnson,153,33.15,33,0.149999999999999,72,87,-15,-14,-1
21700189,1626159,MIA,DET,Justise Winslow,107,23.7166666666667,24,-0.283333333333331,58,53,5,4,1
21700189,1626196,MIA,DET,Josh Richardson,165,35.3833333333333,36,-0.616666666666667,79,76,3,1,2
21700189,201229,DET,MIA,Anthony Tolliver,84,18.3333333333333,19,-0.666666666666668,44,34,10,9,1
21700189,202340,DET,MIA,Avery Bradley,145,30,30,0,66,68,-2,-2,0
21700189,202397,DET,MIA,Ish Smith,84,18.9166666666667,19,-0.0833333333333357,50,38,12,12,0
21700189,202699,DET,MIA,Tobias Harris,172,36.2,37,-0.799999999999997,85,82,3,4,-1
21700189,202704,DET,MIA,Reggie Jackson,138,28.8333333333333,29,-0.166666666666668,62,65,-3,-3,0
21700189,203083,DET,MIA,Andre Drummond,168,36.25,36,0.25,88,77,11,11,0
21700189,203493,DET,MIA,Reggie Bullock,93,20.25,20,0.25,38,54,-16,-12,-4
21700189,203961,DET,MIA,Eric Moreland,20,4.71666666666667,5,-0.283333333333333,7,13,-6,-6,0
21700189,204038,DET,MIA,Langston Galloway,77,17.75,18,-0.25,46,35,11,11,0
21700189,1628379,DET,MIA,Luke Kennard,129,27.5,28,-0.5,74,49,25,21,4
21700190,2772,HOU,IND,Trevor Ariza,159,34.7666666666667,35,-0.233333333333334,87,67,20,21,-1
21700190,200782,HOU,IND,PJ Tucker,113,24.3,25,-0.699999999999999,55,49,6,9,-3
21700190,201569,HOU,IND,Eric Gordon,143,30.4333333333333,31,-0.566666666666663,79,59,20,21,-1
21700190,201583,HOU,IND,Ryan Anderson,152,32.8,33,-0.200000000000003,86,66,20,14,6
21700190,201601,HOU,IND,Luc Mbah a Moute,112,25.05,25,0.0499999999999972,55,54,1,2,-1
21700190,201628,HOU,IND,Bobby Brown,15,3.53333333333333,4,-0.466666666666667,8,8,0,0,0
21700190,201935,HOU,IND,James Harden,156,34.05,34,0.0499999999999972,86,61,25,25,0
21700190,203991,HOU,IND,Clint Capela,148,31.5833333333333,32,-0.416666666666664,86,64,22,20,2
21700190,204028,HOU,IND,Tarik Black,72,16.4166666666667,16,0.416666666666664,32,31,1,3,-2
21700190,1627743,HOU,IND,Demetrius Jackson,15,3.53333333333333,4,-0.466666666666667,8,8,0,0,0
21700190,1627753,HOU,IND,Zhou Qi,15,3.53333333333333,4,-0.466666666666667,8,8,0,0,0
21700190,2863,IND,HOU,Damien Wilkins,15,3.53333333333333,4,-0.466666666666667,8,8,0,0,0
21700190,201152,IND,HOU,Thaddeus Young,111,24.2,24,0.199999999999999,45,66,-21,-19,-2
21700190,201954,IND,HOU,Darren Collison,109,22.8333333333333,23,-0.166666666666664,42,64,-22,-22,0
21700190,202362,IND,HOU,Lance Stephenson,105,23.8666666666667,24,-0.133333333333333,52,53,-1,-1,0
21700190,202709,IND,HOU,Cory Joseph,113,25.55,26,-0.449999999999999,53,57,-4,-4,0
21700190,202711,IND,HOU,Bojan Bogdanovic,142,29.1833333333333,29,0.18333333333333,59,73,-14,-16,2
21700190,203506,IND,HOU,Victor Oladipo,161,35.5,36,-0.5,63,91,-28,-26,-2
21700190,1626167,IND,HOU,Myles Turner,120,26.1,26,0.100000000000001,48,64,-16,-18,2
21700190,1626202,IND,HOU,Joe Young,15,3.53333333333333,4,-0.466666666666667,8,8,0,0,0
21700190,1627734,IND,HOU,Domantas Sabonis,104,22.9,23,-0.100000000000001,49,51,-2,-4,2
21700190,1628387,IND,HOU,Ike Anigbogu,15,3.53333333333333,4,-0.466666666666667,8,8,0,0,0
21700190,1628388,IND,HOU,TJ Leaf,90,19.2666666666667,19,0.266666666666666,40,47,-7,-5,-2
21700191,1717,DAL,OKC,Dirk Nowitzki,88,19.45,20,-0.550000000000001,36,52,-16,-21,5
21700191,200826,DAL,OKC,J.J. Barea,90,19.7666666666667,20,-0.233333333333334,44,47,-3,-5,2
21700191,202083,DAL,OKC,Wesley Matthews,155,33.05,33,0.0499999999999972,62,81,-19,-18,-1
21700191,203084,DAL,OKC,Harrison Barnes,208,43.65,35,8.65,92,99,-7,-5,-2
21700191,203457,DAL,OKC,Nerlens Noel,10,2.26666666666667,2,0.266666666666667,10,5,5,3,2
21700191,203939,DAL,OKC,Dwight Powell,84,18.6833333333333,19,-0.316666666666666,36,47,-11,-9,-2
21700191,1626257,DAL,OKC,Salah Mejri,55,11.4666666666667,11,0.466666666666667,20,22,-2,2,-4
21700191,1627812,DAL,OKC,Yogi Ferrell,160,34.25,34,0.25,72,75,-3,-2,-1
21700191,1627827,DAL,OKC,Dorian Finney-Smith,113,24.1,12,12.1,55,58,-3,0,-3
21700191,1628372,DAL,OKC,Dennis Smith Jr.,175,37.3833333333333,34,3.38333333333333,73,98,-25,-18,-7
21700191,1628467,DAL,OKC,Maxi Kleber,40,8.43333333333333,8,0.433333333333334,24,17,7,7,0
21700191,1628492,DAL,OKC,Gian Clavell,51,11.5,8,3.5,24,23,1,-1,2
21700191,101109,OKC,DAL,Raymond Felton,70,15.4833333333333,19,-3.51666666666667,33,36,-3,-5,2
21700191,201566,OKC,DAL,Russell Westbrook,123,26.5833333333333,33,-6.41666666666667,64,47,17,14,3
21700191,202331,OKC,DAL,Paul George,194,42,42,0,107,85,22,20,2
21700191,202335,OKC,DAL,Patrick Patterson,115,25.2333333333333,25,0.233333333333334,66,53,13,13,0
21700191,203460,OKC,DAL,Andre Roberson,137,28.4666666666667,28,0.466666666666665,59,50,9,7,2
21700191,203518,OKC,DAL,Alex Abrines,49,10.65,15,-4.35,17,24,-7,-1,-6
21700191,203924,OKC,DAL,Jerami Grant,144,30.5333333333333,34,-3.46666666666667,70,60,10,13,-3
21700191,203962,OKC,DAL,Josh Huestis,84,17.7333333333333,22,-4.26666666666667,52,32,20,14,6
21700191,1626177,OKC,DAL,Dakari Johnson,74,16.7333333333333,17,-0.266666666666666,29,29,0,0,0
21700191,1628390,OKC,DAL,Terrance Ferguson,11,2.58333333333333,2,0.583333333333334,5,10,-5,-5,0
21700192,2216,SAC,WAS,Zach Randolph,97,22.6833333333333,23,-0.316666666666666,45,56,-11,-12,1
21700192,201585,SAC,WAS,Kosta Koufos,93,20.9166666666667,21,-0.0833333333333357,39,49,-10,-10,0
21700192,201588,SAC,WAS,George Hill,111,25.3333333333333,25,0.333333333333332,51,60,-9,-9,0
21700192,202066,SAC,WAS,Garrett Temple,94,21.55,21,0.550000000000001,47,51,-4,-5,1
21700192,203992,SAC,WAS,Bogdan Bogdanovic,84,19.85,20,-0.149999999999999,38,49,-11,-7,-4
21700192,1626161,SAC,WAS,Willie Cauley-Stein,101,23.7,23,0.700000000000003,46,56,-10,-11,1
21700192,1627741,SAC,WAS,Buddy Hield,114,25.8833333333333,26,-0.116666666666667,48,56,-8,-10,2
21700192,1627746,SAC,WAS,Skal Labissiere,109,24.5166666666667,25,-0.483333333333334,44,54,-10,-9,-1
21700192,1627834,SAC,WAS,Georgios Papagiannis,13,2.83333333333333,3,-0.166666666666667,6,5,1,3,-2
21700192,1628368,SAC,WAS,De'Aaron Fox,111,25.0833333333333,26,-0.916666666666664,46,56,-10,-9,-1
21700192,1628382,SAC,WAS,Justin Jackson,118,25.9833333333333,26,-0.0166666666666657,50,58,-8,-11,3
21700192,101133,WAS,SAC,Ian Mahinmi,60,13.6166666666667,13,0.616666666666667,27,25,2,3,-1
21700192,101162,WAS,SAC,Marcin Gortat,133,30.75,31,-0.25,78,58,20,21,-1
21700192,201975,WAS,SAC,Jodie Meeks,64,14.7166666666667,15,-0.283333333333333,27,25,2,3,-1
21700192,202322,WAS,SAC,John Wall,118,27.0833333333333,27,0.0833333333333322,71,52,19,23,-4
21700192,202693,WAS,SAC,Markieff Morris,84,20.25,20,0.25,44,38,6,3,3
21700192,203078,WAS,SAC,Bradley Beal,145,32.95,33,-0.0499999999999972,83,67,16,15,1
21700192,203107,WAS,SAC,Tomas Satoransky,13,2.83333333333333,3,-0.166666666666667,5,6,-1,-3,2
21700192,203118,WAS,SAC,Mike Scott,116,25.7,26,-0.300000000000001,59,54,5,8,-3
21700192,203490,WAS,SAC,Otto Porter Jr.,117,26.8333333333333,27,-0.166666666666664,63,51,12,12,0
21700192,204025,WAS,SAC,Tim Frazier,82,18.85,19,-0.149999999999999,34,34,0,-2,2
21700192,1626162,WAS,SAC,Kelly Oubre Jr.,100,21.9166666666667,22,-0.0833333333333357,54,44,10,10,0
21700192,1626191,WAS,SAC,Chris McCullough,13,2.83333333333333,3,-0.166666666666667,5,6,-1,-3,2
21700193,2544,CLE,NYK,LeBron James,183,36.3166666666667,36,0.316666666666663,84,82,2,3,-1
21700193,2548,CLE,NYK,Dwyane Wade,141,27.6833333333333,28,-0.316666666666666,71,57,14,13,1
21700193,2594,CLE,NYK,Kyle Korver,146,28.7166666666667,29,-0.283333333333331,70,62,8,8,0
21700193,2747,CLE,NYK,JR Smith,163,33.25,33,0.25,71,65,6,5,1
21700193,101112,CLE,NYK,Channing Frye,118,24.65,25,-0.350000000000001,64,46,18,20,-2
21700193,201145,CLE,NYK,Jeff Green,91,17.7833333333333,18,-0.216666666666669,38,31,7,3,4
21700193,201567,CLE,NYK,Kevin Love,116,22.95,23,-0.0500000000000007,37,53,-16,-15,-1
21700193,202697,CLE,NYK,Iman Shumpert,99,20.3,20,0.299999999999997,33,44,-11,-10,-1
21700193,203109,CLE,NYK,Jae Crowder,114,22.35,22,0.350000000000001,36,53,-17,-16,-1
21700193,1626224,CLE,NYK,Cedi Osman,29,5.91666666666667,6,-0.0833333333333339,16,12,4,4,0
21700193,101127,NYK,CLE,Jarrett Jack,114,23.5833333333333,24,-0.416666666666664,47,49,-2,-2,0
21700193,201584,NYK,CLE,Courtney Lee,183,36.5,37,-0.5,81,86,-5,-3,-2
21700193,202498,NYK,CLE,Lance Thomas,83,17.2166666666667,17,0.216666666666665,31,47,-16,-14,-2
21700193,202683,NYK,CLE,Enes Kanter,149,30.6166666666667,31,-0.383333333333333,66,72,-6,-6,0
21700193,203124,NYK,CLE,Kyle O'Quinn,38,7.93333333333333,8,-0.0666666666666664,8,11,-3,-3,0
21700193,203501,NYK,CLE,Tim Hardaway Jr.,222,44.0166666666667,44,0.0166666666666657,97,92,5,5,0
21700193,203926,NYK,CLE,Doug McDermott,107,20.7666666666667,20,0.766666666666666,45,34,11,9,2
21700193,204001,NYK,CLE,Kristaps Porzingis,173,34.05,34,0.0499999999999972,76,69,7,5,2
21700193,1628373,NYK,CLE,Frank Ntilikina,126,24.4,24,0.399999999999999,54,55,-1,-1,0
21700193,1628422,NYK,CLE,Damyean Dotson,5,0.833333333333333,1,-0.166666666666667,0,5,-5,-5,0
21700194,202339,MIL,MEM,Eric Bledsoe,116,26.4666666666667,27,-0.533333333333331,68,50,18,19,-1
21700194,202732,MIL,MEM,DeAndre Liggins,91,20.7833333333333,21,-0.216666666666669,43,58,-15,-15,0
21700194,203089,MIL,MEM,John Henson,109,24.85,25,-0.149999999999999,67,54,13,13,0
21700194,203114,MIL,MEM,Khris Middleton,164,38.0166666666667,38,0.0166666666666657,89,63,26,27,-1
21700194,203503,MIL,MEM,Tony Snell,137,31.1833333333333,31,0.18333333333333,79,64,15,16,-1
21700194,203507,MIL,MEM,Giannis Antetokounmpo,188,43.3666666666667,44,-0.633333333333333,96,91,5,6,-1
21700194,203521,MIL,MEM,Matthew Dellavedova,52,12.1833333333333,12,0.183333333333334,24,42,-18,-18,0
21700194,1627748,MIL,MEM,Thon Maker,99,23.0333333333333,23,0.0333333333333314,42,49,-7,-6,-1
21700194,1627763,MIL,MEM,Malcolm Brogdon,84,19.5333333333333,19,0.533333333333331,37,44,-7,-7,0
21700194,201144,MEM,MIL,Mike Conley,143,32.9833333333333,33,-0.0166666666666657,65,74,-9,-13,4
21700194,201148,MEM,MIL,Brandan Wright,62,13.7833333333333,13,0.783333333333333,31,28,3,3,0
21700194,201188,MEM,MIL,Marc Gasol,146,34.1,35,-0.900000000000006,72,81,-9,-10,1
21700194,201596,MEM,MIL,Mario Chalmers,109,25.1666666666667,25,0.166666666666664,61,51,10,12,-2
21700194,201936,MEM,MIL,Tyreke Evans,144,33.05,33,0.0499999999999972,65,75,-10,-9,-1
21700194,202718,MEM,MIL,Chandler Parsons,90,21.0666666666667,21,0.0666666666666664,52,44,8,12,-4
21700194,203463,MEM,MIL,Ben McLemore,51,11.7833333333333,12,-0.216666666666667,29,24,5,8,-3
21700194,203516,MEM,MIL,James Ennis III,123,27.85,28,-0.149999999999999,58,72,-14,-17,3
21700194,1626185,MEM,MIL,Jarell Martin,52,12,12,0,21,31,-10,-12,2
21700194,1628415,MEM,MIL,Dillon Brooks,120,27.6333333333333,28,-0.366666666666667,61,65,-4,-9,5
21700195,201158,ATL,NOP,Marco Belinelli,119,27.3,27,0.300000000000001,52,65,-13,-13,0
21700195,202337,ATL,NOP,Luke Babbitt,140,30.6,30,0.600000000000001,67,68,-1,0,-1
21700195,203145,ATL,NOP,Kent Bazemore,129,29.3666666666667,30,-0.633333333333333,70,61,9,9,0
21700195,203471,ATL,NOP,Dennis Schroder,143,32.4333333333333,33,-0.566666666666663,71,79,-8,-9,1
21700195,203473,ATL,NOP,Dewayne Dedmon,58,12.6833333333333,13,-0.316666666666666,29,23,6,3,3
21700195,1627098,ATL,NOP,Malcolm Delaney,92,20.5166666666667,20,0.516666666666666,45,34,11,10,1
21700195,1627752,ATL,NOP,Taurean Prince,142,31.85,32,-0.149999999999999,76,75,1,0,1
21700195,1627819,ATL,NOP,Isaiah Taylor,69,15.5666666666667,15,0.566666666666666,34,26,8,8,0
21700195,1628381,ATL,NOP,John Collins,98,21.7666666666667,22,-0.233333333333334,35,51,-16,-16,0
21700195,1628463,ATL,NOP,Tyler Cavanaugh,75,17.9166666666667,18,-0.0833333333333357,46,43,3,3,0
21700195,2749,NOP,ATL,Jameer Nelson,96,22.2333333333333,22,0.233333333333334,37,48,-11,-10,-1
21700195,200765,NOP,ATL,Rajon Rondo,25,5.06666666666667,5,0.0666666666666664,14,14,0,0,0
21700195,201950,NOP,ATL,Jrue Holiday,190,43.3,43,0.299999999999997,97,90,7,8,-1
21700195,201967,NOP,ATL,Dante Cunningham,86,18.6333333333333,19,-0.366666666666667,48,47,1,1,0
21700195,202326,NOP,ATL,DeMarcus Cousins,159,34.9166666666667,35,-0.0833333333333357,71,71,0,1,-1
21700195,202734,NOP,ATL,E'Twaun Moore,147,33.6,34,-0.400000000000006,81,75,6,6,0
21700195,203076,NOP,ATL,Anthony Davis,168,37.7,38,-0.299999999999997,93,86,7,7,0
21700195,203121,NOP,ATL,Darius Miller,93,21.9,22,-0.100000000000001,41,48,-7,-6,-1
21700195,203546,NOP,ATL,Ian Clark,91,20.3833333333333,20,0.383333333333333,40,40,0,1,-1
21700195,1627767,NOP,ATL,Cheick Diallo,10,2.26666666666667,2,0.266666666666667,3,6,-3,-3,0
21700196,101106,LAL,PHX,Andrew Bogut,74,15.8,16,-0.199999999999999,33,18,15,15,0
21700196,201147,LAL,PHX,Corey Brewer,83,18.1166666666667,18,0.116666666666667,41,29,12,13,-1
21700196,201572,LAL,PHX,Brook Lopez,139,27.95,28,-0.0500000000000007,60,60,0,0,0
21700196,203484,LAL,PHX,Kentavious Caldwell-Pope,173,33.6666666666667,34,-0.333333333333329,69,70,-1,-1,0
21700196,203505,LAL,PHX,Vander Blue,28,5.51666666666667,6,-0.483333333333334,12,9,3,3,0
21700196,203903,LAL,PHX,Jordan Clarkson,123,26.1833333333333,26,0.18333333333333,57,42,15,15,0
21700196,203944,LAL,PHX,Julius Randle,95,18.5166666666667,19,-0.483333333333334,40,31,9,9,0
21700196,1627742,LAL,PHX,Brandon Ingram,157,32.15,32,0.149999999999999,66,63,3,2,1
21700196,1628366,LAL,PHX,Lonzo Ball,146,27.9,28,-0.100000000000001,55,66,-11,-11,0
21700196,1628398,LAL,PHX,Kyle Kuzma,167,33.6166666666667,34,-0.38333333333334,67,77,-10,-10,0
21700196,2199,PHX,LAL,Tyson Chandler,138,27.7666666666667,28,-0.233333333333334,60,55,5,5,0
21700196,203458,PHX,LAL,Alex Len,99,20.1166666666667,20,0.116666666666667,33,45,-12,-12,0
21700196,203584,PHX,LAL,Troy Daniels,47,8.8,10,-1.2,7,24,-17,-17,0
21700196,203933,PHX,LAL,T.J. Warren,169,35.1666666666667,35,0.166666666666671,73,69,4,4,0
21700196,1626164,PHX,LAL,Devin Booker,186,38.2666666666667,38,0.266666666666666,86,76,10,10,0
21700196,1627733,PHX,LAL,Dragan Bender,99,20.6333333333333,20,0.633333333333333,39,41,-2,-2,0
21700196,1627737,PHX,LAL,Marquese Chriss,137,27.1333333333333,27,0.133333333333333,54,59,-5,-5,0
21700196,1627755,PHX,LAL,Tyler Ulis,131,27.3833333333333,27,0.383333333333333,64,53,11,11,0
21700196,1628367,PHX,LAL,Josh Jackson,95,17.95,18,-0.0500000000000007,28,38,-10,-10,0
21700196,1628455,PHX,LAL,Mike James,84,16.2,17,-0.800000000000001,21,40,-19,-19,0
21700197,2037,MIN,UTA,Jamal Crawford,58,12.8333333333333,13,-0.166666666666666,28,33,-5,-6,1
21700197,201952,MIN,UTA,Jeff Teague,160,37.2666666666667,38,-0.733333333333334,85,72,13,14,-1
21700197,201959,MIN,UTA,Taj Gibson,173,39.6166666666667,39,0.616666666666667,94,74,20,21,-1
21700197,202357,MIN,UTA,Nemanja Bjelica,60,13.2666666666667,13,0.266666666666666,32,31,1,1,0
21700197,202710,MIN,UTA,Jimmy Butler,164,38.45,39,-0.549999999999997,87,76,11,11,0
21700197,203498,MIN,UTA,Shabazz Muhammad,33,8.03333333333333,8,0.0333333333333332,13,24,-11,-11,0
21700197,203952,MIN,UTA,Andrew Wiggins,167,38.4833333333333,39,-0.516666666666666,94,69,25,25,0
21700197,1626145,MIN,UTA,Tyus Jones,47,10.65,10,0.649999999999999,24,26,-2,-3,1
21700197,1626157,MIN,UTA,Karl-Anthony Towns,173,40.9833333333333,41,-0.0166666666666657,88,85,3,3,0
21700197,200757,UTA,MIN,Thabo Sefolosha,100,22.35,22,0.350000000000001,44,53,-9,-10,1
21700197,201937,UTA,MIN,Ricky Rubio,95,22.1333333333333,22,0.133333333333333,38,50,-12,-11,-1
21700197,201973,UTA,MIN,Jonas Jerebko,101,24.25,25,-0.75,48,53,-5,-6,1
21700197,202324,UTA,MIN,Derrick Favors,117,27.8333333333333,27,0.833333333333332,47,67,-20,-22,2
21700197,202327,UTA,MIN,Ekpe Udoh,90,20.0833333333333,21,-0.916666666666664,51,42,9,11,-2
21700197,202692,UTA,MIN,Alec Burks,69,16.15,16,0.149999999999999,42,40,2,3,-1
21700197,203526,UTA,MIN,Raul Neto,79,17.7333333333333,17,0.733333333333334,44,34,10,10,0
21700197,203918,UTA,MIN,Rodney Hood,94,20.9333333333333,21,-0.0666666666666664,48,51,-3,-3,0
21700197,204060,UTA,MIN,Joe Ingles,109,24.7,24,0.699999999999999,36,58,-22,-24,2
21700197,1626220,UTA,MIN,Royce O'Neale,37,8.85,9,-0.15,23,15,8,8,0
21700197,1628378,UTA,MIN,Donovan Mitchell,144,34.5666666666667,35,-0.433333333333337,69,82,-13,-11,-2
21700198,2210,DEN,POR,Richard Jefferson,47,10.2166666666667,10,0.216666666666667,18,22,-4,-4,0
21700198,200794,DEN,POR,Paul Millsap,147,34.1166666666667,34,0.116666666666667,60,72,-12,-12,0
21700198,201163,DEN,POR,Wilson Chandler,146,33.4166666666667,33,0.416666666666671,62,67,-5,-5,0
21700198,202702,DEN,POR,Kenneth Faried,77,16.6166666666667,17,-0.383333333333333,27,42,-15,-15,0
21700198,203115,DEN,POR,Will Barton,161,34.4333333333333,34,0.433333333333337,64,68,-4,-4,0
21700198,203486,DEN,POR,Mason Plumlee,29,5.7,6,-0.300000000000001,5,10,-5,-5,0
21700198,203999,DEN,POR,Nikola Jokic,157,34.4666666666667,35,-0.533333333333331,64,64,0,0,0
21700198,1626144,DEN,POR,Emmanuel Mudiay,95,21.4333333333333,21,0.433333333333334,21,50,-29,-29,0
21700198,1626168,DEN,POR,Trey Lyles,19,4.06666666666667,4,0.0666666666666664,8,6,2,2,0
21700198,1627736,DEN,POR,Malik Beasley,27,5.71666666666667,6,-0.283333333333333,10,14,-4,-4,0
21700198,1627750,DEN,POR,Jamal Murray,175,38.9833333333333,39,-0.0166666666666657,71,80,-9,-9,0
21700198,202323,POR,DEN,Evan Turner,110,24.7666666666667,25,-0.233333333333334,54,39,15,16,-1
21700198,202334,POR,DEN,Ed Davis,62,14.3,15,-0.699999999999999,29,19,10,12,-2
21700198,203081,POR,DEN,Damian Lillard,159,34.1333333333333,34,0.133333333333333,65,61,4,3,1
21700198,203090,POR,DEN,Maurice Harkless,94,20.6833333333333,20,0.683333333333334,39,37,2,1,1
21700198,203468,POR,DEN,CJ McCollum,141,31.3166666666667,31,0.316666666666663,61,60,1,1,0
21700198,203894,POR,DEN,Shabazz Napier,60,14.4,15,-0.600000000000001,38,21,17,18,-1
21700198,203943,POR,DEN,Noah Vonleh,116,26.0333333333333,26,0.0333333333333314,57,36,21,21,0
21700198,203994,POR,DEN,Jusuf Nurkic,139,30.45,30,0.449999999999999,60,57,3,1,2
21700198,1626192,POR,DEN,Pat Connaughton,80,17.6166666666667,18,-0.383333333333333,42,24,18,18,0
21700198,1627774,POR,DEN,Jake Layman,12,2.38333333333333,3,-0.616666666666667,6,6,0,0,0
21700198,1628380,POR,DEN,Zach Collins,12,2.38333333333333,3,-0.616666666666667,6,6,0,0,0
21700198,1628403,POR,DEN,Caleb Swanigan,95,20.7,20,0.699999999999999,38,44,-6,-6,0
21700199,2561,GSW,ORL,David West,67,13.8166666666667,14,-0.183333333333334,31,22,9,9,0
21700199,2585,GSW,ORL,Zaza Pachulia,64,13.2166666666667,14,-0.783333333333333,40,24,16,16,0
21700199,2733,GSW,ORL,Shaun Livingston,98,20.1166666666667,20,0.116666666666667,56,42,14,16,-2
21700199,2738,GSW,ORL,Andre Iguodala,107,22.8666666666667,23,-0.133333333333333,48,42,6,2,4
21700199,201142,GSW,ORL,Kevin Durant,145,30.15,30,0.149999999999999,78,65,13,11,2
21700199,201156,GSW,ORL,Nick Young,93,20.75,20,0.75,40,51,-11,-9,-2
21700199,201580,GSW,ORL,JaVale McGee,34,7.26666666666667,8,-0.733333333333333,15,21,-6,-6,0
21700199,201956,GSW,ORL,Omri Casspi,87,19.0333333333333,18,1.03333333333333,35,37,-2,-1,-1
21700199,202691,GSW,ORL,Klay Thompson,146,30.7833333333333,31,-0.216666666666669,73,58,15,14,1
21700199,203110,GSW,ORL,Draymond Green,152,31.5666666666667,32,-0.433333333333334,78,58,20,25,-5
21700199,1626172,GSW,ORL,Kevon Looney,65,14.55,15,-0.449999999999999,26,38,-12,-14,2
21700199,1626188,GSW,ORL,Quinn Cook,20,4.81666666666667,5,-0.183333333333334,8,16,-8,-8,0
21700199,1627775,GSW,ORL,Patrick McCaw,42,9.31666666666667,9,0.316666666666666,22,26,-4,-5,1
21700199,201167,ORL,GSW,Arron Afflalo,20,4.81666666666667,5,-0.183333333333334,16,8,8,8,0
21700199,201578,ORL,GSW,Marreese Speights,73,16.2,16,0.199999999999999,33,29,4,4,0
21700199,202687,ORL,GSW,Bismack Biyombo,87,19.15,20,-0.850000000000001,37,41,-4,-4,0
21700199,202696,ORL,GSW,Nikola Vucevic,127,26.65,27,-0.350000000000001,59,65,-6,-4,-2
21700199,202714,ORL,GSW,Shelvin Mack,102,22.55,23,-0.449999999999999,47,47,0,2,-2
21700199,203082,ORL,GSW,Terrence Ross,138,28.4333333333333,28,0.433333333333334,50,73,-23,-23,0
21700199,203095,ORL,GSW,Evan Fournier,149,31.0833333333333,31,0.0833333333333322,67,76,-9,-11,2
21700199,203613,ORL,GSW,Jonathon Simmons,121,26.15,26,0.149999999999999,51,55,-4,-2,-2
21700199,203901,ORL,GSW,Elfrid Payton,122,25.1,25,0.100000000000001,53,63,-10,-12,2
21700199,203932,ORL,GSW,Aaron Gordon,161,33.3,33,0.299999999999997,71,85,-14,-16,2
21700199,1626209,ORL,GSW,Mario Hezonja,20,4.81666666666667,5,-0.183333333333334,16,8,8,8,0
21700200,101150,LAC,PHI,Lou Williams,179,38.05,38,0.0499999999999972,88,85,3,2,1
21700200,201599,LAC,PHI,DeAndre Jordan,133,30.0333333333333,30,0.0333333333333314,56,62,-6,-3,-3
21700200,201933,LAC,PHI,Blake Griffin,171,35.9666666666667,36,-0.0333333333333314,84,84,0,1,-1
21700200,202325,LAC,PHI,Wesley Johnson,92,20.1333333333333,20,0.133333333333333,44,44,0,0,0
21700200,203085,LAC,PHI,Austin Rivers,174,37.0333333333333,37,0.0333333333333314,79,84,-5,-2,-3
21700200,203186,LAC,PHI,Willie Reed,90,17.3666666666667,17,0.366666666666667,44,39,5,-1,6
21700200,203710,LAC,PHI,C.J. Williams,5,0.466666666666667,0,0.466666666666667,2,0,2,2,0
21700200,1626155,LAC,PHI,Sam Dekker,57,11.8166666666667,12,-0.183333333333334,20,25,-5,-5,0
21700200,1628393,LAC,PHI,Jawun Evans,92,18.3166666666667,19,-0.68333333333333,42,45,-3,-1,-2
21700200,1628414,LAC,PHI,Sindarius Thornwell,157,30.8166666666667,31,-0.183333333333334,61,77,-16,-13,-3
21700200,101161,PHI,LAC,Amir Johnson,62,12.9166666666667,12,0.916666666666666,25,42,-17,-19,2
21700200,200755,PHI,LAC,JJ Redick,171,35.85,36,-0.149999999999999,84,79,5,3,2
21700200,203496,PHI,LAC,Robert Covington,165,34.6666666666667,35,-0.333333333333329,84,71,13,10,3
21700200,203954,PHI,LAC,Joel Embiid,168,35.0833333333333,36,-0.916666666666671,84,62,22,23,-1
21700200,203967,PHI,LAC,Dario Saric,164,33.85,34,-0.149999999999999,74,75,-1,-2,1
21700200,204456,PHI,LAC,T.J. McConnell,94,19,18,1,43,45,-2,0,-2
21700200,1626147,PHI,LAC,Justin Anderson,64,13.3333333333333,13,0.333333333333334,27,28,-1,1,-2
21700200,1627732,PHI,LAC,Ben Simmons,171,36.9666666666667,37,-0.0333333333333314,87,77,10,7,3
21700200,1627789,PHI,LAC,Timothe Luwawu-Cabarrot,91,18.3333333333333,18,0.333333333333332,37,41,-4,-3,-1
21700201,201143,BOS,BKN,Al Horford,135,30.3,30,0.299999999999997,76,58,18,22,-4
21700201,202681,BOS,BKN,Kyrie Irving,133,28.7,29,-0.300000000000001,69,59,10,10,0
21700201,202694,BOS,BKN,Marcus Morris,110,24.75,25,-0.25,46,58,-12,-10,-2
21700201,203382,BOS,BKN,Aron Baynes,61,12.3166666666667,12,0.316666666666666,20,24,-4,-4,0
21700201,203499,BOS,BKN,Shane Larkin,26,6.55,7,-0.45,15,11,4,4,0
21700201,203935,BOS,BKN,Marcus Smart,161,34.75,35,-0.25,80,74,6,6,0
21700201,1626179,BOS,BKN,Terry Rozier,103,21.05,21,0.0500000000000007,46,50,-4,-4,0
21700201,1627759,BOS,BKN,Jaylen Brown,156,31.6166666666667,31,0.616666666666667,85,59,26,24,2
21700201,1628369,BOS,BKN,Jayson Tatum,139,29.9,30,-0.100000000000001,64,61,3,5,-2
21700201,1628400,BOS,BKN,Semi Ojeleye,43,8.41666666666667,8,0.416666666666666,24,29,-5,-11,6
21700201,1628464,BOS,BKN,Daniel Theis,58,11.4833333333333,11,0.483333333333334,20,27,-7,-7,0
21700201,201960,BKN,BOS,DeMarre Carroll,142,29.95,30,-0.0499999999999972,65,71,-6,-6,0
21700201,202344,BKN,BOS,Trevor Booker,126,27.85,28,-0.149999999999999,60,56,4,2,2
21700201,202389,BKN,BOS,Timofey Mozgov,30,5.35,6,-0.65,11,12,-1,-1,0
21700201,203112,BKN,BOS,Quincy Acy,91,18.8666666666667,19,-0.133333333333333,44,43,1,1,0
21700201,203459,BKN,BOS,Allen Crabbe,154,33.1,33,0.0999999999999943,70,82,-12,-14,2
21700201,203915,BKN,BOS,Spencer Dinwiddie,156,34.1666666666667,34,0.166666666666671,81,82,-1,-2,1
21700201,203925,BKN,BOS,Joe Harris,98,20.1833333333333,20,0.183333333333334,43,47,-4,-2,-2
21700201,1626178,BKN,BOS,Rondae Hollis-Jefferson,148,32.9666666666667,33,-0.0333333333333314,63,80,-17,-21,4
21700201,1627747,BKN,BOS,Caris LeVert,104,22.3333333333333,22,0.333333333333336,46,43,3,3,0
21700201,1627785,BKN,BOS,Isaiah Whitehead,35,6.01666666666667,6,0.0166666666666666,7,8,-1,2,-3
21700201,1628386,BKN,BOS,Jarrett Allen,41,9.05,9,0.0500000000000007,20,21,-1,3,-4
21700202,2772,HOU,TOR,Trevor Ariza,187,37.55,38,-0.450000000000003,94,93,1,0,1
21700202,200782,HOU,TOR,PJ Tucker,80,16.35,16,0.350000000000001,45,56,-11,-12,1
21700202,201569,HOU,TOR,Eric Gordon,162,32.65,33,-0.350000000000001,73,78,-5,-9,4
21700202,201583,HOU,TOR,Ryan Anderson,153,31.2166666666667,31,0.216666666666665,61,87,-26,-24,-2
21700202,201601,HOU,TOR,Luc Mbah a Moute,155,31.3666666666667,31,0.366666666666667,79,86,-7,-11,4
21700202,201628,HOU,TOR,Bobby Brown,7,1.21666666666667,2,-0.783333333333333,3,7,-4,-2,-2
21700202,201935,HOU,TOR,James Harden,194,39.3,39,0.299999999999997,98,99,-1,-2,1
21700202,203991,HOU,TOR,Clint Capela,141,28.2666666666667,29,-0.733333333333334,56,72,-16,-17,1
21700202,204028,HOU,TOR,Tarik Black,87,17.5666666666667,18,-0.433333333333334,50,48,2,1,1
21700202,1627743,HOU,TOR,Demetrius Jackson,7,1.21666666666667,2,-0.783333333333333,3,7,-4,-2,-2
21700202,1627753,HOU,TOR,Zhou Qi,7,1.21666666666667,2,-0.783333333333333,3,7,-4,-2,-2
21700202,101139,TOR,HOU,CJ Miles,86,16.8333333333333,17,-0.166666666666668,41,46,-5,-7,2
21700202,200768,TOR,HOU,Kyle Lowry,186,36.5833333333333,37,-0.416666666666671,96,86,10,14,-4
21700202,201586,TOR,HOU,Serge Ibaka,126,24.6166666666667,25,-0.383333333333333,68,53,15,18,-3
21700202,201942,TOR,HOU,DeMar DeRozan,173,34.1333333333333,34,0.133333333333333,88,82,6,7,-1
21700202,202685,TOR,HOU,Jonas Valanciunas,84,16.9833333333333,17,-0.0166666666666657,37,40,-3,-1,-2
21700202,203512,TOR,HOU,Lucas Nogueira,26,5.61666666666667,5,0.616666666666667,17,17,0,2,-2
21700202,1626153,TOR,HOU,Delon Wright,117,25.3166666666667,26,-0.683333333333334,68,51,17,18,-1
21700202,1627751,TOR,HOU,Jakob Poeltl,62,13.05,14,-0.949999999999999,36,31,5,5,0
21700202,1627783,TOR,HOU,Pascal Siakam,98,18.9166666666667,19,-0.0833333333333357,55,60,-5,-7,2
21700202,1627832,TOR,HOU,Fred VanVleet,77,15.7166666666667,16,-0.283333333333335,49,38,11,7,4
21700202,1628035,TOR,HOU,Alfonzo McKinnie,7,1.21666666666667,2,-0.783333333333333,7,3,4,2,2
21700202,1628384,TOR,HOU,OG Anunoby,138,28.9333333333333,30,-1.06666666666667,78,58,20,22,-2
21700203,1717,DAL,SAS,Dirk Nowitzki,135,28.45,29,-0.549999999999997,58,59,-1,1,-2
21700203,200826,DAL,SAS,J.J. Barea,115,26.4,27,-0.600000000000001,48,47,1,-3,4
21700203,202083,DAL,SAS,Wesley Matthews,167,37.5,38,-0.5,70,79,-9,-11,2
21700203,203084,DAL,SAS,Harrison Barnes,168,37.65,38,-0.350000000000001,67,70,-3,-2,-1
21700203,203457,DAL,SAS,Nerlens Noel,20,4.98333333333333,5,-0.0166666666666666,2,7,-5,-5,0
21700203,1626257,DAL,SAS,Salah Mejri,59,14.5666666666667,14,0.566666666666666,31,31,0,-2,2
21700203,1627812,DAL,SAS,Yogi Ferrell,148,33.1833333333333,33,0.183333333333337,60,62,-2,-1,-1
21700203,1628372,DAL,SAS,Dennis Smith Jr.,165,36.4166666666667,36,0.416666666666671,74,85,-11,-8,-3
21700203,1628467,DAL,SAS,Maxi Kleber,93,20.85,21,-0.149999999999999,45,45,0,1,-1
21700203,1938,SAS,DAL,Manu Ginobili,77,16.4,16,0.399999999999999,40,42,-2,-2,0
21700203,2200,SAS,DAL,Pau Gasol,105,23.1666666666667,23,0.166666666666664,41,34,7,5,2
21700203,200746,SAS,DAL,LaMarcus Aldridge,155,35.65,36,-0.349999999999994,68,58,10,12,-2
21700203,200752,SAS,DAL,Rudy Gay,71,16.35,16,0.350000000000001,23,25,-2,-1,-1
21700203,201980,SAS,DAL,Danny Green,121,26.7666666666667,27,-0.233333333333334,52,53,-1,1,-2
21700203,201988,SAS,DAL,Patty Mills,133,29.2333333333333,30,-0.766666666666666,53,60,-7,-7,0
21700203,202722,SAS,DAL,Davis Bertans,21,5.13333333333333,5,0.133333333333333,17,13,4,5,-1
21700203,203464,SAS,DAL,Brandon Paul,42,9.91666666666667,10,-0.0833333333333322,23,12,11,10,1
21700203,203530,SAS,DAL,Joffrey Lauvergne,25,5.1,5,0.0999999999999996,14,22,-8,-10,2
21700203,203937,SAS,DAL,Kyle Anderson,153,33.8833333333333,34,-0.116666666666667,77,68,9,9,0
21700203,1627749,SAS,DAL,Dejounte Murray,88,20.4166666666667,20,0.416666666666664,49,37,12,11,1
21700203,1627854,SAS,DAL,Bryn Forbes,79,17.9833333333333,18,-0.0166666666666657,28,31,-3,-3,0
21700204,101141,ATL,SAC,Ersan Ilyasova,81,17.75,18,-0.25,37,34,3,0,3
21700204,201158,ATL,SAC,Marco Belinelli,97,20.0833333333333,20,0.0833333333333322,54,30,24,26,-2
21700204,202337,ATL,SAC,Luke Babbitt,47,11,11,0,32,15,17,18,-1
21700204,203145,ATL,SAC,Kent Bazemore,111,23.2833333333333,23,0.283333333333331,59,36,23,22,1
21700204,203471,ATL,SAC,Dennis Schroder,116,24.7166666666667,25,-0.283333333333331,69,50,19,18,1
21700204,203473,ATL,SAC,Dewayne Dedmon,113,23.6666666666667,24,-0.333333333333336,69,47,22,21,1
21700204,1627098,ATL,SAC,Malcolm Delaney,106,23.4,23,0.399999999999999,56,45,11,10,1
21700204,1627752,ATL,SAC,Taurean Prince,146,31.5166666666667,32,-0.483333333333334,88,47,41,35,6
21700204,1627819,ATL,SAC,Isaiah Taylor,103,22.2166666666667,22,0.216666666666669,57,30,27,25,2
21700204,1628381,ATL,SAC,John Collins,99,22.2333333333333,22,0.233333333333334,55,34,21,19,2
21700204,1628463,ATL,SAC,Tyler Cavanaugh,91,19.4666666666667,19,0.466666666666665,54,32,22,21,1
21700204,2216,SAC,ATL,Zach Randolph,113,24.0833333333333,25,-0.916666666666668,48,69,-21,-17,-4
21700204,201585,SAC,ATL,Kosta Koufos,82,16.8166666666667,17,-0.183333333333334,25,45,-20,-20,0
21700204,201588,SAC,ATL,George Hill,113,24.45,24,0.449999999999999,47,63,-16,-16,0
21700204,202066,SAC,ATL,Garrett Temple,83,18.0166666666667,18,0.0166666666666657,36,42,-6,-6,0
21700204,203992,SAC,ATL,Bogdan Bogdanovic,105,22.4333333333333,23,-0.566666666666666,44,62,-18,-17,-1
21700204,1626161,SAC,ATL,Willie Cauley-Stein,96,20.6666666666667,21,-0.333333333333336,37,51,-14,-14,0
21700204,1627741,SAC,ATL,Buddy Hield,100,20.4333333333333,21,-0.566666666666666,29,57,-28,-28,0
21700204,1627746,SAC,ATL,Skal Labissiere,29,7.26666666666667,7,0.266666666666667,15,18,-3,-5,2
21700204,1627781,SAC,ATL,Malachi Richardson,93,20.4666666666667,20,0.466666666666669,28,50,-22,-18,-4
21700204,1627834,SAC,ATL,Georgios Papagiannis,44,10.3833333333333,11,-0.616666666666667,18,30,-12,-9,-3
21700204,1628368,SAC,ATL,De'Aaron Fox,93,18.8333333333333,19,-0.166666666666664,20,52,-32,-29,-3
21700204,1628382,SAC,ATL,Justin Jackson,120,26.0666666666667,26,0.0666666666666664,38,64,-26,-27,1
21700204,1628412,SAC,ATL,Frank Mason,39,9.41666666666667,10,-0.583333333333334,15,27,-12,-9,-3
21700205,201609,MIA,WAS,Goran Dragic,168,36.7,37,-0.299999999999997,70,76,-6,-7,1
21700205,201949,MIA,WAS,James Johnson,122,26.55,27,-0.450000000000003,52,66,-14,-6,-8
21700205,201961,MIA,WAS,Wayne Ellington,31,8.03333333333333,8,0.0333333333333332,21,22,-1,1,-2
21700205,202355,MIA,WAS,Hassan Whiteside,149,33.8,34,-0.200000000000003,60,61,-1,-1,0
21700205,203079,MIA,WAS,Dion Waiters,161,34.9833333333333,35,-0.0166666666666657,70,68,2,5,-3
21700205,203482,MIA,WAS,Kelly Olynyk,47,11.7833333333333,12,-0.216666666666667,27,29,-2,0,-2
21700205,204020,MIA,WAS,Tyler Johnson,141,30.7833333333333,31,-0.216666666666669,62,71,-9,-11,2
21700205,1626159,MIA,WAS,Justise Winslow,104,22.0666666666667,22,0.0666666666666664,42,46,-4,-12,8
21700205,1626196,MIA,WAS,Josh Richardson,152,34.3833333333333,34,0.383333333333333,61,71,-10,-14,4
21700205,101133,WAS,MIA,Ian Mahinmi,69,17.45,17,0.450000000000003,32,39,-7,-3,-4
21700205,101162,WAS,MIA,Marcin Gortat,122,26.9,27,-0.100000000000001,55,51,4,1,3
21700205,201975,WAS,MIA,Jodie Meeks,73,15.5166666666667,16,-0.483333333333334,40,37,3,3,0
21700205,202322,WAS,MIA,John Wall,175,37.2666666666667,38,-0.733333333333334,84,66,18,18,0
21700205,202693,WAS,MIA,Markieff Morris,105,21.7333333333333,22,-0.266666666666666,48,36,12,10,2
21700205,203078,WAS,MIA,Bradley Beal,181,39.4333333333333,39,0.433333333333337,85,75,10,8,2
21700205,203490,WAS,MIA,Otto Porter Jr.,169,39.3,40,-0.700000000000003,78,73,5,7,-2
21700205,204025,WAS,MIA,Tim Frazier,42,10.6833333333333,11,-0.316666666666666,19,27,-8,-9,1
21700205,1626162,WAS,MIA,Kelly Oubre Jr.,139,30.8,31,-0.200000000000003,69,61,8,10,-2
21700206,101127,NYK,UTA,Jarrett Jack,120,28.0166666666667,28,0.0166666666666657,66,70,-4,-4,0
21700206,201584,NYK,UTA,Courtney Lee,171,39.7166666666667,39,0.716666666666669,91,87,4,4,0
21700206,202498,NYK,UTA,Lance Thomas,54,12.35,12,0.35,27,26,1,1,0
21700206,202683,NYK,UTA,Enes Kanter,104,24.6166666666667,24,0.616666666666667,58,64,-6,-6,0
21700206,203124,NYK,UTA,Kyle O'Quinn,71,17.0833333333333,17,0.0833333333333322,33,29,4,4,0
21700206,203501,NYK,UTA,Tim Hardaway Jr.,161,36.6166666666667,37,-0.383333333333333,87,76,11,11,0
21700206,203926,NYK,UTA,Doug McDermott,108,25.4333333333333,26,-0.566666666666666,45,44,1,3,-2
21700206,204001,NYK,UTA,Kristaps Porzingis,159,36.1833333333333,36,0.183333333333337,83,78,5,3,2
21700206,1628373,NYK,UTA,Frank Ntilikina,87,19.9833333333333,20,-0.0166666666666657,40,31,9,9,0
21700206,200757,UTA,NYK,Thabo Sefolosha,66,15.75,16,-0.25,30,30,0,0,0
21700206,201937,UTA,NYK,Ricky Rubio,134,30.8833333333333,31,-0.116666666666667,60,69,-9,-11,2
21700206,201973,UTA,NYK,Jonas Jerebko,96,22.3,22,0.299999999999997,55,51,4,4,0
21700206,202324,UTA,NYK,Derrick Favors,148,34.0833333333333,34,0.0833333333333286,77,81,-4,-4,0
21700206,202327,UTA,NYK,Ekpe Udoh,60,13.9333333333333,14,-0.0666666666666664,24,27,-3,-1,-2
21700206,202692,UTA,NYK,Alec Burks,98,22.85,23,-0.149999999999999,39,38,1,1,0
21700206,203918,UTA,NYK,Rodney Hood,139,32.5,32,0.5,74,67,7,7,0
21700206,204060,UTA,NYK,Joe Ingles,133,31.3166666666667,31,0.316666666666666,70,80,-10,-12,2
21700206,1628378,UTA,NYK,Donovan Mitchell,161,36.3833333333333,36,0.383333333333333,76,87,-11,-9,-2
21700207,2544,CLE,CHA,LeBron James,178,36.8333333333333,37,-0.166666666666664,88,87,1,1,0
21700207,2548,CLE,CHA,Dwyane Wade,97,19.2166666666667,19,0.216666666666669,47,41,6,7,-1
21700207,2594,CLE,CHA,Kyle Korver,113,23.2,23,0.200000000000003,56,50,6,12,-6
21700207,2747,CLE,CHA,JR Smith,155,31.15,31,0.149999999999999,75,72,3,0,3
21700207,101112,CLE,CHA,Channing Frye,96,20.35,20,0.350000000000001,53,40,13,14,-1
21700207,201145,CLE,CHA,Jeff Green,107,21.4833333333333,22,-0.516666666666666,51,49,2,3,-1
21700207,201567,CLE,CHA,Kevin Love,138,27.1333333333333,27,0.133333333333333,60,65,-5,-6,1
21700207,202697,CLE,CHA,Iman Shumpert,169,32.8333333333333,34,-1.16666666666667,82,74,8,6,2
21700207,203109,CLE,CHA,Jae Crowder,132,26.6333333333333,27,-0.366666666666667,63,57,6,3,3
21700207,2730,CHA,CLE,Dwight Howard,118,22.7,23,-0.300000000000001,52,55,-3,1,-4
21700207,101107,CHA,CLE,Marvin Williams,134,26.6166666666667,27,-0.383333333333333,63,62,1,-1,2
21700207,201587,CHA,CLE,Nicolas Batum,159,31.9166666666667,32,-0.0833333333333357,76,72,4,4,0
21700207,202689,CHA,CLE,Kemba Walker,189,38.9,39,-0.100000000000001,87,94,-7,-5,-2
21700207,203077,CHA,CLE,Michael Kidd-Gilchrist,148,30.95,31,-0.0500000000000007,71,72,-1,-1,0
21700207,203087,CHA,CLE,Jeremy Lamb,111,21.7333333333333,22,-0.266666666666666,51,54,-3,-7,4
21700207,203469,CHA,CLE,Cody Zeller,109,23.2666666666667,23,0.266666666666666,50,54,-4,-8,4
21700207,1626163,CHA,CLE,Frank Kaminsky,113,22.95,23,-0.0500000000000007,49,59,-10,-8,-2
21700207,1628370,CHA,CLE,Malik Monk,48,8.86666666666667,9,-0.133333333333333,20,21,-1,-3,2
21700207,1628407,CHA,CLE,Dwayne Bacon,56,10.9333333333333,11,-0.0666666666666664,16,32,-16,-12,-4
21700208,201152,IND,MEM,Thaddeus Young,147,32.7,33,-0.299999999999997,77,71,6,5,1
21700208,201954,IND,MEM,Darren Collison,191,41.3833333333333,41,0.383333333333333,105,90,15,12,3
21700208,202362,IND,MEM,Lance Stephenson,88,18.8166666666667,19,-0.183333333333334,53,51,2,0,2
21700208,202709,IND,MEM,Cory Joseph,104,21.2333333333333,22,-0.766666666666666,55,60,-5,-5,0
21700208,202711,IND,MEM,Bojan Bogdanovic,132,28.8666666666667,29,-0.133333333333333,61,61,0,3,-3
21700208,203506,IND,MEM,Victor Oladipo,155,33.8666666666667,34,-0.133333333333333,74,79,-5,-2,-3
21700208,1626167,IND,MEM,Myles Turner,150,32.75,33,-0.25,75,71,4,3,1
21700208,1627734,IND,MEM,Domantas Sabonis,116,24.4333333333333,24,0.433333333333334,63,65,-2,0,-2
21700208,1628388,IND,MEM,TJ Leaf,27,5.7,6,-0.300000000000001,17,17,0,-1,1
21700208,201148,MEM,IND,Brandan Wright,94,20.85,20,0.850000000000001,52,45,7,4,3
21700208,201188,MEM,IND,Marc Gasol,179,38.8166666666667,39,-0.183333333333337,88,90,-2,0,-2
21700208,201596,MEM,IND,Mario Chalmers,137,30.1,30,0.100000000000001,71,66,5,5,0
21700208,201936,MEM,IND,Tyreke Evans,156,32.8333333333333,33,-0.166666666666671,83,84,-1,-1,0
21700208,202718,MEM,IND,Chandler Parsons,119,25.6833333333333,25,0.683333333333334,67,69,-2,3,-5
21700208,203210,MEM,IND,JaMychal Green,79,17.05,17,0.0500000000000007,33,39,-6,-8,2
21700208,203463,MEM,IND,Ben McLemore,88,18.55,18,0.549999999999997,51,44,7,5,2
21700208,203516,MEM,IND,James Ennis III,74,16.7166666666667,17,-0.283333333333335,32,38,-6,-8,2
21700208,1627782,MEM,IND,Wayne Selden,72,15,15,0,38,44,-6,-4,-2
21700208,1628415,MEM,IND,Dillon Brooks,112,24.15,24,0.149999999999999,50,61,-11,-11,0
21700209,202339,MIL,DET,Eric Bledsoe,145,30.3666666666667,30,0.366666666666667,65,61,4,5,-1
21700209,202732,MIL,DET,DeAndre Liggins,88,19.9666666666667,20,-0.0333333333333314,38,35,3,0,3
21700209,203089,MIL,DET,John Henson,130,27.6,28,-0.399999999999999,67,55,12,12,0
21700209,203114,MIL,DET,Khris Middleton,181,39.9333333333333,40,-0.0666666666666629,91,86,5,8,-3
21700209,203503,MIL,DET,Tony Snell,178,38.35,39,-0.649999999999999,77,80,-3,-5,2
21700209,203507,MIL,DET,Giannis Antetokounmpo,158,34.6333333333333,35,-0.366666666666667,77,60,17,16,1
21700209,1627748,MIL,DET,Thon Maker,89,20.2333333333333,20,0.233333333333334,32,40,-8,-8,0
21700209,1627763,MIL,DET,Malcolm Brogdon,122,26.7,26,0.699999999999999,44,55,-11,-9,-2
21700209,1628391,MIL,DET,D.J. Wilson,9,2.05,2,0.0499999999999998,4,3,1,1,0
21700209,201229,DET,MIL,Anthony Tolliver,144,31.15,31,0.149999999999999,66,53,13,11,2
21700209,202340,DET,MIL,Avery Bradley,150,33.1,33,0.100000000000001,62,82,-20,-19,-1
21700209,202397,DET,MIL,Ish Smith,120,25.4166666666667,26,-0.583333333333336,55,42,13,13,0
21700209,202699,DET,MIL,Tobias Harris,153,34.3166666666667,34,0.316666666666663,68,84,-16,-13,-3
21700209,202704,DET,MIL,Reggie Jackson,99,22.4166666666667,22,0.416666666666664,40,57,-17,-17,0
21700209,203083,DET,MIL,Andre Drummond,134,28.7666666666667,29,-0.233333333333334,59,70,-11,-7,-4
21700209,203961,DET,MIL,Eric Moreland,86,19.2,19,0.200000000000003,36,29,7,3,4
21700209,204038,DET,MIL,Langston Galloway,70,14.8666666666667,15,-0.133333333333333,33,17,16,15,1
21700209,1626169,DET,MIL,Stanley Johnson,78,16.95,18,-1.05,31,46,-15,-12,-3
21700209,1628379,DET,MIL,Luke Kennard,66,13.65,13,0.65,25,15,10,6,4
21700210,2037,MIN,SAS,Jamal Crawford,80,18.15,18,0.149999999999999,43,33,10,8,2
21700210,201952,MIN,SAS,Jeff Teague,144,33.4333333333333,33,0.433333333333337,65,58,7,7,0
21700210,201959,MIN,SAS,Taj Gibson,123,29.6666666666667,30,-0.333333333333336,58,52,6,7,-1
21700210,202357,MIN,SAS,Nemanja Bjelica,102,22.4166666666667,22,0.416666666666664,51,37,14,15,-1
21700210,202710,MIN,SAS,Jimmy Butler,137,32.7166666666667,33,-0.283333333333331,65,59,6,6,0
21700210,203498,MIN,SAS,Shabazz Muhammad,49,12.0166666666667,12,0.0166666666666657,31,22,9,7,2
21700210,203952,MIN,SAS,Andrew Wiggins,155,35.7666666666667,36,-0.233333333333334,67,64,3,5,-2
21700210,1626145,MIN,SAS,Tyus Jones,60,14.35,15,-0.649999999999999,33,28,5,5,0
21700210,1626157,MIN,SAS,Karl-Anthony Towns,170,40.4,40,0.399999999999999,77,77,0,0,0
21700210,1938,SAS,MIN,Manu Ginobili,86,18.0666666666667,18,0.0666666666666664,31,38,-7,-7,0
21700210,2200,SAS,MIN,Pau Gasol,120,28.6833333333333,28,0.683333333333334,56,52,4,3,1
21700210,200746,SAS,MIN,LaMarcus Aldridge,111,27.8,28,-0.199999999999999,52,53,-1,-1,0
21700210,200752,SAS,MIN,Rudy Gay,104,22.0833333333333,22,0.0833333333333357,42,41,1,1,0
21700210,201980,SAS,MIN,Danny Green,122,30.5833333333333,31,-0.416666666666668,57,63,-6,-6,0
21700210,201988,SAS,MIN,Patty Mills,114,28.5833333333333,28,0.583333333333332,54,58,-4,-3,-1
21700210,202722,SAS,MIN,Davis Bertans,5,1.41666666666667,2,-0.583333333333333,2,5,-3,-3,0
21700210,203464,SAS,MIN,Brandon Paul,16,4.3,4,0.300000000000001,6,16,-10,-10,0
21700210,203530,SAS,MIN,Joffrey Lauvergne,59,12.1,13,-0.899999999999999,22,22,0,-2,2
21700210,203937,SAS,MIN,Kyle Anderson,104,25.5333333333333,25,0.533333333333331,43,54,-11,-11,0
21700210,1627749,SAS,MIN,Dejounte Murray,90,19.2,20,-0.800000000000001,32,40,-8,-9,1
21700210,1627854,SAS,MIN,Bryn Forbes,89,20.5666666666667,21,-0.433333333333334,33,48,-15,-12,-3
21700211,2749,NOP,TOR,Jameer Nelson,120,26.1333333333333,26,0.133333333333333,58,73,-15,-17,2
21700211,200765,NOP,TOR,Rajon Rondo,72,14.1666666666667,14,0.166666666666668,42,35,7,9,-2
21700211,201950,NOP,TOR,Jrue Holiday,169,35.85,36,-0.150000000000006,91,87,4,1,3
21700211,201967,NOP,TOR,Dante Cunningham,132,27.75,28,-0.25,72,74,-2,-4,2
21700211,202326,NOP,TOR,DeMarcus Cousins,140,30.1,31,-0.899999999999999,71,73,-2,-6,4
21700211,202734,NOP,TOR,E'Twaun Moore,144,31.8,32,-0.199999999999999,64,83,-19,-17,-2
21700211,203076,NOP,TOR,Anthony Davis,163,33.6666666666667,34,-0.333333333333336,81,83,-2,-6,4
21700211,203121,NOP,TOR,Darius Miller,94,21.25,21,0.25,49,63,-14,-11,-3
21700211,1627767,NOP,TOR,Cheick Diallo,63,13.7,14,-0.300000000000001,30,42,-12,-8,-4
21700211,1627883,NOP,TOR,Jalen Jones,9,2,2,0,11,6,5,7,-2
21700211,1628429,NOP,TOR,Charles Cooke,9,2,2,0,11,6,5,7,-2
21700211,101139,TOR,NOP,CJ Miles,86,18.8166666666667,19,-0.183333333333334,51,36,15,13,2
21700211,200768,TOR,NOP,Kyle Lowry,167,35.4833333333333,36,-0.516666666666666,86,94,-8,-9,1
21700211,201586,TOR,NOP,Serge Ibaka,139,29.2333333333333,30,-0.766666666666666,76,79,-3,-1,-2
21700211,201942,TOR,NOP,DeMar DeRozan,160,33.6666666666667,33,0.666666666666664,89,83,6,12,-6
21700211,202685,TOR,NOP,Jonas Valanciunas,136,28.4666666666667,29,-0.533333333333331,72,75,-3,1,-4
21700211,203512,TOR,NOP,Lucas Nogueira,13,2.9,3,-0.1,9,6,3,3,0
21700211,1626153,TOR,NOP,Delon Wright,45,9.73333333333333,10,-0.266666666666666,29,19,10,8,2
21700211,1627751,TOR,NOP,Jakob Poeltl,74,16.3166666666667,16,0.316666666666666,44,35,9,5,4
21700211,1627783,TOR,NOP,Pascal Siakam,113,25.2333333333333,25,0.233333333333334,65,51,14,15,-1
21700211,1627832,TOR,NOP,Fred VanVleet,100,21.7,22,-0.300000000000001,58,50,8,10,-2
21700211,1628035,TOR,NOP,Alfonzo McKinnie,15,3.28333333333333,3,0.283333333333333,12,13,-1,-3,2
21700211,1628384,TOR,NOP,OG Anunoby,67,13.5833333333333,14,-0.416666666666666,34,39,-5,-9,4
21700212,201577,CHI,OKC,Robin Lopez,97,22.1333333333333,22,0.133333333333333,38,45,-7,-5,-2
21700212,202347,CHI,OKC,Quincy Pondexter,88,20.9666666666667,21,-0.0333333333333314,26,43,-17,-17,0
21700212,1626170,CHI,OKC,Jerian Grant,116,25.75,27,-1.25,47,60,-13,-14,1
21700212,1626171,CHI,OKC,Bobby Portis,92,20.6166666666667,20,0.616666666666667,30,40,-10,-9,-1
21700212,1626245,CHI,OKC,Cristiano Felicio,70,17.15,18,-0.850000000000001,37,27,10,6,4
21700212,1627739,CHI,OKC,Kris Dunn,117,28.8666666666667,29,-0.133333333333333,44,52,-8,-9,1
21700212,1627756,CHI,OKC,Denzel Valentine,124,27.8666666666667,27,0.866666666666667,39,55,-16,-16,0
21700212,1627835,CHI,OKC,Paul Zipser,71,16.95,17,-0.0500000000000007,32,30,2,2,0
21700212,1628374,CHI,OKC,Lauri Markkanen,130,31.5666666666667,32,-0.433333333333334,52,61,-9,-8,-1
21700212,1628469,CHI,OKC,Antonio Blakeney,110,25.6333333333333,26,-0.366666666666667,50,47,3,5,-2
21700212,2546,OKC,CHI,Carmelo Anthony,119,27.9333333333333,28,-0.0666666666666664,59,43,16,15,1
21700212,101109,OKC,CHI,Raymond Felton,79,18.9666666666667,19,-0.033333333333335,32,37,-5,-5,0
21700212,201566,OKC,CHI,Russell Westbrook,137,32.0666666666667,32,0.06666666666667,69,50,19,18,1
21700212,202331,OKC,CHI,Paul George,155,36.45,37,-0.549999999999997,69,61,8,7,1
21700212,202335,OKC,CHI,Patrick Patterson,80,17.9166666666667,18,-0.0833333333333357,35,32,3,4,-1
21700212,203460,OKC,CHI,Andre Roberson,80,18.9833333333333,19,-0.0166666666666657,33,28,5,5,0
21700212,203518,OKC,CHI,Alex Abrines,103,22.7833333333333,23,-0.216666666666669,49,38,11,13,-2
21700212,203924,OKC,CHI,Jerami Grant,146,34.1166666666667,35,-0.883333333333333,70,60,10,11,-1
21700212,203962,OKC,CHI,Josh Huestis,44,10.1333333333333,10,0.133333333333333,22,15,7,7,0
21700212,1626177,OKC,CHI,Dakari Johnson,50,11.9166666666667,12,-0.0833333333333322,18,15,3,2,1
21700212,1627772,OKC,CHI,Daniel Hamilton,11,3.11666666666667,4,-0.883333333333333,2,8,-6,-6,0
21700212,1628390,OKC,CHI,Terrance Ferguson,11,3.11666666666667,4,-0.883333333333333,2,8,-6,-6,0
21700213,201578,ORL,POR,Marreese Speights,64,16.45,16,0.449999999999999,29,25,4,4,0
21700213,202687,ORL,POR,Bismack Biyombo,66,16.8666666666667,17,-0.133333333333333,29,25,4,4,0
21700213,202696,ORL,POR,Nikola Vucevic,139,31.0333333333333,31,0.033333333333335,65,74,-9,-9,0
21700213,202714,ORL,POR,Shelvin Mack,64,16.3833333333333,16,0.383333333333333,28,24,4,6,-2
21700213,203082,ORL,POR,Terrence Ross,118,26.6333333333333,27,-0.366666666666667,47,57,-10,-12,2
21700213,203095,ORL,POR,Evan Fournier,159,36.2166666666667,36,0.216666666666669,73,82,-9,-9,0
21700213,203613,ORL,POR,Jonathon Simmons,108,26.7,26,0.699999999999999,57,47,10,12,-2
21700213,203901,ORL,POR,Elfrid Payton,136,30.3166666666667,31,-0.683333333333334,63,75,-12,-14,2
21700213,203932,ORL,POR,Aaron Gordon,141,31.45,32,-0.550000000000001,65,74,-9,-9,0
21700213,1626209,ORL,POR,Mario Hezonja,30,7.45,7,0.449999999999999,14,12,2,2,0
21700213,202323,POR,ORL,Evan Turner,97,23.7166666666667,23,0.716666666666669,37,47,-10,-12,2
21700213,202334,POR,ORL,Ed Davis,69,16.4666666666667,16,0.466666666666669,32,34,-2,-2,0
21700213,203081,POR,ORL,Damian Lillard,163,37.2166666666667,37,0.216666666666669,84,76,8,8,0
21700213,203090,POR,ORL,Maurice Harkless,124,27.4666666666667,28,-0.533333333333331,68,55,13,13,0
21700213,203468,POR,ORL,CJ McCollum,169,38.2666666666667,38,0.266666666666666,89,78,11,11,0
21700213,203894,POR,ORL,Shabazz Napier,109,26.15,27,-0.850000000000001,52,41,11,11,0
21700213,203943,POR,ORL,Noah Vonleh,85,21.4,21,0.399999999999999,34,39,-5,-5,0
21700213,203994,POR,ORL,Jusuf Nurkic,137,31.6,32,-0.399999999999999,69,60,9,9,0
21700213,1626192,POR,ORL,Pat Connaughton,47,11.7,12,-0.300000000000001,20,21,-1,1,-2
21700213,1628403,POR,ORL,Caleb Swanigan,25,5.51666666666667,6,-0.483333333333333,10,19,-9,-9,0
21700214,101106,LAL,PHI,Andrew Bogut,103,19.45,20,-0.550000000000001,40,42,-2,-2,0
21700214,201147,LAL,PHI,Corey Brewer,50,9.95,10,-0.0500000000000007,22,20,2,-1,3
21700214,201572,LAL,PHI,Brook Lopez,88,15.65,16,-0.35,34,46,-12,-11,-1
21700214,203484,LAL,PHI,Kentavious Caldwell-Pope,218,40.9,41,-0.100000000000001,97,97,0,0,0
21700214,203903,LAL,PHI,Jordan Clarkson,165,31.3333333333333,32,-0.666666666666664,70,67,3,3,0
21700214,203944,LAL,PHI,Julius Randle,152,29.6333333333333,30,-0.366666666666667,67,61,6,5,1
21700214,1627742,LAL,PHI,Brandon Ingram,214,39.75,40,-0.25,93,98,-5,-2,-3
21700214,1628366,LAL,PHI,Lonzo Ball,115,21.3166666666667,21,0.316666666666666,45,63,-18,-18,0
21700214,1628398,LAL,PHI,Kyle Kuzma,165,30.7666666666667,31,-0.233333333333334,77,81,-4,-4,0
21700214,101161,PHI,LAL,Amir Johnson,52,9.05,9,0.0500000000000007,15,25,-10,-10,0
21700214,200755,PHI,LAL,JJ Redick,179,34.75,35,-0.25,84,80,4,3,1
21700214,203496,PHI,LAL,Robert Covington,155,29.65,30,-0.350000000000001,83,65,18,16,2
21700214,203954,PHI,LAL,Joel Embiid,178,34.1166666666667,34,0.116666666666667,91,72,19,19,0
21700214,203967,PHI,LAL,Dario Saric,170,33,33,0,76,77,-1,1,-2
21700214,204456,PHI,LAL,T.J. McConnell,126,22.8166666666667,23,-0.183333333333334,45,52,-7,-8,1
21700214,1626147,PHI,LAL,Justin Anderson,46,7.75,8,-0.25,12,22,-10,-8,-2
21700214,1626158,PHI,LAL,Richaun Holmes,24,4.58333333333333,5,-0.416666666666666,9,12,-3,-3,0
21700214,1627732,PHI,LAL,Ben Simmons,205,38.4833333333333,39,-0.516666666666666,106,86,20,19,1
21700214,1627789,PHI,LAL,Timothe Luwawu-Cabarrot,135,24.55,25,-0.450000000000003,54,54,0,1,-1
21700215,201143,BOS,GSW,Al Horford,166,34.8166666666667,35,-0.183333333333337,76,62,14,16,-2
21700215,202681,BOS,GSW,Kyrie Irving,158,33.8,34,-0.200000000000003,60,66,-6,-4,-2
21700215,202694,BOS,GSW,Marcus Morris,117,25.9666666666667,26,-0.0333333333333314,41,60,-19,-12,-7
21700215,203382,BOS,GSW,Aron Baynes,55,12.3833333333333,12,0.383333333333333,30,20,10,11,-1
21700215,203935,BOS,GSW,Marcus Smart,147,30.9,31,-0.100000000000001,68,49,19,15,4
21700215,1626179,BOS,GSW,Terry Rozier,89,21.2333333333333,21,0.233333333333334,39,35,4,6,-2
21700215,1627759,BOS,GSW,Jaylen Brown,165,34.1833333333333,34,0.18333333333333,75,62,13,8,5
21700215,1628369,BOS,GSW,Jayson Tatum,121,27.2833333333333,27,0.283333333333331,44,58,-14,-18,4
21700215,1628400,BOS,GSW,Semi Ojeleye,75,16.65,17,-0.350000000000001,25,22,3,0,3
21700215,1628464,BOS,GSW,Daniel Theis,12,2.78333333333333,3,-0.216666666666667,2,6,-4,-2,-2
21700215,2561,GSW,BOS,David West,46,11.0833333333333,11,0.0833333333333322,20,15,5,5,0
21700215,2585,GSW,BOS,Zaza Pachulia,83,17.7666666666667,18,-0.233333333333334,43,25,18,16,2
21700215,2733,GSW,BOS,Shaun Livingston,72,16.9166666666667,17,-0.0833333333333322,37,25,12,10,2
21700215,2738,GSW,BOS,Andre Iguodala,139,30,30,0,46,64,-18,-18,0
21700215,201142,GSW,BOS,Kevin Durant,164,34.5666666666667,35,-0.43333333333333,66,70,-4,-6,2
21700215,201156,GSW,BOS,Nick Young,46,9.2,10,-0.800000000000001,10,26,-16,-14,-2
21700215,201580,GSW,BOS,JaVale McGee,17,3.26666666666667,4,-0.733333333333333,4,12,-8,-8,0
21700215,201939,GSW,BOS,Stephen Curry,147,30.9833333333333,31,-0.0166666666666657,54,68,-14,-14,0
21700215,201956,GSW,BOS,Omri Casspi,33,8.46666666666667,8,0.466666666666667,15,11,4,4,0
21700215,202691,GSW,BOS,Klay Thompson,161,34.6166666666667,34,0.616666666666667,67,63,4,4,0
21700215,203110,GSW,BOS,Draymond Green,177,38.3666666666667,38,0.366666666666667,73,70,3,7,-4
21700215,1626172,GSW,BOS,Kevon Looney,20,4.76666666666667,5,-0.233333333333333,5,11,-6,-6,0
21700216,2403,HOU,PHX,Nene,81,14.8166666666667,15,-0.183333333333334,53,36,17,15,2
21700216,2772,HOU,PHX,Trevor Ariza,185,35.2166666666667,35,0.216666666666669,111,89,22,22,0
21700216,101108,HOU,PHX,Chris Paul,103,20.65,21,-0.350000000000001,56,44,12,12,0
21700216,200782,HOU,PHX,PJ Tucker,182,32.9833333333333,33,-0.0166666666666657,92,80,12,12,0
21700216,201569,HOU,PHX,Eric Gordon,143,25.5666666666667,26,-0.433333333333334,81,59,22,22,0
21700216,201583,HOU,PHX,Ryan Anderson,146,28.95,29,-0.0500000000000007,95,73,22,22,0
21700216,201628,HOU,PHX,Bobby Brown,32,5.41666666666667,5,0.416666666666666,11,11,0,1,-1
21700216,201935,HOU,PHX,James Harden,179,34.5,35,-0.5,108,92,16,15,1
21700216,203991,HOU,PHX,Clint Capela,107,21.1666666666667,21,0.166666666666668,67,55,12,14,-2
21700216,204028,HOU,PHX,Tarik Black,66,11.8666666666667,12,-0.133333333333333,22,25,-3,-3,0
21700216,1627753,HOU,PHX,Zhou Qi,46,8.11666666666667,8,0.116666666666667,14,16,-2,-2,0
21700216,202328,PHX,HOU,Greg Monroe,133,26.0833333333333,26,0.0833333333333357,72,75,-3,-2,-1
21700216,203458,PHX,HOU,Alex Len,121,21.7666666666667,22,-0.233333333333334,44,67,-23,-24,1
21700216,203584,PHX,HOU,Troy Daniels,136,25.9333333333333,26,-0.0666666666666664,66,72,-6,-6,0
21700216,203933,PHX,HOU,T.J. Warren,133,26.7333333333333,27,-0.266666666666666,72,96,-24,-23,-1
21700216,1626164,PHX,HOU,Devin Booker,157,30.0833333333333,30,0.0833333333333357,84,107,-23,-23,0
21700216,1627733,PHX,HOU,Dragan Bender,124,22.8333333333333,23,-0.166666666666664,46,71,-25,-21,-4
21700216,1627737,PHX,HOU,Marquese Chriss,84,15.6333333333333,16,-0.366666666666667,37,35,2,0,2
21700216,1627755,PHX,HOU,Tyler Ulis,112,21.9166666666667,22,-0.0833333333333357,56,61,-5,-11,6
21700216,1628367,PHX,HOU,Josh Jackson,158,28.5,29,-0.5,68,74,-6,-9,3
21700216,1628455,PHX,HOU,Mike James,112,19.7666666666667,20,-0.233333333333334,35,52,-17,-11,-6
21700217,201152,IND,DET,Thaddeus Young,179,39,39,0,79,79,0,-1,1
21700217,201954,IND,DET,Darren Collison,145,30.8166666666667,31,-0.183333333333334,71,74,-3,-7,4
21700217,202362,IND,DET,Lance Stephenson,83,18.1,18,0.100000000000001,52,37,15,16,-1
21700217,202709,IND,DET,Cory Joseph,120,26.5666666666667,26,0.566666666666666,63,52,11,11,0
21700217,202711,IND,DET,Bojan Bogdanovic,160,34.5833333333333,35,-0.416666666666671,73,73,0,1,-1
21700217,203506,IND,DET,Victor Oladipo,178,38.4666666666667,39,-0.533333333333331,82,74,8,12,-4
21700217,1626167,IND,DET,Myles Turner,107,23.1333333333333,24,-0.866666666666667,42,54,-12,-10,-2
21700217,1627734,IND,DET,Domantas Sabonis,113,24.55,24,0.550000000000001,65,46,19,17,2
21700217,1628388,IND,DET,TJ Leaf,15,3.2,3,0.2,8,11,-3,-4,1
21700217,201229,DET,IND,Anthony Tolliver,89,18.2666666666667,18,0.266666666666666,42,46,-4,-2,-2
21700217,202340,DET,IND,Avery Bradley,148,32.6,33,-0.400000000000006,62,72,-10,-13,3
21700217,202397,DET,IND,Ish Smith,91,19.8333333333333,20,-0.166666666666664,40,48,-8,-8,0
21700217,202699,DET,IND,Tobias Harris,129,29.0333333333333,30,-0.966666666666669,58,59,-1,-3,2
21700217,202704,DET,IND,Reggie Jackson,131,28.2333333333333,29,-0.766666666666666,60,61,-1,-1,0
21700217,203083,DET,IND,Andre Drummond,161,35.25,35,0.25,66,76,-10,-12,2
21700217,203961,DET,IND,Eric Moreland,59,12.4333333333333,13,-0.566666666666666,34,31,3,5,-2
21700217,204038,DET,IND,Langston Galloway,64,13.1833333333333,13,0.183333333333334,37,32,5,8,-3
21700217,1626169,DET,IND,Stanley Johnson,111,24.6166666666667,25,-0.383333333333333,45,54,-9,-9,0
21700217,1628379,DET,IND,Luke Kennard,117,24.9666666666667,25,-0.033333333333335,56,56,0,0,0
21700218,201609,MIA,WAS,Goran Dragic,154,35,35,0,68,64,4,5,-1
21700218,201949,MIA,WAS,James Johnson,140,31.2,31,0.200000000000003,62,66,-4,-4,0
21700218,201961,MIA,WAS,Wayne Ellington,95,21.35,21,0.350000000000001,37,34,3,2,1
21700218,202355,MIA,WAS,Hassan Whiteside,137,31.0333333333333,31,0.0333333333333314,57,57,0,-1,1
21700218,203079,MIA,WAS,Dion Waiters,141,31.7333333333333,32,-0.266666666666666,62,54,8,6,2
21700218,203482,MIA,WAS,Kelly Olynyk,58,12.1333333333333,12,0.133333333333333,32,20,12,12,0
21700218,204020,MIA,WAS,Tyler Johnson,91,20.1,20,0.100000000000001,39,35,4,5,-1
21700218,1626159,MIA,WAS,Justise Winslow,80,17.7833333333333,18,-0.216666666666669,31,24,7,6,1
21700218,1626196,MIA,WAS,Josh Richardson,159,35.7166666666667,36,-0.283333333333331,66,77,-11,-9,-2
21700218,1628389,MIA,WAS,Bam Adebayo,15,3.95,4,-0.0499999999999998,1,9,-8,-7,-1
21700218,101133,WAS,MIA,Ian Mahinmi,39,8.28333333333333,8,0.283333333333333,10,17,-7,-7,0
21700218,101162,WAS,MIA,Marcin Gortat,123,27.2,28,-0.800000000000001,48,48,0,1,-1
21700218,201160,WAS,MIA,Jason Smith,41,10.2666666666667,10,0.266666666666666,26,20,6,5,1
21700218,201975,WAS,MIA,Jodie Meeks,63,14.3666666666667,14,0.366666666666667,27,29,-2,-1,-1
21700218,202322,WAS,MIA,John Wall,155,35.0666666666667,35,0.0666666666666629,66,69,-3,-5,2
21700218,202693,WAS,MIA,Markieff Morris,102,23.55,24,-0.450000000000003,36,40,-4,-5,1
21700218,203078,WAS,MIA,Bradley Beal,176,39.65,40,-0.350000000000001,75,70,5,6,-1
21700218,203118,WAS,MIA,Mike Scott,45,9.16666666666667,9,0.166666666666668,12,20,-8,-8,0
21700218,203490,WAS,MIA,Otto Porter Jr.,147,32.8833333333333,33,-0.116666666666667,63,62,1,1,0
21700218,204025,WAS,MIA,Tim Frazier,63,14.0333333333333,14,0.0333333333333332,22,24,-2,0,-2
21700218,1626162,WAS,MIA,Kelly Oubre Jr.,116,25.5333333333333,25,0.533333333333331,55,56,-1,-2,1
21700219,201960,BKN,UTA,DeMarre Carroll,117,26.9,27,-0.100000000000001,69,62,7,7,0
21700219,202344,BKN,UTA,Trevor Booker,117,26.8333333333333,27,-0.166666666666664,69,61,8,7,1
21700219,203092,BKN,UTA,Tyler Zeller,108,23.3333333333333,24,-0.666666666666664,49,52,-3,-3,0
21700219,203112,BKN,UTA,Quincy Acy,80,16.8666666666667,17,-0.133333333333333,46,35,11,13,-2
21700219,203459,BKN,UTA,Allen Crabbe,132,30.35,30,0.350000000000001,75,69,6,2,4
21700219,203915,BKN,UTA,Spencer Dinwiddie,144,31.7,31,0.699999999999996,75,67,8,9,-1
21700219,203925,BKN,UTA,Joe Harris,106,22.2166666666667,23,-0.783333333333331,56,46,10,14,-4
21700219,203930,BKN,UTA,Sean Kilpatrick,7,1.38333333333333,2,-0.616666666666667,1,7,-6,-4,-2
21700219,1626178,BKN,UTA,Rondae Hollis-Jefferson,118,27.0666666666667,27,0.0666666666666664,65,63,2,1,1
21700219,1627747,BKN,UTA,Caris LeVert,100,21.8166666666667,22,-0.183333333333334,61,42,19,16,3
21700219,1627785,BKN,UTA,Isaiah Whitehead,46,10.2,10,0.199999999999999,24,31,-7,-7,0
21700219,201973,UTA,BKN,Jonas Jerebko,74,17.1166666666667,17,0.116666666666667,43,41,2,3,-1
21700219,202324,UTA,BKN,Derrick Favors,127,29.1333333333333,29,0.133333333333333,62,66,-4,-2,-2
21700219,202327,UTA,BKN,Ekpe Udoh,76,15.7166666666667,15,0.716666666666667,34,46,-12,-14,2
21700219,202692,UTA,BKN,Alec Burks,122,26.7666666666667,28,-1.23333333333333,57,64,-7,-10,3
21700219,203489,UTA,BKN,Nate Wolters,12,2.88333333333333,3,-0.116666666666667,11,6,5,5,0
21700219,203526,UTA,BKN,Raul Neto,91,20.0333333333333,20,0.0333333333333314,43,56,-13,-9,-4
21700219,203918,UTA,BKN,Rodney Hood,157,35.6833333333333,36,-0.31666666666667,78,85,-7,-9,2
21700219,204060,UTA,BKN,Joe Ingles,146,31.7833333333333,32,-0.216666666666665,69,81,-12,-10,-2
21700219,1626220,UTA,BKN,Royce O'Neale,98,21.1833333333333,21,0.183333333333334,49,55,-6,-7,1
21700219,1628378,UTA,BKN,Donovan Mitchell,160,35.4833333333333,35,0.483333333333334,78,84,-6,-7,1
21700219,1628396,UTA,BKN,Tony Bradley,12,2.88333333333333,3,-0.116666666666667,11,6,5,5,0
21700220,2544,CLE,LAC,LeBron James,211,46,46,0,100,99,1,1,0
21700220,2548,CLE,LAC,Dwyane Wade,177,37.0333333333333,37,0.0333333333333314,97,76,21,19,2
21700220,2594,CLE,LAC,Kyle Korver,134,28.4333333333333,28,0.433333333333334,74,50,24,25,-1
21700220,2747,CLE,LAC,JR Smith,165,35.7833333333333,36,-0.216666666666669,72,82,-10,-9,-1
21700220,101112,CLE,LAC,Channing Frye,53,10.8166666666667,11,-0.183333333333334,26,26,0,-4,4
21700220,101181,CLE,LAC,Jose Calderon,43,10.45,10,0.449999999999999,17,23,-6,-4,-2
21700220,201145,CLE,LAC,Jeff Green,75,15.7,16,-0.300000000000001,36,35,1,-3,4
21700220,201567,CLE,LAC,Kevin Love,195,42.1666666666667,42,0.166666666666664,92,87,5,9,-4
21700220,202697,CLE,LAC,Iman Shumpert,57,11.0333333333333,11,0.0333333333333314,16,26,-10,-8,-2
21700220,203109,CLE,LAC,Jae Crowder,128,27.1833333333333,28,-0.816666666666666,58,59,-1,1,-2
21700220,1626224,CLE,LAC,Cedi Osman,2,0.316666666666667,0,0.316666666666667,2,2,0,-2,2
21700220,101150,LAC,CLE,Lou Williams,177,37.2666666666667,37,0.266666666666666,78,97,-19,-17,-2
21700220,201599,LAC,CLE,DeAndre Jordan,186,40.1166666666667,40,0.116666666666667,85,88,-3,-7,4
21700220,201933,LAC,CLE,Blake Griffin,195,42.2166666666667,42,0.216666666666669,88,98,-10,-8,-2
21700220,202325,LAC,CLE,Wesley Johnson,201,42.55,43,-0.450000000000003,102,90,12,12,0
21700220,203085,LAC,CLE,Austin Rivers,160,34.6833333333333,35,-0.31666666666667,72,62,10,6,4
21700220,1626149,LAC,CLE,Montrezl Harrell,62,12.8666666666667,13,-0.133333333333333,28,30,-2,2,-4
21700220,1626155,LAC,CLE,Sam Dekker,93,18.4666666666667,18,0.466666666666669,42,44,-2,-2,0
21700220,1628393,LAC,CLE,Jawun Evans,25,5.53333333333333,6,-0.466666666666667,12,15,-3,-3,0
21700220,1628414,LAC,CLE,Sindarius Thornwell,141,31.2166666666667,31,0.216666666666665,58,66,-8,-8,0
21700221,101127,NYK,TOR,Jarrett Jack,116,27.0833333333333,27,0.0833333333333357,51,64,-13,-13,0
21700221,201196,NYK,TOR,Ramon Sessions,17,2.98333333333333,3,-0.0166666666666666,4,4,0,0,0
21700221,201563,NYK,TOR,Michael Beasley,55,11.6666666666667,12,-0.333333333333334,20,29,-9,-9,0
21700221,201584,NYK,TOR,Courtney Lee,147,34.9666666666667,35,-0.0333333333333314,60,85,-25,-25,0
21700221,202498,NYK,TOR,Lance Thomas,52,12.55,13,-0.449999999999999,20,24,-4,-4,0
21700221,202683,NYK,TOR,Enes Kanter,99,23.25,24,-0.75,46,56,-10,-10,0
21700221,203124,NYK,TOR,Kyle O'Quinn,56,13.0333333333333,13,0.0333333333333332,20,25,-5,-5,0
21700221,203501,NYK,TOR,Tim Hardaway Jr.,144,33.0166666666667,33,0.0166666666666657,63,78,-15,-15,0
21700221,203926,NYK,TOR,Doug McDermott,94,21.1833333333333,21,0.183333333333334,34,41,-7,-7,0
21700221,204001,NYK,TOR,Kristaps Porzingis,151,35.0333333333333,35,0.0333333333333314,65,82,-17,-17,0
21700221,1626195,NYK,TOR,Willy Hernangomez,17,2.98333333333333,3,-0.0166666666666666,4,4,0,0,0
21700221,1628373,NYK,TOR,Frank Ntilikina,75,17.6,17,0.600000000000001,29,39,-10,-10,0
21700221,1628422,NYK,TOR,Damyean Dotson,17,2.98333333333333,3,-0.0166666666666666,4,4,0,0,0
21700221,101139,TOR,NYK,CJ Miles,106,24.7833333333333,24,0.783333333333331,53,40,13,15,-2
21700221,200768,TOR,NYK,Kyle Lowry,137,31.65,32,-0.350000000000001,83,61,22,22,0
21700221,201942,TOR,NYK,DeMar DeRozan,147,34.15,34,0.149999999999999,78,65,13,11,2
21700221,202685,TOR,NYK,Jonas Valanciunas,83,19.3666666666667,19,0.366666666666667,46,42,4,6,-2
21700221,203485,TOR,NYK,Lorenzo Brown,77,17.5,18,-0.5,33,30,3,5,-2
21700221,203512,TOR,NYK,Lucas Nogueira,72,17.3666666666667,17,0.366666666666667,28,26,2,2,0
21700221,1627751,TOR,NYK,Jakob Poeltl,53,10.9333333333333,12,-1.06666666666667,33,16,17,15,2
21700221,1627783,TOR,NYK,Pascal Siakam,150,33.6666666666667,34,-0.333333333333329,76,63,13,9,4
21700221,1627832,TOR,NYK,Fred VanVleet,78,17.2333333333333,17,0.233333333333334,30,25,5,5,0
21700221,1628035,TOR,NYK,Alfonzo McKinnie,14,2.33333333333333,3,-0.666666666666667,2,2,0,0,0
21700221,1628384,TOR,NYK,OG Anunoby,123,29.35,30,-0.649999999999999,73,50,23,25,-2
21700222,201577,CHI,CHA,Robin Lopez,134,28.4666666666667,28,0.466666666666669,74,67,7,12,-5
21700222,202347,CHI,CHA,Quincy Pondexter,70,15.4666666666667,16,-0.533333333333333,36,37,-1,1,-2
21700222,203200,CHI,CHA,Justin Holiday,170,36.1666666666667,36,0.166666666666671,95,91,4,4,0
21700222,1626170,CHI,CHA,Jerian Grant,102,21.5833333333333,22,-0.416666666666668,51,55,-4,-4,0
21700222,1626171,CHI,CHA,Bobby Portis,76,16.9666666666667,17,-0.0333333333333314,40,41,-1,-5,4
21700222,1626245,CHI,CHA,Cristiano Felicio,89,19.4833333333333,20,-0.516666666666666,47,53,-6,-9,3
21700222,1627739,CHI,CHA,Kris Dunn,122,26.25,26,0.25,72,64,8,8,0
21700222,1627756,CHI,CHA,Denzel Valentine,155,32.5333333333333,32,0.533333333333331,87,83,4,2,2
21700222,1627770,CHI,CHA,Kay Felder,1,0.166666666666667,0,0.166666666666667,,1,,-1,
21700222,1627835,CHI,CHA,Paul Zipser,1,0.166666666666667,0,0.166666666666667,,1,,-1,
21700222,1628374,CHI,CHA,Lauri Markkanen,151,31.0833333333333,31,0.0833333333333357,85,79,6,8,-2
21700222,1628469,CHI,CHA,Antonio Blakeney,54,11.6666666666667,12,-0.333333333333334,28,28,0,0,0
21700222,2730,CHA,CHI,Dwight Howard,131,28.0166666666667,28,0.0166666666666657,65,77,-12,-11,-1
21700222,101107,CHA,CHI,Marvin Williams,132,28.0833333333333,28,0.0833333333333322,76,69,7,2,5
21700222,201587,CHA,CHI,Nicolas Batum,124,26.4166666666667,27,-0.583333333333336,65,74,-9,-5,-4
21700222,202689,CHA,CHI,Kemba Walker,175,38.0333333333333,38,0.0333333333333314,97,94,3,3,0
21700222,203077,CHA,CHI,Michael Kidd-Gilchrist,125,27.1833333333333,27,0.183333333333334,71,64,7,4,3
21700222,203087,CHA,CHI,Jeremy Lamb,114,24.1333333333333,24,0.133333333333333,56,60,-4,-8,4
21700222,203469,CHA,CHI,Cody Zeller,94,19.9833333333333,20,-0.0166666666666657,55,46,9,8,1
21700222,1626163,CHA,CHI,Frank Kaminsky,93,19.9166666666667,20,-0.0833333333333357,44,54,-10,-5,-5
21700222,1628370,CHA,CHI,Malik Monk,50,9.96666666666667,10,-0.033333333333335,23,29,-6,-6,0
21700222,1628407,CHA,CHI,Dwayne Bacon,87,18.2666666666667,18,0.266666666666666,48,48,0,3,-3
21700223,1938,SAS,OKC,Manu Ginobili,89,18.3666666666667,18,0.366666666666667,36,44,-8,-10,2
21700223,2200,SAS,OKC,Pau Gasol,125,29.55,30,-0.450000000000003,72,52,20,21,-1
21700223,200746,SAS,OKC,LaMarcus Aldridge,159,36.05,36,0.0499999999999972,81,72,9,6,3
21700223,200752,SAS,OKC,Rudy Gay,79,16.9833333333333,18,-1.01666666666667,32,48,-16,-13,-3
21700223,201980,SAS,OKC,Danny Green,152,34.55,35,-0.450000000000003,77,66,11,11,0
21700223,201988,SAS,OKC,Patty Mills,148,33.55,34,-0.450000000000003,73,70,3,5,-2
21700223,202722,SAS,OKC,Davis Bertans,48,10.9666666666667,11,-0.0333333333333332,33,20,13,11,2
21700223,203464,SAS,OKC,Brandon Paul,15,2.58333333333333,2,0.583333333333334,2,7,-5,-3,-2
21700223,203530,SAS,OKC,Joffrey Lauvergne,26,4.6,5,-0.4,5,16,-11,-9,-2
21700223,203937,SAS,OKC,Kyle Anderson,135,31.65,31,0.649999999999999,69,57,12,7,5
21700223,1627749,SAS,OKC,Dejounte Murray,51,11.8666666666667,12,-0.133333333333333,29,23,6,1,5
21700223,1627854,SAS,OKC,Bryn Forbes,43,9.28333333333333,9,0.283333333333333,11,25,-14,-12,-2
21700223,2546,OKC,SAS,Carmelo Anthony,143,32.85,33,-0.149999999999999,67,69,-2,-3,1
21700223,101109,OKC,SAS,Raymond Felton,64,14.2833333333333,14,0.283333333333333,28,31,-3,-2,-1
21700223,201566,OKC,SAS,Russell Westbrook,163,37.4833333333333,38,-0.516666666666666,79,78,1,0,1
21700223,202331,OKC,SAS,Paul George,190,42.8833333333333,42,0.883333333333333,86,92,-6,-1,-5
21700223,202335,OKC,SAS,Patrick Patterson,62,13.4,13,0.399999999999999,26,33,-7,-5,-2
21700223,203460,OKC,SAS,Andre Roberson,107,24.3833333333333,25,-0.616666666666667,47,51,-4,-4,0
21700223,203500,OKC,SAS,Steven Adams,152,34.4833333333333,35,-0.516666666666666,70,77,-7,-8,1
21700223,203518,OKC,SAS,Alex Abrines,86,18.3166666666667,18,0.316666666666666,41,43,-2,0,-2
21700223,203924,OKC,SAS,Jerami Grant,67,14.15,14,0.15,33,32,1,3,-2
21700223,203962,OKC,SAS,Josh Huestis,24,5.11666666666667,6,-0.883333333333333,14,12,2,-2,4
21700223,1626177,OKC,SAS,Dakari Johnson,12,2.65,3,-0.35,9,2,7,7,0
21700224,1717,DAL,MIN,Dirk Nowitzki,109,24.0833333333333,24,0.0833333333333357,49,55,-6,-4,-2
21700224,2734,DAL,MIN,Devin Harris,67,14.95,14,0.949999999999999,30,33,-3,-3,0
21700224,200826,DAL,MIN,J.J. Barea,89,20.6666666666667,21,-0.333333333333336,35,43,-8,-10,2
21700224,202083,DAL,MIN,Wesley Matthews,148,33.7333333333333,34,-0.266666666666666,59,78,-19,-19,0
21700224,203084,DAL,MIN,Harrison Barnes,146,33.5666666666667,34,-0.433333333333337,56,81,-25,-25,0
21700224,203457,DAL,MIN,Nerlens Noel,27,5.5,6,-0.5,9,18,-9,-9,0
21700224,203939,DAL,MIN,Dwight Powell,33,6.75,7,-0.25,18,14,4,4,0
21700224,1626257,DAL,MIN,Salah Mejri,77,17.2,17,0.199999999999999,33,39,-6,-5,-1
21700224,1627812,DAL,MIN,Yogi Ferrell,102,22.1333333333333,22,0.133333333333333,39,46,-7,-7,0
21700224,1628372,DAL,MIN,Dennis Smith Jr.,116,26.9166666666667,27,-0.0833333333333357,48,63,-15,-16,1
21700224,1628467,DAL,MIN,Maxi Kleber,117,27.2,27,0.200000000000003,48,66,-18,-19,1
21700224,1628499,DAL,MIN,Antonius Cleveland,34,6.8,7,-0.2,11,19,-8,-7,-1
21700224,2037,MIN,DAL,Jamal Crawford,55,12.3666666666667,13,-0.633333333333333,26,21,5,5,0
21700224,201166,MIN,DAL,Aaron Brooks,12,2.55,3,-0.45,11,7,4,3,1
21700224,201952,MIN,DAL,Jeff Teague,141,32.6166666666667,32,0.616666666666667,77,55,22,24,-2
21700224,201959,MIN,DAL,Taj Gibson,146,33.5166666666667,34,-0.483333333333334,76,56,20,21,-1
21700224,202357,MIN,DAL,Nemanja Bjelica,57,12.3333333333333,12,0.333333333333332,34,26,8,7,1
21700224,202710,MIN,DAL,Jimmy Butler,164,37.1833333333333,37,0.183333333333337,84,64,20,21,-1
21700224,203476,MIN,DAL,Gorgui Dieng,46,10.2666666666667,11,-0.733333333333334,23,20,3,1,2
21700224,203498,MIN,DAL,Shabazz Muhammad,36,7.43333333333333,7,0.433333333333334,10,17,-7,-7,0
21700224,203952,MIN,DAL,Andrew Wiggins,160,36.5833333333333,36,0.583333333333336,85,63,22,22,0
21700224,1626145,MIN,DAL,Tyus Jones,72,15.2833333333333,16,-0.716666666666667,34,32,2,0,2
21700224,1626157,MIN,DAL,Karl-Anthony Towns,167,37.6333333333333,37,0.63333333333334,88,67,21,23,-2
21700224,1627875,MIN,DAL,Marcus Georges-Hunt,9,1.73333333333333,2,-0.266666666666667,7,7,0,0,0
21700225,202323,POR,SAC,Evan Turner,84,19.5333333333333,20,-0.466666666666669,25,38,-13,-14,1
21700225,202334,POR,SAC,Ed Davis,103,22.55,22,0.549999999999997,47,36,11,7,4
21700225,203081,POR,SAC,Damian Lillard,172,37.0666666666667,37,0.0666666666666629,71,65,6,8,-2
21700225,203086,POR,SAC,Meyers Leonard,15,3.83333333333333,4,-0.166666666666667,1,12,-11,-11,0
21700225,203090,POR,SAC,Maurice Harkless,108,23.6666666666667,24,-0.333333333333336,48,38,10,9,1
21700225,203468,POR,SAC,CJ McCollum,167,37.1833333333333,38,-0.816666666666663,73,67,6,8,-2
21700225,203894,POR,SAC,Shabazz Napier,94,21.5833333333333,22,-0.416666666666668,38,47,-9,-9,0
21700225,203943,POR,SAC,Noah Vonleh,103,23.5666666666667,23,0.566666666666666,35,43,-8,-8,0
21700225,203994,POR,SAC,Jusuf Nurkic,125,27.25,27,0.25,45,50,-5,-1,-4
21700225,1626192,POR,SAC,Pat Connaughton,49,10.2333333333333,10,0.233333333333334,16,15,1,-1,2
21700225,1627774,POR,SAC,Jake Layman,17,4.06666666666667,4,0.0666666666666664,0,7,-7,-7,0
21700225,1628403,POR,SAC,Caleb Swanigan,43,9.38333333333333,10,-0.616666666666667,11,12,-1,-1,0
21700225,2216,SAC,POR,Zach Randolph,66,14.3166666666667,14,0.316666666666666,19,23,-4,-3,-1
21700225,201585,SAC,POR,Kosta Koufos,143,32.35,33,-0.649999999999999,65,53,12,9,3
21700225,201588,SAC,POR,George Hill,126,27.4833333333333,27,0.483333333333334,50,60,-10,-10,0
21700225,202066,SAC,POR,Garrett Temple,138,29.2333333333333,29,0.233333333333334,49,58,-9,-7,-2
21700225,203992,SAC,POR,Bogdan Bogdanovic,105,24.2666666666667,24,0.266666666666666,44,33,11,11,0
21700225,1626161,SAC,POR,Willie Cauley-Stein,140,31.3166666666667,31,0.316666666666663,61,54,7,6,1
21700225,1627741,SAC,POR,Buddy Hield,70,16.3,17,-0.699999999999999,31,19,12,12,0
21700225,1627746,SAC,POR,Skal Labissiere,76,16.6666666666667,17,-0.333333333333332,25,28,-3,-2,-1
21700225,1628368,SAC,POR,De'Aaron Fox,123,26.4,27,-0.600000000000001,48,56,-8,-8,0
21700225,1628412,SAC,POR,Frank Mason,93,21.5833333333333,21,0.583333333333336,38,26,12,12,0
21700226,2749,NOP,DEN,Jameer Nelson,135,27.5166666666667,28,-0.483333333333334,71,82,-11,-9,-2
21700226,200765,NOP,DEN,Rajon Rondo,118,24.7,25,-0.300000000000001,54,82,-28,-30,2
21700226,201950,NOP,DEN,Jrue Holiday,130,27.4166666666667,27,0.416666666666668,55,84,-29,-31,2
21700226,201967,NOP,DEN,Dante Cunningham,114,25.8,26,-0.200000000000003,58,83,-25,-23,-2
21700226,202326,NOP,DEN,DeMarcus Cousins,115,24.9666666666667,25,-0.0333333333333314,44,80,-36,-34,-2
21700226,202734,NOP,DEN,E'Twaun Moore,132,27.3666666666667,27,0.366666666666667,77,74,3,3,0
21700226,203076,NOP,DEN,Anthony Davis,103,21.35,21,0.350000000000001,51,58,-7,-11,4
21700226,203121,NOP,DEN,Darius Miller,139,28.4333333333333,28,0.433333333333334,78,85,-7,-5,-2
21700226,203546,NOP,DEN,Ian Clark,64,13.6166666666667,14,-0.383333333333333,39,49,-10,-8,-2
21700226,1627767,NOP,DEN,Cheick Diallo,65,12.1166666666667,13,-0.883333333333333,32,35,-3,-5,2
21700226,1627883,NOP,DEN,Jalen Jones,25,4.63333333333333,5,-0.366666666666667,11,18,-7,-7,0
21700226,200794,DEN,NOP,Paul Millsap,128,26.9,27,-0.100000000000001,84,53,31,33,-2
21700226,201163,DEN,NOP,Wilson Chandler,167,35.5166666666667,36,-0.483333333333334,110,83,27,29,-2
21700226,202702,DEN,NOP,Kenneth Faried,37,6.75,7,-0.25,15,22,-7,-7,0
21700226,203115,DEN,NOP,Will Barton,122,24.5833333333333,25,-0.416666666666664,67,74,-7,-7,0
21700226,203486,DEN,NOP,Mason Plumlee,86,18.3166666666667,19,-0.683333333333334,57,52,5,3,2
21700226,203914,DEN,NOP,Gary Harris,142,30.45,31,-0.550000000000001,102,59,43,41,2
21700226,203999,DEN,NOP,Nikola Jokic,123,26.5166666666667,27,-0.483333333333334,77,54,23,23,0
21700226,1626144,DEN,NOP,Emmanuel Mudiay,115,22.8333333333333,23,-0.166666666666668,66,72,-6,-6,0
21700226,1626168,DEN,NOP,Trey Lyles,20,3.68333333333333,4,-0.316666666666666,15,8,7,7,0
21700226,1627736,DEN,NOP,Malik Beasley,25,4.63333333333333,5,-0.366666666666667,18,11,7,7,0
21700226,1627750,DEN,NOP,Jamal Murray,155,34.05,34,0.0499999999999972,104,74,30,30,0
21700226,1627823,DEN,NOP,Juancho Hernangomez,20,3.68333333333333,4,-0.316666666666666,15,8,7,7,0
21700227,101106,LAL,PHX,Andrew Bogut,29,6.85,7,-0.15,13,17,-4,-4,0
21700227,201147,LAL,PHX,Corey Brewer,71,12.6833333333333,12,0.683333333333334,27,39,-12,-10,-2
21700227,201572,LAL,PHX,Brook Lopez,167,30.8,31,-0.200000000000003,76,78,-2,-2,0
21700227,203484,LAL,PHX,Kentavious Caldwell-Pope,198,36.1333333333333,36,0.133333333333333,84,90,-6,-4,-2
21700227,203505,LAL,PHX,Vander Blue,20,5.06666666666667,5,0.0666666666666664,11,14,-3,-4,1
21700227,203898,LAL,PHX,Tyler Ennis,15,3.88333333333333,4,-0.116666666666667,8,12,-4,-5,1
21700227,203903,LAL,PHX,Jordan Clarkson,87,17.4833333333333,17,0.483333333333334,35,41,-6,-4,-2
21700227,203944,LAL,PHX,Julius Randle,81,15.9833333333333,16,-0.0166666666666675,33,41,-8,-7,-1
21700227,1627742,LAL,PHX,Brandon Ingram,190,34.6833333333333,35,-0.316666666666663,77,82,-5,-3,-2
21700227,1628366,LAL,PHX,Lonzo Ball,205,37.5166666666667,38,-0.483333333333334,94,98,-4,-2,-2
21700227,1628398,LAL,PHX,Kyle Kuzma,207,38.0833333333333,38,0.0833333333333286,97,98,-1,0,-1
21700227,202328,PHX,LAL,Greg Monroe,79,15.3833333333333,16,-0.616666666666667,33,42,-9,-10,1
21700227,203458,PHX,LAL,Alex Len,146,27.0666666666667,27,0.0666666666666664,76,59,17,19,-2
21700227,203584,PHX,LAL,Troy Daniels,73,14.9,15,-0.0999999999999996,36,27,9,5,4
21700227,203933,PHX,LAL,T.J. Warren,204,38.2,39,-0.799999999999997,100,92,8,6,2
21700227,1626164,PHX,LAL,Devin Booker,182,33.1166666666667,33,0.116666666666667,88,84,4,6,-2
21700227,1627733,PHX,LAL,Dragan Bender,122,24.2666666666667,25,-0.733333333333334,56,54,2,1,1
21700227,1627737,PHX,LAL,Marquese Chriss,95,17.8,18,-0.199999999999999,52,48,4,6,-2
21700227,1627755,PHX,LAL,Tyler Ulis,158,28.7333333333333,29,-0.266666666666666,74,74,0,0,0
21700227,1628367,PHX,LAL,Josh Jackson,111,19.6166666666667,19,0.616666666666667,47,38,9,3,6
21700227,1628455,PHX,LAL,Mike James,100,20.0833333333333,20,0.0833333333333322,48,37,11,9,2
21700228,101150,LAC,CHA,Lou Williams,140,29.1333333333333,29,0.133333333333333,51,63,-12,-11,-1
21700228,201599,LAC,CHA,DeAndre Jordan,150,32.8166666666667,33,-0.183333333333337,58,77,-19,-21,2
21700228,201933,LAC,CHA,Blake Griffin,160,35.0166666666667,35,0.0166666666666657,66,80,-14,-14,0
21700228,202325,LAC,CHA,Wesley Johnson,141,31.35,32,-0.649999999999999,55,76,-21,-19,-2
21700228,203085,LAC,CHA,Austin Rivers,153,33.3833333333333,34,-0.616666666666667,60,74,-14,-16,2
21700228,203186,LAC,CHA,Willie Reed,20,4.13333333333333,4,0.133333333333334,7,9,-2,-2,0
21700228,203710,LAC,CHA,C.J. Williams,38,8.26666666666667,8,0.266666666666666,17,15,2,3,-1
21700228,1626149,LAC,CHA,Montrezl Harrell,39,8.23333333333333,8,0.233333333333334,14,11,3,4,-1
21700228,1626155,LAC,CHA,Sam Dekker,70,15.55,15,0.550000000000001,30,30,0,2,-2
21700228,1628393,LAC,CHA,Jawun Evans,50,10,10,0,17,14,3,2,1
21700228,1628414,LAC,CHA,Sindarius Thornwell,129,30.95,31,-0.0500000000000007,60,61,-1,-3,2
21700228,2730,CHA,LAC,Dwight Howard,132,29.1833333333333,30,-0.81666666666667,68,51,17,18,-1
21700228,101107,CHA,LAC,Marvin Williams,127,28.3166666666667,28,0.316666666666666,64,52,12,11,1
21700228,201587,CHA,LAC,Nicolas Batum,126,27.6833333333333,28,-0.316666666666666,67,44,23,27,-4
21700228,202689,CHA,LAC,Kemba Walker,160,35.65,36,-0.350000000000001,82,62,20,19,1
21700228,203077,CHA,LAC,Michael Kidd-Gilchrist,138,30.6,31,-0.399999999999999,72,55,17,16,1
21700228,203087,CHA,LAC,Jeremy Lamb,105,22.6666666666667,22,0.666666666666664,44,45,-1,-3,2
21700228,203469,CHA,LAC,Cody Zeller,85,18.3166666666667,18,0.316666666666666,36,33,3,2,1
21700228,203487,CHA,LAC,Michael Carter-Williams,68,14.65,15,-0.350000000000001,24,30,-6,-9,3
21700228,1626163,CHA,LAC,Frank Kaminsky,92,19.7166666666667,20,-0.283333333333335,36,38,-2,-1,-1
21700228,1628407,CHA,LAC,Dwayne Bacon,57,12.05,12,0.0500000000000007,17,25,-8,-5,-3
21700229,201167,ORL,UTA,Arron Afflalo,120,24.5833333333333,25,-0.416666666666668,37,71,-34,-33,-1
21700229,201571,ORL,UTA,D.J. Augustin,77,17.15,17,0.149999999999999,22,51,-29,-28,-1
21700229,201578,ORL,UTA,Marreese Speights,68,12.75,13,-0.25,23,44,-21,-21,0
21700229,202687,ORL,UTA,Bismack Biyombo,93,18.8333333333333,19,-0.166666666666664,29,44,-15,-17,2
21700229,202696,ORL,UTA,Nikola Vucevic,112,23.7333333333333,24,-0.266666666666666,48,57,-9,-7,-2
21700229,202714,ORL,UTA,Shelvin Mack,55,10.4833333333333,11,-0.516666666666666,18,22,-4,-4,0
21700229,203082,ORL,UTA,Terrence Ross,97,20.2333333333333,20,0.233333333333334,40,45,-5,-5,0
21700229,203095,ORL,UTA,Evan Fournier,119,25.5833333333333,26,-0.416666666666664,50,59,-9,-10,1
21700229,203613,ORL,UTA,Jonathon Simmons,83,18.3166666666667,18,0.316666666666666,29,58,-29,-29,0
21700229,203901,ORL,UTA,Elfrid Payton,110,23.3,23,0.299999999999997,48,54,-6,-7,1
21700229,203932,ORL,UTA,Aaron Gordon,141,29.7666666666667,30,-0.233333333333334,60,79,-19,-19,0
21700229,1626209,ORL,UTA,Mario Hezonja,75,14.6833333333333,15,-0.316666666666666,21,41,-20,-20,0
21700229,200757,UTA,ORL,Thabo Sefolosha,81,18.1333333333333,18,0.133333333333333,56,27,29,29,0
21700229,201937,UTA,ORL,Ricky Rubio,80,16.45,16,0.449999999999999,35,30,5,5,0
21700229,201973,UTA,ORL,Jonas Jerebko,123,23.9666666666667,25,-1.03333333333334,53,43,10,10,0
21700229,202324,UTA,ORL,Derrick Favors,123,24.9833333333333,25,-0.0166666666666657,63,48,15,13,2
21700229,202327,UTA,ORL,Ekpe Udoh,84,18.3833333333333,18,0.383333333333333,55,26,29,31,-2
21700229,202692,UTA,ORL,Alec Burks,118,24.3833333333333,24,0.383333333333333,66,47,19,21,-2
21700229,203489,UTA,ORL,Nate Wolters,17,3.48333333333333,4,-0.516666666666667,5,11,-6,-6,0
21700229,203526,UTA,ORL,Raul Neto,116,24.5333333333333,24,0.533333333333331,77,35,42,44,-2
21700229,203918,UTA,ORL,Rodney Hood,118,26.1333333333333,26,0.133333333333333,74,44,30,30,0
21700229,204060,UTA,ORL,Joe Ingles,107,22.75,23,-0.25,54,41,13,11,2
21700229,1626220,UTA,ORL,Royce O'Neale,33,6.21666666666667,6,0.216666666666667,14,13,1,1,0
21700229,1628378,UTA,ORL,Donovan Mitchell,127,25.4833333333333,26,-0.516666666666666,66,49,17,15,2
21700229,1628396,UTA,ORL,Tony Bradley,23,4.51666666666667,5,-0.483333333333333,7,11,-4,-4,0
21700230,201158,ATL,BOS,Marco Belinelli,121,25.2833333333333,26,-0.716666666666669,48,54,-6,-6,0
21700230,202337,ATL,BOS,Luke Babbitt,109,24.7333333333333,25,-0.266666666666666,56,55,1,1,0
21700230,203145,ATL,BOS,Kent Bazemore,136,31.1,31,0.0999999999999979,68,82,-14,-14,0
21700230,203471,ATL,BOS,Dennis Schroder,158,36.7833333333333,37,-0.216666666666669,79,81,-2,-1,-1
21700230,203473,ATL,BOS,Dewayne Dedmon,93,21.6333333333333,22,-0.366666666666667,49,50,-1,-1,0
21700230,1627098,ATL,BOS,Malcolm Delaney,114,24.7,25,-0.300000000000001,46,63,-17,-15,-2
21700230,1627752,ATL,BOS,Taurean Prince,151,32.95,33,-0.0499999999999972,69,74,-5,-6,1
21700230,1627761,ATL,BOS,DeAndre' Bembry,8,1.88333333333333,1,0.883333333333333,2,2,0,-2,2
21700230,1628381,ATL,BOS,John Collins,119,25.1333333333333,25,0.133333333333333,50,56,-6,-6,0
21700230,1628463,ATL,BOS,Tyler Cavanaugh,71,14.6333333333333,15,-0.366666666666667,28,33,-5,-5,0
21700230,201143,BOS,ATL,Al Horford,140,32.4333333333333,33,-0.566666666666663,77,72,5,2,3
21700230,202681,BOS,ATL,Kyrie Irving,136,31.65,31,0.649999999999999,75,69,6,6,0
21700230,202694,BOS,ATL,Marcus Morris,104,24.5166666666667,24,0.516666666666666,73,55,18,18,0
21700230,203382,BOS,ATL,Aron Baynes,63,12.45,13,-0.550000000000001,30,24,6,9,-3
21700230,203499,BOS,ATL,Shane Larkin,80,16.4666666666667,17,-0.533333333333331,33,29,4,7,-3
21700230,203935,BOS,ATL,Marcus Smart,127,26.9833333333333,27,-0.0166666666666657,58,49,9,7,2
21700230,1626179,BOS,ATL,Terry Rozier,114,24.6666666666667,25,-0.333333333333332,53,44,9,11,-2
21700230,1627759,BOS,ATL,Jaylen Brown,153,35.3166666666667,35,0.316666666666663,87,76,11,8,3
21700230,1628369,BOS,ATL,Jayson Tatum,133,28.6333333333333,29,-0.366666666666667,61,65,-4,-4,0
21700230,1628400,BOS,ATL,Semi Ojeleye,16,2.7,3,-0.3,2,7,-5,-5,0
21700230,1628464,BOS,ATL,Daniel Theis,14,3.01666666666667,3,0.0166666666666666,1,5,-4,-4,0
21700231,2561,GSW,PHI,David West,59,13.1166666666667,13,0.116666666666667,26,21,5,5,0
21700231,2585,GSW,PHI,Zaza Pachulia,83,15.7166666666667,16,-0.283333333333333,42,53,-11,-4,-7
21700231,2733,GSW,PHI,Shaun Livingston,68,15.5833333333333,16,-0.416666666666668,30,27,3,4,-1
21700231,2738,GSW,PHI,Andre Iguodala,120,26.1666666666667,26,0.166666666666664,62,48,14,14,0
21700231,201142,GSW,PHI,Kevin Durant,171,32.8333333333333,33,-0.166666666666671,82,99,-17,-10,-7
21700231,201156,GSW,PHI,Nick Young,26,5.86666666666667,6,-0.133333333333334,19,6,13,13,0
21700231,201580,GSW,PHI,JaVale McGee,26,5.38333333333333,5,0.383333333333333,12,19,-7,-7,0
21700231,201939,GSW,PHI,Stephen Curry,178,34.8166666666667,35,-0.183333333333337,96,98,-2,3,-5
21700231,201956,GSW,PHI,Omri Casspi,28,4.78333333333333,5,-0.216666666666667,12,16,-4,-4,0
21700231,202691,GSW,PHI,Klay Thompson,184,35.9666666666667,36,-0.0333333333333314,91,97,-6,-2,-4
21700231,203110,GSW,PHI,Draymond Green,178,35.6333333333333,36,-0.366666666666667,97,87,10,11,-1
21700231,1626172,GSW,PHI,Kevon Looney,44,9.78333333333333,10,-0.216666666666667,31,14,17,19,-2
21700231,1627775,GSW,PHI,Patrick McCaw,20,4.01666666666667,4,0.0166666666666666,10,10,0,-2,2
21700231,200755,PHI,GSW,JJ Redick,190,37.7,37,0.700000000000003,90,98,-8,-16,8
21700231,203496,PHI,GSW,Robert Covington,179,35.3333333333333,36,-0.666666666666671,97,85,12,5,7
21700231,203954,PHI,GSW,Joel Embiid,170,33.7,33,0.700000000000003,83,89,-6,-10,4
21700231,203967,PHI,GSW,Dario Saric,185,36.8666666666667,37,-0.133333333333333,87,98,-11,-10,-1
21700231,204456,PHI,GSW,T.J. McConnell,94,19.8,19,0.800000000000001,41,52,-11,-12,1
21700231,1626158,PHI,GSW,Richaun Holmes,67,14.2333333333333,15,-0.766666666666668,36,33,3,2,1
21700231,1627732,PHI,GSW,Ben Simmons,185,37.45,38,-0.549999999999997,102,90,12,7,5
21700231,1627789,PHI,GSW,Timothe Luwawu-Cabarrot,115,24.5833333333333,24,0.583333333333332,59,65,-6,-6,0
21700232,2403,HOU,MEM,Nene,76,16.2833333333333,16,0.283333333333331,36,20,16,16,0
21700232,2772,HOU,MEM,Trevor Ariza,130,28.9333333333333,29,-0.0666666666666664,71,53,18,18,0
21700232,101108,HOU,MEM,Chris Paul,109,24.5833333333333,24,0.583333333333332,59,49,10,10,0
21700232,200782,HOU,MEM,PJ Tucker,99,21.2833333333333,21,0.283333333333331,38,34,4,4,0
21700232,201569,HOU,MEM,Eric Gordon,135,28.4333333333333,29,-0.56666666666667,64,37,27,27,0
21700232,201583,HOU,MEM,Ryan Anderson,118,26.6,27,-0.399999999999999,67,49,18,18,0
21700232,201601,HOU,MEM,Luc Mbah a Moute,99,21.2833333333333,21,0.283333333333331,38,34,4,4,0
21700232,201628,HOU,MEM,Bobby Brown,11,2.48333333333333,2,0.483333333333333,3,2,1,1,0
21700232,201935,HOU,MEM,James Harden,156,35.45,36,-0.549999999999997,77,72,5,5,0
21700232,203991,HOU,MEM,Clint Capela,122,26.9,27,-0.100000000000001,63,53,10,10,0
21700232,204028,HOU,MEM,Tarik Black,19,4.7,4,0.7,6,10,-4,-4,0
21700232,1627753,HOU,MEM,Zhou Qi,11,2.48333333333333,2,0.483333333333333,3,2,1,1,0
21700232,201148,MEM,HOU,Brandan Wright,33,6.95,7,-0.0499999999999998,10,17,-7,-9,2
21700232,201188,MEM,HOU,Marc Gasol,144,32.45,32,0.449999999999996,59,73,-14,-12,-2
21700232,201596,MEM,HOU,Mario Chalmers,129,28.8166666666667,29,-0.18333333333333,62,65,-3,-3,0
21700232,201936,MEM,HOU,Tyreke Evans,114,24.1,25,-0.899999999999999,32,54,-22,-20,-2
21700232,202718,MEM,HOU,Chandler Parsons,113,25.1833333333333,25,0.183333333333334,58,58,0,-2,2
21700232,203210,MEM,HOU,JaMychal Green,101,23.3333333333333,23,0.333333333333336,54,53,1,-1,2
21700232,203463,MEM,HOU,Ben McLemore,96,20.1833333333333,20,0.183333333333334,27,38,-11,-12,1
21700232,203516,MEM,HOU,James Ennis III,105,22.6166666666667,23,-0.383333333333333,23,47,-24,-22,-2
21700232,1626150,MEM,HOU,Andrew Harrison,53,11.8,12,-0.199999999999999,15,28,-13,-13,0
21700232,1626185,MEM,HOU,Jarell Martin,11,2.48333333333333,2,0.483333333333333,2,3,-1,-1,0
21700232,1627738,MEM,HOU,Deyonta Davis,40,8.48333333333333,9,-0.516666666666668,14,15,-1,-1,0
21700232,1628415,MEM,HOU,Dillon Brooks,146,33.0166666666667,33,0.0166666666666657,59,74,-15,-14,-1
21700233,1717,DAL,MIL,Dirk Nowitzki,105,24.2333333333333,25,-0.766666666666666,58,41,17,17,0
21700233,2734,DAL,MIL,Devin Harris,86,19.5833333333333,20,-0.416666666666668,50,27,23,24,-1
21700233,200826,DAL,MIL,J.J. Barea,103,23.6333333333333,23,0.633333333333333,52,35,17,19,-2
21700233,202083,DAL,MIL,Wesley Matthews,151,34.1333333333333,34,0.133333333333333,79,61,18,17,1
21700233,203084,DAL,MIL,Harrison Barnes,147,33.05,33,0.0499999999999972,77,57,20,21,-1
21700233,203457,DAL,MIL,Nerlens Noel,13,2.91666666666667,3,-0.0833333333333335,4,4,0,0,0
21700233,203481,DAL,MIL,Jeff Withey,13,2.91666666666667,3,-0.0833333333333335,4,4,0,0,0
21700233,203939,DAL,MIL,Dwight Powell,107,24.9,25,-0.100000000000001,65,35,30,28,2
21700233,1626257,DAL,MIL,Salah Mejri,29,6.75,7,-0.25,12,13,-1,0,-1
21700233,1627812,DAL,MIL,Yogi Ferrell,139,32.35,33,-0.649999999999999,74,51,23,23,0
21700233,1628372,DAL,MIL,Dennis Smith Jr.,94,21.6,22,-0.399999999999999,55,40,15,13,2
21700233,1628467,DAL,MIL,Maxi Kleber,45,9.68333333333333,10,-0.316666666666666,21,23,-2,-2,0
21700233,1628499,DAL,MIL,Antonius Cleveland,13,2.91666666666667,3,-0.0833333333333335,4,4,0,0,0
21700233,1891,MIL,DAL,Jason Terry,12,2.5,3,-0.5,4,4,0,0,0
21700233,202339,MIL,DAL,Eric Bledsoe,94,21.3,22,-0.700000000000003,36,45,-9,-9,0
21700233,202732,MIL,DAL,DeAndre Liggins,82,19.1166666666667,19,0.116666666666667,25,55,-30,-30,0
21700233,203089,MIL,DAL,John Henson,89,20.0666666666667,20,0.0666666666666664,40,42,-2,-4,2
21700233,203114,MIL,DAL,Khris Middleton,143,32.7833333333333,33,-0.216666666666669,60,85,-25,-25,0
21700233,203503,MIL,DAL,Tony Snell,147,32.65,33,-0.350000000000001,54,73,-19,-19,0
21700233,203507,MIL,DAL,Giannis Antetokounmpo,171,39.7,40,-0.299999999999997,71,89,-18,-18,0
21700233,1626173,MIL,DAL,Rashad Vaughn,13,2.91666666666667,3,-0.0833333333333335,4,4,0,0,0
21700233,1627748,MIL,DAL,Thon Maker,107,24.75,25,-0.25,35,65,-30,-28,-2
21700233,1627762,MIL,DAL,Joel Bolomboy,13,2.91666666666667,3,-0.0833333333333335,4,4,0,0,0
21700233,1627763,MIL,DAL,Malcolm Brogdon,141,32.5166666666667,32,0.516666666666666,54,76,-22,-22,0
21700233,1627780,MIL,DAL,Gary Payton II,20,4.53333333333333,5,-0.466666666666667,4,9,-5,-5,0
21700233,1628391,MIL,DAL,D.J. Wilson,13,2.91666666666667,3,-0.0833333333333335,4,4,0,0,0
21700234,202323,POR,SAC,Evan Turner,75,16.4,16,0.399999999999999,25,26,-1,0,-1
21700234,202334,POR,SAC,Ed Davis,92,21.55,22,-0.449999999999999,42,36,6,6,0
21700234,203081,POR,SAC,Damian Lillard,150,33.7,34,-0.299999999999997,77,61,16,18,-2
21700234,203086,POR,SAC,Meyers Leonard,94,21.6333333333333,22,-0.366666666666667,47,39,8,10,-2
21700234,203090,POR,SAC,Maurice Harkless,84,19.2833333333333,19,0.283333333333331,41,40,1,0,1
21700234,203468,POR,SAC,CJ McCollum,149,35.25,35,0.25,78,76,2,-1,3
21700234,203894,POR,SAC,Shabazz Napier,85,20.5833333333333,21,-0.416666666666664,44,39,5,3,2
21700234,203943,POR,SAC,Noah Vonleh,91,20,20,0,46,38,8,4,4
21700234,203994,POR,SAC,Jusuf Nurkic,111,24.8333333333333,25,-0.166666666666668,60,49,11,9,2
21700234,1626192,POR,SAC,Pat Connaughton,98,21.55,22,-0.449999999999999,50,31,19,16,3
21700234,1627774,POR,SAC,Jake Layman,7,1.43333333333333,2,-0.566666666666667,0,5,-5,-5,0
21700234,1628380,POR,SAC,Zach Collins,7,1.43333333333333,2,-0.566666666666667,0,5,-5,-5,0
21700234,1628403,POR,SAC,Caleb Swanigan,7,1.43333333333333,2,-0.566666666666667,0,5,-5,-5,0
21700234,2216,SAC,POR,Zach Randolph,97,21.7833333333333,22,-0.216666666666669,40,52,-12,-11,-1
21700234,201585,SAC,POR,Kosta Koufos,100,22.4666666666667,23,-0.533333333333331,44,52,-8,-9,1
21700234,201588,SAC,POR,George Hill,138,31.1166666666667,31,0.116666666666667,53,67,-14,-12,-2
21700234,202066,SAC,POR,Garrett Temple,122,27.7166666666667,27,0.716666666666669,54,64,-10,-7,-3
21700234,203992,SAC,POR,Bogdan Bogdanovic,117,27.5666666666667,28,-0.433333333333334,49,56,-7,-9,2
21700234,204022,SAC,POR,Jack Cooley,7,1.43333333333333,2,-0.566666666666667,5,0,5,5,0
21700234,1626161,SAC,POR,Willie Cauley-Stein,144,32.6,33,-0.400000000000006,61,69,-8,-8,0
21700234,1627746,SAC,POR,Skal Labissiere,47,10.9833333333333,11,-0.0166666666666675,18,22,-4,-4,0
21700234,1627781,SAC,POR,Malachi Richardson,71,16.5666666666667,17,-0.433333333333334,35,32,3,5,-2
21700234,1628368,SAC,POR,De'Aaron Fox,120,27.6833333333333,28,-0.31666666666667,53,62,-9,-9,0
21700234,1628412,SAC,POR,Frank Mason,87,19.1666666666667,20,-0.833333333333332,38,34,4,-1,5
21700235,2617,MIA,IND,Udonis Haslem,17,3.1,3,0.1,10,12,-2,-2,0
21700235,201609,MIA,IND,Goran Dragic,115,26.85,27,-0.149999999999999,43,64,-21,-19,-2
21700235,201949,MIA,IND,James Johnson,118,27.0833333333333,27,0.0833333333333322,62,60,2,2,0
21700235,201961,MIA,IND,Wayne Ellington,110,24.6,25,-0.399999999999999,61,63,-2,-2,0
21700235,202355,MIA,IND,Hassan Whiteside,96,22.4333333333333,22,0.433333333333334,42,53,-11,-11,0
21700235,203079,MIA,IND,Dion Waiters,111,25.7833333333333,26,-0.216666666666669,45,69,-24,-24,0
21700235,203482,MIA,IND,Kelly Olynyk,63,14.4333333333333,14,0.433333333333334,32,30,2,2,0
21700235,204020,MIA,IND,Tyler Johnson,118,26.4333333333333,27,-0.56666666666667,52,64,-12,-14,2
21700235,1626159,MIA,IND,Justise Winslow,103,23.7833333333333,24,-0.216666666666669,45,65,-20,-20,0
21700235,1626175,MIA,IND,Jordan Mickey,17,3.1,3,0.1,10,12,-2,-2,0
21700235,1626196,MIA,IND,Josh Richardson,126,29.7833333333333,30,-0.216666666666669,50,71,-21,-19,-2
21700235,1628389,MIA,IND,Bam Adebayo,33,7.7,8,-0.3,11,25,-14,-14,0
21700235,1628476,MIA,IND,Derrick Walton Jr.,18,3.25,3,0.25,12,12,0,-2,2
21700235,2863,IND,MIA,Damien Wilkins,16,2.91666666666667,3,-0.083333333333333,9,10,-1,-1,0
21700235,201152,IND,MIA,Thaddeus Young,106,24.9166666666667,25,-0.0833333333333322,66,39,27,27,0
21700235,201954,IND,MIA,Darren Collison,133,31.6,32,-0.400000000000002,80,58,22,22,0
21700235,202362,IND,MIA,Lance Stephenson,98,22.2,23,-0.800000000000001,54,52,2,2,0
21700235,202709,IND,MIA,Cory Joseph,130,29.1333333333333,29,0.133333333333333,77,69,8,8,0
21700235,202711,IND,MIA,Bojan Bogdanovic,146,34.3,35,-0.700000000000003,80,62,18,18,0
21700235,203506,IND,MIA,Victor Oladipo,147,33.7333333333333,34,-0.266666666666666,78,57,21,21,0
21700235,1626167,IND,MIA,Myles Turner,137,31.6166666666667,32,-0.383333333333333,84,54,30,30,0
21700235,1626202,IND,MIA,Joe Young,17,3.1,3,0.1,12,10,2,2,0
21700235,1627734,IND,MIA,Domantas Sabonis,83,18.9833333333333,19,-0.0166666666666657,42,44,-2,-2,0
21700235,1627816,IND,MIA,Alex Poythress,16,2.91666666666667,3,-0.083333333333333,9,10,-1,-1,0
21700235,1628388,IND,MIA,TJ Leaf,16,2.91666666666667,3,-0.083333333333333,9,10,-1,-1,0
21700236,2561,GSW,BKN,David West,46,9.36666666666667,10,-0.633333333333333,18,17,1,1,0
21700236,2585,GSW,BKN,Zaza Pachulia,71,13.3666666666667,14,-0.633333333333333,34,26,8,8,0
21700236,2733,GSW,BKN,Shaun Livingston,77,15.9666666666667,16,-0.0333333333333332,35,33,2,2,0
21700236,2738,GSW,BKN,Andre Iguodala,162,31.55,32,-0.450000000000003,76,80,-4,-4,0
21700236,201156,GSW,BKN,Nick Young,82,16.2833333333333,16,0.283333333333331,41,37,4,3,1
21700236,201580,GSW,BKN,JaVale McGee,39,8.36666666666667,8,0.366666666666667,25,25,0,-1,1
21700236,201939,GSW,BKN,Stephen Curry,174,32.8333333333333,33,-0.166666666666664,84,78,6,4,2
21700236,201956,GSW,BKN,Omri Casspi,120,22.5333333333333,23,-0.466666666666669,53,50,3,4,-1
21700236,202691,GSW,BKN,Klay Thompson,168,33.0166666666667,33,0.0166666666666657,77,71,6,11,-5
21700236,203110,GSW,BKN,Draymond Green,178,34.9833333333333,35,-0.0166666666666657,82,83,-1,-4,3
21700236,1626172,GSW,BKN,Kevon Looney,68,11.9333333333333,12,-0.0666666666666664,38,33,5,6,-1
21700236,1627775,GSW,BKN,Patrick McCaw,38,6.2,6,0.2,17,15,2,0,2
21700236,1628395,GSW,BKN,Jordan Bell,17,3.01666666666667,3,0.0166666666666666,10,7,3,5,-2
21700236,201960,BKN,GSW,DeMarre Carroll,176,33.8333333333333,34,-0.166666666666671,77,79,-2,-4,2
21700236,202344,BKN,GSW,Trevor Booker,54,9.05,9,0.0500000000000007,19,21,-2,-2,0
21700236,203092,BKN,GSW,Tyler Zeller,74,15.1166666666667,16,-0.883333333333333,27,46,-19,-17,-2
21700236,203112,BKN,GSW,Quincy Acy,119,23.2166666666667,23,0.216666666666669,61,63,-2,-2,0
21700236,203459,BKN,GSW,Allen Crabbe,175,34.0666666666667,34,0.0666666666666629,84,85,-1,2,-3
21700236,203915,BKN,GSW,Spencer Dinwiddie,160,31.0833333333333,31,0.0833333333333322,75,66,9,6,3
21700236,203925,BKN,GSW,Joe Harris,107,20.5,21,-0.5,45,58,-13,-9,-4
21700236,203930,BKN,GSW,Sean Kilpatrick,36,7.41666666666667,7,0.416666666666667,8,19,-11,-11,0
21700236,1626178,BKN,GSW,Rondae Hollis-Jefferson,156,31.0833333333333,31,0.0833333333333322,82,68,14,10,4
21700236,1627747,BKN,GSW,Caris LeVert,117,21.5666666666667,22,-0.433333333333334,52,60,-8,-10,2
21700236,1628386,BKN,GSW,Jarrett Allen,66,12.4833333333333,12,0.483333333333334,25,25,0,2,-2
21700237,101139,TOR,WAS,CJ Miles,94,20.8333333333333,21,-0.166666666666668,43,32,11,13,-2
21700237,200768,TOR,WAS,Kyle Lowry,145,33.1666666666667,33,0.166666666666664,69,65,4,3,1
21700237,201586,TOR,WAS,Serge Ibaka,110,25.9,26,-0.100000000000001,48,52,-4,-4,0
21700237,201942,TOR,WAS,DeMar DeRozan,159,35.65,36,-0.349999999999994,74,70,4,4,0
21700237,202685,TOR,WAS,Jonas Valanciunas,73,16.5,17,-0.5,30,35,-5,-5,0
21700237,203485,TOR,WAS,Lorenzo Brown,35,8.03333333333333,8,0.0333333333333332,17,11,6,6,0
21700237,203512,TOR,WAS,Lucas Nogueira,64,13.8166666666667,14,-0.183333333333334,30,26,4,4,0
21700237,1627751,TOR,WAS,Jakob Poeltl,49,10.2666666666667,10,0.266666666666666,28,22,6,6,0
21700237,1627783,TOR,WAS,Pascal Siakam,139,31.3166666666667,31,0.31666666666667,72,54,18,18,0
21700237,1627832,TOR,WAS,Fred VanVleet,103,23.6333333333333,24,-0.366666666666667,48,42,6,7,-1
21700237,1628384,TOR,WAS,OG Anunoby,89,19.8,20,-0.200000000000003,41,46,-5,-7,2
21700237,101133,WAS,TOR,Ian Mahinmi,59,12.6666666666667,13,-0.333333333333334,25,30,-5,-6,1
21700237,101162,WAS,TOR,Marcin Gortat,153,35.1166666666667,35,0.116666666666667,66,70,-4,-3,-1
21700237,201975,WAS,TOR,Jodie Meeks,59,13.6833333333333,14,-0.316666666666666,20,25,-5,-6,1
21700237,202693,WAS,TOR,Markieff Morris,117,26.9333333333333,27,-0.06666666666667,50,52,-2,-2,0
21700237,203078,WAS,TOR,Bradley Beal,162,36.6166666666667,37,-0.38333333333334,75,79,-4,-3,-1
21700237,203107,WAS,TOR,Tomas Satoransky,58,12.4333333333333,12,0.433333333333334,25,30,-5,-5,0
21700237,203118,WAS,TOR,Mike Scott,82,17.5333333333333,18,-0.466666666666669,34,41,-7,-8,1
21700237,203490,WAS,TOR,Otto Porter Jr.,142,32.8,33,-0.200000000000003,62,66,-4,-3,-1
21700237,204025,WAS,TOR,Tim Frazier,152,35.2333333333333,36,-0.766666666666666,65,70,-5,-4,-1
21700237,1626162,WAS,TOR,Kelly Oubre Jr.,76,15.9,16,-0.100000000000001,33,37,-4,-5,1
21700238,2037,MIN,DET,Jamal Crawford,28,6.5,7,-0.5,12,19,-7,-7,0
21700238,201952,MIN,DET,Jeff Teague,183,39.45,40,-0.549999999999997,84,81,3,3,0
21700238,201959,MIN,DET,Taj Gibson,141,31.5166666666667,31,0.516666666666666,60,61,-1,-7,6
21700238,202357,MIN,DET,Nemanja Bjelica,75,15.2666666666667,15,0.266666666666666,35,37,-2,4,-6
21700238,202710,MIN,DET,Jimmy Butler,192,41.4833333333333,42,-0.516666666666666,85,79,6,8,-2
21700238,203476,MIN,DET,Gorgui Dieng,44,10.1166666666667,10,0.116666666666667,16,25,-9,-7,-2
21700238,203498,MIN,DET,Shabazz Muhammad,33,7.28333333333333,7,0.283333333333333,9,19,-10,-10,0
21700238,203952,MIN,DET,Andrew Wiggins,194,41.95,42,-0.0499999999999972,90,85,5,3,2
21700238,1626145,MIN,DET,Tyus Jones,38,8.55,8,0.550000000000001,13,19,-6,-6,0
21700238,1626157,MIN,DET,Karl-Anthony Towns,177,37.8833333333333,38,-0.116666666666667,81,75,6,4,2
21700238,201229,DET,MIN,Anthony Tolliver,50,10.9333333333333,11,-0.0666666666666664,22,13,9,9,0
21700238,202340,DET,MIN,Avery Bradley,157,34.1666666666667,34,0.166666666666671,67,71,-4,-3,-1
21700238,202397,DET,MIN,Ish Smith,80,18.5833333333333,19,-0.416666666666668,42,28,14,14,0
21700238,202699,DET,MIN,Tobias Harris,171,37.0666666666667,37,0.0666666666666629,78,84,-6,-6,0
21700238,202704,DET,MIN,Reggie Jackson,141,29.4166666666667,29,0.416666666666664,58,69,-11,-11,0
21700238,203083,DET,MIN,Andre Drummond,154,33.0333333333333,33,0.0333333333333314,65,71,-6,-5,-1
21700238,203493,DET,MIN,Reggie Bullock,47,10.4666666666667,10,0.466666666666667,23,19,4,5,-1
21700238,203961,DET,MIN,Eric Moreland,67,14.9666666666667,15,-0.033333333333335,35,26,9,8,1
21700238,204038,DET,MIN,Langston Galloway,17,3.63333333333333,4,-0.366666666666667,14,5,9,9,0
21700238,1626169,DET,MIN,Stanley Johnson,178,37.9333333333333,38,-0.0666666666666629,74,83,-9,-9,0
21700238,1628379,DET,MIN,Luke Kennard,43,9.8,10,-0.199999999999999,22,16,6,4,2
21700239,201577,CHI,PHX,Robin Lopez,153,30.8833333333333,31,-0.116666666666667,72,67,5,3,2
21700239,202347,CHI,PHX,Quincy Pondexter,19,3.76666666666667,4,-0.233333333333333,5,9,-4,-4,0
21700239,203200,CHI,PHX,Justin Holiday,177,36.4,37,-0.600000000000001,81,79,2,2,0
21700239,1626170,CHI,PHX,Jerian Grant,103,20.7333333333333,21,-0.266666666666666,40,55,-15,-15,0
21700239,1626171,CHI,PHX,Bobby Portis,101,20.3,20,0.299999999999997,44,55,-11,-7,-4
21700239,1626245,CHI,PHX,Cristiano Felicio,56,11.3666666666667,12,-0.633333333333333,21,31,-10,-10,0
21700239,1627739,CHI,PHX,Kris Dunn,133,27.2,27,0.200000000000003,65,58,7,7,0
21700239,1627756,CHI,PHX,Denzel Valentine,176,36.4666666666667,37,-0.533333333333331,78,85,-7,-5,-2
21700239,1628374,CHI,PHX,Lauri Markkanen,162,33.3166666666667,34,-0.683333333333337,73,73,0,-2,2
21700239,1628469,CHI,PHX,Antonio Blakeney,100,19.2333333333333,19,0.233333333333334,46,53,-7,-9,2
21700239,202328,PHX,CHI,Greg Monroe,105,21.6333333333333,21,0.633333333333333,48,47,1,0,1
21700239,203458,PHX,CHI,Alex Len,124,25.5,26,-0.5,61,55,6,6,0
21700239,203584,PHX,CHI,Troy Daniels,89,18.4333333333333,18,0.433333333333334,49,37,12,11,1
21700239,203933,PHX,CHI,T.J. Warren,159,33.1166666666667,33,0.116666666666667,79,65,14,12,2
21700239,1626164,PHX,CHI,Devin Booker,158,31.9666666666667,32,-0.033333333333335,69,73,-4,-3,-1
21700239,1627733,PHX,CHI,Dragan Bender,105,20.4,20,0.399999999999999,50,50,0,3,-3
21700239,1627737,PHX,CHI,Marquese Chriss,101,20.7,21,-0.300000000000001,50,44,6,4,2
21700239,1627755,PHX,CHI,Tyler Ulis,94,19.7666666666667,20,-0.233333333333334,47,44,3,5,-2
21700239,1628367,PHX,CHI,Josh Jackson,111,22.15,22,0.149999999999999,49,52,-3,-1,-2
21700239,1628455,PHX,CHI,Mike James,134,26,26,0,63,58,5,3,2
21700240,2210,DEN,LAL,Richard Jefferson,20,4.56666666666667,5,-0.433333333333334,8,8,0,-1,1
21700240,200794,DEN,LAL,Paul Millsap,73,13.25,13,0.25,29,40,-11,-11,0
21700240,201163,DEN,LAL,Wilson Chandler,142,26.5166666666667,27,-0.483333333333334,60,73,-13,-14,1
21700240,202702,DEN,LAL,Kenneth Faried,47,9.1,9,0.0999999999999996,19,27,-8,-8,0
21700240,203115,DEN,LAL,Will Barton,140,26.75,27,-0.25,56,73,-17,-15,-2
21700240,203486,DEN,LAL,Mason Plumlee,159,30.7,30,0.700000000000003,73,76,-3,-2,-1
21700240,203914,DEN,LAL,Gary Harris,176,32.6,33,-0.399999999999999,80,87,-7,-7,0
21700240,203999,DEN,LAL,Nikola Jokic,63,11.6,12,-0.399999999999999,21,36,-15,-16,1
21700240,1626144,DEN,LAL,Emmanuel Mudiay,135,25.2833333333333,25,0.283333333333331,57,64,-7,-8,1
21700240,1626168,DEN,LAL,Trey Lyles,78,16.0166666666667,16,0.0166666666666657,40,35,5,5,0
21700240,1627750,DEN,LAL,Jamal Murray,126,24.2,24,0.200000000000003,58,69,-11,-10,-1
21700240,1627823,DEN,LAL,Juancho Hernangomez,96,19.4166666666667,19,0.416666666666664,44,47,-3,-3,0
21700240,101106,LAL,DEN,Andrew Bogut,16,2.78333333333333,3,-0.216666666666667,7,2,5,3,2
21700240,201147,LAL,DEN,Corey Brewer,83,15.25,15,0.25,44,35,9,11,-2
21700240,201572,LAL,DEN,Brook Lopez,113,22.25,22,0.25,63,55,8,8,0
21700240,203484,LAL,DEN,Kentavious Caldwell-Pope,184,35.4333333333333,35,0.433333333333337,90,93,-3,-2,-1
21700240,203903,LAL,DEN,Jordan Clarkson,126,24.3666666666667,24,0.366666666666667,60,48,12,11,1
21700240,203944,LAL,DEN,Julius Randle,169,31.4,32,-0.600000000000001,90,63,27,27,0
21700240,1627742,LAL,DEN,Brandon Ingram,142,28.4666666666667,29,-0.533333333333331,73,68,5,0,5
21700240,1627826,LAL,DEN,Ivica Zubac,10,2.38333333333333,2,0.383333333333333,2,4,-2,-2,0
21700240,1628366,LAL,DEN,Lonzo Ball,208,39.5,40,-0.5,111,84,27,29,-2
21700240,1628398,LAL,DEN,Kyle Kuzma,137,25.6166666666667,26,-0.383333333333333,67,68,-1,1,-2
21700240,1628404,LAL,DEN,Josh Hart,67,12.55,12,0.550000000000001,28,25,3,4,-1
21700241,2037,MIN,CHA,Jamal Crawford,87,18.3833333333333,18,0.383333333333333,41,53,-12,-11,-1
21700241,201166,MIN,CHA,Aaron Brooks,6,1.03333333333333,1,0.0333333333333332,4,3,1,1,0
21700241,201952,MIN,CHA,Jeff Teague,172,34.8833333333333,35,-0.116666666666667,68,80,-12,-13,1
21700241,201959,MIN,CHA,Taj Gibson,145,29,29,0,61,65,-4,-7,3
21700241,202332,MIN,CHA,Cole Aldrich,6,1.03333333333333,1,0.0333333333333332,4,3,1,1,0
21700241,202357,MIN,CHA,Nemanja Bjelica,72,15.2833333333333,16,-0.716666666666665,35,41,-6,-6,0
21700241,202710,MIN,CHA,Jimmy Butler,164,33.2166666666667,33,0.216666666666669,63,74,-11,-11,0
21700241,203476,MIN,CHA,Gorgui Dieng,77,16.5166666666667,17,-0.483333333333334,39,44,-5,-6,1
21700241,203498,MIN,CHA,Shabazz Muhammad,57,12.0666666666667,12,0.0666666666666664,29,32,-3,-3,0
21700241,203952,MIN,CHA,Andrew Wiggins,177,35.85,36,-0.149999999999999,73,85,-12,-13,1
21700241,1626145,MIN,CHA,Tyus Jones,50,10.9166666666667,11,-0.0833333333333322,30,32,-2,-2,0
21700241,1626157,MIN,CHA,Karl-Anthony Towns,151,30.3666666666667,30,0.366666666666667,59,70,-11,-11,0
21700241,1627875,MIN,CHA,Marcus Georges-Hunt,6,1.03333333333333,1,0.0333333333333332,4,3,1,1,0
21700241,2730,CHA,MIN,Dwight Howard,150,30.3666666666667,30,0.366666666666667,70,63,7,6,1
21700241,101107,CHA,MIN,Marvin Williams,128,25.2833333333333,25,0.283333333333331,54,50,4,8,-4
21700241,201587,CHA,MIN,Nicolas Batum,145,29.1166666666667,29,0.116666666666667,69,56,13,12,1
21700241,202689,CHA,MIN,Kemba Walker,166,33.8166666666667,34,-0.18333333333333,79,68,11,12,-1
21700241,203077,CHA,MIN,Michael Kidd-Gilchrist,161,32.2833333333333,32,0.283333333333331,76,66,10,13,-3
21700241,203087,CHA,MIN,Jeremy Lamb,98,20.9166666666667,21,-0.0833333333333357,55,44,11,11,0
21700241,203469,CHA,MIN,Cody Zeller,84,17.55,18,-0.450000000000003,47,39,8,10,-2
21700241,203487,CHA,MIN,Michael Carter-Williams,68,14.1,14,0.0999999999999996,38,34,4,4,0
21700241,1626163,CHA,MIN,Frank Kaminsky,100,21.6333333333333,22,-0.366666666666667,60,52,8,6,2
21700241,1628370,CHA,MIN,Malik Monk,6,1.03333333333333,1,0.0333333333333332,3,4,-1,-1,0
21700241,1628407,CHA,MIN,Dwayne Bacon,64,13.4833333333333,14,-0.516666666666666,34,34,0,-1,1
21700242,2544,CLE,DET,LeBron James,114,26.8833333333333,27,-0.116666666666667,71,52,19,21,-2
21700242,2548,CLE,DET,Dwyane Wade,81,19.5833333333333,20,-0.416666666666668,48,35,13,13,0
21700242,2594,CLE,DET,Kyle Korver,74,17,17,0,51,31,20,21,-1
21700242,2747,CLE,DET,JR Smith,113,27.0166666666667,27,0.0166666666666657,71,46,25,23,2
21700242,101112,CLE,DET,Channing Frye,90,22.15,22,0.149999999999999,46,41,5,5,0
21700242,101181,CLE,DET,Jose Calderon,120,28.2333333333333,28,0.233333333333334,68,53,15,15,0
21700242,201145,CLE,DET,Jeff Green,92,22.6166666666667,22,0.616666666666667,48,41,7,5,2
21700242,201567,CLE,DET,Kevin Love,111,25.6666666666667,26,-0.333333333333336,72,44,28,30,-2
21700242,203109,CLE,DET,Jae Crowder,111,25.6666666666667,26,-0.333333333333336,70,47,23,23,0
21700242,204066,CLE,DET,John Holland,42,10.2666666666667,10,0.266666666666666,13,21,-8,-7,-1
21700242,1626224,CLE,DET,Cedi Osman,57,14,14,0,22,29,-7,-9,2
21700242,201229,DET,CLE,Anthony Tolliver,55,13.2833333333333,13,0.283333333333333,21,40,-19,-21,2
21700242,202340,DET,CLE,Avery Bradley,117,27.2166666666667,27,0.216666666666669,52,73,-21,-21,0
21700242,202397,DET,CLE,Ish Smith,69,16.8833333333333,17,-0.116666666666667,22,38,-16,-17,1
21700242,202699,DET,CLE,Tobias Harris,120,27.5666666666667,28,-0.433333333333334,51,78,-27,-27,0
21700242,202704,DET,CLE,Reggie Jackson,105,24.35,24,0.350000000000001,50,71,-21,-20,-1
21700242,203083,DET,CLE,Andre Drummond,103,24.9,25,-0.100000000000001,46,64,-18,-19,1
21700242,203493,DET,CLE,Reggie Bullock,27,6.58333333333333,7,-0.416666666666667,16,7,9,9,0
21700242,203961,DET,CLE,Eric Moreland,89,21.0333333333333,21,0.0333333333333314,37,44,-7,-4,-3
21700242,204038,DET,CLE,Langston Galloway,84,20.6,21,-0.399999999999999,36,43,-7,-7,0
21700242,1626169,DET,CLE,Stanley Johnson,122,28.1,28,0.100000000000001,51,80,-29,-29,0
21700242,1627740,DET,CLE,Henry Ellenson,48,11.8166666666667,12,-0.183333333333334,26,15,11,11,0
21700242,1628379,DET,CLE,Luke Kennard,66,16.75,17,-0.25,32,27,5,5,0
21700243,201167,ORL,IND,Arron Afflalo,60,11.95,12,-0.0500000000000007,21,20,1,5,-4
21700243,201571,ORL,IND,D.J. Augustin,114,22.9666666666667,23,-0.0333333333333314,38,49,-11,-5,-6
21700243,201578,ORL,IND,Marreese Speights,57,11.0166666666667,11,0.0166666666666657,19,21,-2,0,-2
21700243,202687,ORL,IND,Bismack Biyombo,93,19.1833333333333,19,0.183333333333334,36,35,1,1,0
21700243,202696,ORL,IND,Nikola Vucevic,141,28.75,29,-0.25,59,72,-13,-9,-4
21700243,203082,ORL,IND,Terrence Ross,113,24.5333333333333,24,0.533333333333331,47,50,-3,-3,0
21700243,203095,ORL,IND,Evan Fournier,153,30.9666666666667,31,-0.033333333333335,66,77,-11,-9,-2
21700243,203613,ORL,IND,Jonathon Simmons,149,30.0333333333333,30,0.0333333333333314,58,69,-11,-7,-4
21700243,203901,ORL,IND,Elfrid Payton,120,24.9666666666667,25,-0.0333333333333314,57,58,-1,-3,2
21700243,203932,ORL,IND,Aaron Gordon,170,35.3,35,0.299999999999997,74,84,-10,-10,0
21700243,201152,IND,ORL,Thaddeus Young,180,36.7833333333333,37,-0.216666666666669,91,71,20,16,4
21700243,201954,IND,ORL,Darren Collison,169,34.7166666666667,35,-0.283333333333331,83,64,19,15,4
21700243,202362,IND,ORL,Lance Stephenson,107,23.0833333333333,23,0.0833333333333322,43,43,0,2,-2
21700243,202709,IND,ORL,Cory Joseph,111,22.7333333333333,22,0.733333333333334,40,48,-8,-10,2
21700243,202711,IND,ORL,Bojan Bogdanovic,175,34.5833333333333,35,-0.416666666666671,77,72,5,1,4
21700243,203506,IND,ORL,Victor Oladipo,165,33.7333333333333,34,-0.266666666666666,89,69,20,14,6
21700243,1626167,IND,ORL,Myles Turner,159,33.7666666666667,34,-0.233333333333334,66,67,-1,0,-1
21700243,1627734,IND,ORL,Domantas Sabonis,104,20.2666666666667,20,0.266666666666666,46,41,5,2,3
21700244,101161,PHI,UTA,Amir Johnson,99,20.7333333333333,21,-0.266666666666666,45,43,2,5,-3
21700244,200755,PHI,UTA,JJ Redick,153,32.3333333333333,32,0.333333333333329,79,58,21,21,0
21700244,201573,PHI,UTA,Jerryd Bayless,77,16.4666666666667,16,0.466666666666669,30,32,-2,-2,0
21700244,203496,PHI,UTA,Robert Covington,165,33.6,33,0.599999999999994,80,64,16,16,0
21700244,203954,PHI,UTA,Joel Embiid,126,26.8,27,-0.200000000000003,62,43,19,16,3
21700244,203967,PHI,UTA,Dario Saric,109,23.7,24,-0.300000000000001,55,35,20,15,5
21700244,204456,PHI,UTA,T.J. McConnell,161,33.2333333333333,34,-0.766666666666666,79,67,12,17,-5
21700244,1626643,PHI,UTA,Jacob Pullen,2,0.516666666666667,1,-0.483333333333333,0,0,0,0,0
21700244,1627732,PHI,UTA,Ben Simmons,163,34.3833333333333,34,0.383333333333333,72,66,6,6,0
21700244,1627788,PHI,UTA,Furkan Korkmaz,2,0.516666666666667,1,-0.483333333333333,0,0,0,0,0
21700244,1627789,PHI,UTA,Timothe Luwawu-Cabarrot,68,15.3833333333333,16,-0.616666666666667,33,22,11,11,0
21700244,200757,UTA,PHI,Thabo Sefolosha,85,18.6166666666667,19,-0.383333333333333,39,35,4,0,4
21700244,201937,UTA,PHI,Ricky Rubio,109,22.4166666666667,22,0.416666666666664,38,42,-4,-4,0
21700244,201973,UTA,PHI,Jonas Jerebko,96,19.7666666666667,20,-0.233333333333334,31,41,-10,-8,-2
21700244,202324,UTA,PHI,Derrick Favors,124,26.2833333333333,26,0.283333333333331,52,60,-8,-9,1
21700244,202327,UTA,PHI,Ekpe Udoh,101,21.25,22,-0.75,34,47,-13,-12,-1
21700244,202692,UTA,PHI,Alec Burks,78,16.9666666666667,17,-0.0333333333333314,35,29,6,4,2
21700244,203526,UTA,PHI,Raul Neto,43,9.85,10,-0.15,13,24,-11,-13,2
21700244,203918,UTA,PHI,Rodney Hood,153,32.1833333333333,32,0.183333333333337,59,82,-23,-23,0
21700244,204060,UTA,PHI,Joe Ingles,120,24.7666666666667,25,-0.233333333333334,40,64,-24,-20,-4
21700244,1626220,UTA,PHI,Royce O'Neale,41,8.66666666666667,9,-0.333333333333332,18,25,-7,-7,0
21700244,1628378,UTA,PHI,Donovan Mitchell,175,36.9,37,-0.0999999999999943,71,86,-15,-13,-2
21700245,101150,LAC,NYK,Lou Williams,132,26.35,26,0.350000000000001,33,62,-29,-29,0
21700245,201599,LAC,NYK,DeAndre Jordan,156,32.5,33,-0.5,55,75,-20,-22,2
21700245,201933,LAC,NYK,Blake Griffin,158,33.3333333333333,33,0.333333333333329,55,74,-19,-20,1
21700245,201976,LAC,NYK,Patrick Beverley,107,21.7666666666667,22,-0.233333333333334,51,48,3,1,2
21700245,202325,LAC,NYK,Wesley Johnson,113,24.0166666666667,24,0.0166666666666657,47,49,-2,-7,5
21700245,203085,LAC,NYK,Austin Rivers,157,31.15,32,-0.850000000000001,61,81,-20,-20,0
21700245,203186,LAC,NYK,Willie Reed,57,11.0833333333333,11,0.0833333333333322,26,26,0,1,-1
21700245,203710,LAC,NYK,C.J. Williams,21,4.5,5,-0.5,9,13,-4,-2,-2
21700245,203966,LAC,NYK,Jamil Wilson,7,1.58333333333333,2,-0.416666666666667,4,2,2,4,-2
21700245,1626149,LAC,NYK,Montrezl Harrell,17,4.06666666666667,4,0.0666666666666664,4,5,-1,-1,0
21700245,1626155,LAC,NYK,Sam Dekker,66,12.7333333333333,13,-0.266666666666668,26,31,-5,-6,1
21700245,1628393,LAC,NYK,Jawun Evans,94,19.2333333333333,19,0.233333333333334,38,39,-1,3,-4
21700245,1628414,LAC,NYK,Sindarius Thornwell,70,15.9333333333333,16,-0.0666666666666664,16,30,-14,-12,-2
21700245,101127,NYK,LAC,Jarrett Jack,120,24.5333333333333,25,-0.466666666666669,65,45,20,24,-4
21700245,201196,NYK,LAC,Ramon Sessions,52,11.65,12,-0.35,24,17,7,7,0
21700245,201563,NYK,LAC,Michael Beasley,17,3.83333333333333,4,-0.166666666666667,11,7,4,2,2
21700245,201584,NYK,LAC,Courtney Lee,125,26.4666666666667,27,-0.533333333333335,59,50,9,11,-2
21700245,202498,NYK,LAC,Lance Thomas,75,14.95,15,-0.0500000000000007,20,27,-7,-7,0
21700245,202683,NYK,LAC,Enes Kanter,162,32.7666666666667,33,-0.233333333333334,79,62,17,21,-4
21700245,203124,NYK,LAC,Kyle O'Quinn,59,12.6333333333333,13,-0.366666666666667,19,20,-1,-5,4
21700245,203501,NYK,LAC,Tim Hardaway Jr.,133,26.1833333333333,26,0.183333333333334,67,57,10,10,0
21700245,203926,NYK,LAC,Doug McDermott,148,30.05,30,0.0499999999999972,66,44,22,24,-2
21700245,204001,NYK,LAC,Kristaps Porzingis,139,28.8666666666667,29,-0.133333333333333,76,51,25,27,-2
21700245,1626195,NYK,LAC,Willy Hernangomez,17,3.83333333333333,4,-0.166666666666667,11,7,4,2,2
21700245,1628373,NYK,LAC,Frank Ntilikina,59,11.4666666666667,11,0.466666666666665,18,23,-5,-9,4
21700245,1628422,NYK,LAC,Damyean Dotson,49,11.0166666666667,11,0.0166666666666657,20,15,5,3,2
21700246,202323,POR,MEM,Evan Turner,91,19.95,20,-0.0500000000000007,44,28,16,16,0
21700246,202334,POR,MEM,Ed Davis,75,16.3166666666667,16,0.316666666666666,32,28,4,4,0
21700246,203081,POR,MEM,Damian Lillard,150,33.2,34,-0.800000000000004,66,63,3,-1,4
21700246,203086,POR,MEM,Meyers Leonard,74,16.6833333333333,17,-0.316666666666666,35,29,6,6,0
21700246,203090,POR,MEM,Maurice Harkless,101,20.5333333333333,21,-0.466666666666669,38,49,-11,-11,0
21700246,203468,POR,MEM,CJ McCollum,178,37.5833333333333,37,0.583333333333329,76,76,0,4,-4
21700246,203894,POR,MEM,Shabazz Napier,130,26.9333333333333,27,-0.0666666666666664,63,50,13,13,0
21700246,203943,POR,MEM,Noah Vonleh,145,30.9833333333333,31,-0.0166666666666657,66,62,4,2,2
21700246,203994,POR,MEM,Jusuf Nurkic,148,30.8666666666667,31,-0.133333333333333,63,63,0,0,0
21700246,1626192,POR,MEM,Pat Connaughton,28,5.78333333333333,6,-0.216666666666667,17,12,5,7,-2
21700246,201188,MEM,POR,Marc Gasol,187,39.6166666666667,40,-0.383333333333333,77,84,-7,-7,0
21700246,201596,MEM,POR,Mario Chalmers,150,32.3166666666667,33,-0.683333333333337,71,66,5,5,0
21700246,201936,MEM,POR,Tyreke Evans,151,31.5,31,0.5,61,69,-8,-7,-1
21700246,202718,MEM,POR,Chandler Parsons,121,24.05,24,0.0499999999999972,53,54,-1,4,-5
21700246,203210,MEM,POR,JaMychal Green,159,33.6666666666667,34,-0.333333333333336,74,70,4,3,1
21700246,203463,MEM,POR,Ben McLemore,68,15.7166666666667,16,-0.283333333333333,26,30,-4,-8,4
21700246,203516,MEM,POR,James Ennis III,34,7.58333333333333,8,-0.416666666666666,7,19,-12,-10,-2
21700246,1626150,MEM,POR,Andrew Harrison,16,3,3,0,3,8,-5,-4,-1
21700246,1626185,MEM,POR,Jarell Martin,40,8.61666666666667,9,-0.383333333333333,10,20,-10,-11,1
21700246,1627738,MEM,POR,Deyonta Davis,60,13.4166666666667,14,-0.583333333333334,23,24,-1,-1,0
21700246,1628415,MEM,POR,Dillon Brooks,134,29.35,30,-0.649999999999999,55,56,-1,-4,3
21700247,202339,MIL,WAS,Eric Bledsoe,150,35.3333333333333,35,0.333333333333329,66,67,-1,1,-2
21700247,202732,MIL,WAS,DeAndre Liggins,67,17.2,17,0.200000000000003,31,47,-16,-16,0
21700247,203089,MIL,WAS,John Henson,113,25.9333333333333,26,-0.0666666666666664,45,48,-3,-4,1
21700247,203114,MIL,WAS,Khris Middleton,161,38.1166666666667,39,-0.883333333333333,71,70,1,0,1
21700247,203503,MIL,WAS,Tony Snell,129,30.6,31,-0.399999999999999,54,61,-7,-5,-2
21700247,203507,MIL,WAS,Giannis Antetokounmpo,168,39.6333333333333,39,0.633333333333333,72,80,-8,-12,4
21700247,1627748,MIL,WAS,Thon Maker,80,20.0166666666667,20,0.0166666666666657,42,46,-4,-4,0
21700247,1627763,MIL,WAS,Malcolm Brogdon,75,17.55,18,-0.450000000000003,31,45,-14,-12,-2
21700247,1627780,MIL,WAS,Gary Payton II,57,14.6166666666667,15,-0.383333333333333,28,31,-3,-3,0
21700247,101133,WAS,MIL,Ian Mahinmi,48,12.0833333333333,13,-0.916666666666668,30,20,10,6,4
21700247,101162,WAS,MIL,Marcin Gortat,152,35.7166666666667,35,0.716666666666669,69,68,1,5,-4
21700247,201975,WAS,MIL,Jodie Meeks,74,18.9,19,-0.100000000000001,41,37,4,4,0
21700247,202322,WAS,MIL,John Wall,134,31.2,31,0.200000000000003,60,57,3,3,0
21700247,202693,WAS,MIL,Markieff Morris,112,25.7166666666667,26,-0.283333333333331,46,43,3,3,0
21700247,203078,WAS,MIL,Bradley Beal,157,36.8166666666667,37,-0.18333333333333,75,71,4,3,1
21700247,203490,WAS,MIL,Otto Porter Jr.,161,39.0666666666667,39,0.0666666666666629,86,65,21,22,-1
21700247,204025,WAS,MIL,Tim Frazier,66,16.6,17,-0.399999999999999,39,31,8,8,0
21700247,1626162,WAS,MIL,Kelly Oubre Jr.,96,22.9,23,-0.100000000000001,49,48,1,1,0
21700248,2749,NOP,OKC,Jameer Nelson,86,17.95,18,-0.0500000000000007,51,26,25,30,-5
21700248,2754,NOP,OKC,Tony Allen,89,18.65,18,0.649999999999999,51,34,17,11,6
21700248,200765,NOP,OKC,Rajon Rondo,157,30.6,31,-0.399999999999999,65,83,-18,-19,1
21700248,201950,NOP,OKC,Jrue Holiday,168,33.5166666666667,34,-0.483333333333334,69,85,-16,-14,-2
21700248,201967,NOP,OKC,Dante Cunningham,78,16.1166666666667,16,0.116666666666667,45,24,21,19,2
21700248,202326,NOP,OKC,DeMarcus Cousins,131,25.9166666666667,26,-0.0833333333333357,53,68,-15,-11,-4
21700248,202734,NOP,OKC,E'Twaun Moore,165,31.45,31,0.449999999999999,72,83,-11,-9,-2
21700248,203076,NOP,OKC,Anthony Davis,221,44.3166666666667,45,-0.683333333333337,107,101,6,4,2
21700248,203121,NOP,OKC,Darius Miller,100,21.4,22,-0.600000000000001,57,31,26,24,2
21700248,2546,OKC,NOP,Carmelo Anthony,180,35.0166666666667,35,0.0166666666666657,91,80,11,11,0
21700248,101109,OKC,NOP,Raymond Felton,113,23.1833333333333,23,0.183333333333334,40,51,-11,-13,2
21700248,201566,OKC,NOP,Russell Westbrook,197,38.35,39,-0.650000000000006,94,87,7,9,-2
21700248,202331,OKC,NOP,Paul George,178,36.4833333333333,36,0.483333333333334,80,86,-6,-3,-3
21700248,202335,OKC,NOP,Patrick Patterson,59,12.9666666666667,13,-0.0333333333333332,16,34,-18,-18,0
21700248,203460,OKC,NOP,Andre Roberson,139,27.2166666666667,28,-0.783333333333331,72,62,10,7,3
21700248,203500,OKC,NOP,Steven Adams,125,25.1166666666667,26,-0.883333333333333,62,50,12,14,-2
21700248,203518,OKC,NOP,Alex Abrines,80,16.55,16,0.549999999999997,33,50,-17,-17,0
21700248,203924,OKC,NOP,Jerami Grant,95,19.55,19,0.550000000000001,36,48,-12,-16,4
21700248,203962,OKC,NOP,Josh Huestis,10,2.16666666666667,2,0.166666666666667,2,6,-4,-4,0
21700248,1626177,OKC,NOP,Dakari Johnson,19,3.31666666666667,3,0.316666666666666,9,16,-7,-5,-2
21700249,201143,BOS,DAL,Al Horford,173,38.65,39,-0.350000000000001,92,80,12,15,-3
21700249,202681,BOS,DAL,Kyrie Irving,175,38.3166666666667,39,-0.683333333333337,95,76,19,21,-2
21700249,202694,BOS,DAL,Marcus Morris,115,25.4333333333333,26,-0.566666666666666,51,48,3,0,3
21700249,203382,BOS,DAL,Aron Baynes,54,13.0333333333333,13,0.0333333333333332,25,25,0,1,-1
21700249,203499,BOS,DAL,Shane Larkin,10,2.68333333333333,3,-0.316666666666667,3,6,-3,-3,0
21700249,203935,BOS,DAL,Marcus Smart,154,34.85,35,-0.149999999999999,76,63,13,15,-2
21700249,1626179,BOS,DAL,Terry Rozier,58,13.95,14,-0.0500000000000007,15,25,-10,-13,3
21700249,1627759,BOS,DAL,Jaylen Brown,163,36.7833333333333,37,-0.216666666666669,80,72,8,6,2
21700249,1627846,BOS,DAL,Abdel Nader,16,3.73333333333333,4,-0.266666666666667,5,9,-4,-5,1
21700249,1628369,BOS,DAL,Jayson Tatum,171,37.7166666666667,38,-0.283333333333331,82,65,17,15,2
21700249,1628400,BOS,DAL,Semi Ojeleye,51,12.2,12,0.199999999999999,17,24,-7,-7,0
21700249,1628464,BOS,DAL,Daniel Theis,30,6.56666666666667,6,0.566666666666666,9,12,-3,-5,2
21700249,1717,DAL,BOS,Dirk Nowitzki,143,32.7166666666667,32,0.716666666666669,67,63,4,8,-4
21700249,2734,DAL,BOS,Devin Harris,58,13.5,13,0.5,23,26,-3,-5,2
21700249,200826,DAL,BOS,J.J. Barea,111,27.1666666666667,27,0.166666666666664,47,54,-7,-6,-1
21700249,202083,DAL,BOS,Wesley Matthews,191,42.4833333333333,43,-0.516666666666666,85,95,-10,-9,-1
21700249,203084,DAL,BOS,Harrison Barnes,180,39.9666666666667,41,-1.03333333333333,76,94,-18,-21,3
21700249,203939,DAL,BOS,Dwight Powell,100,23.3,23,0.299999999999997,43,45,-2,-2,0
21700249,1626257,DAL,BOS,Salah Mejri,31,6.78333333333333,7,-0.216666666666667,14,9,5,6,-1
21700249,1627812,DAL,BOS,Yogi Ferrell,167,37.2166666666667,37,0.216666666666669,61,79,-18,-15,-3
21700249,1628372,DAL,BOS,Dennis Smith Jr.,123,26.1333333333333,27,-0.866666666666667,57,54,3,5,-2
21700249,1628467,DAL,BOS,Maxi Kleber,66,14.65,15,-0.35,32,31,1,-1,2
21700250,101141,ATL,SAS,Ersan Ilyasova,36,7.43333333333333,7,0.433333333333334,14,18,-4,-4,0
21700250,201158,ATL,SAS,Marco Belinelli,132,30.0833333333333,30,0.0833333333333357,59,68,-9,-9,0
21700250,202337,ATL,SAS,Luke Babbitt,35,7.38333333333333,7,0.383333333333333,6,17,-11,-9,-2
21700250,203145,ATL,SAS,Kent Bazemore,121,24.9833333333333,25,-0.0166666666666657,36,47,-11,-9,-2
21700250,203471,ATL,SAS,Dennis Schroder,140,31.0666666666667,31,0.0666666666666664,55,57,-2,-2,0
21700250,203473,ATL,SAS,Dewayne Dedmon,124,27.1,27,0.100000000000001,52,41,11,9,2
21700250,1627098,ATL,SAS,Malcolm Delaney,131,29.4833333333333,30,-0.516666666666666,53,68,-15,-15,0
21700250,1627752,ATL,SAS,Taurean Prince,178,38.65,39,-0.349999999999994,72,77,-5,-7,2
21700250,1627761,ATL,SAS,DeAndre' Bembry,21,4.51666666666667,4,0.516666666666667,4,8,-4,-4,0
21700250,1628381,ATL,SAS,John Collins,161,35.6833333333333,36,-0.316666666666663,72,71,1,-1,2
21700250,1628463,ATL,SAS,Tyler Cavanaugh,11,2.36666666666667,2,0.366666666666667,2,8,-6,-4,-2
21700250,1938,SAS,ATL,Manu Ginobili,115,25.75,26,-0.25,60,49,11,11,0
21700250,2200,SAS,ATL,Pau Gasol,84,18.2333333333333,18,0.233333333333334,33,37,-4,-4,0
21700250,200746,SAS,ATL,LaMarcus Aldridge,176,38.7,39,-0.299999999999997,74,72,2,4,-2
21700250,200752,SAS,ATL,Rudy Gay,60,13.7,13,0.699999999999999,28,27,1,1,0
21700250,201980,SAS,ATL,Danny Green,136,29.5,30,-0.5,57,48,9,9,0
21700250,201988,SAS,ATL,Patty Mills,146,32.6333333333333,33,-0.366666666666667,62,60,2,2,0
21700250,202722,SAS,ATL,Davis Bertans,23,4.63333333333333,5,-0.366666666666667,10,7,3,3,0
21700250,203464,SAS,ATL,Brandon Paul,15,3.45,4,-0.55,2,2,0,-1,1
21700250,203530,SAS,ATL,Joffrey Lauvergne,32,7.13333333333333,7,0.133333333333333,16,12,4,4,0
21700250,203937,SAS,ATL,Kyle Anderson,138,29.7166666666667,30,-0.283333333333335,54,55,-1,-1,0
21700250,1627749,SAS,ATL,Dejounte Murray,72,15.1166666666667,15,0.116666666666667,34,25,9,9,0
21700250,1627854,SAS,ATL,Bryn Forbes,93,20.1833333333333,20,0.183333333333334,50,31,19,18,1
21700251,202702,DEN,SAC,Kenneth Faried,93,19.2166666666667,19,0.216666666666669,45,44,1,0,1
21700251,203115,DEN,SAC,Will Barton,164,36.2,37,-0.799999999999997,89,70,19,19,0
21700251,203486,DEN,SAC,Mason Plumlee,91,20.2666666666667,20,0.266666666666666,38,40,-2,-3,1
21700251,203914,DEN,SAC,Gary Harris,180,38.9166666666667,39,-0.0833333333333357,94,78,16,18,-2
21700251,203999,DEN,SAC,Nikola Jokic,156,34.8,35,-0.200000000000003,90,67,23,24,-1
21700251,1626144,DEN,SAC,Emmanuel Mudiay,91,19.35,20,-0.649999999999999,45,48,-3,-2,-1
21700251,1626168,DEN,SAC,Trey Lyles,83,18.85,19,-0.149999999999999,49,36,13,14,-1
21700251,1627736,DEN,SAC,Malik Beasley,11,2.46666666666667,3,-0.533333333333333,6,9,-3,-3,0
21700251,1627750,DEN,SAC,Jamal Murray,108,24.2666666666667,24,0.266666666666666,57,41,16,13,3
21700251,1627823,DEN,SAC,Juancho Hernangomez,98,22.5166666666667,23,-0.483333333333334,54,48,6,6,0
21700251,1628399,DEN,SAC,Tyler Lydon,10,2.15,2,0.15,3,9,-6,-6,0
21700251,2216,SAC,DEN,Zach Randolph,120,25.45,26,-0.549999999999997,55,67,-12,-12,0
21700251,201585,SAC,DEN,Kosta Koufos,122,27.4,28,-0.600000000000001,52,64,-12,-12,0
21700251,201588,SAC,DEN,George Hill,153,32.0666666666667,33,-0.93333333333333,65,74,-9,-9,0
21700251,202066,SAC,DEN,Garrett Temple,118,25.0166666666667,26,-0.983333333333334,50,53,-3,-3,0
21700251,203992,SAC,DEN,Bogdan Bogdanovic,94,21.2166666666667,21,0.216666666666669,46,59,-13,-13,0
21700251,1626161,SAC,DEN,Willie Cauley-Stein,105,23.35,23,0.350000000000001,51,55,-4,-6,2
21700251,1627746,SAC,DEN,Skal Labissiere,60,12.7333333333333,13,-0.266666666666668,25,29,-4,-4,0
21700251,1627781,SAC,DEN,Malachi Richardson,35,8.58333333333333,9,-0.416666666666668,15,15,0,2,-2
21700251,1628368,SAC,DEN,De'Aaron Fox,147,32.1,32,0.0999999999999943,65,74,-9,-9,0
21700251,1628382,SAC,DEN,Justin Jackson,40,9.6,9,0.6,20,23,-3,-3,0
21700251,1628412,SAC,DEN,Frank Mason,91,21.4833333333333,21,0.483333333333334,46,57,-11,-11,0
21700252,201577,CHI,LAL,Robin Lopez,161,32.5666666666667,33,-0.433333333333337,57,70,-13,-12,-1
21700252,203200,CHI,LAL,Justin Holiday,201,40.5333333333333,41,-0.466666666666669,75,88,-13,-14,1
21700252,1626170,CHI,LAL,Jerian Grant,79,16.0333333333333,16,0.0333333333333314,30,37,-7,-7,0
21700252,1626171,CHI,LAL,Bobby Portis,99,20.7166666666667,20,0.716666666666669,48,44,4,7,-3
21700252,1626245,CHI,LAL,Cristiano Felicio,59,11.95,12,-0.0500000000000007,28,29,-1,-3,2
21700252,1627739,CHI,LAL,Kris Dunn,156,31.9666666666667,32,-0.0333333333333314,64,65,-1,-2,1
21700252,1627756,CHI,LAL,Denzel Valentine,182,37.5833333333333,38,-0.416666666666671,73,75,-2,-3,1
21700252,1628374,CHI,LAL,Lauri Markkanen,151,30.7666666666667,31,-0.233333333333334,55,61,-6,-10,4
21700252,1628469,CHI,LAL,Antonio Blakeney,87,17.8833333333333,18,-0.116666666666667,40,41,-1,-1,0
21700252,201147,LAL,CHI,Corey Brewer,17,3.55,4,-0.45,3,14,-11,-10,-1
21700252,201572,LAL,CHI,Brook Lopez,119,24.8333333333333,25,-0.166666666666668,51,46,5,4,1
21700252,203484,LAL,CHI,Kentavious Caldwell-Pope,196,39.4166666666667,39,0.416666666666671,91,68,23,23,0
21700252,203903,LAL,CHI,Jordan Clarkson,76,15.9,16,-0.100000000000001,33,39,-6,-5,-1
21700252,203944,LAL,CHI,Julius Randle,140,28.4166666666667,28,0.416666666666664,60,55,5,8,-3
21700252,1627742,LAL,CHI,Brandon Ingram,186,38.5333333333333,39,-0.466666666666669,80,73,7,7,0
21700252,1627826,LAL,CHI,Ivica Zubac,13,2.9,3,-0.0999999999999996,4,7,-3,-3,0
21700252,1628366,LAL,CHI,Lonzo Ball,159,32.1,32,0.100000000000001,69,55,14,14,0
21700252,1628398,LAL,CHI,Kyle Kuzma,198,39.85,40,-0.149999999999999,89,80,9,9,0
21700252,1628404,LAL,CHI,Josh Hart,71,14.5,15,-0.5,30,33,-3,-2,-1
21700253,101133,WAS,CHA,Ian Mahinmi,71,16.2333333333333,16,0.233333333333334,43,35,8,6,2
21700253,101162,WAS,CHA,Marcin Gortat,177,36.65,37,-0.350000000000001,81,94,-13,-11,-2
21700253,201975,WAS,CHA,Jodie Meeks,60,13.9333333333333,14,-0.0666666666666664,41,26,15,13,2
21700253,202322,WAS,CHA,John Wall,196,41,41,0,96,98,-2,-2,0
21700253,202693,WAS,CHA,Markieff Morris,161,34.05,34,0.0499999999999972,76,86,-10,-10,0
21700253,203078,WAS,CHA,Bradley Beal,197,40.9833333333333,41,-0.0166666666666657,89,103,-14,-12,-2
21700253,203118,WAS,CHA,Mike Scott,87,18.8333333333333,19,-0.166666666666668,48,43,5,5,0
21700253,203490,WAS,CHA,Otto Porter Jr.,133,27.5166666666667,28,-0.483333333333334,62,72,-10,-10,0
21700253,204025,WAS,CHA,Tim Frazier,52,11.8833333333333,12,-0.116666666666667,28,31,-3,-3,0
21700253,1626162,WAS,CHA,Kelly Oubre Jr.,106,23.3333333333333,23,0.333333333333332,56,57,-1,-1,0
21700253,2730,CHA,WAS,Dwight Howard,175,36.9333333333333,37,-0.06666666666667,88,89,-1,1,-2
21700253,101107,CHA,WAS,Marvin Williams,148,30.4333333333333,30,0.433333333333334,81,66,15,17,-2
21700253,201587,CHA,WAS,Nicolas Batum,62,13.6,14,-0.4,23,38,-15,-13,-2
21700253,202689,CHA,WAS,Kemba Walker,194,40.3,40,0.299999999999997,98,92,6,6,0
21700253,203077,CHA,WAS,Michael Kidd-Gilchrist,173,36.5333333333333,36,0.533333333333331,90,81,9,11,-2
21700253,203087,CHA,WAS,Jeremy Lamb,177,37.3833333333333,37,0.383333333333333,104,76,28,26,2
21700253,203469,CHA,WAS,Cody Zeller,74,15.9833333333333,16,-0.0166666666666657,41,35,6,4,2
21700253,203487,CHA,WAS,Michael Carter-Williams,80,18.15,18,0.149999999999999,39,52,-13,-15,2
21700253,1626163,CHA,WAS,Frank Kaminsky,101,22.6,23,-0.399999999999999,52,58,-6,-8,2
21700253,1628407,CHA,WAS,Dwayne Bacon,56,12.5,13,-0.5,29,33,-4,-4,0
21700254,2544,CLE,BKN,LeBron James,148,33.5833333333333,33,0.583333333333329,85,66,19,20,-1
21700254,2548,CLE,BKN,Dwyane Wade,136,27.7166666666667,28,-0.283333333333331,81,71,10,8,2
21700254,2594,CLE,BKN,Kyle Korver,126,27.6833333333333,28,-0.316666666666666,80,71,9,10,-1
21700254,2747,CLE,BKN,JR Smith,148,33.25,33,0.25,78,76,2,3,-1
21700254,101112,CLE,BKN,Channing Frye,70,16.2,16,0.199999999999999,44,40,4,1,3
21700254,101181,CLE,BKN,Jose Calderon,86,19.4,20,-0.600000000000001,39,38,1,0,1
21700254,201145,CLE,BKN,Jeff Green,69,15.4833333333333,16,-0.516666666666668,36,42,-6,-4,-2
21700254,201567,CLE,BKN,Kevin Love,142,31.0833333333333,31,0.0833333333333357,74,68,6,10,-4
21700254,203109,CLE,BKN,Jae Crowder,116,26.35,26,0.350000000000001,59,53,6,6,0
21700254,204066,CLE,BKN,John Holland,2,0.0666666666666667,0,0.0666666666666667,1,0,1,0,1
21700254,1626224,CLE,BKN,Cedi Osman,35,7.03333333333333,7,0.0333333333333332,17,20,-3,-4,1
21700254,1627790,CLE,BKN,Ante Zizic,2,0.0666666666666667,0,0.0666666666666667,1,0,1,0,1
21700254,201960,BKN,CLE,DeMarre Carroll,155,35.0666666666667,35,0.06666666666667,73,95,-22,-22,0
21700254,203092,BKN,CLE,Tyler Zeller,91,20.7666666666667,21,-0.233333333333334,47,49,-2,-2,0
21700254,203112,BKN,CLE,Quincy Acy,88,19.3666666666667,19,0.366666666666667,39,52,-13,-11,-2
21700254,203459,BKN,CLE,Allen Crabbe,138,30.3666666666667,30,0.366666666666667,74,78,-4,-6,2
21700254,203915,BKN,CLE,Spencer Dinwiddie,118,27.2333333333333,27,0.233333333333334,63,75,-12,-10,-2
21700254,203925,BKN,CLE,Joe Harris,136,28,29,-1,76,74,2,2,0
21700254,203930,BKN,CLE,Sean Kilpatrick,51,11.6166666666667,12,-0.383333333333333,23,24,-1,1,-2
21700254,1626178,BKN,CLE,Rondae Hollis-Jefferson,110,24.3666666666667,25,-0.633333333333333,58,69,-11,-11,0
21700254,1627747,BKN,CLE,Caris LeVert,106,22.4833333333333,23,-0.516666666666666,48,47,1,-1,2
21700254,1628386,BKN,CLE,Jarrett Allen,87,18.65,19,-0.350000000000001,44,32,12,10,2
21700255,101161,PHI,POR,Amir Johnson,99,18.05,18,0.0500000000000007,45,33,12,11,1
21700255,200755,PHI,POR,JJ Redick,152,30.9333333333333,31,-0.06666666666667,66,48,18,22,-4
21700255,201573,PHI,POR,Jerryd Bayless,117,22.35,22,0.350000000000001,47,44,3,1,2
21700255,203496,PHI,POR,Robert Covington,164,33.45,33,0.450000000000003,72,46,26,28,-2
21700255,203954,PHI,POR,Joel Embiid,138,29.65,30,-0.350000000000001,56,48,8,9,-1
21700255,203967,PHI,POR,Dario Saric,123,26.4333333333333,27,-0.566666666666666,49,41,8,8,0
21700255,204456,PHI,POR,T.J. McConnell,142,26.25,27,-0.75,64,57,7,7,0
21700255,1627732,PHI,POR,Ben Simmons,186,38.7666666666667,39,-0.233333333333334,78,58,20,18,2
21700255,1627788,PHI,POR,Furkan Korkmaz,12,1.93333333333333,2,-0.0666666666666667,8,8,0,0,0
21700255,1627789,PHI,POR,Timothe Luwawu-Cabarrot,52,10.6833333333333,11,-0.316666666666666,20,22,-2,-4,2
21700255,202323,POR,PHI,Evan Turner,169,34.3666666666667,34,0.366666666666667,58,70,-12,-8,-4
21700255,202334,POR,PHI,Ed Davis,81,16.0833333333333,16,0.0833333333333357,38,34,4,2,2
21700255,203081,POR,PHI,Damian Lillard,185,37.2,37,0.200000000000003,64,79,-15,-15,0
21700255,203086,POR,PHI,Meyers Leonard,22,4.1,4,0.0999999999999996,5,11,-6,-4,-2
21700255,203090,POR,PHI,Maurice Harkless,84,18.2666666666667,18,0.266666666666666,18,29,-11,-13,2
21700255,203468,POR,PHI,CJ McCollum,172,36.0333333333333,36,0.0333333333333314,51,71,-20,-21,1
21700255,203894,POR,PHI,Shabazz Napier,139,26.7166666666667,27,-0.283333333333331,53,60,-7,-6,-1
21700255,203943,POR,PHI,Noah Vonleh,91,19.1666666666667,19,0.166666666666668,31,44,-13,-13,0
21700255,203994,POR,PHI,Jusuf Nurkic,119,24.8333333333333,25,-0.166666666666664,30,48,-18,-18,0
21700255,1626192,POR,PHI,Pat Connaughton,59,10.4,10,0.4,26,25,1,-2,3
21700255,1627774,POR,PHI,Jake Layman,34,5.96666666666667,6,-0.0333333333333332,15,18,-3,-2,-1
21700255,1628380,POR,PHI,Zach Collins,15,2.68333333333333,3,-0.316666666666667,8,8,0,0,0
21700255,1628403,POR,PHI,Caleb Swanigan,15,2.68333333333333,3,-0.316666666666667,8,8,0,0,0
21700256,101141,ATL,LAC,Ersan Ilyasova,21,5.36666666666667,5,0.366666666666667,12,15,-3,-3,0
21700256,201158,ATL,LAC,Marco Belinelli,121,26.2,26,0.199999999999999,62,69,-7,-7,0
21700256,203145,ATL,LAC,Kent Bazemore,115,27.75,28,-0.25,51,62,-11,-11,0
21700256,203471,ATL,LAC,Dennis Schroder,145,32.55,33,-0.450000000000003,76,88,-12,-14,2
21700256,203473,ATL,LAC,Dewayne Dedmon,119,28.2833333333333,29,-0.716666666666669,59,67,-8,-8,0
21700256,203705,ATL,LAC,Josh Magette,63,15.1666666666667,15,0.166666666666668,27,28,-1,1,-2
21700256,1627098,ATL,LAC,Malcolm Delaney,67,15.1666666666667,15,0.166666666666666,32,35,-3,1,-4
21700256,1627752,ATL,LAC,Taurean Prince,90,20.75,21,-0.25,48,52,-4,-8,4
21700256,1627761,ATL,LAC,DeAndre' Bembry,52,13.2,13,0.199999999999999,25,27,-2,-2,0
21700256,1628381,ATL,LAC,John Collins,169,37.6,38,-0.399999999999999,83,96,-13,-13,0
21700256,1628463,ATL,LAC,Tyler Cavanaugh,78,16.55,17,-0.449999999999999,40,41,-1,-1,0
21700256,101150,LAC,ATL,Lou Williams,161,36.7833333333333,37,-0.216666666666669,92,75,17,18,-1
21700256,201599,LAC,ATL,DeAndre Jordan,159,36.4666666666667,37,-0.533333333333331,98,76,22,20,2
21700256,201933,LAC,ATL,Blake Griffin,163,36.5166666666667,37,-0.483333333333334,97,82,15,11,4
21700256,202325,LAC,ATL,Wesley Johnson,155,35.0833333333333,36,-0.916666666666671,95,78,17,15,2
21700256,203085,LAC,ATL,Austin Rivers,159,36.25,37,-0.75,91,82,9,13,-4
21700256,203186,LAC,ATL,Willie Reed,47,11,11,0,18,27,-9,-7,-2
21700256,203710,LAC,ATL,C.J. Williams,38,8.46666666666667,8,0.466666666666667,19,16,3,4,-1
21700256,1626155,LAC,ATL,Sam Dekker,47,11.45,11,0.449999999999999,19,21,-2,2,-4
21700256,1628393,LAC,ATL,Jawun Evans,81,19.5333333333333,19,0.533333333333331,39,43,-4,-8,4
21700256,1628414,LAC,ATL,Sindarius Thornwell,30,7.03333333333333,7,0.0333333333333332,12,15,-3,-3,0
21700257,201143,BOS,MIA,Al Horford,154,34.7666666666667,35,-0.233333333333334,76,69,7,8,-1
21700257,202681,BOS,MIA,Kyrie Irving,152,33.3,33,0.299999999999997,67,77,-10,-4,-6
21700257,202694,BOS,MIA,Marcus Morris,94,20.9833333333333,21,-0.0166666666666657,36,49,-13,-12,-1
21700257,203382,BOS,MIA,Aron Baynes,56,11.8166666666667,12,-0.183333333333334,17,20,-3,-3,0
21700257,203499,BOS,MIA,Shane Larkin,23,5.95,6,-0.0499999999999998,11,15,-4,-6,2
21700257,203935,BOS,MIA,Marcus Smart,155,34.7166666666667,34,0.716666666666669,80,79,1,-4,5
21700257,1626179,BOS,MIA,Terry Rozier,84,17.3666666666667,18,-0.633333333333333,44,42,2,1,1
21700257,1627759,BOS,MIA,Jaylen Brown,137,31.45,31,0.450000000000003,60,58,2,2,0
21700257,1628369,BOS,MIA,Jayson Tatum,155,34,34,0,73,69,4,4,0
21700257,1628400,BOS,MIA,Semi Ojeleye,22,4.93333333333333,5,-0.0666666666666664,9,12,-3,-2,-1
21700257,1628464,BOS,MIA,Daniel Theis,43,9.71666666666667,10,-0.283333333333333,17,30,-13,-14,1
21700257,201609,MIA,BOS,Goran Dragic,143,30.6,31,-0.399999999999999,70,68,2,4,-2
21700257,201949,MIA,BOS,James Johnson,90,20.3,21,-0.699999999999999,48,39,9,11,-2
21700257,201961,MIA,BOS,Wayne Ellington,100,22.3,22,0.299999999999997,50,42,8,8,0
21700257,202355,MIA,BOS,Hassan Whiteside,125,28.0166666666667,28,0.0166666666666657,52,62,-10,-13,3
21700257,203079,MIA,BOS,Dion Waiters,159,35.8833333333333,36,-0.116666666666667,77,74,3,1,2
21700257,203482,MIA,BOS,Kelly Olynyk,90,19.7833333333333,20,-0.216666666666669,52,36,16,19,-3
21700257,204020,MIA,BOS,Tyler Johnson,119,27.8166666666667,27,0.816666666666663,61,62,-1,1,-2
21700257,1626159,MIA,BOS,Justise Winslow,111,24.55,25,-0.450000000000003,51,55,-4,-6,2
21700257,1626196,MIA,BOS,Josh Richardson,138,29.75,30,-0.25,59,52,7,5,2
21700258,101127,NYK,TOR,Jarrett Jack,156,31.85,32,-0.149999999999999,73,59,14,12,2
21700258,201584,NYK,TOR,Courtney Lee,162,33.25,33,0.25,78,64,14,18,-4
21700258,202498,NYK,TOR,Lance Thomas,73,15.1833333333333,15,0.183333333333334,32,28,4,2,2
21700258,202683,NYK,TOR,Enes Kanter,152,31.4833333333333,32,-0.516666666666666,71,56,15,15,0
21700258,203124,NYK,TOR,Kyle O'Quinn,68,14.0833333333333,14,0.0833333333333322,31,40,-9,-7,-2
21700258,203501,NYK,TOR,Tim Hardaway Jr.,170,36.4833333333333,37,-0.516666666666666,88,70,18,16,2
21700258,203926,NYK,TOR,Doug McDermott,126,25.7666666666667,26,-0.233333333333334,50,66,-16,-18,2
21700258,204001,NYK,TOR,Kristaps Porzingis,165,34.75,35,-0.25,82,76,6,6,0
21700258,1628373,NYK,TOR,Frank Ntilikina,73,15.9,16,-0.100000000000001,35,41,-6,-4,-2
21700258,101139,TOR,NYK,CJ Miles,98,20.7333333333333,20,0.733333333333334,41,46,-5,-3,-2
21700258,200768,TOR,NYK,Kyle Lowry,173,35.4666666666667,36,-0.533333333333331,73,90,-17,-16,-1
21700258,201586,TOR,NYK,Serge Ibaka,143,29.0166666666667,29,0.0166666666666657,67,64,3,3,0
21700258,201942,TOR,NYK,DeMar DeRozan,146,30.8666666666667,31,-0.133333333333333,66,74,-8,-8,0
21700258,202685,TOR,NYK,Jonas Valanciunas,87,17.5,18,-0.5,38,43,-5,-5,0
21700258,203512,TOR,NYK,Lucas Nogueira,37,8,8,0,23,20,3,5,-2
21700258,1626181,TOR,NYK,Norman Powell,111,23.15,23,0.149999999999999,45,43,2,3,-1
21700258,1627751,TOR,NYK,Jakob Poeltl,46,10.2166666666667,11,-0.783333333333335,8,24,-16,-18,2
21700258,1627783,TOR,NYK,Pascal Siakam,136,28.5833333333333,29,-0.416666666666664,60,59,1,-1,2
21700258,1627832,TOR,NYK,Fred VanVleet,91,19.2833333333333,19,0.283333333333331,43,37,6,4,2
21700258,1628384,TOR,NYK,OG Anunoby,77,15.9333333333333,16,-0.0666666666666664,36,40,-4,-4,0
21700259,201163,DEN,HOU,Wilson Chandler,131,27.0833333333333,27,0.0833333333333322,48,66,-18,-16,-2
21700259,203115,DEN,HOU,Will Barton,169,35.7833333333333,36,-0.216666666666669,60,100,-40,-42,2
21700259,203486,DEN,HOU,Mason Plumlee,110,22.2,22,0.199999999999999,40,57,-17,-18,1
21700259,203914,DEN,HOU,Gary Harris,146,29.9333333333333,30,-0.0666666666666664,53,83,-30,-30,0
21700259,203999,DEN,HOU,Nikola Jokic,125,25.7333333333333,26,-0.266666666666666,55,68,-13,-12,-1
21700259,1626144,DEN,HOU,Emmanuel Mudiay,124,25.2333333333333,25,0.233333333333334,53,70,-17,-17,0
21700259,1626168,DEN,HOU,Trey Lyles,119,23.6166666666667,24,-0.383333333333333,50,70,-20,-20,0
21700259,1627736,DEN,HOU,Malik Beasley,42,8.2,8,0.199999999999999,28,11,17,17,0
21700259,1627750,DEN,HOU,Jamal Murray,120,23.8833333333333,24,-0.116666666666667,46,58,-12,-12,0
21700259,1627823,DEN,HOU,Juancho Hernangomez,89,18,18,0,42,42,0,0,0
21700259,2403,HOU,DEN,Nene,101,19.5,19,0.5,68,37,31,32,-1
21700259,2772,HOU,DEN,Trevor Ariza,172,34.7833333333333,35,-0.216666666666669,99,62,37,34,3
21700259,101108,HOU,DEN,Chris Paul,126,27.1833333333333,28,-0.816666666666666,67,42,25,26,-1
21700259,200782,HOU,DEN,PJ Tucker,167,35.35,35,0.350000000000001,99,59,40,39,1
21700259,201601,HOU,DEN,Luc Mbah a Moute,130,25.7666666666667,26,-0.233333333333334,93,39,54,57,-3
21700259,201628,HOU,DEN,Bobby Brown,42,8.2,8,0.199999999999999,11,28,-17,-17,0
21700259,201935,HOU,DEN,James Harden,157,31.65,32,-0.350000000000001,86,57,29,29,0
21700259,203991,HOU,DEN,Clint Capela,76,16.5,17,-0.5,33,30,3,2,1
21700259,204028,HOU,DEN,Tarik Black,58,11.9333333333333,12,-0.0666666666666664,24,28,-4,-4,0
21700259,1627362,HOU,DEN,Briante Weber,42,8.2,8,0.199999999999999,11,28,-17,-17,0
21700259,1627753,HOU,DEN,Zhou Qi,62,12.4,12,0.4,23,37,-14,-14,0
21700259,1627786,HOU,DEN,Troy Williams,42,8.2,8,0.199999999999999,11,28,-17,-17,0
21700260,1717,DAL,MEM,Dirk Nowitzki,123,28.5166666666667,28,0.516666666666666,61,54,7,9,-2
21700260,2734,DAL,MEM,Devin Harris,89,18,18,0,42,31,11,10,1
21700260,200826,DAL,MEM,J.J. Barea,119,23.8666666666667,24,-0.133333333333333,51,43,8,7,1
21700260,202083,DAL,MEM,Wesley Matthews,162,35.85,36,-0.149999999999999,72,78,-6,-3,-3
21700260,203084,DAL,MEM,Harrison Barnes,156,34.5333333333333,35,-0.466666666666669,73,76,-3,-1,-2
21700260,203457,DAL,MEM,Nerlens Noel,17,4.06666666666667,4,0.0666666666666664,3,11,-8,-8,0
21700260,203939,DAL,MEM,Dwight Powell,90,18.85,19,-0.149999999999999,35,25,10,10,0
21700260,1626257,DAL,MEM,Salah Mejri,46,10.0333333333333,10,0.0333333333333332,16,22,-6,-8,2
21700260,1627812,DAL,MEM,Yogi Ferrell,95,21.6333333333333,21,0.633333333333333,24,45,-21,-19,-2
21700260,1628372,DAL,MEM,Dennis Smith Jr.,113,27.05,27,0.0500000000000007,49,57,-8,-6,-2
21700260,1628467,DAL,MEM,Maxi Kleber,48,12.6666666666667,13,-0.333333333333334,29,24,5,5,0
21700260,1628499,DAL,MEM,Antonius Cleveland,22,4.93333333333333,5,-0.0666666666666664,15,4,11,9,2
21700260,201188,MEM,DAL,Marc Gasol,144,33.6,34,-0.399999999999999,59,71,-12,-10,-2
21700260,201596,MEM,DAL,Mario Chalmers,150,34.1,34,0.0999999999999943,73,61,12,12,0
21700260,201936,MEM,DAL,Tyreke Evans,144,30.3333333333333,30,0.333333333333336,66,63,3,2,1
21700260,202718,MEM,DAL,Chandler Parsons,103,23.7833333333333,24,-0.216666666666669,54,45,9,9,0
21700260,203210,MEM,DAL,JaMychal Green,119,28.3833333333333,28,0.383333333333333,52,61,-9,-9,0
21700260,203463,MEM,DAL,Ben McLemore,60,12.7833333333333,13,-0.216666666666667,16,24,-8,-9,1
21700260,203516,MEM,DAL,James Ennis III,62,13.1,13,0.0999999999999996,16,28,-12,-13,1
21700260,1626185,MEM,DAL,Jarell Martin,83,16.8333333333333,17,-0.166666666666668,34,30,4,3,1
21700260,1627738,MEM,DAL,Deyonta Davis,76,15,15,0,39,26,13,10,3
21700260,1628415,MEM,DAL,Dillon Brooks,139,32.0833333333333,32,0.0833333333333286,61,61,0,0,0
21700261,2037,MIN,ORL,Jamal Crawford,62,11.6666666666667,12,-0.333333333333332,24,27,-3,-8,5
21700261,201952,MIN,ORL,Jeff Teague,180,37.1,37,0.100000000000001,103,94,9,12,-3
21700261,201959,MIN,ORL,Taj Gibson,199,40.2666666666667,40,0.266666666666666,117,96,21,21,0
21700261,202357,MIN,ORL,Nemanja Bjelica,37,7.71666666666667,8,-0.283333333333333,6,21,-15,-16,1
21700261,202710,MIN,ORL,Jimmy Butler,176,36.35,36,0.350000000000001,101,90,11,15,-4
21700261,203476,MIN,ORL,Gorgui Dieng,61,12.1666666666667,12,0.166666666666666,26,25,1,-1,2
21700261,203498,MIN,ORL,Shabazz Muhammad,35,7.31666666666667,7,0.316666666666666,7,20,-13,-13,0
21700261,203952,MIN,ORL,Andrew Wiggins,202,40.6833333333333,41,-0.316666666666663,117,97,20,19,1
21700261,1626145,MIN,ORL,Tyus Jones,57,10.9,11,-0.100000000000001,21,23,-2,-6,4
21700261,1626157,MIN,ORL,Karl-Anthony Towns,176,35.8333333333333,36,-0.166666666666671,98,92,6,7,-1
21700261,201167,ORL,MIN,Arron Afflalo,52,10.85,11,-0.15,23,29,-6,-7,1
21700261,201571,ORL,MIN,D.J. Augustin,68,12.9166666666667,13,-0.0833333333333322,33,36,-3,-5,2
21700261,201578,ORL,MIN,Marreese Speights,57,11.6333333333333,11,0.633333333333333,23,31,-8,-9,1
21700261,202687,ORL,MIN,Bismack Biyombo,74,14.6,14,0.6,29,35,-6,-6,0
21700261,202696,ORL,MIN,Nikola Vucevic,161,32.95,34,-1.05,88,88,0,0,0
21700261,203082,ORL,MIN,Terrence Ross,169,33.9833333333333,34,-0.0166666666666657,88,86,2,3,-1
21700261,203095,ORL,MIN,Evan Fournier,169,34.0666666666667,34,0.0666666666666629,90,91,-1,3,-4
21700261,203613,ORL,MIN,Jonathon Simmons,89,18.1,18,0.100000000000001,38,45,-7,-11,4
21700261,203901,ORL,MIN,Elfrid Payton,164,34.0833333333333,34,0.0833333333333286,79,85,-6,-1,-5
21700261,203932,ORL,MIN,Aaron Gordon,182,36.8166666666667,37,-0.183333333333337,94,94,0,3,-3
21700262,2749,NOP,SAS,Jameer Nelson,91,19.5833333333333,20,-0.416666666666668,50,37,13,15,-2
21700262,2754,NOP,SAS,Tony Allen,62,13.7,13,0.699999999999999,26,29,-3,-3,0
21700262,200765,NOP,SAS,Rajon Rondo,105,22.3833333333333,23,-0.616666666666667,47,36,11,11,0
21700262,201950,NOP,SAS,Jrue Holiday,138,28.9666666666667,30,-1.03333333333333,75,44,31,31,0
21700262,201967,NOP,SAS,Dante Cunningham,105,23.1833333333333,23,0.18333333333333,54,51,3,3,0
21700262,202326,NOP,SAS,DeMarcus Cousins,146,30.9666666666667,32,-1.03333333333333,62,53,9,5,4
21700262,202734,NOP,SAS,E'Twaun Moore,118,25.4166666666667,26,-0.583333333333336,50,51,-1,-1,0
21700262,203076,NOP,SAS,Anthony Davis,169,35.4333333333333,35,0.433333333333337,88,57,31,33,-2
21700262,203121,NOP,SAS,Darius Miller,131,28.6,28,0.600000000000001,67,58,9,11,-2
21700262,203546,NOP,SAS,Ian Clark,27,5.9,6,-0.0999999999999996,10,17,-7,-9,2
21700262,1627767,NOP,SAS,Cheick Diallo,23,5.2,5,0.199999999999999,6,17,-11,-11,0
21700262,1938,SAS,NOP,Manu Ginobili,59,12.4333333333333,12,0.433333333333334,21,36,-15,-15,0
21700262,2200,SAS,NOP,Pau Gasol,116,25.2833333333333,25,0.283333333333331,47,52,-5,-5,0
21700262,200746,SAS,NOP,LaMarcus Aldridge,123,26.6833333333333,27,-0.316666666666666,48,52,-4,-8,4
21700262,200752,SAS,NOP,Rudy Gay,123,25.7,26,-0.300000000000001,50,68,-18,-14,-4
21700262,201980,SAS,NOP,Danny Green,81,18.0166666666667,18,0.0166666666666657,32,28,4,6,-2
21700262,201988,SAS,NOP,Patty Mills,108,23.6,24,-0.399999999999999,40,45,-5,-5,0
21700262,202722,SAS,NOP,Davis Bertans,62,13.15,13,0.149999999999999,29,29,0,4,-4
21700262,203464,SAS,NOP,Brandon Paul,56,12.5166666666667,12,0.516666666666666,33,20,13,11,2
21700262,203530,SAS,NOP,Joffrey Lauvergne,72,14.5833333333333,15,-0.416666666666666,21,46,-25,-25,0
21700262,203937,SAS,NOP,Kyle Anderson,117,25.6833333333333,26,-0.316666666666666,42,54,-12,-14,2
21700262,1627749,SAS,NOP,Dejounte Murray,115,24.2666666666667,24,0.266666666666666,50,62,-12,-12,0
21700262,1627854,SAS,NOP,Bryn Forbes,83,17.4166666666667,17,0.416666666666664,37,43,-6,-8,2
21700263,2561,GSW,OKC,David West,51,11.8666666666667,12,-0.133333333333333,18,17,1,0,1
21700263,2585,GSW,OKC,Zaza Pachulia,66,11.9833333333333,12,-0.0166666666666675,21,23,-2,-2,0
21700263,2733,GSW,OKC,Shaun Livingston,50,12.2333333333333,12,0.233333333333333,24,27,-3,-3,0
21700263,2738,GSW,OKC,Andre Iguodala,110,23.0333333333333,23,0.0333333333333314,48,68,-20,-21,1
21700263,201142,GSW,OKC,Kevin Durant,161,32.2666666666667,33,-0.733333333333334,64,83,-19,-17,-2
21700263,201156,GSW,OKC,Nick Young,77,16.6333333333333,16,0.633333333333333,30,26,4,0,4
21700263,201580,GSW,OKC,JaVale McGee,32,7.16666666666667,7,0.166666666666666,13,14,-1,0,-1
21700263,201939,GSW,OKC,Stephen Curry,162,30.7833333333333,31,-0.216666666666669,64,81,-17,-17,0
21700263,201956,GSW,OKC,Omri Casspi,61,14.15,14,0.15,22,16,6,5,1
21700263,202691,GSW,OKC,Klay Thompson,144,28.15,28,0.149999999999999,53,76,-23,-20,-3
21700263,203110,GSW,OKC,Draymond Green,161,31.2833333333333,31,0.283333333333331,64,76,-12,-13,1
21700263,1626172,GSW,OKC,Kevon Looney,60,12.2,12,0.199999999999999,23,24,-1,-3,2
21700263,1627775,GSW,OKC,Patrick McCaw,35,8.16666666666667,8,0.166666666666666,11,4,7,6,1
21700263,2546,OKC,GSW,Carmelo Anthony,180,35.6833333333333,36,-0.31666666666667,84,70,14,16,-2
21700263,101109,OKC,GSW,Raymond Felton,49,11.5166666666667,11,0.516666666666666,19,23,-4,-4,0
21700263,201566,OKC,GSW,Russell Westbrook,189,36.7666666666667,37,-0.233333333333334,88,72,16,17,-1
21700263,202331,OKC,GSW,Paul George,196,39.4666666666667,40,-0.533333333333331,81,76,5,8,-3
21700263,202335,OKC,GSW,Patrick Patterson,26,6.23333333333333,6,0.233333333333333,13,10,3,1,2
21700263,203460,OKC,GSW,Andre Roberson,161,32.0833333333333,32,0.0833333333333286,74,59,15,14,1
21700263,203500,OKC,GSW,Steven Adams,181,36.8333333333333,37,-0.166666666666671,79,71,8,8,0
21700263,203518,OKC,GSW,Alex Abrines,33,6.16666666666667,6,0.166666666666666,20,15,5,6,-1
21700263,203924,OKC,GSW,Jerami Grant,71,14.2166666666667,14,0.216666666666667,38,31,7,9,-2
21700263,203962,OKC,GSW,Josh Huestis,74,17.95,18,-0.0500000000000007,39,28,11,10,1
21700263,1626177,OKC,GSW,Dakari Johnson,5,1.5,2,-0.5,0,0,0,0,0
21700263,1628390,OKC,GSW,Terrance Ferguson,5,1.5,2,-0.5,0,0,0,0,0
21700264,202339,MIL,PHX,Eric Bledsoe,232,45.05,45,0.0499999999999972,95,86,9,10,-1
21700264,202732,MIL,PHX,DeAndre Liggins,211,41.6166666666667,41,0.61666666666666,84,84,0,-1,1
21700264,203114,MIL,PHX,Khris Middleton,235,46.6833333333333,46,0.683333333333337,106,100,6,8,-2
21700264,203503,MIL,PHX,Tony Snell,108,21.9,22,-0.100000000000001,44,44,0,-1,1
21700264,1627748,MIL,PHX,Thon Maker,169,32.7833333333333,33,-0.216666666666669,76,68,8,4,4
21700264,1627762,MIL,PHX,Joel Bolomboy,102,20.1833333333333,20,0.18333333333333,37,39,-2,0,-2
21700264,1627763,MIL,PHX,Malcolm Brogdon,212,41.2666666666667,41,0.266666666666666,91,87,4,5,-1
21700264,1627780,MIL,PHX,Gary Payton II,50,9.06666666666667,9,0.0666666666666664,25,20,5,5,0
21700264,1628391,MIL,PHX,D.J. Wilson,6,1.26666666666667,1,0.266666666666667,0,0,0,0,0
21700264,1628425,MIL,PHX,Sterling Brown,30,5.01666666666667,5,0.0166666666666666,7,7,0,-2,2
21700264,2199,PHX,MIL,Tyson Chandler,113,21.2,21,0.200000000000003,54,50,4,6,-2
21700264,202328,PHX,MIL,Greg Monroe,158,31.7666666666667,32,-0.233333333333334,53,63,-10,-12,2
21700264,203584,PHX,MIL,Troy Daniels,69,13.4166666666667,13,0.416666666666668,27,23,4,3,1
21700264,203933,PHX,MIL,T.J. Warren,224,42.9333333333333,43,-0.06666666666667,82,92,-10,-14,4
21700264,1626164,PHX,MIL,Devin Booker,206,39.4666666666667,40,-0.533333333333331,83,92,-9,-9,0
21700264,1627733,PHX,MIL,Dragan Bender,168,33.7833333333333,34,-0.216666666666669,63,67,-4,0,-4
21700264,1627737,PHX,MIL,Marquese Chriss,67,12.45,12,0.449999999999999,26,30,-4,-4,0
21700264,1627755,PHX,MIL,Tyler Ulis,164,32.3333333333333,32,0.333333333333336,73,65,8,6,2
21700264,1628367,PHX,MIL,Josh Jackson,86,17.3333333333333,17,0.333333333333336,40,41,-1,0,-1
21700264,1628455,PHX,MIL,Mike James,100,20.15,21,-0.850000000000001,34,42,-8,-6,-2
21700265,201577,CHI,UTA,Robin Lopez,110,24.5666666666667,25,-0.433333333333334,47,62,-15,-19,4
21700265,202347,CHI,UTA,Quincy Pondexter,41,9.76666666666667,10,-0.233333333333334,13,19,-6,-8,2
21700265,203200,CHI,UTA,Justin Holiday,139,30.55,30,0.550000000000001,57,74,-17,-19,2
21700265,1626170,CHI,UTA,Jerian Grant,98,23.4333333333333,24,-0.566666666666666,43,54,-11,-9,-2
21700265,1626171,CHI,UTA,Bobby Portis,105,24.45,25,-0.550000000000001,45,54,-9,-7,-2
21700265,1626245,CHI,UTA,Cristiano Felicio,52,12.7833333333333,12,0.783333333333333,16,26,-10,-8,-2
21700265,1627739,CHI,UTA,Kris Dunn,128,27.6333333333333,28,-0.366666666666667,43,66,-23,-23,0
21700265,1627756,CHI,UTA,Denzel Valentine,105,22.3333333333333,22,0.333333333333332,39,53,-14,-16,2
21700265,1627770,CHI,UTA,Kay Felder,24,5.95,6,-0.0500000000000007,6,12,-6,-6,0
21700265,1627835,CHI,UTA,Paul Zipser,45,10.4666666666667,10,0.466666666666667,12,26,-14,-12,-2
21700265,1628374,CHI,UTA,Lauri Markkanen,110,23.4666666666667,24,-0.533333333333335,40,52,-12,-14,2
21700265,1628469,CHI,UTA,Antonio Blakeney,98,23.9333333333333,24,-0.0666666666666664,39,52,-13,-9,-4
21700265,200757,UTA,CHI,Thabo Sefolosha,87,22.0166666666667,22,0.0166666666666657,45,39,6,8,-2
21700265,201937,UTA,CHI,Ricky Rubio,100,23.05,24,-0.950000000000003,54,35,19,17,2
21700265,201973,UTA,CHI,Jonas Jerebko,104,21.9166666666667,22,-0.0833333333333357,53,35,18,16,2
21700265,202324,UTA,CHI,Derrick Favors,135,29.2333333333333,29,0.233333333333334,70,45,25,27,-2
21700265,202327,UTA,CHI,Ekpe Udoh,64,16.1333333333333,17,-0.866666666666667,35,33,2,0,2
21700265,202692,UTA,CHI,Alec Burks,101,25.2,25,0.200000000000003,52,40,12,12,0
21700265,203526,UTA,CHI,Raul Neto,86,19.0666666666667,19,0.06666666666667,43,33,10,10,0
21700265,203918,UTA,CHI,Rodney Hood,108,25.1333333333333,25,0.133333333333333,57,46,11,10,1
21700265,204060,UTA,CHI,Joe Ingles,121,25.8166666666667,26,-0.183333333333334,65,42,23,24,-1
21700265,1626220,UTA,CHI,Royce O'Neale,14,3.41666666666667,4,-0.583333333333334,7,2,5,5,0
21700265,1628378,UTA,CHI,Donovan Mitchell,123,25.85,26,-0.149999999999999,64,48,16,18,-2
21700265,1628396,UTA,CHI,Tony Bradley,12,2.5,2,0.5,5,2,3,3,0
21700266,101106,LAL,SAC,Andrew Bogut,27,5.66666666666667,6,-0.333333333333334,11,9,2,2,0
21700266,201147,LAL,SAC,Corey Brewer,37,8.1,8,0.0999999999999996,16,14,2,2,0
21700266,201572,LAL,SAC,Brook Lopez,75,17.3833333333333,17,0.383333333333333,28,46,-18,-19,1
21700266,203484,LAL,SAC,Kentavious Caldwell-Pope,157,35.2833333333333,35,0.283333333333331,76,78,-2,-3,1
21700266,203898,LAL,SAC,Tyler Ennis,5,1.1,1,0.1,7,3,4,2,2
21700266,203903,LAL,SAC,Jordan Clarkson,121,26.0666666666667,26,0.0666666666666664,60,76,-16,-14,-2
21700266,203944,LAL,SAC,Julius Randle,135,29.3666666666667,29,0.366666666666667,67,64,3,6,-3
21700266,1627742,LAL,SAC,Brandon Ingram,142,32.6333333333333,33,-0.366666666666667,58,74,-16,-16,0
21700266,1627826,LAL,SAC,Ivica Zubac,5,1.1,1,0.1,7,3,4,2,2
21700266,1628366,LAL,SAC,Lonzo Ball,169,36.95,37,-0.0499999999999972,75,79,-4,-1,-3
21700266,1628398,LAL,SAC,Kyle Kuzma,159,35.3666666666667,36,-0.633333333333333,76,91,-15,-15,0
21700266,1628404,LAL,SAC,Josh Hart,43,10.2333333333333,10,0.233333333333334,29,28,1,-1,2
21700266,1713,SAC,LAL,Vince Carter,42,9.46666666666667,9,0.466666666666667,26,23,3,1,2
21700266,2216,SAC,LAL,Zach Randolph,131,30.1,30,0.100000000000001,66,58,8,9,-1
21700266,201585,SAC,LAL,Kosta Koufos,39,7.81666666666667,8,-0.183333333333334,18,14,4,3,1
21700266,201588,SAC,LAL,George Hill,94,22.1166666666667,22,0.116666666666667,39,36,3,3,0
21700266,202066,SAC,LAL,Garrett Temple,129,29.6666666666667,30,-0.333333333333332,57,56,1,-2,3
21700266,203992,SAC,LAL,Bogdan Bogdanovic,125,26.7666666666667,27,-0.233333333333334,76,63,13,11,2
21700266,1626161,SAC,LAL,Willie Cauley-Stein,130,27.9833333333333,28,-0.0166666666666657,79,67,12,12,0
21700266,1627741,SAC,LAL,Buddy Hield,72,14.95,15,-0.0500000000000007,48,35,13,14,-1
21700266,1627746,SAC,LAL,Skal Labissiere,83,19.2333333333333,19,0.233333333333334,34,35,-1,-1,0
21700266,1627781,SAC,LAL,Malachi Richardson,5,1.1,1,0.1,3,7,-4,-2,-2
21700266,1628368,SAC,LAL,De'Aaron Fox,101,23.0333333333333,23,0.0333333333333314,44,49,-5,-8,3
21700266,1628382,SAC,LAL,Justin Jackson,5,1.1,1,0.1,3,7,-4,-2,-2
21700266,1628412,SAC,LAL,Frank Mason,119,25.9166666666667,26,-0.0833333333333357,72,60,12,17,-5
21700267,201960,BKN,POR,DeMarre Carroll,121,24.4166666666667,25,-0.583333333333336,66,66,0,3,-3
21700267,202344,BKN,POR,Trevor Booker,103,19.7833333333333,20,-0.216666666666669,51,49,2,0,2
21700267,203092,BKN,POR,Tyler Zeller,92,19.4166666666667,19,0.416666666666664,60,50,10,12,-2
21700267,203459,BKN,POR,Allen Crabbe,153,30.9666666666667,31,-0.0333333333333314,81,82,-1,-1,0
21700267,203915,BKN,POR,Spencer Dinwiddie,151,30.7,31,-0.300000000000004,78,83,-5,-5,0
21700267,203925,BKN,POR,Joe Harris,107,19.9833333333333,20,-0.0166666666666657,49,55,-6,-3,-3
21700267,203930,BKN,POR,Sean Kilpatrick,75,13.9166666666667,14,-0.0833333333333339,37,40,-3,-5,2
21700267,1626178,BKN,POR,Rondae Hollis-Jefferson,142,29.8666666666667,30,-0.133333333333333,76,78,-2,-3,1
21700267,1627747,BKN,POR,Caris LeVert,142,26.8166666666667,27,-0.183333333333334,68,70,-2,-5,3
21700267,1628386,BKN,POR,Jarrett Allen,129,23.9666666666667,24,-0.033333333333335,59,62,-3,-3,0
21700267,202323,POR,BKN,Evan Turner,147,27.1666666666667,27,0.166666666666664,70,66,4,1,3
21700267,202334,POR,BKN,Ed Davis,90,16.8333333333333,17,-0.166666666666664,46,44,2,0,2
21700267,203081,POR,BKN,Damian Lillard,182,36.9333333333333,37,-0.0666666666666629,100,99,1,3,-2
21700267,203090,POR,BKN,Maurice Harkless,99,18.7833333333333,19,-0.216666666666669,48,53,-5,-5,0
21700267,203468,POR,BKN,CJ McCollum,200,39.2833333333333,39,0.283333333333331,104,100,4,5,-1
21700267,203894,POR,BKN,Shabazz Napier,111,20.5,20,0.5,55,46,9,10,-1
21700267,203943,POR,BKN,Noah Vonleh,115,24.7,25,-0.300000000000001,65,65,0,-1,1
21700267,203994,POR,BKN,Jusuf Nurkic,152,31.0666666666667,31,0.0666666666666629,80,81,-1,1,-2
21700267,1626192,POR,BKN,Pat Connaughton,70,14.9166666666667,15,-0.0833333333333322,42,46,-4,-3,-1
21700267,1627774,POR,BKN,Jake Layman,49,9.65,9,0.649999999999999,25,25,0,-1,1
21700268,101141,ATL,NYK,Ersan Ilyasova,122,25.5833333333333,25,0.583333333333336,53,56,-3,-3,0
21700268,201158,ATL,NYK,Marco Belinelli,124,27.4333333333333,28,-0.566666666666666,69,56,13,13,0
21700268,203145,ATL,NYK,Kent Bazemore,145,30.1,31,-0.899999999999999,77,65,12,12,0
21700268,203471,ATL,NYK,Dennis Schroder,170,34.1166666666667,35,-0.88333333333334,91,86,5,5,0
21700268,203473,ATL,NYK,Dewayne Dedmon,120,24.7666666666667,25,-0.233333333333334,66,56,10,8,2
21700268,203705,ATL,NYK,Josh Magette,56,13.4833333333333,13,0.483333333333334,25,18,7,7,0
21700268,1627752,ATL,NYK,Taurean Prince,157,31.0166666666667,31,0.0166666666666657,89,80,9,9,0
21700268,1627761,ATL,NYK,DeAndre' Bembry,68,16.0333333333333,16,0.0333333333333314,29,25,4,4,0
21700268,1628381,ATL,NYK,John Collins,117,23.65,24,-0.350000000000001,54,56,-2,0,-2
21700268,1628463,ATL,NYK,Tyler Cavanaugh,51,11.8166666666667,12,-0.183333333333334,27,22,5,5,0
21700268,101127,NYK,ATL,Jarrett Jack,162,32.35,33,-0.649999999999999,81,86,-5,-5,0
21700268,201584,NYK,ATL,Courtney Lee,180,37.0833333333333,38,-0.916666666666671,88,90,-2,-2,0
21700268,202498,NYK,ATL,Lance Thomas,49,11.75,12,-0.25,16,27,-11,-11,0
21700268,203124,NYK,ATL,Kyle O'Quinn,116,23.0333333333333,23,0.0333333333333314,63,61,2,3,-1
21700268,203501,NYK,ATL,Tim Hardaway Jr.,175,36.85,38,-1.15,83,97,-14,-15,1
21700268,203926,NYK,ATL,Doug McDermott,125,27.4666666666667,27,0.466666666666669,50,63,-13,-12,-1
21700268,204001,NYK,ATL,Kristaps Porzingis,177,35.85,36,-0.149999999999999,88,89,-1,-1,0
21700268,1626195,NYK,ATL,Willy Hernangomez,82,18.3666666666667,19,-0.633333333333333,28,37,-9,-10,1
21700268,1628373,NYK,ATL,Frank Ntilikina,64,15.25,15,0.25,23,30,-7,-7,0
21700269,201143,BOS,ORL,Al Horford,126,25.9666666666667,26,-0.0333333333333314,75,57,18,19,-1
21700269,202681,BOS,ORL,Kyrie Irving,120,24.8666666666667,25,-0.133333333333333,71,54,17,18,-1
21700269,202694,BOS,ORL,Marcus Morris,120,25.6,26,-0.399999999999999,66,53,13,11,2
21700269,203382,BOS,ORL,Aron Baynes,102,21.8666666666667,22,-0.133333333333333,42,46,-4,-4,0
21700269,203935,BOS,ORL,Marcus Smart,117,24.6833333333333,24,0.68333333333333,55,49,6,5,1
21700269,1626179,BOS,ORL,Terry Rozier,142,29.7666666666667,30,-0.233333333333334,69,62,7,5,2
21700269,1627759,BOS,ORL,Jaylen Brown,136,27.5333333333333,28,-0.466666666666669,78,59,19,20,-1
21700269,1627824,BOS,ORL,Guerschon Yabusele,29,7.01666666666667,7,0.0166666666666666,12,26,-14,-14,0
21700269,1627846,BOS,ORL,Abdel Nader,13,2.98333333333333,3,-0.0166666666666666,8,9,-1,-1,0
21700269,1628369,BOS,ORL,Jayson Tatum,106,21.8,22,-0.200000000000003,51,42,9,13,-4
21700269,1628400,BOS,ORL,Semi Ojeleye,129,27.0833333333333,27,0.0833333333333322,58,58,0,3,-3
21700269,201167,ORL,BOS,Arron Afflalo,88,19.3,20,-0.699999999999999,44,35,9,12,-3
21700269,201571,ORL,BOS,D.J. Augustin,65,12.5666666666667,13,-0.433333333333334,18,30,-12,-15,3
21700269,201578,ORL,BOS,Marreese Speights,96,21.1833333333333,22,-0.816666666666666,45,36,9,9,0
21700269,202687,ORL,BOS,Bismack Biyombo,131,27.4166666666667,27,0.416666666666664,59,58,1,-4,5
21700269,202696,ORL,BOS,Nikola Vucevic,97,20.4166666666667,21,-0.583333333333336,44,59,-15,-11,-4
21700269,202714,ORL,BOS,Shelvin Mack,65,15.2833333333333,15,0.283333333333333,40,26,14,18,-4
21700269,203082,ORL,BOS,Terrence Ross,95,19.3333333333333,19,0.333333333333332,43,56,-13,-12,-1
21700269,203095,ORL,BOS,Evan Fournier,93,18.5333333333333,19,-0.466666666666669,39,58,-19,-23,4
21700269,203613,ORL,BOS,Jonathon Simmons,118,24.0166666666667,24,0.0166666666666657,42,62,-20,-23,3
21700269,203901,ORL,BOS,Elfrid Payton,113,23.4,23,0.399999999999999,51,68,-17,-15,-2
21700269,203932,ORL,BOS,Aaron Gordon,129,25.85,26,-0.149999999999999,56,78,-22,-26,4
21700269,1626209,ORL,BOS,Mario Hezonja,50,11.8666666666667,12,-0.133333333333333,34,19,15,15,0
21700270,2544,CLE,CHA,LeBron James,182,39.7166666666667,40,-0.283333333333331,80,83,-3,-2,-1
21700270,2548,CLE,CHA,Dwyane Wade,121,24.9666666666667,25,-0.0333333333333314,54,37,17,14,3
21700270,2594,CLE,CHA,Kyle Korver,124,25.3666666666667,25,0.366666666666667,51,41,10,12,-2
21700270,2747,CLE,CHA,JR Smith,163,35.6666666666667,36,-0.333333333333329,80,79,1,4,-3
21700270,101112,CLE,CHA,Channing Frye,93,19.4166666666667,19,0.416666666666664,44,31,13,12,1
21700270,101181,CLE,CHA,Jose Calderon,85,19.75,20,-0.25,41,55,-14,-13,-1
21700270,201145,CLE,CHA,Jeff Green,78,16.1833333333333,16,0.183333333333334,36,30,6,4,2
21700270,201567,CLE,CHA,Kevin Love,136,30.6666666666667,31,-0.333333333333332,57,70,-13,-11,-2
21700270,203109,CLE,CHA,Jae Crowder,121,27.6333333333333,28,-0.366666666666667,52,69,-17,-15,-2
21700270,1626224,CLE,CHA,Cedi Osman,2,0.633333333333333,0,0.633333333333333,,0,,0,
21700270,2730,CHA,CLE,Dwight Howard,139,30.3166666666667,30,0.316666666666666,66,60,6,4,2
21700270,101107,CHA,CLE,Marvin Williams,130,28.8333333333333,29,-0.166666666666668,64,55,9,6,3
21700270,202689,CHA,CLE,Kemba Walker,171,37.7333333333333,38,-0.266666666666666,77,76,1,-3,4
21700270,203077,CHA,CLE,Michael Kidd-Gilchrist,165,36.4166666666667,37,-0.583333333333336,79,73,6,5,1
21700270,203087,CHA,CLE,Jeremy Lamb,165,35.5833333333333,35,0.583333333333329,74,72,2,-2,4
21700270,203469,CHA,CLE,Cody Zeller,109,23.0666666666667,24,-0.933333333333334,46,48,-2,-2,0
21700270,203487,CHA,CLE,Michael Carter-Williams,94,19.6666666666667,20,-0.333333333333336,36,44,-8,-4,-4
21700270,1626163,CHA,CLE,Frank Kaminsky,70,14.9,14,0.9,24,35,-11,-8,-3
21700270,1628370,CHA,CLE,Malik Monk,17,3.76666666666667,3,0.766666666666667,9,13,-4,-2,-2
21700270,1628407,CHA,CLE,Dwayne Bacon,45,9.71666666666667,10,-0.283333333333335,20,19,1,1,0
21700271,201152,IND,TOR,Thaddeus Young,166,36.3,36,0.299999999999997,88,75,13,13,0
21700271,201954,IND,TOR,Darren Collison,171,36.6833333333333,37,-0.31666666666667,84,76,8,8,0
21700271,202362,IND,TOR,Lance Stephenson,107,22.5333333333333,22,0.533333333333331,41,51,-10,-11,1
21700271,202709,IND,TOR,Cory Joseph,104,21.8833333333333,22,-0.116666666666667,38,52,-14,-14,0
21700271,202711,IND,TOR,Bojan Bogdanovic,185,38.8166666666667,39,-0.183333333333337,93,84,9,9,0
21700271,203506,IND,TOR,Victor Oladipo,137,28.95,29,-0.0499999999999972,76,61,15,16,-1
21700271,1626167,IND,TOR,Myles Turner,96,20.55,21,-0.449999999999999,56,34,22,18,4
21700271,1627734,IND,TOR,Domantas Sabonis,129,27.1166666666667,26,1.11666666666667,51,68,-17,-13,-4
21700271,1628388,IND,TOR,TJ Leaf,35,7,7,0,8,19,-11,-11,0
21700271,200768,TOR,IND,Kyle Lowry,183,39.6666666666667,40,-0.333333333333329,87,90,-3,-5,2
21700271,201586,TOR,IND,Serge Ibaka,123,26.4833333333333,27,-0.516666666666666,60,67,-7,-9,2
21700271,201942,TOR,IND,DeMar DeRozan,188,39.15,39,0.150000000000006,87,93,-6,-6,0
21700271,202685,TOR,IND,Jonas Valanciunas,70,13.8666666666667,14,-0.133333333333333,22,44,-22,-20,-2
21700271,203485,TOR,IND,Lorenzo Brown,10,1.95,2,-0.05,0,5,-5,-5,0
21700271,203512,TOR,IND,Lucas Nogueira,8,1.98333333333333,2,-0.0166666666666668,5,4,1,1,0
21700271,1626181,TOR,IND,Norman Powell,132,27.1,27,0.100000000000001,60,45,15,16,-1
21700271,1627751,TOR,IND,Jakob Poeltl,56,12.1666666666667,12,0.166666666666668,31,15,16,16,0
21700271,1627783,TOR,IND,Pascal Siakam,106,21.7666666666667,22,-0.233333333333334,44,45,-1,-1,0
21700271,1627832,TOR,IND,Fred VanVleet,132,28.4,29,-0.600000000000001,71,55,16,18,-2
21700271,1628384,TOR,IND,OG Anunoby,122,27.3,27,0.300000000000001,53,72,-19,-20,1
21700272,201609,MIA,MIN,Goran Dragic,139,31.5,31,0.5,80,67,13,13,0
21700272,201949,MIA,MIN,James Johnson,130,28.8333333333333,29,-0.166666666666668,61,59,2,3,-1
21700272,201961,MIA,MIN,Wayne Ellington,123,27.0666666666667,27,0.0666666666666664,58,54,4,4,0
21700272,202355,MIA,MIN,Hassan Whiteside,100,23.75,24,-0.25,61,45,16,14,2
21700272,203079,MIA,MIN,Dion Waiters,123,28.0833333333333,28,0.0833333333333357,58,54,4,2,2
21700272,203482,MIA,MIN,Kelly Olynyk,105,22.9333333333333,23,-0.06666666666667,45,49,-4,-3,-1
21700272,204020,MIA,MIN,Tyler Johnson,86,19.5333333333333,20,-0.466666666666669,39,37,2,4,-2
21700272,1626159,MIA,MIN,Justise Winslow,91,21.15,21,0.149999999999999,51,45,6,6,0
21700272,1626196,MIA,MIN,Josh Richardson,158,36.3166666666667,37,-0.683333333333337,92,75,17,17,0
21700272,2037,MIN,MIA,Jamal Crawford,80,17.9833333333333,18,-0.0166666666666657,33,41,-8,-8,0
21700272,201166,MIN,MIA,Aaron Brooks,55,13.5166666666667,13,0.516666666666666,21,35,-14,-15,1
21700272,201959,MIN,MIA,Taj Gibson,163,36.5833333333333,37,-0.416666666666671,75,73,2,2,0
21700272,202710,MIN,MIA,Jimmy Butler,154,34.9833333333333,35,-0.0166666666666657,75,86,-11,-11,0
21700272,203476,MIN,MIA,Gorgui Dieng,69,15.6,16,-0.4,28,29,-1,-1,0
21700272,203498,MIN,MIA,Shabazz Muhammad,48,11.25,11,0.25,22,36,-14,-14,0
21700272,203952,MIN,MIA,Andrew Wiggins,172,38.55,39,-0.450000000000003,79,81,-2,-2,0
21700272,1626145,MIN,MIA,Tyus Jones,147,32.35,33,-0.650000000000006,72,66,6,7,-1
21700272,1626157,MIN,MIA,Karl-Anthony Towns,167,38.35,39,-0.649999999999999,80,98,-18,-18,0
21700273,2546,OKC,DET,Carmelo Anthony,175,36.6833333333333,37,-0.316666666666663,68,72,-4,-6,2
21700273,101109,OKC,DET,Raymond Felton,41,9.36666666666667,9,0.366666666666667,18,19,-1,-1,0
21700273,201566,OKC,DET,Russell Westbrook,185,38.6666666666667,39,-0.333333333333336,80,80,0,0,0
21700273,202331,OKC,DET,Paul George,150,32.2333333333333,32,0.233333333333334,62,72,-10,-11,1
21700273,202335,OKC,DET,Patrick Patterson,26,6.31666666666667,6,0.316666666666666,20,19,1,-1,2
21700273,203460,OKC,DET,Andre Roberson,196,41.6,42,-0.399999999999999,84,75,9,11,-2
21700273,203500,OKC,DET,Steven Adams,180,37.6,38,-0.400000000000006,71,68,3,5,-2
21700273,203518,OKC,DET,Alex Abrines,43,8.88333333333333,9,-0.116666666666667,21,20,1,1,0
21700273,203924,OKC,DET,Jerami Grant,69,15.3333333333333,15,0.333333333333332,37,39,-2,0,-2
21700273,203962,OKC,DET,Josh Huestis,60,13.15,13,0.15,29,31,-2,-3,1
21700273,201229,DET,OKC,Anthony Tolliver,82,18.3333333333333,18,0.333333333333336,47,47,0,-2,2
21700273,202340,DET,OKC,Avery Bradley,149,30.4666666666667,31,-0.533333333333331,55,59,-4,-6,2
21700273,202397,DET,OKC,Ish Smith,97,21.8166666666667,22,-0.183333333333334,53,52,1,1,0
21700273,202699,DET,OKC,Tobias Harris,162,33.6666666666667,34,-0.333333333333329,65,65,0,2,-2
21700273,202704,DET,OKC,Reggie Jackson,128,26.15,26,0.149999999999999,46,46,0,0,0
21700273,203083,DET,OKC,Andre Drummond,178,37.5666666666667,38,-0.433333333333337,71,67,4,2,2
21700273,203961,DET,OKC,Eric Moreland,47,10.4,10,0.4,28,31,-3,-1,-2
21700273,204038,DET,OKC,Langston Galloway,79,16.6166666666667,16,0.616666666666667,36,31,5,5,0
21700273,1626169,DET,OKC,Stanley Johnson,138,29.9833333333333,30,-0.0166666666666657,53,56,-3,-3,0
21700273,1628379,DET,OKC,Luke Kennard,65,14.8333333333333,15,-0.166666666666666,41,36,5,7,-2
21700274,201163,DEN,MEM,Wilson Chandler,104,23.2833333333333,23,0.283333333333331,47,53,-6,-6,0
21700274,202702,DEN,MEM,Kenneth Faried,139,31.0166666666667,31,0.0166666666666657,77,66,11,11,0
21700274,203115,DEN,MEM,Will Barton,79,17.0666666666667,17,0.0666666666666664,33,34,-1,-3,2
21700274,203486,DEN,MEM,Mason Plumlee,58,12.2666666666667,12,0.266666666666666,20,26,-6,-5,-1
21700274,203914,DEN,MEM,Gary Harris,169,37.6166666666667,38,-0.383333333333333,88,69,19,21,-2
21700274,203999,DEN,MEM,Nikola Jokic,157,35.4166666666667,36,-0.583333333333329,84,66,18,17,1
21700274,1626144,DEN,MEM,Emmanuel Mudiay,55,11.3333333333333,11,0.333333333333332,19,25,-6,-6,0
21700274,1626168,DEN,MEM,Trey Lyles,76,16.6666666666667,17,-0.333333333333336,27,26,1,1,0
21700274,1627736,DEN,MEM,Malik Beasley,1,0.0666666666666667,0,0.0666666666666667,0,,,0,
21700274,1627750,DEN,MEM,Jamal Murray,160,36.35,37,-0.649999999999999,85,67,18,18,0
21700274,1627823,DEN,MEM,Juancho Hernangomez,77,17.3333333333333,18,-0.666666666666664,40,28,12,12,0
21700274,201188,MEM,DEN,Marc Gasol,173,37.8833333333333,38,-0.116666666666667,79,80,-1,-1,0
21700274,201596,MEM,DEN,Mario Chalmers,133,29.2,30,-0.800000000000001,54,75,-21,-21,0
21700274,201936,MEM,DEN,Tyreke Evans,131,29.0666666666667,29,0.0666666666666664,59,54,5,5,0
21700274,202718,MEM,DEN,Chandler Parsons,106,24.35,25,-0.649999999999999,51,62,-11,-11,0
21700274,203210,MEM,DEN,JaMychal Green,145,31.6333333333333,32,-0.366666666666667,64,81,-17,-17,0
21700274,203463,MEM,DEN,Ben McLemore,97,22.2,22,0.199999999999999,44,43,1,-2,3
21700274,1626185,MEM,DEN,Jarell Martin,70,16.05,16,0.0500000000000007,28,23,5,5,0
21700274,1627738,MEM,DEN,Deyonta Davis,61,12.9,13,-0.100000000000001,15,29,-14,-12,-2
21700274,1628415,MEM,DEN,Dillon Brooks,159,35.1333333333333,35,0.133333333333333,66,73,-7,-6,-1
21700275,2749,NOP,PHX,Jameer Nelson,123,23.2,23,0.199999999999999,57,38,19,18,1
21700275,2754,NOP,PHX,Tony Allen,58,11,11,0,23,16,7,7,0
21700275,200765,NOP,PHX,Rajon Rondo,119,24.4333333333333,25,-0.56666666666667,58,22,36,6,30
21700275,201600,NOP,PHX,Omer Asik,52,10.3333333333333,11,-0.666666666666668,20,27,-7,-7,0
21700275,201950,NOP,PHX,Jrue Holiday,131,27,27,0,69,23,46,15,31
21700275,201967,NOP,PHX,Dante Cunningham,115,20.8833333333333,21,-0.116666666666667,60,31,29,24,5
21700275,202326,NOP,PHX,DeMarcus Cousins,147,30.0666666666667,30,0.0666666666666664,77,26,51,19,32
21700275,202734,NOP,PHX,E'Twaun Moore,118,24.05,24,0.0500000000000007,57,16,41,11,30
21700275,203076,NOP,PHX,Anthony Davis,126,25.35,26,-0.649999999999999,58,11,47,20,27
21700275,203121,NOP,PHX,Darius Miller,146,27.55,28,-0.450000000000003,70,50,20,19,1
21700275,203546,NOP,PHX,Ian Clark,44,8.63333333333333,9,-0.366666666666667,15,25,-10,-8,-2
21700275,1627767,NOP,PHX,Cheick Diallo,31,5.66666666666667,6,-0.333333333333334,11,15,-4,-4,0
21700275,2199,PHX,NOP,Tyson Chandler,135,27.6166666666667,28,-0.383333333333333,25,71,-46,-14,-32
21700275,201162,PHX,NOP,Jared Dudley,35,6.51666666666667,6,0.516666666666667,11,22,-11,-11,0
21700275,202328,PHX,NOP,Greg Monroe,53,12.1166666666667,12,0.116666666666667,-6,23,-29,0,-29
21700275,203458,PHX,NOP,Alex Len,104,19.3333333333333,19,0.333333333333336,39,48,-9,-6,-3
21700275,203584,PHX,NOP,Troy Daniels,50,9.18333333333333,9,0.183333333333334,12,23,-11,-11,0
21700275,203933,PHX,NOP,T.J. Warren,146,30.35,30,0.350000000000001,31,74,-43,-12,-31
21700275,1626164,PHX,NOP,Devin Booker,161,32.7833333333333,33,-0.216666666666669,33,81,-48,-17,-31
21700275,1627733,PHX,NOP,Dragan Bender,85,16.4166666666667,17,-0.583333333333332,24,38,-14,-13,-1
21700275,1627737,PHX,NOP,Marquese Chriss,72,13.2666666666667,14,-0.733333333333334,27,28,-1,-4,3
21700275,1627755,PHX,NOP,Tyler Ulis,128,25.85,26,-0.149999999999999,18,63,-45,-14,-31
21700275,1627884,PHX,NOP,Derrick Jones Jr.,31,5.66666666666667,6,-0.333333333333334,15,11,4,4,0
21700275,1628367,PHX,NOP,Josh Jackson,125,23.25,24,-0.75,43,51,-8,-8,0
21700275,1628455,PHX,NOP,Mike James,85,15.8166666666667,16,-0.183333333333334,28,42,-14,-14,0
21700276,201577,CHI,GSW,Robin Lopez,128,25.4333333333333,26,-0.566666666666666,46,68,-22,-21,-1
21700276,202347,CHI,GSW,Quincy Pondexter,21,3.5,3,0.5,4,11,-7,-8,1
21700276,203200,CHI,GSW,Justin Holiday,142,28.1666666666667,28,0.166666666666664,47,86,-39,-39,0
21700276,1626170,CHI,GSW,Jerian Grant,143,28.55,28,0.550000000000001,58,87,-29,-27,-2
21700276,1626171,CHI,GSW,Bobby Portis,114,23.7666666666667,24,-0.233333333333334,53,77,-24,-25,1
21700276,1626245,CHI,GSW,Cristiano Felicio,78,16.05,16,0.0500000000000007,39,50,-11,-7,-4
21700276,1627739,CHI,GSW,Kris Dunn,126,24.8833333333333,25,-0.116666666666667,47,79,-32,-34,2
21700276,1627756,CHI,GSW,Denzel Valentine,102,20.55,21,-0.449999999999999,40,51,-11,-11,0
21700276,1627770,CHI,GSW,Kay Felder,30,5.85,6,-0.15,12,19,-7,-7,0
21700276,1627835,CHI,GSW,Paul Zipser,81,16.15,16,0.149999999999999,38,51,-13,-13,0
21700276,1628374,CHI,GSW,Lauri Markkanen,139,27.0166666666667,27,0.0166666666666657,46,80,-34,-37,3
21700276,1628469,CHI,GSW,Antonio Blakeney,96,19.5,20,-0.5,40,56,-16,-16,0
21700276,2561,GSW,CHI,David West,61,12.7,13,-0.300000000000001,37,24,13,15,-2
21700276,2585,GSW,CHI,Zaza Pachulia,98,18.8333333333333,19,-0.166666666666668,62,37,25,23,2
21700276,2733,GSW,CHI,Shaun Livingston,42,7.78333333333333,8,-0.216666666666667,27,11,16,16,0
21700276,2738,GSW,CHI,Andre Iguodala,86,17.5333333333333,17,0.533333333333331,52,27,25,27,-2
21700276,201156,GSW,CHI,Nick Young,97,19.2666666666667,19,0.266666666666666,64,43,21,22,-1
21700276,201580,GSW,CHI,JaVale McGee,66,13.0166666666667,13,0.0166666666666657,34,20,14,15,-1
21700276,201939,GSW,CHI,Stephen Curry,140,26.85,27,-0.149999999999999,87,45,42,39,3
21700276,201956,GSW,CHI,Omri Casspi,123,24.7166666666667,25,-0.283333333333331,64,54,10,9,1
21700276,202691,GSW,CHI,Klay Thompson,129,25.6166666666667,26,-0.383333333333333,72,50,22,19,3
21700276,1626172,GSW,CHI,Kevon Looney,90,18.7666666666667,19,-0.233333333333334,60,40,20,22,-2
21700276,1626188,GSW,CHI,Quinn Cook,65,13.2666666666667,13,0.266666666666666,35,29,6,6,0
21700276,1627775,GSW,CHI,Patrick McCaw,71,14.8666666666667,15,-0.133333333333333,44,35,9,12,-3
21700276,1628395,GSW,CHI,Jordan Bell,132,26.2,26,0.199999999999999,77,55,22,20,2
21700277,1938,SAS,CHA,Manu Ginobili,91,19.4333333333333,20,-0.566666666666666,46,36,10,8,2
21700277,2200,SAS,CHA,Pau Gasol,113,24.25,25,-0.75,43,44,-1,-1,0
21700277,200746,SAS,CHA,LaMarcus Aldridge,152,33.65,33,0.649999999999999,76,56,20,20,0
21700277,200752,SAS,CHA,Rudy Gay,109,23.85,24,-0.149999999999999,58,40,18,18,0
21700277,201980,SAS,CHA,Danny Green,140,30.8666666666667,30,0.866666666666667,61,56,5,9,-4
21700277,201988,SAS,CHA,Patty Mills,103,23.9166666666667,24,-0.0833333333333322,54,38,16,18,-2
21700277,202722,SAS,CHA,Davis Bertans,30,7.2,7,0.2,17,14,3,5,-2
21700277,203464,SAS,CHA,Brandon Paul,15,3.03333333333333,3,0.0333333333333332,10,7,3,3,0
21700277,203530,SAS,CHA,Joffrey Lauvergne,15,3.03333333333333,3,0.0333333333333332,10,7,3,3,0
21700277,203937,SAS,CHA,Kyle Anderson,137,31.2666666666667,31,0.266666666666666,70,50,20,20,0
21700277,1627749,SAS,CHA,Dejounte Murray,115,23.8333333333333,24,-0.166666666666668,52,46,6,2,4
21700277,1627854,SAS,CHA,Bryn Forbes,75,15,16,-1,33,36,-3,-5,2
21700277,2730,CHA,SAS,Dwight Howard,104,22.05,22,0.0499999999999972,31,46,-15,-15,0
21700277,101107,CHA,SAS,Marvin Williams,75,16.9,17,-0.100000000000001,26,33,-7,-7,0
21700277,201587,CHA,SAS,Nicolas Batum,104,22.05,22,0.0499999999999972,31,46,-15,-15,0
21700277,202689,CHA,SAS,Kemba Walker,141,30.7833333333333,31,-0.216666666666669,62,74,-12,-12,0
21700277,203077,CHA,SAS,Michael Kidd-Gilchrist,96,20.9666666666667,21,-0.0333333333333314,31,43,-12,-12,0
21700277,203087,CHA,SAS,Jeremy Lamb,109,24.8666666666667,25,-0.133333333333333,48,57,-9,-9,0
21700277,203469,CHA,SAS,Cody Zeller,99,22.4833333333333,22,0.483333333333334,48,50,-2,-2,0
21700277,203487,CHA,SAS,Michael Carter-Williams,78,17.0833333333333,17,0.0833333333333322,24,32,-8,-8,0
21700277,203948,CHA,SAS,Johnny O'Bryant III,16,3.33333333333333,3,0.333333333333333,7,10,-3,-3,0
21700277,1626163,CHA,SAS,Frank Kaminsky,128,27.6333333333333,27,0.633333333333333,53,63,-10,-10,0
21700277,1626203,CHA,SAS,Treveon Graham,16,3.33333333333333,3,0.333333333333333,7,10,-3,-3,0
21700277,1628370,CHA,SAS,Malik Monk,79,17.0833333333333,17,0.0833333333333322,44,47,-3,-3,0
21700277,1628407,CHA,SAS,Dwayne Bacon,50,10.7666666666667,11,-0.233333333333334,18,19,-1,-1,0
21700278,201167,ORL,PHI,Arron Afflalo,37,7.65,8,-0.35,13,17,-4,-5,1
21700278,201571,ORL,PHI,D.J. Augustin,83,17.6333333333333,17,0.633333333333333,44,55,-11,-9,-2
21700278,201578,ORL,PHI,Marreese Speights,69,13.9833333333333,14,-0.0166666666666657,32,49,-17,-16,-1
21700278,202687,ORL,PHI,Bismack Biyombo,66,13.9166666666667,14,-0.0833333333333322,27,42,-15,-12,-3
21700278,202696,ORL,PHI,Nikola Vucevic,155,32.55,33,-0.450000000000003,84,82,2,-1,3
21700278,202714,ORL,PHI,Shelvin Mack,8,1.4,2,-0.6,2,2,0,0,0
21700278,203082,ORL,PHI,Terrence Ross,137,29.8833333333333,30,-0.116666666666667,71,78,-7,-6,-1
21700278,203095,ORL,PHI,Evan Fournier,157,32.6166666666667,32,0.616666666666667,84,89,-5,-6,1
21700278,203613,ORL,PHI,Jonathon Simmons,117,24.25,24,0.25,52,74,-22,-21,-1
21700278,203901,ORL,PHI,Elfrid Payton,137,28.8666666666667,29,-0.133333333333333,65,73,-8,-10,2
21700278,203932,ORL,PHI,Aaron Gordon,166,35.35,35,0.349999999999994,79,87,-8,-9,1
21700278,1626209,ORL,PHI,Mario Hezonja,8,1.4,2,-0.6,2,2,0,0,0
21700278,101161,PHI,ORL,Amir Johnson,96,18.8333333333333,19,-0.166666666666664,53,52,1,1,0
21700278,200755,PHI,ORL,JJ Redick,154,32.7,33,-0.299999999999997,90,75,15,13,2
21700278,201573,PHI,ORL,Jerryd Bayless,114,23.8333333333333,23,0.833333333333332,71,54,17,19,-2
21700278,203496,PHI,ORL,Robert Covington,134,28.6333333333333,29,-0.366666666666667,77,73,4,3,1
21700278,203954,PHI,ORL,Joel Embiid,128,28.1833333333333,29,-0.81666666666667,73,59,14,14,0
21700278,203967,PHI,ORL,Dario Saric,157,33.2833333333333,34,-0.716666666666669,93,85,8,9,-1
21700278,204456,PHI,ORL,T.J. McConnell,174,36.9166666666667,37,-0.0833333333333286,99,87,12,12,0
21700278,1626158,PHI,ORL,Richaun Holmes,51,10.3666666666667,10,0.366666666666667,21,20,1,1,0
21700278,1626643,PHI,ORL,Jacob Pullen,8,1.4,2,-0.6,2,2,0,0,0
21700278,1627788,PHI,ORL,Furkan Korkmaz,8,1.4,2,-0.6,2,2,0,0,0
21700278,1627789,PHI,ORL,Timothe Luwawu-Cabarrot,116,23.95,24,-0.0500000000000007,69,46,23,23,0
21700279,202323,POR,WAS,Evan Turner,71,15.5166666666667,15,0.516666666666668,30,46,-16,-15,-1
21700279,202334,POR,WAS,Ed Davis,65,14.4666666666667,15,-0.533333333333333,27,39,-12,-13,1
21700279,203081,POR,WAS,Damian Lillard,183,40.7166666666667,41,-0.283333333333331,100,86,14,15,-1
21700279,203090,POR,WAS,Maurice Harkless,72,16.1333333333333,16,0.133333333333333,27,38,-11,-13,2
21700279,203468,POR,WAS,CJ McCollum,151,32.3166666666667,33,-0.683333333333337,81,69,12,10,2
21700279,203894,POR,WAS,Shabazz Napier,64,14.25,14,0.25,16,29,-13,-13,0
21700279,203943,POR,WAS,Noah Vonleh,142,31.7333333333333,32,-0.266666666666666,81,65,16,16,0
21700279,203994,POR,WAS,Jusuf Nurkic,152,33.5333333333333,33,0.533333333333331,81,66,15,16,-1
21700279,1626192,POR,WAS,Pat Connaughton,167,36.9833333333333,37,-0.0166666666666657,85,73,12,12,0
21700279,1627774,POR,WAS,Jake Layman,18,4.35,4,0.35,12,14,-2,0,-2
21700279,101133,WAS,POR,Ian Mahinmi,75,17.0833333333333,17,0.0833333333333322,41,33,8,6,2
21700279,101162,WAS,POR,Marcin Gortat,128,27.8666666666667,28,-0.133333333333333,61,73,-12,-8,-4
21700279,201160,WAS,POR,Jason Smith,34,7.53333333333333,8,-0.466666666666667,13,8,5,3,2
21700279,201975,WAS,POR,Jodie Meeks,81,17.8333333333333,18,-0.166666666666664,35,32,3,2,1
21700279,202693,WAS,POR,Markieff Morris,133,29.6666666666667,30,-0.333333333333336,68,76,-8,-6,-2
21700279,203078,WAS,POR,Bradley Beal,158,35.45,35,0.450000000000003,74,94,-20,-20,0
21700279,203107,WAS,POR,Tomas Satoransky,67,14.3666666666667,15,-0.633333333333333,35,19,16,16,0
21700279,203490,WAS,POR,Otto Porter Jr.,167,36.9166666666667,37,-0.0833333333333357,79,77,2,1,1
21700279,204025,WAS,POR,Tim Frazier,128,28.35,28,0.350000000000001,66,71,-5,-4,-1
21700279,1626162,WAS,POR,Kelly Oubre Jr.,114,24.9333333333333,25,-0.0666666666666664,53,57,-4,-5,1
21700280,101141,ATL,TOR,Ersan Ilyasova,92,21.25,22,-0.75,35,47,-12,-12,0
21700280,201158,ATL,TOR,Marco Belinelli,105,22.0666666666667,22,0.0666666666666664,36,63,-27,-27,0
21700280,203101,ATL,TOR,Miles Plumlee,35,8.95,9,-0.0500000000000007,17,11,6,6,0
21700280,203145,ATL,TOR,Kent Bazemore,84,18.6,19,-0.399999999999999,24,53,-29,-27,-2
21700280,203471,ATL,TOR,Dennis Schroder,116,26.0833333333333,26,0.0833333333333357,39,67,-28,-28,0
21700280,203473,ATL,TOR,Dewayne Dedmon,98,22.0166666666667,23,-0.983333333333334,34,56,-22,-22,0
21700280,203705,ATL,TOR,Josh Magette,76,16.3666666666667,17,-0.633333333333333,32,36,-4,-5,1
21700280,1627098,ATL,TOR,Malcolm Delaney,66,15.9666666666667,16,-0.033333333333335,31,32,-1,-2,1
21700280,1627752,ATL,TOR,Taurean Prince,98,21.8833333333333,22,-0.116666666666667,38,58,-20,-20,0
21700280,1627761,ATL,TOR,DeAndre' Bembry,104,24.3666666666667,24,0.366666666666667,37,55,-18,-18,0
21700280,1628381,ATL,TOR,John Collins,90,20.05,20,0.0500000000000007,26,50,-24,-24,0
21700280,1628416,ATL,TOR,Tyler Dorsey,47,11.7166666666667,12,-0.283333333333333,20,13,7,7,0
21700280,1628463,ATL,TOR,Tyler Cavanaugh,44,9.26666666666667,9,0.266666666666666,21,19,2,2,0
21700280,200768,TOR,ATL,Kyle Lowry,123,27.5,27,0.5,68,45,23,21,2
21700280,201586,TOR,ATL,Serge Ibaka,87,19.4166666666667,19,0.416666666666664,41,31,10,12,-2
21700280,201942,TOR,ATL,DeMar DeRozan,128,27.9333333333333,28,-0.0666666666666664,68,48,20,20,0
21700280,202685,TOR,ATL,Jonas Valanciunas,89,19.85,20,-0.149999999999999,45,35,10,10,0
21700280,203485,TOR,ATL,Lorenzo Brown,72,17.7833333333333,18,-0.216666666666669,34,27,7,7,0
21700280,203512,TOR,ATL,Lucas Nogueira,27,6.26666666666667,7,-0.733333333333333,11,12,-1,-1,0
21700280,1626181,TOR,ATL,Norman Powell,135,30.5666666666667,31,-0.433333333333334,73,58,15,17,-2
21700280,1627751,TOR,ATL,Jakob Poeltl,84,19.1166666666667,19,0.116666666666667,52,29,23,21,2
21700280,1627783,TOR,ATL,Pascal Siakam,135,30.7833333333333,31,-0.216666666666669,75,49,26,26,0
21700280,1627832,TOR,ATL,Fred VanVleet,72,15.95,16,-0.0500000000000007,43,24,19,21,-2
21700280,1628035,TOR,ATL,Alfonzo McKinnie,27,6.26666666666667,7,-0.733333333333333,11,12,-1,-1,0
21700280,1628384,TOR,ATL,OG Anunoby,76,17.15,17,0.149999999999999,39,20,19,17,2
21700281,201143,BOS,IND,Al Horford,130,31.35,32,-0.649999999999999,73,59,14,12,2
21700281,202681,BOS,IND,Kyrie Irving,150,33.75,34,-0.25,77,67,10,9,1
21700281,203382,BOS,IND,Aron Baynes,99,23.9333333333333,24,-0.0666666666666664,49,45,4,4,0
21700281,203499,BOS,IND,Shane Larkin,20,4.08333333333333,4,0.083333333333333,7,6,1,1,0
21700281,203935,BOS,IND,Marcus Smart,143,33.95,35,-1.05,80,70,10,12,-2
21700281,1626179,BOS,IND,Terry Rozier,87,20.3833333333333,20,0.383333333333333,52,45,7,6,1
21700281,1627846,BOS,IND,Abdel Nader,58,13.0833333333333,13,0.0833333333333339,24,32,-8,-12,4
21700281,1628369,BOS,IND,Jayson Tatum,160,37.35,38,-0.650000000000006,84,74,10,14,-4
21700281,1628400,BOS,IND,Semi Ojeleye,88,18.6333333333333,19,-0.366666666666667,37,43,-6,-4,-2
21700281,1628464,BOS,IND,Daniel Theis,95,21.15,21,0.149999999999999,57,49,8,8,0
21700281,2863,IND,BOS,Damien Wilkins,61,12.9666666666667,13,-0.033333333333335,31,25,6,7,-1
21700281,201152,IND,BOS,Thaddeus Young,143,33.4333333333333,33,0.433333333333337,65,73,-8,-8,0
21700281,201954,IND,BOS,Darren Collison,131,30.25,31,-0.75,63,62,1,3,-2
21700281,202362,IND,BOS,Lance Stephenson,150,35.8666666666667,36,-0.13333333333334,74,86,-12,-12,0
21700281,202709,IND,BOS,Cory Joseph,105,23.3,24,-0.699999999999999,49,57,-8,-12,4
21700281,202711,IND,BOS,Bojan Bogdanovic,130,30.85,32,-1.15,57,74,-17,-16,-1
21700281,1626167,IND,BOS,Myles Turner,130,30.5666666666667,31,-0.433333333333334,70,67,3,5,-2
21700281,1626202,IND,BOS,Joe Young,46,10.1833333333333,10,0.183333333333334,22,24,-2,-2,0
21700281,1627734,IND,BOS,Domantas Sabonis,134,30.25,30,0.25,59,72,-13,-15,2
21700282,2403,HOU,NYK,Nene,69,14.1333333333333,14,0.133333333333333,41,30,11,10,1
21700282,2772,HOU,NYK,Trevor Ariza,148,30.8166666666667,31,-0.183333333333334,62,68,-6,-6,0
21700282,101108,HOU,NYK,Chris Paul,143,30.55,31,-0.450000000000003,83,71,12,13,-1
21700282,200782,HOU,NYK,PJ Tucker,130,27.95,28,-0.0500000000000007,61,63,-2,-2,0
21700282,201569,HOU,NYK,Eric Gordon,120,24.65,24,0.649999999999999,65,48,17,15,2
21700282,201583,HOU,NYK,Ryan Anderson,99,20,20,0,56,39,17,17,0
21700282,201601,HOU,NYK,Luc Mbah a Moute,102,20.9,21,-0.100000000000001,60,40,20,21,-1
21700282,201935,HOU,NYK,James Harden,174,36.9333333333333,37,-0.0666666666666629,81,79,2,2,0
21700282,203991,HOU,NYK,Clint Capela,141,29.8333333333333,30,-0.166666666666664,66,60,6,9,-3
21700282,204028,HOU,NYK,Tarik Black,19,3.98333333333333,4,-0.0166666666666666,10,12,-2,-4,2
21700282,101127,NYK,HOU,Jarrett Jack,153,32.5666666666667,33,-0.433333333333337,77,65,12,12,0
21700282,201563,NYK,HOU,Michael Beasley,174,35.95,36,-0.0499999999999972,78,82,-4,-4,0
21700282,201584,NYK,HOU,Courtney Lee,156,32.95,33,-0.0499999999999972,74,76,-2,-5,3
21700282,202498,NYK,HOU,Lance Thomas,55,12,12,0,24,35,-11,-11,0
21700282,203124,NYK,HOU,Kyle O'Quinn,124,26.1333333333333,26,0.133333333333333,54,53,1,2,-1
21700282,203501,NYK,HOU,Tim Hardaway Jr.,179,37.75,38,-0.25,86,83,3,3,0
21700282,203926,NYK,HOU,Doug McDermott,67,13.7833333333333,14,-0.216666666666667,23,46,-23,-23,0
21700282,1626195,NYK,HOU,Willy Hernangomez,105,21.8166666666667,22,-0.183333333333334,48,64,-16,-17,1
21700282,1627758,NYK,HOU,Ron Baker,5,0.95,1,-0.05,0,3,-3,-3,0
21700282,1628373,NYK,HOU,Frank Ntilikina,76,15.3833333333333,15,0.383333333333333,25,52,-27,-27,0
21700282,1628422,NYK,HOU,Damyean Dotson,51,10.4666666666667,10,0.466666666666665,21,26,-5,-2,-3
21700283,1717,DAL,OKC,Dirk Nowitzki,98,22.4666666666667,22,0.466666666666669,56,31,25,26,-1
21700283,2734,DAL,OKC,Devin Harris,83,19.3833333333333,19,0.383333333333333,51,27,24,22,2
21700283,200826,DAL,OKC,J.J. Barea,71,16.75,17,-0.25,39,27,12,13,-1
21700283,202083,DAL,OKC,Wesley Matthews,146,34.4833333333333,35,-0.516666666666666,72,61,11,14,-3
21700283,203084,DAL,OKC,Harrison Barnes,138,32.0333333333333,33,-0.966666666666669,54,56,-2,-2,0
21700283,203939,DAL,OKC,Dwight Powell,65,15.6666666666667,15,0.666666666666666,43,25,18,18,0
21700283,1626257,DAL,OKC,Salah Mejri,97,23.1833333333333,24,-0.81666666666667,41,48,-7,-8,1
21700283,1627812,DAL,OKC,Yogi Ferrell,100,23.6166666666667,24,-0.383333333333333,54,37,17,16,1
21700283,1628372,DAL,OKC,Dennis Smith Jr.,121,28.7333333333333,29,-0.266666666666666,40,56,-16,-16,0
21700283,1628467,DAL,OKC,Maxi Kleber,91,20.65,21,-0.350000000000001,31,34,-3,-4,1
21700283,1628499,DAL,OKC,Antonius Cleveland,5,1.53333333333333,2,-0.466666666666667,4,3,1,1,0
21700283,2546,OKC,DAL,Carmelo Anthony,117,26.5,27,-0.5,43,50,-7,-7,0
21700283,2555,OKC,DAL,Nick Collison,32,7.65,8,-0.350000000000001,18,8,10,10,0
21700283,101109,OKC,DAL,Raymond Felton,98,24.1666666666667,24,0.166666666666668,44,51,-7,-7,0
21700283,201566,OKC,DAL,Russell Westbrook,170,39.5166666666667,40,-0.483333333333334,71,73,-2,-2,0
21700283,202331,OKC,DAL,Paul George,169,39.45,40,-0.549999999999997,62,78,-16,-16,0
21700283,202335,OKC,DAL,Patrick Patterson,52,13,13,0,20,38,-18,-18,0
21700283,203460,OKC,DAL,Andre Roberson,69,15.5,16,-0.5,25,25,0,0,0
21700283,203500,OKC,DAL,Steven Adams,119,27.05,27,0.0500000000000007,43,51,-8,-8,0
21700283,203518,OKC,DAL,Alex Abrines,5,1.53333333333333,2,-0.466666666666667,3,4,-1,-1,0
21700283,203924,OKC,DAL,Jerami Grant,82,20,20,0,35,43,-8,-9,1
21700283,203962,OKC,DAL,Josh Huestis,7,2.08333333333333,2,0.083333333333333,3,5,-2,-2,0
21700283,1626177,OKC,DAL,Dakari Johnson,4,1.2,1,0.2,3,4,-1,0,-1
21700283,1628390,OKC,DAL,Terrance Ferguson,91,20.85,21,-0.149999999999999,35,55,-20,-20,0
21700284,2749,NOP,GSW,Jameer Nelson,103,21.3,21,0.299999999999997,46,49,-3,-5,2
21700284,2754,NOP,GSW,Tony Allen,54,10.5,10,0.5,17,28,-11,-13,2
21700284,200765,NOP,GSW,Rajon Rondo,133,26.6333333333333,27,-0.366666666666667,49,59,-10,-10,0
21700284,201950,NOP,GSW,Jrue Holiday,194,39.85,40,-0.149999999999999,79,86,-7,-7,0
21700284,201967,NOP,GSW,Dante Cunningham,60,12.1166666666667,12,0.116666666666667,22,24,-2,-1,-1
21700284,202326,NOP,GSW,DeMarcus Cousins,149,30.5166666666667,31,-0.483333333333334,63,65,-2,-6,4
21700284,202734,NOP,GSW,E'Twaun Moore,146,28.7833333333333,29,-0.216666666666669,62,71,-9,-12,3
21700284,203076,NOP,GSW,Anthony Davis,192,38.65,39,-0.350000000000001,80,85,-5,-5,0
21700284,203121,NOP,GSW,Darius Miller,109,22.2166666666667,22,0.216666666666665,45,58,-13,-14,1
21700284,203546,NOP,GSW,Ian Clark,35,7.66666666666667,8,-0.333333333333333,12,12,0,1,-1
21700284,1627767,NOP,GSW,Cheick Diallo,5,1.43333333333333,1,0.433333333333333,0,3,-3,-3,0
21700284,2561,GSW,NOP,David West,64,12.5333333333333,12,0.533333333333333,29,24,5,5,0
21700284,2585,GSW,NOP,Zaza Pachulia,95,19.4,20,-0.600000000000001,38,40,-2,0,-2
21700284,2733,GSW,NOP,Shaun Livingston,74,14.35,14,0.35,35,26,9,9,0
21700284,2738,GSW,NOP,Andre Iguodala,150,30.7833333333333,31,-0.216666666666669,76,60,16,17,-1
21700284,201156,GSW,NOP,Nick Young,50,9.75,10,-0.25,29,20,9,9,0
21700284,201580,GSW,NOP,JaVale McGee,22,5.05,5,0.0500000000000007,6,12,-6,-6,0
21700284,201939,GSW,NOP,Stephen Curry,178,36.5166666666667,36,0.516666666666666,81,75,6,5,1
21700284,201956,GSW,NOP,Omri Casspi,122,24.6,25,-0.399999999999999,47,51,-4,1,-5
21700284,202691,GSW,NOP,Klay Thompson,180,35.6666666666667,36,-0.333333333333329,83,70,13,18,-5
21700284,203110,GSW,NOP,Draymond Green,127,25.7333333333333,26,-0.266666666666666,55,48,7,5,2
21700284,1626172,GSW,NOP,Kevon Looney,49,9.61666666666667,9,0.616666666666667,24,15,9,9,0
21700284,1627775,GSW,NOP,Patrick McCaw,37,8.55,8,0.550000000000001,17,19,-2,-2,0
21700284,1628395,GSW,NOP,Jordan Bell,32,7.11666666666667,7,0.116666666666667,20,15,5,5,0
21700285,202339,MIL,UTA,Eric Bledsoe,136,30.65,31,-0.350000000000001,74,81,-7,-7,0
21700285,202732,MIL,UTA,DeAndre Liggins,33,7.96666666666667,8,-0.0333333333333332,20,17,3,1,2
21700285,203089,MIL,UTA,John Henson,115,24.9,25,-0.100000000000001,63,68,-5,-3,-2
21700285,203114,MIL,UTA,Khris Middleton,153,34.3166666666667,34,0.31666666666667,75,94,-19,-17,-2
21700285,203503,MIL,UTA,Tony Snell,167,37.6333333333333,38,-0.366666666666667,96,93,3,1,2
21700285,203507,MIL,UTA,Giannis Antetokounmpo,170,39.0666666666667,39,0.0666666666666629,91,104,-13,-13,0
21700285,1626173,MIL,UTA,Rashad Vaughn,22,5.23333333333333,5,0.233333333333333,11,9,2,0,2
21700285,1627748,MIL,UTA,Thon Maker,71,16.5,16,0.5,34,34,0,-2,2
21700285,1627762,MIL,UTA,Joel Bolomboy,8,1.9,2,-0.1,2,1,1,1,0
21700285,1627763,MIL,UTA,Malcolm Brogdon,115,27,27,0,51,71,-20,-20,0
21700285,1627780,MIL,UTA,Gary Payton II,30,7.08333333333333,7,0.083333333333333,10,16,-6,-4,-2
21700285,1628425,MIL,UTA,Sterling Brown,35,7.5,7,0.5,13,17,-4,-2,-2
21700285,200757,UTA,MIL,Thabo Sefolosha,93,20.5833333333333,20,0.583333333333332,54,51,3,6,-3
21700285,201937,UTA,MIL,Ricky Rubio,96,22.4833333333333,22,0.483333333333334,56,53,3,0,3
21700285,201973,UTA,MIL,Jonas Jerebko,56,13.1333333333333,14,-0.866666666666667,32,24,8,6,2
21700285,202324,UTA,MIL,Derrick Favors,129,29.15,29,0.149999999999999,73,67,6,6,0
21700285,202327,UTA,MIL,Ekpe Udoh,75,17.3,17,0.300000000000001,47,39,8,8,0
21700285,202692,UTA,MIL,Alec Burks,98,23.3,23,0.299999999999997,60,50,10,12,-2
21700285,203526,UTA,MIL,Raul Neto,83,19.25,19,0.25,49,41,8,12,-4
21700285,203918,UTA,MIL,Rodney Hood,129,29.0666666666667,29,0.0666666666666664,74,70,4,4,0
21700285,204060,UTA,MIL,Joe Ingles,150,33.1666666666667,33,0.166666666666664,83,78,5,5,0
21700285,1626220,UTA,MIL,Royce O'Neale,7,1.5,2,-0.5,1,2,-1,-1,0
21700285,1628378,UTA,MIL,Donovan Mitchell,132,29.3166666666667,29,0.316666666666666,75,63,12,8,4
21700285,1628396,UTA,MIL,Tony Bradley,7,1.5,2,-0.5,1,2,-1,-1,0
21700286,101150,LAC,SAC,Lou Williams,156,35.9166666666667,36,-0.0833333333333286,76,75,1,2,-1
21700286,201599,LAC,SAC,DeAndre Jordan,120,28.1833333333333,28,0.183333333333334,57,62,-5,-7,2
21700286,201933,LAC,SAC,Blake Griffin,162,38.0666666666667,38,0.0666666666666629,82,75,7,7,0
21700286,202325,LAC,SAC,Wesley Johnson,166,39.65,40,-0.349999999999994,86,77,9,9,0
21700286,203085,LAC,SAC,Austin Rivers,163,37.7666666666667,37,0.766666666666666,78,67,11,8,3
21700286,203186,LAC,SAC,Willie Reed,29,5.31666666666667,5,0.316666666666666,9,16,-7,-7,0
21700286,203710,LAC,SAC,C.J. Williams,24,4.66666666666667,5,-0.333333333333333,2,6,-4,-5,1
21700286,1626149,LAC,SAC,Montrezl Harrell,72,16.1833333333333,16,0.183333333333334,36,24,12,15,-3
21700286,1626155,LAC,SAC,Sam Dekker,44,9.18333333333333,9,0.183333333333334,10,13,-3,-4,1
21700286,1628393,LAC,SAC,Jawun Evans,28,5.33333333333333,5,0.333333333333333,11,18,-7,-6,-1
21700286,1628414,LAC,SAC,Sindarius Thornwell,91,19.7333333333333,20,-0.266666666666666,38,42,-4,-2,-2
21700286,2216,SAC,LAC,Zach Randolph,130,30.5666666666667,31,-0.433333333333334,70,64,6,4,2
21700286,201585,SAC,LAC,Kosta Koufos,102,22.5333333333333,23,-0.466666666666669,39,48,-9,-7,-2
21700286,201588,SAC,LAC,George Hill,100,23.0166666666667,23,0.0166666666666657,51,46,5,7,-2
21700286,202066,SAC,LAC,Garrett Temple,140,32.8833333333333,33,-0.116666666666667,68,58,10,10,0
21700286,203992,SAC,LAC,Bogdan Bogdanovic,106,23.05,23,0.0499999999999972,30,44,-14,-14,0
21700286,1626161,SAC,LAC,Willie Cauley-Stein,130,30.3,30,0.299999999999997,54,51,3,3,0
21700286,1627741,SAC,LAC,Buddy Hield,116,26.2833333333333,26,0.283333333333331,53,55,-2,-4,2
21700286,1627746,SAC,LAC,Skal Labissiere,59,12.5666666666667,13,-0.433333333333334,25,31,-6,-6,0
21700286,1628368,SAC,LAC,De'Aaron Fox,121,28.7,29,-0.299999999999997,63,61,2,4,-2
21700286,1628412,SAC,LAC,Frank Mason,51,10.1,10,0.0999999999999996,22,27,-5,-7,2
21700287,201577,CHI,MIA,Robin Lopez,117,27.6666666666667,27,0.666666666666664,43,40,3,5,-2
21700287,203200,CHI,MIA,Justin Holiday,163,36.4833333333333,37,-0.516666666666666,62,62,0,0,0
21700287,1626170,CHI,MIA,Jerian Grant,133,30.0833333333333,30,0.0833333333333322,65,76,-11,-9,-2
21700287,1626171,CHI,MIA,Bobby Portis,110,23.6,24,-0.399999999999999,55,66,-11,-13,2
21700287,1627739,CHI,MIA,Kris Dunn,104,23.4166666666667,24,-0.583333333333336,42,46,-4,-6,2
21700287,1627756,CHI,MIA,Denzel Valentine,177,39.2833333333333,40,-0.716666666666669,76,92,-16,-14,-2
21700287,1627835,CHI,MIA,Paul Zipser,58,13.2333333333333,13,0.233333333333333,31,39,-8,-8,0
21700287,1628374,CHI,MIA,Lauri Markkanen,141,31.3,32,-0.700000000000003,57,55,2,2,0
21700287,1628469,CHI,MIA,Antonio Blakeney,62,14.4333333333333,14,0.433333333333334,34,24,10,8,2
21700287,201609,MIA,CHI,Goran Dragic,155,33.45,34,-0.549999999999997,71,64,7,5,2
21700287,201949,MIA,CHI,James Johnson,128,28.1833333333333,28,0.183333333333334,75,66,9,11,-2
21700287,201961,MIA,CHI,Wayne Ellington,134,30.0166666666667,30,0.0166666666666657,75,74,1,3,-2
21700287,202355,MIA,CHI,Hassan Whiteside,93,21.0333333333333,21,0.0333333333333314,32,30,2,2,0
21700287,203079,MIA,CHI,Dion Waiters,111,26.15,26,0.149999999999999,36,38,-2,-2,0
21700287,203482,MIA,CHI,Kelly Olynyk,120,26.8666666666667,27,-0.133333333333333,68,63,5,5,0
21700287,204020,MIA,CHI,Tyler Johnson,134,29.8666666666667,30,-0.133333333333333,72,70,2,4,-2
21700287,1626159,MIA,CHI,Justise Winslow,85,19.7166666666667,20,-0.283333333333331,25,27,-2,-4,2
21700287,1626196,MIA,CHI,Josh Richardson,105,24.2166666666667,24,0.216666666666669,46,33,13,11,2
21700288,2037,MIN,PHX,Jamal Crawford,61,11.6,12,-0.4,28,37,-9,-8,-1
21700288,201166,MIN,PHX,Aaron Brooks,49,9.31666666666667,9,0.316666666666666,23,35,-12,-11,-1
21700288,201959,MIN,PHX,Taj Gibson,170,36.5166666666667,37,-0.483333333333334,92,77,15,15,0
21700288,202710,MIN,PHX,Jimmy Butler,160,35.9833333333333,36,-0.0166666666666657,91,71,20,19,1
21700288,203476,MIN,PHX,Gorgui Dieng,97,19.8666666666667,20,-0.133333333333333,43,49,-6,-6,0
21700288,203498,MIN,PHX,Shabazz Muhammad,37,7.1,7,0.0999999999999996,17,26,-9,-9,0
21700288,203952,MIN,PHX,Andrew Wiggins,184,40.4833333333333,41,-0.516666666666666,102,82,20,20,0
21700288,1626145,MIN,PHX,Tyus Jones,172,38.2666666666667,39,-0.733333333333334,96,73,23,22,1
21700288,1626157,MIN,PHX,Karl-Anthony Towns,175,38.7833333333333,39,-0.216666666666669,103,90,13,13,0
21700288,2199,PHX,MIN,Tyson Chandler,111,24.4666666666667,25,-0.533333333333331,58,63,-5,-5,0
21700288,201162,PHX,MIN,Jared Dudley,75,17.2,18,-0.800000000000001,39,34,5,5,0
21700288,202328,PHX,MIN,Greg Monroe,78,16.8166666666667,17,-0.183333333333334,28,50,-22,-21,-1
21700288,203584,PHX,MIN,Troy Daniels,147,31.5833333333333,31,0.583333333333332,72,71,1,8,-7
21700288,203933,PHX,MIN,T.J. Warren,171,37.2666666666667,38,-0.733333333333334,81,91,-10,-12,2
21700288,1627733,PHX,MIN,Dragan Bender,103,21.6,21,0.600000000000001,53,56,-3,-4,1
21700288,1627737,PHX,MIN,Marquese Chriss,84,16.6166666666667,16,0.616666666666667,38,43,-5,-7,2
21700288,1627755,PHX,MIN,Tyler Ulis,84,19.6333333333333,20,-0.366666666666667,36,57,-21,-21,0
21700288,1628367,PHX,MIN,Josh Jackson,103,22.2,23,-0.800000000000001,60,59,1,-2,3
21700288,1628455,PHX,MIN,Mike James,149,30.5333333333333,30,0.533333333333331,75,71,4,4,0
21700289,201960,BKN,MEM,DeMarre Carroll,152,34.7666666666667,35,-0.233333333333334,74,59,15,17,-2
21700289,202344,BKN,MEM,Trevor Booker,131,30.0166666666667,31,-0.983333333333334,67,48,19,21,-2
21700289,202389,BKN,MEM,Timofey Mozgov,61,13.3666666666667,13,0.366666666666667,22,32,-10,-12,2
21700289,203092,BKN,MEM,Tyler Zeller,84,20,20,0,47,26,21,21,0
21700289,203915,BKN,MEM,Spencer Dinwiddie,138,32.5666666666667,33,-0.43333333333333,69,52,17,17,0
21700289,203925,BKN,MEM,Joe Harris,166,37.3666666666667,37,0.36666666666666,83,65,18,18,0
21700289,203930,BKN,MEM,Sean Kilpatrick,95,20.3833333333333,21,-0.616666666666667,35,46,-11,-11,0
21700289,1626178,BKN,MEM,Rondae Hollis-Jefferson,47,9.43333333333333,9,0.433333333333334,19,28,-9,-9,0
21700289,1627747,BKN,MEM,Caris LeVert,131,29.1833333333333,29,0.183333333333334,58,61,-3,-5,2
21700289,1628386,BKN,MEM,Jarrett Allen,45,11.25,11,0.25,16,23,-7,-7,0
21700289,201188,MEM,BKN,Marc Gasol,120,27.5833333333333,28,-0.416666666666664,40,55,-15,-17,2
21700289,201596,MEM,BKN,Mario Chalmers,85,19.2333333333333,19,0.233333333333334,31,43,-12,-10,-2
21700289,201936,MEM,BKN,Tyreke Evans,141,31.4333333333333,32,-0.566666666666666,51,70,-19,-19,0
21700289,202718,MEM,BKN,Chandler Parsons,58,11.95,12,-0.0500000000000007,28,21,7,7,0
21700289,203210,MEM,BKN,JaMychal Green,133,31.8666666666667,32,-0.133333333333333,54,67,-13,-13,0
21700289,203463,MEM,BKN,Ben McLemore,111,25.2666666666667,26,-0.733333333333334,55,51,4,4,0
21700289,203516,MEM,BKN,James Ennis III,72,17.5666666666667,18,-0.433333333333334,37,31,6,4,2
21700289,1626150,MEM,BKN,Andrew Harrison,90,19.75,20,-0.25,42,40,2,0,2
21700289,1626185,MEM,BKN,Jarell Martin,47,10.45,11,-0.550000000000001,21,19,2,2,0
21700289,1627738,MEM,BKN,Deyonta Davis,90,20.0833333333333,20,0.0833333333333322,48,43,5,7,-2
21700289,1628415,MEM,BKN,Dillon Brooks,103,23.15,23,0.149999999999999,33,50,-17,-15,-2
21700290,201571,ORL,IND,D.J. Augustin,109,22.1166666666667,22,0.116666666666667,49,55,-6,-6,0
21700290,201578,ORL,IND,Marreese Speights,61,12.2,12,0.199999999999999,33,29,4,6,-2
21700290,202687,ORL,IND,Bismack Biyombo,35,7.51666666666667,8,-0.483333333333333,16,14,2,2,0
21700290,202696,ORL,IND,Nikola Vucevic,166,36.65,37,-0.350000000000001,81,92,-11,-13,2
21700290,203082,ORL,IND,Terrence Ross,124,25.7833333333333,25,0.783333333333331,61,65,-4,-3,-1
21700290,203095,ORL,IND,Evan Fournier,161,35.9166666666667,36,-0.0833333333333286,71,92,-21,-20,-1
21700290,203613,ORL,IND,Jonathon Simmons,159,34.45,34,0.450000000000003,88,87,1,1,0
21700290,203901,ORL,IND,Elfrid Payton,114,26.0166666666667,26,0.0166666666666657,62,66,-4,-6,2
21700290,203932,ORL,IND,Aaron Gordon,176,39.1,39,0.0999999999999943,84,105,-21,-21,0
21700290,201152,IND,ORL,Thaddeus Young,140,30.0333333333333,30,0.0333333333333314,76,76,0,2,-2
21700290,201954,IND,ORL,Darren Collison,127,27.7166666666667,28,-0.283333333333335,72,65,7,9,-2
21700290,202362,IND,ORL,Lance Stephenson,117,23.9666666666667,24,-0.0333333333333314,57,57,0,0,0
21700290,202709,IND,ORL,Cory Joseph,148,31.0666666666667,31,0.0666666666666629,77,73,4,2,2
21700290,202711,IND,ORL,Bojan Bogdanovic,170,37.1,37,0.0999999999999943,96,87,9,7,2
21700290,203506,IND,ORL,Victor Oladipo,142,32.9666666666667,33,-0.0333333333333314,89,60,29,29,0
21700290,1626167,IND,ORL,Myles Turner,136,30.2,30,0.199999999999999,66,67,-1,1,-2
21700290,1627734,IND,ORL,Domantas Sabonis,125,26.7,27,-0.300000000000001,72,60,12,10,2
21700291,2544,CLE,PHI,LeBron James,145,31.1833333333333,31,0.183333333333334,65,66,-1,1,-2
21700291,2548,CLE,PHI,Dwyane Wade,113,24.8833333333333,25,-0.116666666666667,59,38,21,21,0
21700291,2594,CLE,PHI,Kyle Korver,100,20.9666666666667,21,-0.033333333333335,52,31,21,25,-4
21700291,2747,CLE,PHI,JR Smith,128,27.7833333333333,28,-0.216666666666669,65,58,7,9,-2
21700291,101112,CLE,PHI,Channing Frye,83,18.4166666666667,19,-0.583333333333336,47,25,22,23,-1
21700291,101181,CLE,PHI,Jose Calderon,110,22.8166666666667,23,-0.183333333333334,54,53,1,-2,3
21700291,201145,CLE,PHI,Jeff Green,129,27.4333333333333,27,0.433333333333334,67,42,25,25,0
21700291,201567,CLE,PHI,Kevin Love,119,24.9333333333333,25,-0.0666666666666664,57,56,1,0,1
21700291,202697,CLE,PHI,Iman Shumpert,30,6.61666666666667,7,-0.383333333333333,20,7,13,14,-1
21700291,203109,CLE,PHI,Jae Crowder,95,20.5166666666667,21,-0.483333333333334,46,49,-3,-3,0
21700291,204066,CLE,PHI,John Holland,23,4.8,5,-0.2,12,10,2,-1,3
21700291,1626224,CLE,PHI,Cedi Osman,23,4.8,5,-0.2,12,10,2,-1,3
21700291,1627790,CLE,PHI,Ante Zizic,22,4.6,5,-0.4,9,10,-1,-1,0
21700291,101161,PHI,CLE,Amir Johnson,42,8.35,8,0.35,19,15,4,6,-2
21700291,200755,PHI,CLE,JJ Redick,168,36.6666666666667,37,-0.333333333333329,65,92,-27,-29,2
21700291,201573,PHI,CLE,Jerryd Bayless,100,21.4666666666667,21,0.466666666666669,46,53,-7,-7,0
21700291,203496,PHI,CLE,Robert Covington,126,26.5833333333333,27,-0.416666666666668,51,57,-6,-7,1
21700291,203954,PHI,CLE,Joel Embiid,149,32.8666666666667,33,-0.133333333333333,60,81,-21,-23,2
21700291,203967,PHI,CLE,Dario Saric,138,30.65,30,0.649999999999999,51,76,-25,-26,1
21700291,204456,PHI,CLE,T.J. McConnell,130,27.55,28,-0.449999999999999,58,61,-3,-4,1
21700291,1626158,PHI,CLE,Richaun Holmes,23,4.8,5,-0.2,10,12,-2,1,-3
21700291,1627732,PHI,CLE,Ben Simmons,166,34.5333333333333,35,-0.466666666666669,65,83,-18,-16,-2
21700291,1627788,PHI,CLE,Furkan Korkmaz,22,4.6,5,-0.4,10,9,1,1,0
21700291,1627789,PHI,CLE,Timothe Luwawu-Cabarrot,56,11.6833333333333,11,0.683333333333334,20,26,-6,-6,0
21700292,201143,BOS,DET,Al Horford,149,33.2666666666667,34,-0.733333333333334,78,89,-11,-13,2
21700292,202681,BOS,DET,Kyrie Irving,161,35.8166666666667,36,-0.183333333333337,70,94,-24,-21,-3
21700292,202694,BOS,DET,Marcus Morris,100,22.0666666666667,23,-0.933333333333334,41,54,-13,-15,2
21700292,203382,BOS,DET,Aron Baynes,54,12.85,13,-0.15,34,29,5,5,0
21700292,203935,BOS,DET,Marcus Smart,137,31.6833333333333,32,-0.31666666666667,79,72,7,9,-2
21700292,1626179,BOS,DET,Terry Rozier,82,19.6166666666667,19,0.616666666666667,43,40,3,5,-2
21700292,1627759,BOS,DET,Jaylen Brown,153,32.2,33,-0.800000000000004,76,90,-14,-14,0
21700292,1628369,BOS,DET,Jayson Tatum,156,34.0833333333333,35,-0.916666666666671,81,91,-10,-13,3
21700292,1628400,BOS,DET,Semi Ojeleye,26,6.7,7,-0.300000000000001,16,11,5,5,0
21700292,1628464,BOS,DET,Daniel Theis,47,10.2166666666667,10,0.216666666666667,22,20,2,2,0
21700292,201229,DET,BOS,Anthony Tolliver,65,15.3666666666667,15,0.366666666666667,31,33,-2,-2,0
21700292,202340,DET,BOS,Avery Bradley,174,37.3833333333333,38,-0.616666666666667,95,81,14,14,0
21700292,202397,DET,BOS,Ish Smith,86,19.7166666666667,20,-0.283333333333331,45,46,-1,-1,0
21700292,202699,DET,BOS,Tobias Harris,156,34.4166666666667,35,-0.583333333333329,93,82,11,11,0
21700292,202704,DET,BOS,Reggie Jackson,127,27.9833333333333,28,-0.0166666666666657,73,62,11,11,0
21700292,203083,DET,BOS,Andre Drummond,179,39.5333333333333,40,-0.466666666666669,104,91,13,13,0
21700292,203961,DET,BOS,Eric Moreland,34,8.16666666666667,8,0.166666666666668,14,17,-3,-3,0
21700292,204038,DET,BOS,Langston Galloway,18,4.88333333333333,5,-0.116666666666667,6,14,-8,-8,0
21700292,1626169,DET,BOS,Stanley Johnson,157,34.55,35,-0.450000000000003,91,79,12,12,0
21700292,1628379,DET,BOS,Luke Kennard,69,16.5,17,-0.5,38,35,3,3,0
21700293,101127,NYK,POR,Jarrett Jack,93,20.6166666666667,21,-0.383333333333333,43,51,-8,-8,0
21700293,201149,NYK,POR,Joakim Noah,16,3.01666666666667,3,0.0166666666666666,4,5,-1,-1,0
21700293,201196,NYK,POR,Ramon Sessions,37,7.26666666666667,7,0.266666666666667,14,20,-6,-6,0
21700293,201563,NYK,POR,Michael Beasley,66,14.0666666666667,14,0.0666666666666664,30,19,11,11,0
21700293,201584,NYK,POR,Courtney Lee,164,35.2833333333333,36,-0.716666666666669,70,84,-14,-14,0
21700293,202498,NYK,POR,Lance Thomas,23,5.11666666666667,5,0.116666666666666,5,13,-8,-9,1
21700293,203124,NYK,POR,Kyle O'Quinn,109,24.7166666666667,25,-0.283333333333331,54,59,-5,-5,0
21700293,203501,NYK,POR,Tim Hardaway Jr.,173,38.0333333333333,38,0.0333333333333314,83,75,8,6,2
21700293,203926,NYK,POR,Doug McDermott,93,19.6833333333333,20,-0.316666666666666,28,37,-9,-9,0
21700293,204001,NYK,POR,Kristaps Porzingis,155,33.0666666666667,33,0.0666666666666629,68,82,-14,-14,0
21700293,1626195,NYK,POR,Willy Hernangomez,73,15.3833333333333,15,0.383333333333333,21,28,-7,-6,-1
21700293,1628373,NYK,POR,Frank Ntilikina,91,19.8,20,-0.200000000000003,34,32,2,2,0
21700293,1628422,NYK,POR,Damyean Dotson,12,2.36666666666667,2,0.366666666666667,1,10,-9,-7,-2
21700293,202323,POR,NYK,Evan Turner,95,19.8,20,-0.200000000000003,42,30,12,12,0
21700293,202334,POR,NYK,Ed Davis,84,17.6666666666667,18,-0.333333333333336,30,20,10,8,2
21700293,203081,POR,NYK,Damian Lillard,179,37.7833333333333,38,-0.216666666666669,92,79,13,14,-1
21700293,203090,POR,NYK,Maurice Harkless,73,15.6333333333333,15,0.633333333333333,24,25,-1,-1,0
21700293,203468,POR,NYK,CJ McCollum,179,39.0166666666667,40,-0.983333333333334,81,79,2,2,0
21700293,203894,POR,NYK,Shabazz Napier,84,18.0333333333333,18,0.0333333333333314,26,23,3,2,1
21700293,203943,POR,NYK,Noah Vonleh,139,30.9833333333333,31,-0.0166666666666657,70,64,6,6,0
21700293,203994,POR,NYK,Jusuf Nurkic,136,29.95,30,-0.0500000000000007,71,71,0,2,-2
21700293,1626192,POR,NYK,Pat Connaughton,116,25.6333333333333,26,-0.366666666666667,66,59,7,7,0
21700293,1627774,POR,NYK,Jake Layman,20,3.91666666666667,4,-0.0833333333333335,13,5,8,8,0
21700294,2772,HOU,BKN,Trevor Ariza,128,28.5833333333333,29,-0.416666666666668,65,59,6,4,2
21700294,101108,HOU,BKN,Chris Paul,147,30.9833333333333,31,-0.0166666666666657,77,67,10,12,-2
21700294,200782,HOU,BKN,PJ Tucker,107,21.15,21,0.149999999999999,59,44,15,18,-3
21700294,201569,HOU,BKN,Eric Gordon,136,28.5666666666667,29,-0.433333333333334,64,59,5,5,0
21700294,201583,HOU,BKN,Ryan Anderson,116,25.8,26,-0.200000000000003,60,50,10,8,2
21700294,201601,HOU,BKN,Luc Mbah a Moute,104,20.7333333333333,20,0.733333333333334,56,48,8,11,-3
21700294,201628,HOU,BKN,Bobby Brown,6,1.18333333333333,1,0.183333333333333,0,5,-5,-5,0
21700294,201935,HOU,BKN,James Harden,165,35.7833333333333,36,-0.216666666666669,96,74,22,22,0
21700294,203991,HOU,BKN,Clint Capela,126,27.8333333333333,28,-0.166666666666668,64,65,-1,-2,1
21700294,204028,HOU,BKN,Tarik Black,83,15.6,16,-0.399999999999999,39,34,5,7,-2
21700294,1627362,HOU,BKN,Briante Weber,6,1.18333333333333,1,0.183333333333333,0,5,-5,-5,0
21700294,1627786,HOU,BKN,Troy Williams,6,1.18333333333333,1,0.183333333333333,0,5,-5,-5,0
21700294,202344,BKN,HOU,Trevor Booker,97,20.4666666666667,20,0.466666666666669,45,54,-9,-8,-1
21700294,202389,BKN,HOU,Timofey Mozgov,88,19.2666666666667,19,0.266666666666666,41,34,7,7,0
21700294,203092,BKN,HOU,Tyler Zeller,74,16.6666666666667,17,-0.333333333333332,38,48,-10,-10,0
21700294,203112,BKN,HOU,Quincy Acy,96,20.25,21,-0.75,45,47,-2,-4,2
21700294,203915,BKN,HOU,Spencer Dinwiddie,141,30.9,31,-0.100000000000001,63,77,-14,-15,1
21700294,203925,BKN,HOU,Joe Harris,127,28.2333333333333,28,0.233333333333334,67,75,-8,-8,0
21700294,203930,BKN,HOU,Sean Kilpatrick,138,27.85,28,-0.149999999999999,57,66,-9,-9,0
21700294,1627747,BKN,HOU,Caris LeVert,137,28.9666666666667,29,-0.0333333333333314,69,69,0,-1,1
21700294,1627785,BKN,HOU,Isaiah Whitehead,135,27.2,28,-0.800000000000001,53,61,-8,-9,1
21700294,1628386,BKN,HOU,Jarrett Allen,97,18.7833333333333,19,-0.216666666666669,37,49,-12,-13,1
21700295,1717,DAL,SAS,Dirk Nowitzki,109,25.7333333333333,26,-0.266666666666666,60,64,-4,-4,0
21700295,2734,DAL,SAS,Devin Harris,106,25.6833333333333,26,-0.316666666666666,58,46,12,10,2
21700295,200826,DAL,SAS,J.J. Barea,96,22.2833333333333,22,0.283333333333331,52,47,5,9,-4
21700295,202083,DAL,SAS,Wesley Matthews,151,32.1333333333333,33,-0.866666666666667,71,98,-27,-27,0
21700295,203084,DAL,SAS,Harrison Barnes,167,35.6333333333333,36,-0.366666666666667,79,101,-22,-22,0
21700295,203939,DAL,SAS,Dwight Powell,89,20.5,20,0.5,50,29,21,23,-2
21700295,1626257,DAL,SAS,Salah Mejri,70,15.6166666666667,16,-0.383333333333333,31,36,-5,-7,2
21700295,1627812,DAL,SAS,Yogi Ferrell,89,20.4833333333333,21,-0.516666666666666,50,27,23,19,4
21700295,1628372,DAL,SAS,Dennis Smith Jr.,133,28.45,28,0.449999999999999,68,90,-22,-20,-2
21700295,1628467,DAL,SAS,Maxi Kleber,54,12.6833333333333,13,-0.316666666666666,21,37,-16,-16,0
21700295,1628499,DAL,SAS,Antonius Cleveland,1,0.133333333333333,0,0.133333333333333,,0,,0,
21700295,1938,SAS,DAL,Manu Ginobili,68,16.9166666666667,17,-0.0833333333333357,31,36,-5,-5,0
21700295,2200,SAS,DAL,Pau Gasol,158,34.8833333333333,35,-0.116666666666667,97,83,14,18,-4
21700295,2225,SAS,DAL,Tony Parker,60,14.0333333333333,14,0.0333333333333332,36,27,9,9,0
21700295,200746,SAS,DAL,LaMarcus Aldridge,170,36.9666666666667,38,-1.03333333333333,101,85,16,12,4
21700295,201980,SAS,DAL,Danny Green,151,33.6166666666667,34,-0.383333333333333,97,75,22,20,2
21700295,201988,SAS,DAL,Patty Mills,132,28.35,28,0.350000000000001,67,72,-5,-7,2
21700295,202722,SAS,DAL,Davis Bertans,13,3.05,3,0.0499999999999998,2,5,-3,-3,0
21700295,203464,SAS,DAL,Brandon Paul,22,3.95,4,-0.0499999999999998,7,10,-3,-3,0
21700295,203530,SAS,DAL,Joffrey Lauvergne,38,8.96666666666667,9,-0.0333333333333332,12,14,-2,-8,6
21700295,203937,SAS,DAL,Kyle Anderson,156,34.15,34,0.149999999999999,89,78,11,11,0
21700295,1627749,SAS,DAL,Dejounte Murray,21,5.48333333333333,5,0.483333333333333,12,9,3,3,0
21700295,1627854,SAS,DAL,Bryn Forbes,76,18.9666666666667,19,-0.0333333333333314,24,46,-22,-22,0
21700296,2561,GSW,SAC,David West,71,16.1166666666667,17,-0.883333333333333,46,33,13,11,2
21700296,2585,GSW,SAC,Zaza Pachulia,65,14.0666666666667,14,0.0666666666666664,34,31,3,3,0
21700296,2733,GSW,SAC,Shaun Livingston,73,17.45,18,-0.549999999999997,38,42,-4,-3,-1
21700296,2738,GSW,SAC,Andre Iguodala,103,25.6333333333333,26,-0.366666666666667,56,60,-4,-4,0
21700296,201156,GSW,SAC,Nick Young,54,12.3166666666667,12,0.316666666666666,20,35,-15,-13,-2
21700296,201580,GSW,SAC,JaVale McGee,31,8.41666666666667,8,0.416666666666668,20,21,-1,-2,1
21700296,201956,GSW,SAC,Omri Casspi,135,30.75,30,0.75,64,72,-8,-7,-1
21700296,202691,GSW,SAC,Klay Thompson,145,32.4166666666667,33,-0.583333333333329,73,72,1,0,1
21700296,203110,GSW,SAC,Draymond Green,169,38.9166666666667,39,-0.0833333333333286,81,90,-9,-6,-3
21700296,1626172,GSW,SAC,Kevon Looney,16,4.31666666666667,4,0.316666666666666,7,9,-2,-2,0
21700296,1627775,GSW,SAC,Patrick McCaw,148,33.4833333333333,33,0.483333333333334,75,72,3,2,1
21700296,1628395,GSW,SAC,Jordan Bell,30,6.03333333333333,6,0.0333333333333332,16,13,3,1,2
21700296,1713,SAC,GSW,Vince Carter,77,18.05,18,0.0500000000000007,46,38,8,8,0
21700296,2216,SAC,GSW,Zach Randolph,102,21.4666666666667,22,-0.533333333333335,49,55,-6,-6,0
21700296,201585,SAC,GSW,Kosta Koufos,39,9.63333333333333,10,-0.366666666666667,20,19,1,1,0
21700296,201588,SAC,GSW,George Hill,135,31.2,31,0.199999999999999,75,62,13,11,2
21700296,202066,SAC,GSW,Garrett Temple,135,30.5333333333333,30,0.533333333333331,68,68,0,1,-1
21700296,203992,SAC,GSW,Bogdan Bogdanovic,90,21.6166666666667,22,-0.383333333333333,52,41,11,10,1
21700296,1626161,SAC,GSW,Willie Cauley-Stein,123,29.4666666666667,29,0.466666666666669,66,64,2,4,-2
21700296,1627741,SAC,GSW,Buddy Hield,62,15.1833333333333,15,0.183333333333334,30,38,-8,-8,0
21700296,1627746,SAC,GSW,Skal Labissiere,69,14.7833333333333,15,-0.216666666666665,34,39,-5,-5,0
21700296,1628368,SAC,GSW,De'Aaron Fox,106,23.1333333333333,23,0.133333333333333,52,55,-3,-3,0
21700296,1628412,SAC,GSW,Frank Mason,102,24.85,25,-0.149999999999999,58,51,7,7,0
21700297,101150,LAC,LAL,Lou Williams,184,37.9666666666667,38,-0.0333333333333314,97,79,18,23,-5
21700297,201599,LAC,LAL,DeAndre Jordan,150,30.6666666666667,31,-0.333333333333336,82,66,16,20,-4
21700297,201933,LAC,LAL,Blake Griffin,176,35.8666666666667,36,-0.133333333333333,95,85,10,12,-2
21700297,202325,LAC,LAL,Wesley Johnson,136,28.65,29,-0.350000000000001,70,53,17,17,0
21700297,203085,LAC,LAL,Austin Rivers,179,37.3666666666667,38,-0.63333333333334,94,82,12,10,2
21700297,203186,LAC,LAL,Willie Reed,30,6.48333333333333,6,0.483333333333333,13,15,-2,-4,2
21700297,203710,LAC,LAL,C.J. Williams,85,16,16,0,40,53,-13,-15,2
21700297,1626149,LAC,LAL,Montrezl Harrell,56,10.2833333333333,10,0.283333333333333,25,31,-6,-6,0
21700297,1626155,LAC,LAL,Sam Dekker,77,15.0333333333333,15,0.0333333333333314,31,40,-9,-13,4
21700297,1628393,LAC,LAL,Jawun Evans,51,9.21666666666667,9,0.216666666666667,23,31,-8,-6,-2
21700297,1628414,LAC,LAL,Sindarius Thornwell,66,11.8,12,-0.199999999999999,30,40,-10,-13,3
21700297,101106,LAL,LAC,Andrew Bogut,35,6.7,7,-0.3,21,21,0,0,0
21700297,201147,LAL,LAC,Corey Brewer,52,10.6333333333333,11,-0.366666666666667,29,25,4,1,3
21700297,201572,LAL,LAC,Brook Lopez,74,15.65,16,-0.350000000000001,25,37,-12,-15,3
21700297,203484,LAL,LAC,Kentavious Caldwell-Pope,186,37.2333333333333,37,0.233333333333334,86,95,-9,-6,-3
21700297,203903,LAL,LAC,Jordan Clarkson,125,25.5333333333333,26,-0.466666666666669,66,62,4,3,1
21700297,203944,LAL,LAC,Julius Randle,121,24.4,24,0.399999999999999,66,57,9,11,-2
21700297,1626204,LAL,LAC,Larry Nance Jr.,144,29.3833333333333,30,-0.616666666666667,55,74,-19,-18,-1
21700297,1627742,LAL,LAC,Brandon Ingram,107,22.2833333333333,22,0.283333333333331,35,56,-21,-18,-3
21700297,1628366,LAL,LAC,Lonzo Ball,131,26.1333333333333,26,0.133333333333333,55,67,-12,-12,0
21700297,1628398,LAL,LAC,Kyle Kuzma,102,19.6,20,-0.399999999999999,63,51,12,12,0
21700297,1628404,LAL,LAC,Josh Hart,113,21.7833333333333,22,-0.216666666666669,74,55,19,17,2
21700298,2544,CLE,MIA,LeBron James,137,28.5833333333333,28,0.583333333333336,81,55,26,26,0
21700298,2548,CLE,MIA,Dwyane Wade,128,28.0833333333333,28,0.0833333333333322,56,63,-7,-9,2
21700298,2594,CLE,MIA,Kyle Korver,121,26.2,27,-0.800000000000001,57,53,4,4,0
21700298,2747,CLE,MIA,JR Smith,193,41.8333333333333,42,-0.166666666666664,103,84,19,19,0
21700298,101112,CLE,MIA,Channing Frye,90,20.6833333333333,21,-0.31666666666667,33,44,-11,-10,-1
21700298,101181,CLE,MIA,Jose Calderon,75,16.2333333333333,17,-0.766666666666666,37,29,8,10,-2
21700298,201145,CLE,MIA,Jeff Green,117,26.5,27,-0.5,52,54,-2,-2,0
21700298,201567,CLE,MIA,Kevin Love,124,25.4666666666667,25,0.466666666666669,75,49,26,25,1
21700298,203109,CLE,MIA,Jae Crowder,95,19.9666666666667,20,-0.0333333333333314,46,42,4,4,0
21700298,204066,CLE,MIA,John Holland,6,1.7,2,-0.3,0,4,-4,-4,0
21700298,1626224,CLE,MIA,Cedi Osman,8,2.3,2,0.3,0,4,-4,-4,0
21700298,1627790,CLE,MIA,Ante Zizic,6,1.7,2,-0.3,0,4,-4,-4,0
21700298,2617,MIA,CLE,Udonis Haslem,19,5.35,5,0.35,12,2,10,8,2
21700298,201609,MIA,CLE,Goran Dragic,111,22.9666666666667,23,-0.0333333333333314,45,63,-18,-17,-1
21700298,201949,MIA,CLE,James Johnson,149,31.6666666666667,32,-0.333333333333336,73,80,-7,-7,0
21700298,201961,MIA,CLE,Wayne Ellington,102,23.6333333333333,24,-0.366666666666667,50,40,10,13,-3
21700298,202355,MIA,CLE,Hassan Whiteside,89,18.6833333333333,19,-0.31666666666667,34,40,-6,-5,-1
21700298,203079,MIA,CLE,Dion Waiters,165,34.1666666666667,34,0.166666666666671,67,86,-19,-20,1
21700298,203482,MIA,CLE,Kelly Olynyk,49,10.95,11,-0.0500000000000007,21,28,-7,-5,-2
21700298,204020,MIA,CLE,Tyler Johnson,110,23.8333333333333,24,-0.166666666666668,52,52,0,-1,1
21700298,1626159,MIA,CLE,Justise Winslow,86,19.5833333333333,19,0.583333333333336,29,41,-12,-14,2
21700298,1626196,MIA,CLE,Josh Richardson,129,27.05,27,0.0499999999999972,52,77,-25,-26,1
21700298,1628389,MIA,CLE,Bam Adebayo,80,18.3,18,0.299999999999997,44,31,13,13,0
21700298,1628476,MIA,CLE,Derrick Walton Jr.,11,3.06666666666667,3,0.0666666666666664,6,0,6,6,0
21700299,201577,CHI,PHX,Robin Lopez,156,33.9333333333333,34,-0.0666666666666629,78,72,6,6,0
21700299,203200,CHI,PHX,Justin Holiday,159,34.35,34,0.350000000000001,88,71,17,14,3
21700299,1626170,CHI,PHX,Jerian Grant,97,20.7,21,-0.299999999999997,29,45,-16,-13,-3
21700299,1626171,CHI,PHX,Bobby Portis,83,17.6166666666667,18,-0.383333333333333,34,35,-1,-1,0
21700299,1626245,CHI,PHX,Cristiano Felicio,49,9.83333333333333,10,-0.166666666666666,8,23,-15,-16,1
21700299,1627739,CHI,PHX,Kris Dunn,152,32.5,33,-0.5,76,72,4,2,2
21700299,1627756,CHI,PHX,Denzel Valentine,182,38.7666666666667,39,-0.233333333333334,80,90,-10,-11,1
21700299,1627835,CHI,PHX,Paul Zipser,27,6.1,6,0.0999999999999996,5,11,-6,-6,0
21700299,1628374,CHI,PHX,Lauri Markkanen,158,34.3833333333333,34,0.383333333333333,78,76,2,1,1
21700299,1628469,CHI,PHX,Antonio Blakeney,52,11.2333333333333,11,0.233333333333333,19,20,-1,-1,0
21700299,2199,PHX,CHI,Tyson Chandler,81,18.2166666666667,18,0.216666666666669,42,39,3,4,-1
21700299,203458,PHX,CHI,Alex Len,142,29.6666666666667,30,-0.333333333333332,61,60,1,1,0
21700299,203584,PHX,CHI,Troy Daniels,70,14.8666666666667,15,-0.133333333333333,32,20,12,10,2
21700299,203933,PHX,CHI,T.J. Warren,185,39.9,40,-0.100000000000001,88,81,7,8,-1
21700299,1626164,PHX,CHI,Devin Booker,153,33.0166666666667,33,0.0166666666666657,71,79,-8,-5,-3
21700299,1627733,PHX,CHI,Dragan Bender,107,22.9666666666667,23,-0.033333333333335,43,49,-6,-7,1
21700299,1627737,PHX,CHI,Marquese Chriss,116,24.9166666666667,25,-0.0833333333333357,60,50,10,12,-2
21700299,1627755,PHX,CHI,Tyler Ulis,146,31.4333333333333,31,0.43333333333333,69,70,-1,2,-3
21700299,1628367,PHX,CHI,Josh Jackson,38,7.98333333333333,8,-0.0166666666666666,15,18,-3,-3,0
21700299,1628455,PHX,CHI,Mike James,77,16.45,17,-0.550000000000001,34,29,5,3,2
21700300,2037,MIN,WAS,Jamal Crawford,72,16.1166666666667,16,0.116666666666667,28,41,-13,-13,0
21700300,201166,MIN,WAS,Aaron Brooks,35,8.18333333333333,8,0.183333333333334,11,17,-6,-6,0
21700300,201959,MIN,WAS,Taj Gibson,175,41.2166666666667,41,0.216666666666669,81,77,4,4,0
21700300,202710,MIN,WAS,Jimmy Butler,161,38.3833333333333,38,0.383333333333333,74,62,12,12,0
21700300,203476,MIN,WAS,Gorgui Dieng,65,15.5333333333333,15,0.533333333333331,25,38,-13,-13,0
21700300,203498,MIN,WAS,Shabazz Muhammad,18,4.05,4,0.0499999999999998,2,11,-9,-9,0
21700300,203952,MIN,WAS,Andrew Wiggins,157,37.45,37,0.450000000000003,74,70,4,4,0
21700300,1626145,MIN,WAS,Tyus Jones,169,39.8166666666667,40,-0.183333333333337,78,75,3,3,0
21700300,1626157,MIN,WAS,Karl-Anthony Towns,168,39.25,40,-0.75,72,69,3,3,0
21700300,101133,WAS,MIN,Ian Mahinmi,113,27.0166666666667,26,1.01666666666667,61,43,18,18,0
21700300,101162,WAS,MIN,Marcin Gortat,83,19.5166666666667,20,-0.483333333333334,30,44,-14,-14,0
21700300,201975,WAS,MIN,Jodie Meeks,76,17.0833333333333,17,0.0833333333333322,40,29,11,12,-1
21700300,202693,WAS,MIN,Markieff Morris,84,20.3166666666667,21,-0.683333333333334,25,46,-21,-19,-2
21700300,203078,WAS,MIN,Bradley Beal,144,34.6166666666667,34,0.616666666666667,60,66,-6,-6,0
21700300,203107,WAS,MIN,Tomas Satoransky,94,21.5833333333333,22,-0.416666666666664,52,39,13,12,1
21700300,203118,WAS,MIN,Mike Scott,91,20.4666666666667,20,0.466666666666669,45,31,14,15,-1
21700300,203490,WAS,MIN,Otto Porter Jr.,135,32.2666666666667,32,0.266666666666666,55,62,-7,-8,1
21700300,204025,WAS,MIN,Tim Frazier,62,15.3833333333333,16,-0.616666666666667,20,33,-13,-11,-2
21700300,1626162,WAS,MIN,Kelly Oubre Jr.,138,31.75,31,0.75,72,52,20,16,4
21700301,202702,DEN,UTA,Kenneth Faried,100,22.4666666666667,23,-0.533333333333331,42,47,-5,-5,0
21700301,203115,DEN,UTA,Will Barton,136,31.4333333333333,31,0.43333333333333,49,70,-21,-21,0
21700301,203486,DEN,UTA,Mason Plumlee,69,15.6,16,-0.4,27,31,-4,-4,0
21700301,203914,DEN,UTA,Gary Harris,143,32.8166666666667,33,-0.18333333333333,55,77,-22,-23,1
21700301,203999,DEN,UTA,Nikola Jokic,112,26.2,26,0.199999999999999,43,63,-20,-20,0
21700301,1626144,DEN,UTA,Emmanuel Mudiay,82,18.7666666666667,19,-0.233333333333334,29,37,-8,-8,0
21700301,1626168,DEN,UTA,Trey Lyles,79,18.3,18,0.300000000000001,25,47,-22,-19,-3
21700301,1627736,DEN,UTA,Malik Beasley,47,10.85,11,-0.15,16,24,-8,-7,-1
21700301,1627750,DEN,UTA,Jamal Murray,125,28.9333333333333,29,-0.0666666666666664,48,69,-21,-21,0
21700301,1627823,DEN,UTA,Juancho Hernangomez,116,27.2333333333333,28,-0.766666666666666,44,53,-9,-12,3
21700301,1628470,DEN,UTA,Torrey Craig,26,5.9,6,-0.0999999999999996,7,12,-5,-5,0
21700301,200757,UTA,DEN,Thabo Sefolosha,60,14.4666666666667,15,-0.533333333333333,29,24,5,5,0
21700301,201937,UTA,DEN,Ricky Rubio,123,28.8333333333333,29,-0.166666666666664,68,54,14,14,0
21700301,201973,UTA,DEN,Jonas Jerebko,119,26.85,27,-0.149999999999999,65,44,21,19,2
21700301,202324,UTA,DEN,Derrick Favors,137,32.5,33,-0.5,79,51,28,30,-2
21700301,202327,UTA,DEN,Ekpe Udoh,70,15.2,15,0.199999999999999,27,26,1,-1,2
21700301,202692,UTA,DEN,Alec Burks,92,20.3166666666667,20,0.316666666666666,38,33,5,5,0
21700301,203489,UTA,DEN,Nate Wolters,13,2.38333333333333,3,-0.616666666666667,7,2,5,5,0
21700301,203526,UTA,DEN,Raul Neto,69,16.05,16,0.0499999999999972,31,20,11,11,0
21700301,204060,UTA,DEN,Joe Ingles,127,29.6833333333333,30,-0.316666666666666,58,52,6,9,-3
21700301,1626220,UTA,DEN,Royce O'Neale,87,20.1833333333333,21,-0.816666666666666,53,27,26,23,3
21700301,1628378,UTA,DEN,Donovan Mitchell,126,29.9666666666667,30,-0.0333333333333314,68,50,18,20,-2
21700301,1628396,UTA,DEN,Tony Bradley,12,2.06666666666667,2,0.0666666666666669,7,2,5,5,0
21700302,1891,MIL,SAC,Jason Terry,98,23.0833333333333,23,0.0833333333333357,50,37,13,12,1
21700302,202339,MIL,SAC,Eric Bledsoe,111,23.1833333333333,24,-0.816666666666666,65,40,25,27,-2
21700302,202732,MIL,SAC,DeAndre Liggins,103,24.2333333333333,25,-0.766666666666666,50,51,-1,-1,0
21700302,203089,MIL,SAC,John Henson,111,23.6666666666667,24,-0.333333333333336,64,36,28,28,0
21700302,203114,MIL,SAC,Khris Middleton,106,23.5,24,-0.5,59,39,20,21,-1
21700302,203503,MIL,SAC,Tony Snell,136,29.2166666666667,30,-0.783333333333335,77,46,31,32,-1
21700302,203507,MIL,SAC,Giannis Antetokounmpo,122,25.9333333333333,26,-0.06666666666667,72,45,27,26,1
21700302,1626173,MIL,SAC,Rashad Vaughn,18,3.98333333333333,4,-0.0166666666666666,5,10,-5,-5,0
21700302,1627748,MIL,SAC,Thon Maker,83,19.9333333333333,20,-0.0666666666666664,43,41,2,2,0
21700302,1627762,MIL,SAC,Joel Bolomboy,18,3.98333333333333,4,-0.0166666666666666,5,10,-5,-5,0
21700302,1627763,MIL,SAC,Malcolm Brogdon,83,20.4166666666667,20,0.416666666666668,42,37,5,3,2
21700302,1627780,MIL,SAC,Gary Payton II,18,3.98333333333333,4,-0.0166666666666666,5,10,-5,-5,0
21700302,1628391,MIL,SAC,D.J. Wilson,53,12.8,13,-0.199999999999999,23,33,-10,-10,0
21700302,1713,SAC,MIL,Vince Carter,48,9.63333333333333,9,0.633333333333333,7,23,-16,-16,0
21700302,2216,SAC,MIL,Zach Randolph,90,19.0166666666667,19,0.0166666666666657,36,55,-19,-19,0
21700302,201585,SAC,MIL,Kosta Koufos,63,14.0833333333333,14,0.0833333333333322,19,32,-13,-13,0
21700302,201588,SAC,MIL,George Hill,85,19.5166666666667,20,-0.483333333333334,41,54,-13,-13,0
21700302,202066,SAC,MIL,Garrett Temple,114,24,25,-1,42,67,-25,-26,1
21700302,203992,SAC,MIL,Bogdan Bogdanovic,86,20,20,0,35,44,-9,-8,-1
21700302,1626161,SAC,MIL,Willie Cauley-Stein,108,24.2666666666667,24,0.266666666666666,41,54,-13,-13,0
21700302,1627741,SAC,MIL,Buddy Hield,89,21.25,21,0.25,39,39,0,0,0
21700302,1627746,SAC,MIL,Skal Labissiere,100,23.6,24,-0.399999999999999,53,55,-2,0,-2
21700302,1627781,SAC,MIL,Malachi Richardson,36,8.16666666666667,8,0.166666666666666,21,14,7,5,2
21700302,1628368,SAC,MIL,De'Aaron Fox,110,23.2,24,-0.800000000000001,42,63,-21,-24,3
21700302,1628382,SAC,MIL,Justin Jackson,29,6.8,7,-0.199999999999999,14,11,3,3,0
21700302,1628412,SAC,MIL,Frank Mason,102,24.3833333333333,24,0.383333333333333,45,49,-4,-1,-3
21700303,201162,PHX,DET,Jared Dudley,113,21.6833333333333,22,-0.316666666666666,51,57,-6,-5,-1
21700303,202328,PHX,DET,Greg Monroe,120,24.7833333333333,25,-0.216666666666669,53,67,-14,-13,-1
21700303,203458,PHX,DET,Alex Len,88,16.7166666666667,17,-0.283333333333331,31,51,-20,-21,1
21700303,203584,PHX,DET,Troy Daniels,89,16.9166666666667,17,-0.0833333333333322,31,51,-20,-19,-1
21700303,203933,PHX,DET,T.J. Warren,110,22.9666666666667,23,-0.0333333333333314,50,62,-12,-13,1
21700303,1626164,PHX,DET,Devin Booker,138,27.05,27,0.0500000000000007,57,78,-21,-19,-2
21700303,1627733,PHX,DET,Dragan Bender,89,16.5666666666667,16,0.566666666666666,47,48,-1,-3,2
21700303,1627737,PHX,DET,Marquese Chriss,108,22.65,23,-0.350000000000001,55,52,3,4,-1
21700303,1627755,PHX,DET,Tyler Ulis,107,22.9666666666667,23,-0.0333333333333314,49,64,-15,-15,0
21700303,1628367,PHX,DET,Josh Jackson,167,31.6666666666667,32,-0.333333333333336,76,86,-10,-12,2
21700303,1628455,PHX,DET,Mike James,81,15.8666666666667,16,-0.133333333333333,35,39,-4,-4,0
21700303,201229,DET,PHX,Anthony Tolliver,81,15.75,16,-0.25,43,32,11,11,0
21700303,202340,DET,PHX,Avery Bradley,140,27.9166666666667,28,-0.0833333333333322,77,60,17,15,2
21700303,202397,DET,PHX,Ish Smith,109,20.6,21,-0.399999999999999,64,38,26,25,1
21700303,202699,DET,PHX,Tobias Harris,134,26.7833333333333,27,-0.216666666666669,79,56,23,23,0
21700303,202704,DET,PHX,Reggie Jackson,106,21.9333333333333,22,-0.0666666666666664,58,50,8,9,-1
21700303,203083,DET,PHX,Andre Drummond,141,27.7166666666667,28,-0.283333333333335,79,59,20,18,2
21700303,203493,DET,PHX,Reggie Bullock,27,5.43333333333333,5,0.433333333333334,9,19,-10,-10,0
21700303,203961,DET,PHX,Eric Moreland,74,14.8166666666667,15,-0.183333333333334,43,29,14,16,-2
21700303,204038,DET,PHX,Langston Galloway,102,20.05,20,0.0500000000000007,54,47,7,9,-2
21700303,1626169,DET,PHX,Stanley Johnson,108,21.8166666666667,22,-0.183333333333334,63,42,21,21,0
21700303,1626246,DET,PHX,Boban Marjanovic,27,5.43333333333333,5,0.433333333333334,9,19,-10,-10,0
21700303,1627740,DET,PHX,Henry Ellenson,27,5.43333333333333,5,0.433333333333334,9,19,-10,-10,0
21700303,1628379,DET,PHX,Luke Kennard,134,26.15,26,0.149999999999999,68,65,3,3,0
21700304,201167,ORL,OKC,Arron Afflalo,72,16.1833333333333,16,0.183333333333334,41,21,20,20,0
21700304,201571,ORL,OKC,D.J. Augustin,75,17.05,17,0.0500000000000007,41,23,18,18,0
21700304,202687,ORL,OKC,Bismack Biyombo,76,17.1166666666667,17,0.116666666666667,41,40,1,-1,2
21700304,202696,ORL,OKC,Nikola Vucevic,155,30.6,31,-0.400000000000002,79,68,11,14,-3
21700304,203082,ORL,OKC,Terrence Ross,65,13.7666666666667,14,-0.233333333333334,34,32,2,0,2
21700304,203095,ORL,OKC,Evan Fournier,171,32.8333333333333,33,-0.166666666666664,80,80,0,3,-3
21700304,203613,ORL,OKC,Jonathon Simmons,154,32.65,33,-0.350000000000001,85,83,2,3,-1
21700304,203901,ORL,OKC,Elfrid Payton,156,30.6666666666667,31,-0.333333333333332,79,85,-6,-5,-1
21700304,203932,ORL,OKC,Aaron Gordon,215,43.6666666666667,44,-0.333333333333336,115,99,16,17,-1
21700304,1626209,ORL,OKC,Mario Hezonja,16,4.05,4,0.0499999999999998,5,9,-4,-4,0
21700304,2546,OKC,ORL,Carmelo Anthony,169,33.6833333333333,34,-0.316666666666663,85,87,-2,-3,1
21700304,101109,OKC,ORL,Raymond Felton,69,16.0333333333333,16,0.033333333333335,33,42,-9,-9,0
21700304,201566,OKC,ORL,Russell Westbrook,184,37.5166666666667,38,-0.483333333333334,91,95,-4,-5,1
21700304,202331,OKC,ORL,Paul George,193,40.5666666666667,41,-0.433333333333337,88,99,-11,-12,1
21700304,202335,OKC,ORL,Patrick Patterson,30,7.41666666666667,7,0.416666666666666,13,19,-6,-7,1
21700304,203460,OKC,ORL,Andre Roberson,148,29.5833333333333,30,-0.416666666666664,76,74,2,1,1
21700304,203500,OKC,ORL,Steven Adams,142,27.15,28,-0.850000000000001,68,70,-2,-5,3
21700304,203924,OKC,ORL,Jerami Grant,89,20.5666666666667,20,0.566666666666666,40,50,-10,-8,-2
21700304,1626177,OKC,ORL,Dakari Johnson,29,6.43333333333333,6,0.433333333333334,9,14,-5,-3,-2
21700304,1628390,OKC,ORL,Terrance Ferguson,102,19.6333333333333,20,-0.366666666666667,37,50,-13,-14,1
21700305,101161,PHI,WAS,Amir Johnson,65,13.8666666666667,13,0.866666666666667,25,24,1,1,0
21700305,200755,PHI,WAS,JJ Redick,163,30.3,30,0.299999999999997,74,82,-8,-8,0
21700305,201573,PHI,WAS,Jerryd Bayless,135,25.7333333333333,26,-0.266666666666666,63,60,3,6,-3
21700305,203496,PHI,WAS,Robert Covington,179,34.0333333333333,34,0.0333333333333314,84,80,4,8,-4
21700305,203954,PHI,WAS,Joel Embiid,168,31.6166666666667,32,-0.383333333333333,81,76,5,3,2
21700305,203967,PHI,WAS,Dario Saric,180,31.7833333333333,32,-0.216666666666669,88,83,5,6,-1
21700305,204456,PHI,WAS,T.J. McConnell,74,16.05,16,0.0500000000000007,34,24,10,9,1
21700305,1627732,PHI,WAS,Ben Simmons,219,40.5666666666667,41,-0.433333333333337,101,92,9,11,-2
21700305,1627789,PHI,WAS,Timothe Luwawu-Cabarrot,77,15.9666666666667,16,-0.033333333333335,35,44,-9,-11,2
21700305,101133,WAS,PHI,Ian Mahinmi,141,25.4666666666667,25,0.466666666666669,76,59,17,17,0
21700305,101162,WAS,PHI,Marcin Gortat,101,20.5666666666667,21,-0.433333333333334,35,56,-21,-20,-1
21700305,201975,WAS,PHI,Jodie Meeks,149,26.5833333333333,26,0.583333333333336,78,64,14,11,3
21700305,202693,WAS,PHI,Markieff Morris,79,16.85,17,-0.149999999999999,24,36,-12,-15,3
21700305,203078,WAS,PHI,Bradley Beal,119,22.85,23,-0.149999999999999,53,59,-6,-9,3
21700305,203107,WAS,PHI,Tomas Satoransky,160,28.9333333333333,29,-0.0666666666666664,80,69,11,10,1
21700305,203118,WAS,PHI,Mike Scott,41,8.46666666666667,8,0.466666666666667,14,22,-8,-6,-2
21700305,203490,WAS,PHI,Otto Porter Jr.,128,25.15,25,0.149999999999999,41,65,-24,-22,-2
21700305,204025,WAS,PHI,Tim Frazier,92,19.05,19,0.0499999999999972,33,48,-15,-15,0
21700305,1626162,WAS,PHI,Kelly Oubre Jr.,147,28.6333333333333,29,-0.366666666666667,69,64,5,5,0
21700305,1626191,WAS,PHI,Chris McCullough,103,17.3666666666667,17,0.366666666666667,62,43,19,19,0
21700306,201609,MIA,NYK,Goran Dragic,107,23.1,23,0.100000000000001,36,54,-18,-20,2
21700306,201949,MIA,NYK,James Johnson,85,18.5333333333333,19,-0.466666666666669,38,49,-11,-12,1
21700306,201961,MIA,NYK,Wayne Ellington,127,26.85,27,-0.149999999999999,57,67,-10,-8,-2
21700306,203079,MIA,NYK,Dion Waiters,138,29.95,30,-0.0499999999999972,54,70,-16,-16,0
21700306,203482,MIA,NYK,Kelly Olynyk,121,25.1166666666667,25,0.116666666666667,53,58,-5,-1,-4
21700306,204020,MIA,NYK,Tyler Johnson,135,29.4166666666667,29,0.416666666666664,56,75,-19,-17,-2
21700306,1626159,MIA,NYK,Justise Winslow,79,16.7333333333333,17,-0.266666666666666,23,44,-21,-19,-2
21700306,1626175,MIA,NYK,Jordan Mickey,30,4.85,5,-0.15,9,17,-8,-6,-2
21700306,1626196,MIA,NYK,Josh Richardson,135,29.9833333333333,30,-0.0166666666666657,46,70,-24,-26,2
21700306,1628389,MIA,NYK,Bam Adebayo,127,30.0666666666667,31,-0.933333333333334,49,62,-13,-20,7
21700306,1628476,MIA,NYK,Derrick Walton Jr.,21,3.65,4,-0.35,9,9,0,0,0
21700306,101127,NYK,MIA,Jarrett Jack,109,23.7833333333333,24,-0.216666666666669,58,38,20,24,-4
21700306,201196,NYK,MIA,Ramon Sessions,112,23.8666666666667,24,-0.133333333333333,57,48,9,5,4
21700306,201563,NYK,MIA,Michael Beasley,96,18.7833333333333,19,-0.216666666666669,47,32,15,16,-1
21700306,201584,NYK,MIA,Courtney Lee,131,28.4833333333333,28,0.483333333333334,69,47,22,20,2
21700306,202498,NYK,MIA,Lance Thomas,84,20.9,21,-0.100000000000001,46,36,10,9,1
21700306,202683,NYK,MIA,Enes Kanter,116,25.1833333333333,25,0.183333333333334,62,40,22,24,-2
21700306,203124,NYK,MIA,Kyle O'Quinn,64,14.0166666666667,14,0.0166666666666657,34,30,4,2,2
21700306,203501,NYK,MIA,Tim Hardaway Jr.,137,29.2666666666667,29,0.266666666666666,70,50,20,22,-2
21700306,203926,NYK,MIA,Doug McDermott,133,29.1,29,0.100000000000001,72,59,13,13,0
21700306,204001,NYK,MIA,Kristaps Porzingis,11,2.43333333333333,3,-0.566666666666666,7,5,2,2,0
21700306,1626195,NYK,MIA,Willy Hernangomez,41,8.45,9,-0.550000000000001,19,16,3,3,0
21700306,1627758,NYK,MIA,Ron Baker,41,8.45,9,-0.550000000000001,19,16,3,3,0
21700306,1628422,NYK,MIA,Damyean Dotson,30,5.53333333333333,6,-0.466666666666667,15,13,2,2,0
21700307,101139,TOR,CHA,CJ Miles,80,16.9,17,-0.100000000000001,52,46,6,4,2
21700307,200768,TOR,CHA,Kyle Lowry,168,36.2166666666667,37,-0.783333333333331,92,78,14,10,4
21700307,201586,TOR,CHA,Serge Ibaka,136,29.4333333333333,30,-0.566666666666666,75,65,10,12,-2
21700307,201942,TOR,CHA,DeMar DeRozan,164,35.55,35,0.549999999999997,95,82,13,15,-2
21700307,202685,TOR,CHA,Jonas Valanciunas,100,22.2333333333333,22,0.233333333333334,56,46,10,7,3
21700307,203512,TOR,CHA,Lucas Nogueira,40,8.35,8,0.35,25,14,11,13,-2
21700307,1626181,TOR,CHA,Norman Powell,78,16.6833333333333,17,-0.316666666666666,40,44,-4,-4,0
21700307,1627751,TOR,CHA,Jakob Poeltl,83,17.2166666666667,17,0.216666666666665,45,53,-8,-7,-1
21700307,1627783,TOR,CHA,Pascal Siakam,87,18.3666666666667,18,0.366666666666667,51,48,3,1,2
21700307,1627832,TOR,CHA,Fred VanVleet,87,18.7,19,-0.300000000000001,56,49,7,11,-4
21700307,1628384,TOR,CHA,OG Anunoby,92,19.35,19,0.350000000000001,43,40,3,3,0
21700307,2730,CHA,TOR,Dwight Howard,143,30.9166666666667,31,-0.0833333333333357,64,75,-11,-12,1
21700307,101107,CHA,TOR,Marvin Williams,99,20.5666666666667,20,0.566666666666666,42,46,-4,-4,0
21700307,201587,CHA,TOR,Nicolas Batum,151,32.5833333333333,33,-0.416666666666664,73,80,-7,-8,1
21700307,203077,CHA,TOR,Michael Kidd-Gilchrist,130,27.9,28,-0.100000000000001,59,66,-7,-9,2
21700307,203087,CHA,TOR,Jeremy Lamb,128,28.4833333333333,29,-0.516666666666666,65,83,-18,-17,-1
21700307,203469,CHA,TOR,Cody Zeller,73,15.75,16,-0.25,43,45,-2,-2,0
21700307,203487,CHA,TOR,Michael Carter-Williams,146,32.2,32,0.200000000000003,68,75,-7,-10,3
21700307,203948,CHA,TOR,Johnny O'Bryant III,7,1.13333333333333,1,0.133333333333333,6,6,0,1,-1
21700307,1626163,CHA,TOR,Frank Kaminsky,124,27.2333333333333,28,-0.766666666666666,71,80,-9,-9,0
21700307,1626203,CHA,TOR,Treveon Graham,7,1.13333333333333,1,0.133333333333333,6,6,0,1,-1
21700307,1628370,CHA,TOR,Malik Monk,77,15.6,16,-0.4,45,51,-6,-3,-3
21700307,1628407,CHA,TOR,Dwayne Bacon,30,5.5,6,-0.5,23,17,6,7,-1
21700308,2403,HOU,IND,Nene,45,10.05,10,0.0500000000000007,25,18,7,9,-2
21700308,2772,HOU,IND,Trevor Ariza,117,25.8166666666667,26,-0.183333333333334,64,52,12,12,0
21700308,101108,HOU,IND,Chris Paul,135,29.5833333333333,30,-0.416666666666664,70,56,14,14,0
21700308,200782,HOU,IND,PJ Tucker,95,20.5,21,-0.5,51,45,6,6,0
21700308,201569,HOU,IND,Eric Gordon,122,26.1,26,0.100000000000001,69,57,12,12,0
21700308,201583,HOU,IND,Ryan Anderson,139,30.2333333333333,31,-0.766666666666666,74,61,13,13,0
21700308,201601,HOU,IND,Luc Mbah a Moute,125,25.5666666666667,26,-0.433333333333334,64,51,13,11,2
21700308,201628,HOU,IND,Bobby Brown,11,1.96666666666667,2,-0.0333333333333332,0,5,-5,-5,0
21700308,201935,HOU,IND,James Harden,165,35.55,35,0.549999999999997,97,71,26,26,0
21700308,203991,HOU,IND,Clint Capela,134,28.6166666666667,28,0.616666666666667,76,59,17,17,0
21700308,204028,HOU,IND,Tarik Black,11,1.96666666666667,2,-0.0333333333333332,0,5,-5,-5,0
21700308,1627362,HOU,IND,Briante Weber,11,1.96666666666667,2,-0.0333333333333332,0,5,-5,-5,0
21700308,2863,IND,HOU,Damien Wilkins,11,1.96666666666667,2,-0.0333333333333332,5,0,5,5,0
21700308,201152,IND,HOU,Thaddeus Young,142,31.55,31,0.549999999999997,70,77,-7,-5,-2
21700308,201954,IND,HOU,Darren Collison,147,32.25,32,0.25,65,75,-10,-10,0
21700308,202362,IND,HOU,Lance Stephenson,113,24.7833333333333,25,-0.216666666666669,48,67,-19,-17,-2
21700308,202709,IND,HOU,Cory Joseph,117,24.7833333333333,25,-0.216666666666669,51,58,-7,-7,0
21700308,202711,IND,HOU,Bojan Bogdanovic,149,31.15,31,0.149999999999999,61,81,-20,-22,2
21700308,203506,IND,HOU,Victor Oladipo,160,34.2666666666667,34,0.266666666666666,69,95,-26,-26,0
21700308,1626167,IND,HOU,Myles Turner,149,31.1166666666667,31,0.116666666666667,64,75,-11,-13,2
21700308,1626202,IND,HOU,Joe Young,20,3.86666666666667,4,-0.133333333333334,9,8,1,1,0
21700308,1627734,IND,HOU,Domantas Sabonis,89,19.7166666666667,20,-0.283333333333331,38,51,-13,-13,0
21700308,1628388,IND,HOU,TJ Leaf,13,2.46666666666667,3,-0.533333333333333,5,3,2,2,0
21700309,2749,NOP,MIN,Jameer Nelson,110,27.2666666666667,27,0.266666666666666,54,74,-20,-18,-2
21700309,2754,NOP,MIN,Tony Allen,68,15.6166666666667,16,-0.383333333333333,40,34,6,6,0
21700309,200765,NOP,MIN,Rajon Rondo,128,26.1,27,-0.899999999999999,55,58,-3,-8,5
21700309,201950,NOP,MIN,Jrue Holiday,176,37.7666666666667,38,-0.233333333333334,83,95,-12,-15,3
21700309,201967,NOP,MIN,Dante Cunningham,80,17.4833333333333,18,-0.516666666666666,32,45,-13,-13,0
21700309,202326,NOP,MIN,DeMarcus Cousins,175,38.8,39,-0.200000000000003,84,97,-13,-18,5
21700309,202734,NOP,MIN,E'Twaun Moore,126,26.6166666666667,27,-0.383333333333333,54,68,-14,-13,-1
21700309,203076,NOP,MIN,Anthony Davis,90,17.4666666666667,18,-0.533333333333335,38,41,-3,-1,-2
21700309,203121,NOP,MIN,Darius Miller,103,25.5833333333333,25,0.583333333333332,53,68,-15,-13,-2
21700309,203546,NOP,MIN,Ian Clark,11,2.68333333333333,2,0.683333333333333,7,10,-3,0,-3
21700309,1627767,NOP,MIN,Cheick Diallo,18,3.86666666666667,4,-0.133333333333334,10,10,0,3,-3
21700309,2037,MIN,NOP,Jamal Crawford,110,26.3,26,0.299999999999997,66,59,7,4,3
21700309,201166,MIN,NOP,Aaron Brooks,31,7.06666666666667,7,0.0666666666666664,17,15,2,1,1
21700309,201959,MIN,NOP,Taj Gibson,172,37.8833333333333,38,-0.116666666666667,98,84,14,14,0
21700309,202710,MIN,NOP,Jimmy Butler,152,32.25,33,-0.75,76,62,14,16,-2
21700309,203476,MIN,NOP,Gorgui Dieng,158,36.7833333333333,37,-0.216666666666669,96,81,15,15,0
21700309,203952,MIN,NOP,Andrew Wiggins,169,36.4833333333333,37,-0.516666666666666,95,83,12,13,-1
21700309,1626145,MIN,NOP,Tyus Jones,189,41.45,42,-0.549999999999997,106,87,19,20,-1
21700309,1626157,MIN,NOP,Karl-Anthony Towns,101,20.3666666666667,21,-0.633333333333333,43,39,4,4,0
21700309,1627875,MIN,NOP,Marcus Georges-Hunt,3,0.666666666666667,1,-0.333333333333333,3,0,3,3,0
21700310,1717,DAL,BKN,Dirk Nowitzki,124,26.3333333333333,26,0.333333333333336,66,60,6,8,-2
21700310,2734,DAL,BKN,Devin Harris,117,23.3166666666667,23,0.316666666666666,52,53,-1,0,-1
21700310,200826,DAL,BKN,J.J. Barea,106,21.8833333333333,22,-0.116666666666667,45,49,-4,-4,0
21700310,202083,DAL,BKN,Wesley Matthews,172,35.7666666666667,36,-0.233333333333334,84,85,-1,-1,0
21700310,203084,DAL,BKN,Harrison Barnes,174,36.0166666666667,36,0.0166666666666657,84,85,-1,-1,0
21700310,203481,DAL,BKN,Jeff Withey,1,0.0333333333333333,0,0.0333333333333333,,2,,0,
21700310,203939,DAL,BKN,Dwight Powell,99,20.5666666666667,20,0.566666666666666,35,42,-7,-7,0
21700310,1626257,DAL,BKN,Salah Mejri,31,6.56666666666667,7,-0.433333333333334,9,13,-4,-4,0
21700310,1627812,DAL,BKN,Yogi Ferrell,102,21.5,22,-0.5,38,44,-6,-5,-1
21700310,1628372,DAL,BKN,Dennis Smith Jr.,120,25.3333333333333,25,0.333333333333336,49,59,-10,-10,0
21700310,1628467,DAL,BKN,Maxi Kleber,99,22.4333333333333,23,-0.56666666666667,53,53,0,-1,1
21700310,201960,BKN,DAL,DeMarre Carroll,162,33.5333333333333,34,-0.466666666666669,81,82,-1,-1,0
21700310,202344,BKN,DAL,Trevor Booker,133,27.95,28,-0.0499999999999972,67,61,6,4,2
21700310,203092,BKN,DAL,Tyler Zeller,101,21.4166666666667,22,-0.583333333333336,54,53,1,2,-1
21700310,203112,BKN,DAL,Quincy Acy,95,20.3666666666667,20,0.366666666666667,41,35,6,5,1
21700310,203915,BKN,DAL,Spencer Dinwiddie,160,32.8166666666667,33,-0.183333333333337,80,73,7,6,1
21700310,203925,BKN,DAL,Joe Harris,148,30.0833333333333,30,0.0833333333333357,75,71,4,3,1
21700310,203930,BKN,DAL,Sean Kilpatrick,77,17.15,17,0.149999999999999,34,32,2,2,0
21700310,1627747,BKN,DAL,Caris LeVert,135,28.1,28,0.100000000000001,63,56,7,7,0
21700310,1627785,BKN,DAL,Isaiah Whitehead,57,11.9,12,-0.100000000000001,21,19,2,1,1
21700310,1628386,BKN,DAL,Jarrett Allen,77,16.4333333333333,16,0.433333333333334,29,33,-4,-4,0
21700311,1938,SAS,MEM,Manu Ginobili,104,23.7,24,-0.299999999999997,56,49,7,7,0
21700311,2200,SAS,MEM,Pau Gasol,124,28.6333333333333,29,-0.366666666666667,56,54,2,3,-1
21700311,2225,SAS,MEM,Tony Parker,69,17.6666666666667,18,-0.333333333333332,38,32,6,7,-1
21700311,200746,SAS,MEM,LaMarcus Aldridge,146,36.4,37,-0.600000000000001,86,69,17,16,1
21700311,200752,SAS,MEM,Rudy Gay,90,21.7333333333333,22,-0.266666666666666,46,48,-2,-1,-1
21700311,201980,SAS,MEM,Danny Green,113,27.4666666666667,28,-0.533333333333331,62,47,15,14,1
21700311,201988,SAS,MEM,Patty Mills,116,26.8666666666667,27,-0.133333333333333,62,55,7,4,3
21700311,202722,SAS,MEM,Davis Bertans,2,0.516666666666667,1,-0.483333333333333,0,2,-2,-2,0
21700311,203464,SAS,MEM,Brandon Paul,17,4.36666666666667,4,0.366666666666667,10,9,1,0,1
21700311,203937,SAS,MEM,Kyle Anderson,123,29.15,29,0.149999999999999,64,56,8,7,1
21700311,1627749,SAS,MEM,Dejounte Murray,23,4.78333333333333,5,-0.216666666666667,8,10,-2,-2,0
21700311,1627854,SAS,MEM,Bryn Forbes,83,17.05,17,0.0500000000000007,32,44,-12,-8,-4
21700311,201188,MEM,SAS,Marc Gasol,142,35.2,36,-0.799999999999997,66,83,-17,-14,-3
21700311,201936,MEM,SAS,Tyreke Evans,126,30.3666666666667,31,-0.633333333333333,53,61,-8,-11,3
21700311,203210,MEM,SAS,JaMychal Green,112,27.7,28,-0.300000000000001,52,63,-11,-13,2
21700311,203463,MEM,SAS,Ben McLemore,111,27.2833333333333,27,0.283333333333331,48,58,-10,-11,1
21700311,203516,MEM,SAS,James Ennis III,107,23.5666666666667,23,0.566666666666666,47,51,-4,-2,-2
21700311,1626150,MEM,SAS,Andrew Harrison,109,24.3833333333333,24,0.383333333333333,61,57,4,7,-3
21700311,1626185,MEM,SAS,Jarell Martin,86,19.4666666666667,19,0.466666666666669,42,40,2,3,-1
21700311,1627738,MEM,SAS,Deyonta Davis,64,12.9666666666667,13,-0.0333333333333332,30,22,8,6,2
21700311,1628415,MEM,SAS,Dillon Brooks,131,32.5333333333333,33,-0.466666666666669,61,75,-14,-13,-1
21700311,1628424,MEM,SAS,Kobi Simmons,22,4.86666666666667,5,-0.133333333333333,15,10,5,3,2
21700312,2585,GSW,LAL,Zaza Pachulia,68,13.9333333333333,14,-0.0666666666666664,39,29,10,11,-1
21700312,2733,GSW,LAL,Shaun Livingston,44,9.68333333333333,10,-0.316666666666666,19,23,-4,-4,0
21700312,2738,GSW,LAL,Andre Iguodala,164,35.0333333333333,35,0.0333333333333314,77,81,-4,-5,1
21700312,201142,GSW,LAL,Kevin Durant,207,42.1666666666667,42,0.166666666666671,108,100,8,8,0
21700312,201156,GSW,LAL,Nick Young,66,13.5833333333333,14,-0.416666666666666,31,27,4,4,0
21700312,201939,GSW,LAL,Stephen Curry,194,39.7166666666667,39,0.716666666666669,98,94,4,4,0
21700312,202691,GSW,LAL,Klay Thompson,186,39.15,39,0.149999999999999,96,92,4,4,0
21700312,203110,GSW,LAL,Draymond Green,179,38.4166666666667,38,0.416666666666671,89,92,-3,-2,-1
21700312,1626172,GSW,LAL,Kevon Looney,64,13.0166666666667,13,0.0166666666666657,25,28,-3,-3,0
21700312,1627775,GSW,LAL,Patrick McCaw,47,8.18333333333333,8,0.183333333333334,21,23,-2,-2,0
21700312,1628395,GSW,LAL,Jordan Bell,61,11.95,12,-0.0500000000000007,32,26,6,5,1
21700312,101106,LAL,GSW,Andrew Bogut,23,5.45,5,0.449999999999999,12,10,2,2,0
21700312,201147,LAL,GSW,Corey Brewer,54,12.0666666666667,12,0.0666666666666664,29,25,4,4,0
21700312,201572,LAL,GSW,Brook Lopez,82,16.65,17,-0.350000000000001,32,45,-13,-15,2
21700312,203484,LAL,GSW,Kentavious Caldwell-Pope,206,41.3666666666667,42,-0.633333333333333,101,100,1,1,0
21700312,203903,LAL,GSW,Jordan Clarkson,168,35.45,36,-0.549999999999997,85,80,5,8,-3
21700312,203944,LAL,GSW,Julius Randle,145,31.3333333333333,31,0.333333333333336,78,69,9,11,-2
21700312,1626204,LAL,GSW,Larry Nance Jr.,116,22.4833333333333,22,0.483333333333334,49,60,-11,-11,0
21700312,1627742,LAL,GSW,Brandon Ingram,215,43.95,44,-0.0499999999999972,102,110,-8,-8,0
21700312,1628366,LAL,GSW,Lonzo Ball,212,43.2833333333333,43,0.283333333333331,100,108,-8,-8,0
21700312,1628404,LAL,GSW,Josh Hart,59,12.8,13,-0.199999999999999,27,28,-1,-4,3
21700313,101141,ATL,CLE,Ersan Ilyasova,141,30.1666666666667,30,0.166666666666664,74,70,4,7,-3
21700313,201158,ATL,CLE,Marco Belinelli,133,28.3666666666667,28,0.366666666666667,67,65,2,3,-1
21700313,202337,ATL,CLE,Luke Babbitt,81,18.2666666666667,18,0.266666666666666,47,61,-14,-11,-3
21700313,203101,ATL,CLE,Miles Plumlee,19,3.46666666666667,4,-0.533333333333333,12,2,10,7,3
21700313,203145,ATL,CLE,Kent Bazemore,138,31.1,32,-0.899999999999999,70,78,-8,-6,-2
21700313,203471,ATL,CLE,Dennis Schroder,145,32.85,33,-0.149999999999999,72,82,-10,-10,0
21700313,1627752,ATL,CLE,Taurean Prince,125,28.45,28,0.449999999999999,68,68,0,-8,8
21700313,1627761,ATL,CLE,DeAndre' Bembry,101,21.1333333333333,21,0.133333333333333,52,57,-5,-3,-2
21700313,1627819,ATL,CLE,Isaiah Taylor,76,14.9666666666667,15,-0.033333333333335,42,39,3,3,0
21700313,1628381,ATL,CLE,John Collins,117,25.1833333333333,26,-0.81666666666667,57,64,-7,-7,0
21700313,1628463,ATL,CLE,Tyler Cavanaugh,29,5.13333333333333,5,0.133333333333333,9,19,-10,-10,0
21700313,2544,CLE,ATL,LeBron James,172,37.5833333333333,38,-0.416666666666664,93,86,7,10,-3
21700313,2548,CLE,ATL,Dwyane Wade,112,22.1333333333333,23,-0.866666666666667,53,53,0,0,0
21700313,2594,CLE,ATL,Kyle Korver,104,21.2666666666667,21,0.266666666666666,44,48,-4,-2,-2
21700313,2747,CLE,ATL,JR Smith,158,34.9166666666667,35,-0.0833333333333286,89,79,10,10,0
21700313,101112,CLE,ATL,Channing Frye,58,12.2166666666667,13,-0.783333333333335,32,30,2,-3,5
21700313,101181,CLE,ATL,Jose Calderon,84,18.0166666666667,18,0.0166666666666657,45,50,-5,-3,-2
21700313,201145,CLE,ATL,Jeff Green,87,19.4166666666667,19,0.416666666666664,55,46,9,9,0
21700313,201567,CLE,ATL,Kevin Love,148,33.55,33,0.549999999999997,87,77,10,12,-2
21700313,203109,CLE,ATL,Jae Crowder,125,28.6833333333333,29,-0.31666666666667,79,68,11,7,4
21700313,1626224,CLE,ATL,Cedi Osman,57,11.3,11,0.300000000000001,28,33,-5,-5,0
21700314,201143,BOS,PHI,Al Horford,151,33.4833333333333,34,-0.516666666666666,83,73,10,10,0
21700314,202681,BOS,PHI,Kyrie Irving,152,32.4166666666667,33,-0.583333333333336,74,74,0,2,-2
21700314,202694,BOS,PHI,Marcus Morris,137,28.3833333333333,28,0.383333333333333,65,53,12,13,-1
21700314,203382,BOS,PHI,Aron Baynes,57,13.4666666666667,14,-0.533333333333333,27,25,2,2,0
21700314,203935,BOS,PHI,Marcus Smart,156,32.2833333333333,33,-0.716666666666669,81,66,15,15,0
21700314,1626179,BOS,PHI,Terry Rozier,87,18.7333333333333,20,-1.26666666666667,42,32,10,13,-3
21700314,1627759,BOS,PHI,Jaylen Brown,103,22.1166666666667,22,0.116666666666667,38,48,-10,-9,-1
21700314,1628369,BOS,PHI,Jayson Tatum,121,27.3666666666667,28,-0.633333333333333,67,60,7,7,0
21700314,1628400,BOS,PHI,Semi Ojeleye,67,15.4333333333333,16,-0.566666666666666,34,30,4,1,3
21700314,1628464,BOS,PHI,Daniel Theis,69,14.0666666666667,14,0.0666666666666664,24,24,0,1,-1
21700314,101161,PHI,BOS,Amir Johnson,98,21.2333333333333,22,-0.766666666666666,39,46,-7,-6,-1
21700314,200755,PHI,BOS,JJ Redick,151,32.6,33,-0.399999999999999,68,69,-1,-2,1
21700314,201573,PHI,BOS,Jerryd Bayless,152,32.2333333333333,32,0.233333333333334,68,82,-14,-15,1
21700314,203496,PHI,BOS,Robert Covington,137,31.4666666666667,32,-0.533333333333331,64,71,-7,-8,1
21700314,203917,PHI,BOS,Nik Stauskas,48,9.28333333333333,10,-0.716666666666667,18,13,5,5,0
21700314,203967,PHI,BOS,Dario Saric,154,33.9833333333333,35,-1.01666666666667,74,75,-1,-1,0
21700314,1626158,PHI,BOS,Richaun Holmes,97,20.4166666666667,20,0.416666666666664,40,43,-3,-5,2
21700314,1627732,PHI,BOS,Ben Simmons,179,39.2166666666667,40,-0.783333333333331,82,92,-10,-10,0
21700314,1627789,PHI,BOS,Timothe Luwawu-Cabarrot,84,17.3166666666667,17,0.316666666666666,32,44,-12,-13,1
21700315,201577,CHI,DEN,Robin Lopez,152,34.0833333333333,34,0.0833333333333286,78,80,-2,0,-2
21700315,203200,CHI,DEN,Justin Holiday,170,37.0833333333333,37,0.0833333333333286,95,92,3,3,0
21700315,1626170,CHI,DEN,Jerian Grant,103,22.6333333333333,23,-0.366666666666667,50,54,-4,-4,0
21700315,1626171,CHI,DEN,Bobby Portis,84,17.5333333333333,17,0.533333333333331,44,43,1,-3,4
21700315,1627739,CHI,DEN,Kris Dunn,117,26.65,27,-0.350000000000001,62,61,1,1,0
21700315,1627756,CHI,DEN,Denzel Valentine,176,39.3333333333333,40,-0.666666666666671,82,82,0,2,-2
21700315,1627835,CHI,DEN,Paul Zipser,79,17.55,17,0.550000000000001,43,40,3,1,2
21700315,1628374,CHI,DEN,Lauri Markkanen,138,31.6,32,-0.399999999999999,70,72,-2,0,-2
21700315,1628469,CHI,DEN,Antonio Blakeney,61,13.2833333333333,13,0.283333333333333,26,31,-5,-5,0
21700315,2210,DEN,CHI,Richard Jefferson,53,12.3833333333333,12,0.383333333333333,24,25,-1,-1,0
21700315,202702,DEN,CHI,Kenneth Faried,101,22.1,22,0.100000000000001,51,52,-1,-3,2
21700315,203115,DEN,CHI,Will Barton,165,35.25,35,0.25,93,82,11,12,-1
21700315,203486,DEN,CHI,Mason Plumlee,90,20.5166666666667,20,0.516666666666666,43,47,-4,-2,-2
21700315,203914,DEN,CHI,Gary Harris,177,39.8666666666667,40,-0.133333333333333,93,83,10,10,0
21700315,203999,DEN,CHI,Nikola Jokic,70,15.9166666666667,16,-0.0833333333333339,38,44,-6,-6,0
21700315,1626144,DEN,CHI,Emmanuel Mudiay,81,17.35,17,0.350000000000001,40,42,-2,-1,-1
21700315,1626168,DEN,CHI,Trey Lyles,102,22.4166666666667,22,0.416666666666664,50,50,0,0,0
21700315,1627750,DEN,CHI,Jamal Murray,135,30.6,31,-0.399999999999999,71,68,3,2,1
21700315,1627823,DEN,CHI,Juancho Hernangomez,106,23.35,23,0.350000000000001,52,57,-5,-6,1
21700316,1891,MIL,POR,Jason Terry,74,17.5666666666667,18,-0.433333333333334,32,36,-4,-5,1
21700316,202339,MIL,POR,Eric Bledsoe,135,28.2833333333333,28,0.283333333333331,71,50,21,21,0
21700316,202732,MIL,POR,DeAndre Liggins,92,21.1,21,0.100000000000001,33,43,-10,-12,2
21700316,203089,MIL,POR,John Henson,142,30.1166666666667,30,0.116666666666667,68,51,17,19,-2
21700316,203114,MIL,POR,Khris Middleton,159,35.0833333333333,35,0.0833333333333286,80,65,15,15,0
21700316,203503,MIL,POR,Tony Snell,130,28.1,28,0.100000000000001,72,51,21,21,0
21700316,203507,MIL,POR,Giannis Antetokounmpo,169,36.9333333333333,37,-0.06666666666667,85,66,19,21,-2
21700316,1626173,MIL,POR,Rashad Vaughn,4,0.783333333333333,1,-0.216666666666667,0,4,-4,-4,0
21700316,1627748,MIL,POR,Thon Maker,71,16.9333333333333,17,-0.0666666666666664,35,36,-1,-3,2
21700316,1627762,MIL,POR,Joel Bolomboy,4,0.783333333333333,1,-0.216666666666667,0,4,-4,-4,0
21700316,1627763,MIL,POR,Malcolm Brogdon,97,21.9166666666667,22,-0.0833333333333357,39,41,-2,-1,-1
21700316,1627780,MIL,POR,Gary Payton II,4,0.783333333333333,1,-0.216666666666667,0,4,-4,-4,0
21700316,1628391,MIL,POR,D.J. Wilson,4,0.783333333333333,1,-0.216666666666667,0,4,-4,-4,0
21700316,202323,POR,MIL,Evan Turner,121,26.8666666666667,27,-0.133333333333333,52,50,2,1,1
21700316,202329,POR,MIL,Al-Farouq Aminu,98,22.0166666666667,22,0.0166666666666657,46,45,1,-1,2
21700316,202334,POR,MIL,Ed Davis,33,8.03333333333333,8,0.0333333333333332,15,19,-4,-5,1
21700316,203081,POR,MIL,Damian Lillard,180,39.2833333333333,40,-0.716666666666669,73,88,-15,-12,-3
21700316,203086,POR,MIL,Meyers Leonard,32,8.25,8,0.25,17,18,-1,1,-2
21700316,203090,POR,MIL,Maurice Harkless,28,5.9,6,-0.0999999999999996,11,17,-6,-6,0
21700316,203468,POR,MIL,CJ McCollum,185,41.35,41,0.349999999999994,75,88,-13,-15,2
21700316,203894,POR,MIL,Shabazz Napier,66,15.4166666666667,16,-0.583333333333332,33,29,4,4,0
21700316,203943,POR,MIL,Noah Vonleh,105,22.7166666666667,23,-0.283333333333331,39,54,-15,-13,-2
21700316,203994,POR,MIL,Jusuf Nurkic,152,31.55,32,-0.450000000000003,59,66,-7,-8,1
21700316,1626192,POR,MIL,Pat Connaughton,75,15.6833333333333,16,-0.316666666666666,27,41,-14,-14,0
21700316,1627774,POR,MIL,Jake Layman,5,1.05,1,0.0499999999999998,4,0,4,4,0
21700316,1628380,POR,MIL,Zach Collins,5,1.05,1,0.0499999999999998,4,0,4,4,0
21700317,101150,LAC,UTA,Lou Williams,168,36.7,37,-0.299999999999997,92,99,-7,-5,-2
21700317,201599,LAC,UTA,DeAndre Jordan,139,30.8166666666667,31,-0.183333333333337,73,83,-10,-9,-1
21700317,202325,LAC,UTA,Wesley Johnson,148,32.5833333333333,33,-0.416666666666671,78,86,-8,-7,-1
21700317,203085,LAC,UTA,Austin Rivers,158,35.3166666666667,36,-0.683333333333337,82,97,-15,-14,-1
21700317,203186,LAC,UTA,Willie Reed,62,13.6666666666667,14,-0.333333333333334,27,36,-9,-10,1
21700317,203710,LAC,UTA,C.J. Williams,83,18,18,0,27,48,-21,-24,3
21700317,203966,LAC,UTA,Jamil Wilson,19,4.8,5,-0.2,10,11,-1,-1,0
21700317,1626149,LAC,UTA,Montrezl Harrell,91,20.5333333333333,21,-0.466666666666669,59,54,5,5,0
21700317,1626155,LAC,UTA,Sam Dekker,93,20.2333333333333,20,0.233333333333334,36,52,-16,-16,0
21700317,1627744,LAC,UTA,Brice Johnson,14,3.3,3,0.3,7,7,0,0,0
21700317,1628393,LAC,UTA,Jawun Evans,53,11.7166666666667,12,-0.283333333333333,21,28,-7,-9,2
21700317,1628414,LAC,UTA,Sindarius Thornwell,47,11.25,11,0.25,23,29,-6,-5,-1
21700317,200757,UTA,LAC,Thabo Sefolosha,105,22.9,23,-0.100000000000001,63,49,14,14,0
21700317,201937,UTA,LAC,Ricky Rubio,128,27.25,27,0.25,71,73,-2,-3,1
21700317,201973,UTA,LAC,Jonas Jerebko,110,24.8833333333333,25,-0.116666666666667,63,58,5,5,0
21700317,202324,UTA,LAC,Derrick Favors,121,27.3666666666667,28,-0.633333333333333,70,64,6,7,-1
21700317,202327,UTA,LAC,Ekpe Udoh,94,20.4166666666667,20,0.416666666666664,56,43,13,12,1
21700317,202692,UTA,LAC,Alec Burks,130,29.4833333333333,29,0.483333333333334,80,49,31,30,1
21700317,203489,UTA,LAC,Nate Wolters,6,1.16666666666667,1,0.166666666666667,2,3,-1,-1,0
21700317,204060,UTA,LAC,Joe Ingles,120,26.8,27,-0.200000000000003,69,69,0,2,-2
21700317,1626220,UTA,LAC,Royce O'Neale,95,20.9833333333333,21,-0.0166666666666657,57,38,19,17,2
21700317,1628378,UTA,LAC,Donovan Mitchell,160,36.5,36,0.5,97,86,11,13,-2
21700317,1628396,UTA,LAC,Tony Bradley,6,1.16666666666667,1,0.166666666666667,2,3,-1,-1,0
21700318,2561,GSW,ORL,David West,48,10.9833333333333,11,-0.0166666666666657,23,20,3,3,0
21700318,2585,GSW,ORL,Zaza Pachulia,75,15.05,15,0.0500000000000007,46,35,11,11,0
21700318,2733,GSW,ORL,Shaun Livingston,80,16.0333333333333,16,0.0333333333333314,39,36,3,3,0
21700318,201142,GSW,ORL,Kevin Durant,152,30.3833333333333,30,0.383333333333333,89,81,8,6,2
21700318,201156,GSW,ORL,Nick Young,11,2.3,2,0.3,3,2,1,1,0
21700318,201580,GSW,ORL,JaVale McGee,11,2.3,2,0.3,3,2,1,1,0
21700318,201939,GSW,ORL,Stephen Curry,173,33.2833333333333,33,0.283333333333331,105,86,19,19,0
21700318,201956,GSW,ORL,Omri Casspi,95,19.9666666666667,20,-0.0333333333333314,45,42,3,3,0
21700318,202691,GSW,ORL,Klay Thompson,166,34.6833333333333,35,-0.31666666666667,99,79,20,18,2
21700318,203110,GSW,ORL,Draymond Green,167,33.7,34,-0.299999999999997,106,74,32,34,-2
21700318,1626172,GSW,ORL,Kevon Looney,11,2.3,2,0.3,3,2,1,1,0
21700318,1627775,GSW,ORL,Patrick McCaw,114,21.9833333333333,22,-0.0166666666666657,62,56,6,8,-2
21700318,1628395,GSW,ORL,Jordan Bell,87,15.8666666666667,16,-0.133333333333333,42,45,-3,-3,0
21700318,201167,ORL,GSW,Arron Afflalo,87,17.8166666666667,18,-0.183333333333334,33,42,-9,-9,0
21700318,201571,ORL,GSW,D.J. Augustin,89,18.45,18,0.450000000000003,36,48,-12,-12,0
21700318,202687,ORL,GSW,Bismack Biyombo,78,16.7666666666667,16,0.766666666666666,34,36,-2,-4,2
21700318,202696,ORL,GSW,Nikola Vucevic,132,25.4666666666667,26,-0.533333333333331,68,81,-13,-11,-2
21700318,202714,ORL,GSW,Shelvin Mack,16,3.25,3,0.25,4,5,-1,-1,0
21700318,203095,ORL,GSW,Evan Fournier,163,32.5333333333333,33,-0.466666666666669,87,99,-12,-12,0
21700318,203613,ORL,GSW,Jonathon Simmons,195,39.25,39,0.25,93,111,-18,-18,0
21700318,203901,ORL,GSW,Elfrid Payton,148,28.75,29,-0.25,79,89,-10,-10,0
21700318,203920,ORL,GSW,Khem Birch,16,3.25,3,0.25,4,5,-1,-1,0
21700318,203932,ORL,GSW,Aaron Gordon,186,36.65,37,-0.350000000000001,96,114,-18,-18,0
21700318,1626209,ORL,GSW,Mario Hezonja,64,13.4,14,-0.600000000000001,22,30,-8,-8,0
21700318,1628411,ORL,GSW,Wes Iwundu,16,3.25,3,0.25,4,5,-1,-1,0
21700319,201152,IND,TOR,Thaddeus Young,163,32.85,33,-0.150000000000006,77,88,-11,-9,-2
21700319,201954,IND,TOR,Darren Collison,177,33.6,34,-0.399999999999999,78,85,-7,-7,0
21700319,202362,IND,TOR,Lance Stephenson,104,18.5,19,-0.5,40,50,-10,-10,0
21700319,202709,IND,TOR,Cory Joseph,114,21.85,22,-0.149999999999999,48,57,-9,-11,2
21700319,202711,IND,TOR,Bojan Bogdanovic,177,35.2666666666667,35,0.266666666666666,87,82,5,7,-2
21700319,203506,IND,TOR,Victor Oladipo,198,39,39,0,102,92,10,10,0
21700319,1626167,IND,TOR,Myles Turner,171,33.85,34,-0.149999999999999,85,77,8,7,1
21700319,1627734,IND,TOR,Domantas Sabonis,111,20.6166666666667,20,0.616666666666667,50,53,-3,-4,1
21700319,1628388,IND,TOR,TJ Leaf,25,4.46666666666667,4,0.466666666666667,8,16,-8,-8,0
21700319,101139,TOR,IND,CJ Miles,92,16.2,16,0.199999999999999,42,38,4,5,-1
21700319,200768,TOR,IND,Kyle Lowry,174,35.1833333333333,35,0.18333333333333,83,89,-6,-5,-1
21700319,201586,TOR,IND,Serge Ibaka,128,25.2166666666667,25,0.216666666666665,66,64,2,0,2
21700319,201942,TOR,IND,DeMar DeRozan,171,33.8833333333333,34,-0.116666666666667,79,83,-4,-4,0
21700319,202685,TOR,IND,Jonas Valanciunas,100,21.0666666666667,21,0.0666666666666664,57,50,7,5,2
21700319,1626181,TOR,IND,Norman Powell,80,14.9166666666667,15,-0.0833333333333322,41,34,7,7,0
21700319,1627751,TOR,IND,Jakob Poeltl,134,25.1833333333333,25,0.183333333333334,59,61,-2,0,-2
21700319,1627783,TOR,IND,Pascal Siakam,134,24.5333333333333,24,0.533333333333331,58,55,3,5,-2
21700319,1627832,TOR,IND,Fred VanVleet,134,24.25,24,0.25,61,53,8,9,-1
21700319,1628384,TOR,IND,OG Anunoby,93,19.5666666666667,20,-0.433333333333334,54,48,6,3,3
21700320,101133,WAS,DET,Ian Mahinmi,66,14.65,15,-0.350000000000001,29,33,-4,-4,0
21700320,101162,WAS,DET,Marcin Gortat,148,31.5166666666667,32,-0.483333333333334,78,56,22,22,0
21700320,201975,WAS,DET,Jodie Meeks,69,14.0833333333333,14,0.0833333333333322,33,31,2,2,0
21700320,202693,WAS,DET,Markieff Morris,124,26.95,28,-1.05,65,49,16,18,-2
21700320,203078,WAS,DET,Bradley Beal,148,32.75,33,-0.25,73,65,8,9,-1
21700320,203107,WAS,DET,Tomas Satoransky,109,22.65,23,-0.350000000000001,55,41,14,14,0
21700320,203118,WAS,DET,Mike Scott,62,14.1666666666667,14,0.166666666666668,31,28,3,1,2
21700320,203490,WAS,DET,Otto Porter Jr.,152,32.4833333333333,33,-0.516666666666666,77,63,14,16,-2
21700320,204025,WAS,DET,Tim Frazier,101,23.3666666666667,24,-0.633333333333333,55,38,17,16,1
21700320,1626162,WAS,DET,Kelly Oubre Jr.,111,23.55,24,-0.450000000000003,46,49,-3,-4,1
21700320,1626191,WAS,DET,Chris McCullough,10,2.16666666666667,2,0.166666666666667,3,2,1,0,1
21700320,201229,DET,WAS,Anthony Tolliver,114,24.5,25,-0.5,48,60,-12,-12,0
21700320,202340,DET,WAS,Avery Bradley,149,34.1333333333333,34,0.133333333333333,66,73,-7,-10,3
21700320,202397,DET,WAS,Ish Smith,103,22.3166666666667,22,0.31666666666667,36,48,-12,-14,2
21700320,202699,DET,WAS,Tobias Harris,126,27.1833333333333,27,0.183333333333334,55,62,-7,-5,-2
21700320,202704,DET,WAS,Reggie Jackson,117,25.35,26,-0.649999999999999,55,61,-6,-4,-2
21700320,203083,DET,WAS,Andre Drummond,164,36.7333333333333,37,-0.266666666666666,73,82,-9,-11,2
21700320,203961,DET,WAS,Eric Moreland,24,5.25,5,0.25,5,14,-9,-7,-2
21700320,204038,DET,WAS,Langston Galloway,59,12.15,12,0.15,19,31,-12,-11,-1
21700320,1626169,DET,WAS,Stanley Johnson,110,23.9166666666667,24,-0.0833333333333357,41,53,-12,-12,0
21700320,1626246,DET,WAS,Boban Marjanovic,32,5.68333333333333,6,-0.316666666666666,13,13,0,0,0
21700320,1627740,DET,WAS,Henry Ellenson,16,2.91666666666667,3,-0.083333333333333,5,6,-1,-1,0
21700320,1628379,DET,WAS,Luke Kennard,86,18.2,18,0.199999999999999,39,42,-3,-3,0
21700321,201609,MIA,CHA,Goran Dragic,137,27.3,28,-0.699999999999999,52,58,-6,-7,1
21700321,201949,MIA,CHA,James Johnson,133,28.5666666666667,29,-0.433333333333334,67,50,17,17,0
21700321,201961,MIA,CHA,Wayne Ellington,77,17.9,18,-0.100000000000001,40,33,7,9,-2
21700321,203079,MIA,CHA,Dion Waiters,148,29.45,30,-0.549999999999997,65,65,0,0,0
21700321,203482,MIA,CHA,Kelly Olynyk,134,30.0833333333333,30,0.0833333333333357,74,58,16,18,-2
21700321,204020,MIA,CHA,Tyler Johnson,95,22.1833333333333,22,0.183333333333334,53,44,9,10,-1
21700321,1626159,MIA,CHA,Justise Winslow,145,31.4,32,-0.600000000000001,60,74,-14,-16,2
21700321,1626196,MIA,CHA,Josh Richardson,169,34.8666666666667,35,-0.133333333333333,83,76,7,7,0
21700321,1628389,MIA,CHA,Bam Adebayo,92,17.8333333333333,18,-0.166666666666664,31,42,-11,-13,2
21700321,2730,CHA,MIA,Dwight Howard,85,16.6,17,-0.399999999999999,32,28,4,3,1
21700321,101107,CHA,MIA,Marvin Williams,154,32.15,32,0.149999999999999,67,71,-4,-4,0
21700321,201587,CHA,MIA,Nicolas Batum,170,34.8666666666667,35,-0.133333333333333,77,71,6,6,0
21700321,203077,CHA,MIA,Michael Kidd-Gilchrist,164,35.8666666666667,35,0.86666666666666,78,80,-2,-4,2
21700321,203087,CHA,MIA,Jeremy Lamb,118,25.1,25,0.100000000000001,45,59,-14,-12,-2
21700321,203469,CHA,MIA,Cody Zeller,141,31.3166666666667,31,0.316666666666666,68,77,-9,-8,-1
21700321,203487,CHA,MIA,Michael Carter-Williams,138,27.65,28,-0.350000000000001,60,60,0,0,0
21700321,1626163,CHA,MIA,Frank Kaminsky,72,15.7666666666667,16,-0.233333333333334,33,34,-1,-1,0
21700321,1628370,CHA,MIA,Malik Monk,88,20.2666666666667,20,0.266666666666666,40,45,-5,-5,0
21700322,201577,CHI,SAC,Robin Lopez,130,29.5333333333333,29,0.533333333333331,60,66,-6,-4,-2
21700322,203200,CHI,SAC,Justin Holiday,162,36.6,36,0.600000000000001,73,82,-9,-9,0
21700322,1626170,CHI,SAC,Jerian Grant,116,26.85,27,-0.149999999999999,68,55,13,13,0
21700322,1626245,CHI,SAC,Cristiano Felicio,74,16.35,16,0.350000000000001,43,39,4,4,0
21700322,1627739,CHI,SAC,Kris Dunn,122,27.7166666666667,28,-0.283333333333331,51,67,-16,-16,0
21700322,1627756,CHI,SAC,Denzel Valentine,114,25.4,26,-0.600000000000001,54,60,-6,-6,0
21700322,1627835,CHI,SAC,Paul Zipser,100,23.3833333333333,23,0.383333333333333,55,47,8,6,2
21700322,1628021,CHI,SAC,David Nwaba,95,22.25,22,0.25,58,43,15,16,-1
21700322,1628374,CHI,SAC,Lauri Markkanen,120,27.55,28,-0.449999999999999,54,64,-10,-11,1
21700322,1628469,CHI,SAC,Antonio Blakeney,22,4.36666666666667,5,-0.633333333333333,14,12,2,2,0
21700322,1713,SAC,CHI,Vince Carter,52,11.8833333333333,12,-0.116666666666667,26,22,4,4,0
21700322,2216,SAC,CHI,Zach Randolph,139,31.6,32,-0.399999999999999,73,65,8,10,-2
21700322,201585,SAC,CHI,Kosta Koufos,65,14.2833333333333,14,0.283333333333333,32,38,-6,-8,2
21700322,201588,SAC,CHI,George Hill,102,25.2333333333333,26,-0.766666666666666,51,54,-3,-1,-2
21700322,202066,SAC,CHI,Garrett Temple,160,36.5666666666667,37,-0.43333333333333,85,74,11,11,0
21700322,203992,SAC,CHI,Bogdan Bogdanovic,136,31.0166666666667,30,1.01666666666667,66,67,-1,-3,2
21700322,1626161,SAC,CHI,Willie Cauley-Stein,105,23.65,24,-0.350000000000001,51,60,-9,-9,0
21700322,1627741,SAC,CHI,Buddy Hield,38,7.43333333333333,7,0.433333333333334,18,24,-6,-6,0
21700322,1627746,SAC,CHI,Skal Labissiere,61,14.5833333333333,15,-0.416666666666666,32,27,5,5,0
21700322,1628368,SAC,CHI,De'Aaron Fox,123,28.05,28,0.0499999999999972,64,57,7,8,-1
21700322,1628412,SAC,CHI,Frank Mason,74,15.7,16,-0.300000000000001,37,42,-5,-6,1
21700323,1938,SAS,MEM,Manu Ginobili,100,24.7,25,-0.300000000000001,63,30,33,30,3
21700323,2200,SAS,MEM,Pau Gasol,118,28.9,29,-0.100000000000001,47,45,2,9,-7
21700323,2225,SAS,MEM,Tony Parker,63,16.0333333333333,16,0.0333333333333314,31,24,7,4,3
21700323,200746,SAS,MEM,LaMarcus Aldridge,133,32.0666666666667,32,0.0666666666666629,61,52,9,10,-1
21700323,200752,SAS,MEM,Rudy Gay,79,20.0333333333333,20,0.0333333333333314,40,31,9,7,2
21700323,201980,SAS,MEM,Danny Green,116,28.3333333333333,29,-0.666666666666668,52,39,13,13,0
21700323,201988,SAS,MEM,Patty Mills,91,21.9333333333333,22,-0.0666666666666664,47,35,12,15,-3
21700323,202722,SAS,MEM,Davis Bertans,16,2.8,3,-0.2,2,9,-7,-7,0
21700323,203464,SAS,MEM,Brandon Paul,22,4.13333333333333,4,0.133333333333333,4,11,-7,-7,0
21700323,203530,SAS,MEM,Joffrey Lauvergne,43,9.46666666666667,9,0.466666666666667,21,20,1,-2,3
21700323,203937,SAS,MEM,Kyle Anderson,96,22.5166666666667,23,-0.483333333333334,50,44,6,6,0
21700323,1627749,SAS,MEM,Dejounte Murray,47,9.93333333333333,10,-0.0666666666666664,17,20,-3,-3,0
21700323,1627854,SAS,MEM,Bryn Forbes,81,18.65,18,0.649999999999999,40,35,5,5,0
21700323,201148,MEM,SAS,Brandan Wright,29,7.76666666666667,8,-0.233333333333333,12,14,-2,-2,0
21700323,201188,MEM,SAS,Marc Gasol,142,34.1666666666667,34,0.166666666666664,55,67,-12,-12,0
21700323,201596,MEM,SAS,Mario Chalmers,82,17.9,18,-0.100000000000001,33,37,-4,-4,0
21700323,201936,MEM,SAS,Tyreke Evans,120,28.85,29,-0.149999999999999,43,61,-18,-18,0
21700323,202718,MEM,SAS,Chandler Parsons,96,22.9666666666667,23,-0.033333333333335,37,51,-14,-12,-2
21700323,203210,MEM,SAS,JaMychal Green,84,19.9333333333333,20,-0.0666666666666664,35,34,1,-1,2
21700323,203463,MEM,SAS,Ben McLemore,76,19.25,20,-0.75,29,34,-5,-9,4
21700323,203516,MEM,SAS,James Ennis III,109,25.85,25,0.850000000000001,41,59,-18,-14,-4
21700323,1626150,MEM,SAS,Andrew Harrison,40,9.08333333333333,9,0.0833333333333322,18,17,1,3,-2
21700323,1626185,MEM,SAS,Jarell Martin,63,15.0666666666667,15,0.0666666666666664,26,29,-3,-3,0
21700323,1626205,MEM,SAS,Vincent Hunter,16,2.8,3,-0.2,9,2,7,7,0
21700323,1627738,MEM,SAS,Deyonta Davis,59,13.7333333333333,14,-0.266666666666666,24,28,-4,-4,0
21700323,1628415,MEM,SAS,Dillon Brooks,89,22.1333333333333,23,-0.866666666666667,33,42,-9,-11,2
21700324,2037,MIN,OKC,Jamal Crawford,78,18.3,18,0.300000000000001,35,40,-5,-5,0
21700324,201952,MIN,OKC,Jeff Teague,155,33.7,34,-0.299999999999997,90,81,9,9,0
21700324,201959,MIN,OKC,Taj Gibson,157,36.05,36,0.0499999999999972,89,79,10,10,0
21700324,202710,MIN,OKC,Jimmy Butler,185,41.1666666666667,41,0.166666666666671,98,100,-2,0,-2
21700324,203476,MIN,OKC,Gorgui Dieng,96,21.4333333333333,22,-0.56666666666667,45,61,-16,-16,0
21700324,203498,MIN,OKC,Shabazz Muhammad,13,3.46666666666667,3,0.466666666666667,2,4,-2,-2,0
21700324,203952,MIN,OKC,Andrew Wiggins,178,39.3666666666667,40,-0.633333333333333,88,99,-11,-11,0
21700324,1626145,MIN,OKC,Tyus Jones,46,11.1,11,0.100000000000001,13,21,-8,-10,2
21700324,1626157,MIN,OKC,Karl-Anthony Towns,157,35.4166666666667,35,0.416666666666664,75,70,5,5,0
21700324,2546,OKC,MIN,Carmelo Anthony,128,28.95,29,-0.0500000000000007,68,75,-7,-3,-4
21700324,2555,OKC,MIN,Nick Collison,13,2.18333333333333,2,0.183333333333334,4,7,-3,-1,-2
21700324,101109,OKC,MIN,Raymond Felton,43,10.7333333333333,11,-0.266666666666666,21,16,5,9,-4
21700324,201566,OKC,MIN,Russell Westbrook,168,36.9666666666667,37,-0.0333333333333314,90,91,-1,-3,2
21700324,202331,OKC,MIN,Paul George,185,41.7166666666667,42,-0.283333333333331,102,93,9,9,0
21700324,202335,OKC,MIN,Patrick Patterson,57,13.6333333333333,14,-0.366666666666667,31,18,13,11,2
21700324,203460,OKC,MIN,Andre Roberson,143,32.35,32,0.350000000000001,67,61,6,0,6
21700324,203500,OKC,MIN,Steven Adams,141,31.85,32,-0.149999999999999,88,64,24,18,6
21700324,203924,OKC,MIN,Jerami Grant,117,25.2166666666667,25,0.216666666666669,55,73,-18,-16,-2
21700324,203962,OKC,MIN,Josh Huestis,56,13.45,13,0.449999999999999,24,33,-9,-7,-2
21700324,1628390,OKC,MIN,Terrance Ferguson,14,2.95,3,-0.0499999999999998,5,4,1,3,-2
21700325,2749,NOP,UTA,Jameer Nelson,80,18.35,19,-0.649999999999999,31,41,-10,-8,-2
21700325,2754,NOP,UTA,Tony Allen,29,5.68333333333333,5,0.683333333333334,5,13,-8,-10,2
21700325,200765,NOP,UTA,Rajon Rondo,129,28.7833333333333,29,-0.216666666666669,72,69,3,1,2
21700325,201950,NOP,UTA,Jrue Holiday,178,40.05,40,0.0499999999999972,101,99,2,2,0
21700325,201967,NOP,UTA,Dante Cunningham,15,4.36666666666667,4,0.366666666666667,6,5,1,1,0
21700325,202326,NOP,UTA,DeMarcus Cousins,174,39.2833333333333,39,0.283333333333331,94,97,-3,-4,1
21700325,202734,NOP,UTA,E'Twaun Moore,160,36.0333333333333,36,0.0333333333333314,89,92,-3,-1,-2
21700325,203076,NOP,UTA,Anthony Davis,143,31.4666666666667,32,-0.533333333333335,69,65,4,5,-1
21700325,203121,NOP,UTA,Darius Miller,124,26.9166666666667,28,-1.08333333333334,61,70,-9,-9,0
21700325,203546,NOP,UTA,Ian Clark,43,8.65,9,-0.35,12,19,-7,-7,0
21700325,200757,UTA,NOP,Thabo Sefolosha,117,26.75,26,0.75,49,61,-12,-14,2
21700325,201937,UTA,NOP,Ricky Rubio,107,24.6666666666667,25,-0.333333333333336,40,47,-7,-5,-2
21700325,201973,UTA,NOP,Jonas Jerebko,98,21.1666666666667,22,-0.833333333333336,65,47,18,20,-2
21700325,202324,UTA,NOP,Derrick Favors,153,33.6166666666667,34,-0.383333333333333,84,77,7,7,0
21700325,202327,UTA,NOP,Ekpe Udoh,62,14.3,14,0.300000000000001,30,31,-1,-1,0
21700325,202692,UTA,NOP,Alec Burks,143,31.2333333333333,31,0.233333333333334,82,74,8,6,2
21700325,204060,UTA,NOP,Joe Ingles,174,39.1666666666667,39,0.166666666666664,96,95,1,1,0
21700325,1626220,UTA,NOP,Royce O'Neale,56,12.0833333333333,12,0.0833333333333322,28,23,5,5,0
21700325,1628378,UTA,NOP,Donovan Mitchell,165,36.6,37,-0.399999999999999,96,85,11,11,0
21700326,201143,BOS,PHX,Al Horford,147,31.7833333333333,32,-0.216666666666669,80,82,-2,-1,-1
21700326,202681,BOS,PHX,Kyrie Irving,150,30.95,31,-0.0500000000000007,84,76,8,8,0
21700326,202694,BOS,PHX,Marcus Morris,120,27.5166666666667,27,0.516666666666666,66,65,1,-3,4
21700326,203382,BOS,PHX,Aron Baynes,77,17.1833333333333,18,-0.81666666666667,39,26,13,16,-3
21700326,203935,BOS,PHX,Marcus Smart,142,28.6,28,0.600000000000001,83,71,12,10,2
21700326,1626179,BOS,PHX,Terry Rozier,81,19.4333333333333,19,0.43333333333333,38,37,1,1,0
21700326,1627759,BOS,PHX,Jaylen Brown,149,32.4,32,0.399999999999999,74,82,-8,-8,0
21700326,1628369,BOS,PHX,Jayson Tatum,129,26.1666666666667,27,-0.833333333333332,68,62,6,8,-2
21700326,1628400,BOS,PHX,Semi Ojeleye,65,15.3833333333333,15,0.383333333333333,31,32,-1,-1,0
21700326,1628464,BOS,PHX,Daniel Theis,40,9.91666666666667,10,-0.0833333333333339,17,22,-5,-5,0
21700326,2199,PHX,BOS,Tyson Chandler,133,27.9833333333333,28,-0.0166666666666657,72,71,1,-2,3
21700326,201162,PHX,BOS,Jared Dudley,38,7.76666666666667,7,0.766666666666667,21,10,11,13,-2
21700326,202328,PHX,BOS,Greg Monroe,87,19.8833333333333,20,-0.116666666666667,39,45,-6,-3,-3
21700326,203584,PHX,BOS,Troy Daniels,33,8.53333333333333,8,0.533333333333333,16,18,-2,0,-2
21700326,203933,PHX,BOS,T.J. Warren,172,36,36,0,83,90,-7,-9,2
21700326,1626164,PHX,BOS,Devin Booker,184,38.7833333333333,39,-0.216666666666669,95,95,0,-2,2
21700326,1627733,PHX,BOS,Dragan Bender,69,16.25,16,0.25,28,46,-18,-18,0
21700326,1627737,PHX,BOS,Marquese Chriss,98,21.4166666666667,22,-0.583333333333336,51,49,2,1,1
21700326,1627755,PHX,BOS,Tyler Ulis,120,24.55,25,-0.450000000000003,59,64,-5,-7,2
21700326,1628367,PHX,BOS,Josh Jackson,66,14.85,15,-0.15,39,40,-1,0,-1
21700326,1628455,PHX,BOS,Mike James,100,23.3166666666667,23,0.316666666666666,52,52,0,2,-2
21700327,1717,DAL,LAC,Dirk Nowitzki,111,24.5333333333333,25,-0.466666666666669,66,36,30,32,-2
21700327,2734,DAL,LAC,Devin Harris,90,20.5333333333333,21,-0.466666666666669,55,36,19,21,-2
21700327,200826,DAL,LAC,J.J. Barea,105,24.0833333333333,24,0.0833333333333357,69,40,29,32,-3
21700327,202083,DAL,LAC,Wesley Matthews,108,23.7166666666667,24,-0.283333333333331,50,47,3,5,-2
21700327,203084,DAL,LAC,Harrison Barnes,128,29.4166666666667,29,0.416666666666664,63,57,6,6,0
21700327,203481,DAL,LAC,Jeff Withey,32,5.83333333333333,6,-0.166666666666666,9,11,-2,-2,0
21700327,203939,DAL,LAC,Dwight Powell,97,20.2333333333333,20,0.233333333333334,50,25,25,23,2
21700327,1626257,DAL,LAC,Salah Mejri,67,15.3,15,0.300000000000001,28,35,-7,-7,0
21700327,1627812,DAL,LAC,Yogi Ferrell,100,20.85,21,-0.149999999999999,38,32,6,1,5
21700327,1628372,DAL,LAC,Dennis Smith Jr.,108,23.7333333333333,24,-0.266666666666666,63,36,27,27,0
21700327,1628467,DAL,LAC,Maxi Kleber,104,22.9166666666667,23,-0.0833333333333357,40,44,-4,-6,2
21700327,1628499,DAL,LAC,Antonius Cleveland,40,7.85,8,-0.15,9,11,-2,-2,0
21700327,101150,LAC,DAL,Lou Williams,147,32.9333333333333,33,-0.0666666666666629,60,83,-23,-21,-2
21700327,201599,LAC,DAL,DeAndre Jordan,135,30.65,31,-0.350000000000001,62,67,-5,-5,0
21700327,202325,LAC,DAL,Wesley Johnson,123,27.2,28,-0.800000000000001,55,57,-2,-6,4
21700327,203085,LAC,DAL,Austin Rivers,132,29.1333333333333,29,0.133333333333333,51,67,-16,-16,0
21700327,203186,LAC,DAL,Willie Reed,28,6.16666666666667,6,0.166666666666667,7,16,-9,-9,0
21700327,203710,LAC,DAL,C.J. Williams,101,22.35,22,0.350000000000001,36,55,-19,-15,-4
21700327,203966,LAC,DAL,Jamil Wilson,63,14.7,14,0.699999999999999,29,34,-5,-3,-2
21700327,1626149,LAC,DAL,Montrezl Harrell,116,24.5333333333333,25,-0.466666666666669,37,61,-24,-24,0
21700327,1626155,LAC,DAL,Sam Dekker,59,12.8,13,-0.199999999999999,17,23,-6,-10,4
21700327,1627744,LAC,DAL,Brice Johnson,26,4.93333333333333,5,-0.0666666666666664,10,7,3,3,0
21700327,1628393,LAC,DAL,Jawun Evans,87,18.3,18,0.300000000000001,27,37,-10,-10,0
21700327,1628414,LAC,DAL,Sindarius Thornwell,73,15.3,16,-0.699999999999999,19,33,-14,-14,0
21700328,101141,ATL,BKN,Ersan Ilyasova,106,23.2,24,-0.800000000000001,46,43,3,3,0
21700328,201158,ATL,BKN,Marco Belinelli,121,25.2333333333333,25,0.233333333333334,68,58,10,10,0
21700328,202337,ATL,BKN,Luke Babbitt,92,19.8666666666667,21,-1.13333333333333,57,43,14,8,6
21700328,203101,ATL,BKN,Miles Plumlee,97,19.4333333333333,19,0.43333333333333,49,46,3,6,-3
21700328,203145,ATL,BKN,Kent Bazemore,154,31.3833333333333,32,-0.616666666666667,67,64,3,5,-2
21700328,203471,ATL,BKN,Dennis Schroder,141,30.6166666666667,31,-0.383333333333333,65,62,3,3,0
21700328,1627752,ATL,BKN,Taurean Prince,131,28.3166666666667,29,-0.683333333333334,57,59,-2,-2,0
21700328,1627761,ATL,BKN,DeAndre' Bembry,110,21.65,22,-0.350000000000001,65,52,13,13,0
21700328,1627819,ATL,BKN,Isaiah Taylor,87,16.95,17,-0.0500000000000007,49,40,9,9,0
21700328,1628463,ATL,BKN,Tyler Cavanaugh,101,21.1833333333333,21,0.183333333333334,47,43,4,5,-1
21700328,201960,BKN,ATL,DeMarre Carroll,137,30.4833333333333,31,-0.516666666666666,54,65,-11,-7,-4
21700328,202344,BKN,ATL,Trevor Booker,68,15.5166666666667,16,-0.483333333333334,30,30,0,0,0
21700328,203092,BKN,ATL,Tyler Zeller,111,23.65,24,-0.350000000000001,46,51,-5,-2,-3
21700328,203112,BKN,ATL,Quincy Acy,30,6.28333333333333,6,0.283333333333333,11,11,0,0,0
21700328,203459,BKN,ATL,Allen Crabbe,114,25.3333333333333,25,0.333333333333336,51,49,2,4,-2
21700328,203915,BKN,ATL,Spencer Dinwiddie,133,29.7833333333333,30,-0.216666666666669,56,62,-6,-1,-5
21700328,203925,BKN,ATL,Joe Harris,129,26.05,26,0.0500000000000007,58,70,-12,-12,0
21700328,203930,BKN,ATL,Sean Kilpatrick,81,15.1,15,0.0999999999999996,39,45,-6,-10,4
21700328,1626178,BKN,ATL,Rondae Hollis-Jefferson,105,21,21,0,54,53,1,-1,2
21700328,1627747,BKN,ATL,Caris LeVert,126,25.1333333333333,25,0.133333333333333,58,77,-19,-24,5
21700328,1627785,BKN,ATL,Isaiah Whitehead,16,2.81666666666667,3,-0.183333333333334,9,6,3,3,0
21700328,1628386,BKN,ATL,Jarrett Allen,90,16.6833333333333,17,-0.316666666666666,44,51,-7,-10,3
21700329,2544,CLE,MEM,LeBron James,166,39.2666666666667,39,0.266666666666666,88,95,-7,-5,-2
21700329,2548,CLE,MEM,Dwyane Wade,103,24.6833333333333,25,-0.316666666666666,61,55,6,10,-4
21700329,2594,CLE,MEM,Kyle Korver,144,32.4833333333333,32,0.483333333333334,82,66,16,16,0
21700329,2747,CLE,MEM,JR Smith,144,33.7666666666667,34,-0.233333333333334,87,77,10,8,2
21700329,101112,CLE,MEM,Channing Frye,60,13.9333333333333,14,-0.0666666666666664,32,31,1,1,0
21700329,101181,CLE,MEM,Jose Calderon,54,13.65,14,-0.350000000000001,28,41,-13,-13,0
21700329,201145,CLE,MEM,Jeff Green,107,24.2333333333333,24,0.233333333333334,56,52,4,3,1
21700329,201567,CLE,MEM,Kevin Love,127,30.0166666666667,30,0.0166666666666657,72,71,1,1,0
21700329,203109,CLE,MEM,Jae Crowder,91,21.85,22,-0.149999999999999,56,56,0,-1,1
21700329,1626224,CLE,MEM,Cedi Osman,24,5.86666666666667,6,-0.133333333333334,18,11,7,5,2
21700329,201188,MEM,CLE,Marc Gasol,171,40.6166666666667,41,-0.38333333333334,97,90,7,8,-1
21700329,201596,MEM,CLE,Mario Chalmers,71,15.7,16,-0.300000000000001,30,41,-11,-9,-2
21700329,201936,MEM,CLE,Tyreke Evans,164,39.05,39,0.0499999999999972,93,97,-4,-5,1
21700329,203210,MEM,CLE,JaMychal Green,134,31.8,32,-0.199999999999999,73,88,-15,-14,-1
21700329,203463,MEM,CLE,Ben McLemore,111,25.7333333333333,26,-0.266666666666666,60,68,-8,-10,2
21700329,203516,MEM,CLE,James Ennis III,83,20,20,0,41,46,-5,-2,-3
21700329,1626150,MEM,CLE,Andrew Harrison,76,18.3166666666667,18,0.316666666666666,47,33,14,14,0
21700329,1626185,MEM,CLE,Jarell Martin,89,20.5833333333333,21,-0.416666666666668,44,47,-3,-4,1
21700329,1628415,MEM,CLE,Dillon Brooks,121,27.95,28,-0.0500000000000007,70,70,0,-3,3
21700330,101161,PHI,DET,Amir Johnson,83,15.8666666666667,16,-0.133333333333333,41,32,9,5,4
21700330,200755,PHI,DET,JJ Redick,167,35.8,36,-0.200000000000003,73,80,-7,-8,1
21700330,201573,PHI,DET,Jerryd Bayless,129,25.2,26,-0.800000000000001,62,55,7,7,0
21700330,203496,PHI,DET,Robert Covington,185,38.25,39,-0.75,91,81,10,8,2
21700330,203917,PHI,DET,Nik Stauskas,42,9.18333333333333,9,0.183333333333334,19,17,2,1,1
21700330,203954,PHI,DET,Joel Embiid,145,31.6333333333333,32,-0.366666666666667,63,67,-4,1,-5
21700330,203967,PHI,DET,Dario Saric,147,31.3666666666667,31,0.366666666666667,66,70,-4,-5,1
21700330,1627732,PHI,DET,Ben Simmons,189,38.9333333333333,39,-0.0666666666666629,90,83,7,6,1
21700330,1627789,PHI,DET,Timothe Luwawu-Cabarrot,68,13.2666666666667,14,-0.733333333333334,35,25,10,10,0
21700330,201229,DET,PHI,Anthony Tolliver,68,12.8,13,-0.199999999999999,22,25,-3,-2,-1
21700330,202340,DET,PHI,Avery Bradley,136,29.1833333333333,30,-0.816666666666666,61,68,-7,-6,-1
21700330,202397,DET,PHI,Ish Smith,94,18.8666666666667,19,-0.133333333333333,35,40,-5,-3,-2
21700330,202699,DET,PHI,Tobias Harris,163,35.1,35,0.100000000000001,80,83,-3,-3,0
21700330,202704,DET,PHI,Reggie Jackson,137,29.0333333333333,29,0.0333333333333314,67,68,-1,-2,1
21700330,203083,DET,PHI,Andre Drummond,161,34.5333333333333,35,-0.466666666666669,80,71,9,8,1
21700330,203961,DET,PHI,Eric Moreland,40,8.2,8,0.199999999999999,12,22,-10,-8,-2
21700330,204038,DET,PHI,Langston Galloway,51,10,10,0,28,20,8,10,-2
21700330,1626169,DET,PHI,Stanley Johnson,170,35.85,36,-0.150000000000006,70,81,-11,-9,-2
21700330,1626246,DET,PHI,Boban Marjanovic,30,5.16666666666667,5,0.166666666666666,10,15,-5,-5,0
21700330,1628379,DET,PHI,Luke Kennard,105,20.7666666666667,21,-0.233333333333334,45,47,-2,-5,3
21700331,1891,MIL,SAC,Jason Terry,88,21.6,22,-0.399999999999999,44,51,-7,-9,2
21700331,202339,MIL,SAC,Eric Bledsoe,149,32.9333333333333,33,-0.0666666666666629,78,69,9,9,0
21700331,202732,MIL,SAC,DeAndre Liggins,52,13.2333333333333,13,0.233333333333334,27,30,-3,-1,-2
21700331,203089,MIL,SAC,John Henson,129,28.5666666666667,29,-0.433333333333334,67,60,7,12,-5
21700331,203114,MIL,SAC,Khris Middleton,146,33.8333333333333,34,-0.166666666666671,77,67,10,12,-2
21700331,203503,MIL,SAC,Tony Snell,142,30.9666666666667,31,-0.033333333333335,78,65,13,13,0
21700331,203507,MIL,SAC,Giannis Antetokounmpo,154,33.95,34,-0.0499999999999972,80,71,9,7,2
21700331,1627748,MIL,SAC,Thon Maker,80,19.3833333333333,19,0.383333333333333,42,44,-2,-7,5
21700331,1627763,MIL,SAC,Malcolm Brogdon,105,25.2833333333333,25,0.283333333333331,52,63,-11,-11,0
21700331,1713,SAC,MIL,Vince Carter,35,7.8,8,-0.200000000000001,22,21,1,1,0
21700331,2216,SAC,MIL,Zach Randolph,147,33.6833333333333,34,-0.316666666666663,83,69,14,16,-2
21700331,201585,SAC,MIL,Kosta Koufos,38,8.6,9,-0.4,8,25,-17,-19,2
21700331,201588,SAC,MIL,George Hill,82,18.1333333333333,18,0.133333333333333,34,48,-14,-16,2
21700331,202066,SAC,MIL,Garrett Temple,142,32.4166666666667,32,0.416666666666664,66,76,-10,-14,4
21700331,203960,SAC,MIL,JaKarr Sampson,103,25.0666666666667,25,0.0666666666666664,52,49,3,5,-2
21700331,203992,SAC,MIL,Bogdan Bogdanovic,117,27.1833333333333,27,0.183333333333334,66,57,9,11,-2
21700331,1626161,SAC,MIL,Willie Cauley-Stein,39,8.78333333333333,9,-0.216666666666667,13,25,-12,-14,2
21700331,1627741,SAC,MIL,Buddy Hield,127,29.8166666666667,30,-0.18333333333333,70,61,9,11,-2
21700331,1627746,SAC,MIL,Skal Labissiere,22,4.18333333333333,4,0.183333333333334,8,12,-4,-4,0
21700331,1628368,SAC,MIL,De'Aaron Fox,92,20.7666666666667,21,-0.233333333333334,38,52,-14,-16,2
21700331,1628412,SAC,MIL,Frank Mason,101,23.3166666666667,23,0.316666666666666,60,50,10,14,-4
21700332,2210,DEN,LAL,Richard Jefferson,67,13.9833333333333,14,-0.0166666666666657,27,32,-5,-5,0
21700332,201589,DEN,LAL,Darrell Arthur,26,4.88333333333333,5,-0.116666666666667,10,14,-4,-6,2
21700332,202702,DEN,LAL,Kenneth Faried,126,26.6166666666667,27,-0.383333333333333,55,55,0,0,0
21700332,203115,DEN,LAL,Will Barton,139,28.3,28,0.299999999999997,69,69,0,0,0
21700332,203486,DEN,LAL,Mason Plumlee,149,30.7333333333333,31,-0.266666666666666,82,58,24,26,-2
21700332,203914,DEN,LAL,Gary Harris,165,33.9666666666667,34,-0.0333333333333314,88,68,20,20,0
21700332,1626144,DEN,LAL,Emmanuel Mudiay,73,14.85,15,-0.149999999999999,34,33,1,1,0
21700332,1626168,DEN,LAL,Trey Lyles,144,29.8833333333333,30,-0.116666666666667,74,62,12,12,0
21700332,1627750,DEN,LAL,Jamal Murray,159,33.1,33,0.100000000000001,81,67,14,14,0
21700332,1627823,DEN,LAL,Juancho Hernangomez,112,23.4333333333333,23,0.433333333333334,55,42,13,13,0
21700332,201147,LAL,DEN,Corey Brewer,42,9.1,9,0.0999999999999996,20,20,0,0,0
21700332,201572,LAL,DEN,Brook Lopez,117,23.75,24,-0.25,52,54,-2,-4,2
21700332,203484,LAL,DEN,Kentavious Caldwell-Pope,111,22.9166666666667,23,-0.0833333333333357,44,57,-13,-13,0
21700332,203903,LAL,DEN,Jordan Clarkson,141,28.6,28,0.600000000000001,67,66,1,3,-2
21700332,203944,LAL,DEN,Julius Randle,103,21.8,22,-0.199999999999999,46,54,-8,-4,-4
21700332,1626204,LAL,DEN,Larry Nance Jr.,116,23.7333333333333,24,-0.266666666666666,45,56,-11,-15,4
21700332,1627742,LAL,DEN,Brandon Ingram,134,27.5,28,-0.5,46,70,-24,-26,2
21700332,1628366,LAL,DEN,Lonzo Ball,160,33.0666666666667,33,0.0666666666666629,66,79,-13,-15,2
21700332,1628398,LAL,DEN,Kyle Kuzma,128,26.6166666666667,27,-0.383333333333333,57,66,-9,-7,-2
21700332,1628404,LAL,DEN,Josh Hart,108,22.6666666666667,22,0.666666666666664,57,53,4,6,-2
21700333,2749,NOP,POR,Jameer Nelson,86,19.0666666666667,19,0.0666666666666664,44,47,-3,-5,2
21700333,2754,NOP,POR,Tony Allen,87,17.8,18,-0.199999999999999,44,46,-2,-2,0
21700333,200765,NOP,POR,Rajon Rondo,131,28.2166666666667,28,0.216666666666669,75,62,13,15,-2
21700333,201600,NOP,POR,Omer Asik,59,13.8833333333333,14,-0.116666666666667,35,31,4,2,2
21700333,201950,NOP,POR,Jrue Holiday,180,37.5666666666667,38,-0.433333333333337,97,96,1,2,-1
21700333,201967,NOP,POR,Dante Cunningham,69,13.8166666666667,14,-0.183333333333334,38,31,7,7,0
21700333,202326,NOP,POR,DeMarcus Cousins,169,34.1166666666667,34,0.116666666666667,88,85,3,5,-2
21700333,202734,NOP,POR,E'Twaun Moore,170,34.55,35,-0.450000000000003,94,87,7,6,1
21700333,203121,NOP,POR,Darius Miller,159,34.1833333333333,34,0.183333333333337,85,85,0,0,0
21700333,203546,NOP,POR,Ian Clark,30,6.8,7,-0.199999999999999,15,10,5,5,0
21700333,202323,POR,NOP,Evan Turner,105,24,24,0,55,62,-7,-5,-2
21700333,202329,POR,NOP,Al-Farouq Aminu,114,25.5,26,-0.5,59,56,3,3,0
21700333,202334,POR,NOP,Ed Davis,35,8.38333333333333,8,0.383333333333333,16,21,-5,-7,2
21700333,203081,POR,NOP,Damian Lillard,195,40.4166666666667,40,0.416666666666664,102,107,-5,-7,2
21700333,203086,POR,NOP,Meyers Leonard,79,15.6166666666667,16,-0.383333333333335,44,44,0,2,-2
21700333,203090,POR,NOP,Maurice Harkless,23,5.2,5,0.2,14,19,-5,-5,0
21700333,203468,POR,NOP,CJ McCollum,165,33.8666666666667,34,-0.13333333333334,80,82,-2,-2,0
21700333,203894,POR,NOP,Shabazz Napier,116,24.7666666666667,24,0.766666666666666,63,57,6,6,0
21700333,203943,POR,NOP,Noah Vonleh,67,13.35,13,0.35,29,38,-9,-9,0
21700333,203994,POR,NOP,Jusuf Nurkic,114,24,24,0,56,58,-2,-2,0
21700333,1626192,POR,NOP,Pat Connaughton,127,24.9,25,-0.100000000000001,62,71,-9,-9,0
21700334,101127,NYK,ORL,Jarrett Jack,135,27.65,28,-0.350000000000001,66,65,1,3,-2
21700334,201196,NYK,ORL,Ramon Sessions,17,4.05,4,0.0499999999999998,6,11,-5,-5,0
21700334,201563,NYK,ORL,Michael Beasley,128,27.3833333333333,28,-0.616666666666667,61,68,-7,-6,-1
21700334,201584,NYK,ORL,Courtney Lee,164,35.0333333333333,36,-0.966666666666669,73,71,2,7,-5
21700334,202498,NYK,ORL,Lance Thomas,94,20.8666666666667,21,-0.133333333333333,41,39,2,-5,7
21700334,202683,NYK,ORL,Enes Kanter,141,30.55,31,-0.450000000000003,72,73,-1,-3,2
21700334,203124,NYK,ORL,Kyle O'Quinn,78,17.2333333333333,17,0.233333333333334,26,32,-6,-2,-4
21700334,203926,NYK,ORL,Doug McDermott,140,30.25,30,0.25,64,59,5,8,-3
21700334,1627758,NYK,ORL,Ron Baker,40,8.5,8,0.5,19,21,-2,-3,1
21700334,1628373,NYK,ORL,Frank Ntilikina,67,16.1833333333333,16,0.183333333333334,28,27,1,-3,4
21700334,1628422,NYK,ORL,Damyean Dotson,96,21.9666666666667,22,-0.033333333333335,44,59,-15,-16,1
21700334,201167,ORL,NYK,Arron Afflalo,83,18.8,18,0.800000000000001,30,32,-2,1,-3
21700334,201571,ORL,NYK,D.J. Augustin,74,16.0833333333333,16,0.0833333333333322,27,29,-2,5,-7
21700334,201578,ORL,NYK,Marreese Speights,42,9.48333333333333,9,0.483333333333333,12,14,-2,0,-2
21700334,202687,ORL,NYK,Bismack Biyombo,59,13.35,13,0.35,16,24,-8,-6,-2
21700334,202696,ORL,NYK,Nikola Vucevic,160,34.4333333333333,35,-0.566666666666663,89,74,15,13,2
21700334,203095,ORL,NYK,Evan Fournier,177,37.4666666666667,37,0.466666666666669,92,88,4,4,0
21700334,203613,ORL,NYK,Jonathon Simmons,168,37.6333333333333,38,-0.366666666666667,78,77,1,-5,6
21700334,203901,ORL,NYK,Elfrid Payton,158,33.9166666666667,34,-0.0833333333333286,86,76,10,4,6
21700334,203932,ORL,NYK,Aaron Gordon,179,38.5,39,-0.5,95,86,9,9,0
21700335,2561,GSW,MIA,David West,54,11.8666666666667,12,-0.133333333333333,23,15,8,8,0
21700335,2585,GSW,MIA,Zaza Pachulia,72,17.35,18,-0.650000000000002,49,31,18,20,-2
21700335,2733,GSW,MIA,Shaun Livingston,28,5.7,6,-0.300000000000001,13,9,4,2,2
21700335,201142,GSW,MIA,Kevin Durant,123,28.1666666666667,28,0.166666666666664,78,62,16,18,-2
21700335,201156,GSW,MIA,Nick Young,69,15.45,15,0.449999999999999,42,37,5,2,3
21700335,201580,GSW,MIA,JaVale McGee,21,4.13333333333333,4,0.133333333333333,10,11,-1,-1,0
21700335,201939,GSW,MIA,Stephen Curry,131,30.3,30,0.299999999999997,86,68,18,20,-2
21700335,201956,GSW,MIA,Omri Casspi,116,24.95,25,-0.0499999999999972,57,51,6,4,2
21700335,202691,GSW,MIA,Klay Thompson,134,30.8166666666667,31,-0.183333333333334,77,49,28,33,-5
21700335,203110,GSW,MIA,Draymond Green,138,32,32,0,83,52,31,32,-1
21700335,1626172,GSW,MIA,Kevon Looney,30,6.25,7,-0.75,15,16,-1,-1,0
21700335,1627775,GSW,MIA,Patrick McCaw,86,18.4833333333333,19,-0.516666666666666,45,40,5,3,2
21700335,1628395,GSW,MIA,Jordan Bell,58,12.95,13,-0.0500000000000007,37,34,3,0,3
21700335,201609,MIA,GSW,Goran Dragic,108,25.4833333333333,25,0.483333333333334,52,75,-23,-23,0
21700335,201949,MIA,GSW,James Johnson,132,29.4333333333333,29,0.43333333333333,53,70,-17,-15,-2
21700335,201961,MIA,GSW,Wayne Ellington,122,26.75,27,-0.25,53,63,-10,-9,-1
21700335,203079,MIA,GSW,Dion Waiters,106,24.1,24,0.100000000000001,51,70,-19,-19,0
21700335,203482,MIA,GSW,Kelly Olynyk,127,27.7666666666667,28,-0.233333333333334,56,67,-11,-12,1
21700335,204020,MIA,GSW,Tyler Johnson,122,26.65,27,-0.350000000000001,53,60,-7,-7,0
21700335,1626159,MIA,GSW,Justise Winslow,93,20.9,21,-0.100000000000001,50,59,-9,-11,2
21700335,1626175,MIA,GSW,Jordan Mickey,30,6.25,7,-0.75,16,15,1,1,0
21700335,1626196,MIA,GSW,Josh Richardson,135,31.1666666666667,31,0.166666666666664,52,80,-28,-29,1
21700335,1628389,MIA,GSW,Bam Adebayo,85,19.9166666666667,20,-0.0833333333333357,39,56,-17,-16,-1
21700336,101150,LAC,MIN,Lou Williams,163,34.2333333333333,35,-0.766666666666666,79,88,-9,-6,-3
21700336,201599,LAC,MIN,DeAndre Jordan,151,34.6833333333333,35,-0.31666666666667,74,85,-11,-14,3
21700336,202325,LAC,MIN,Wesley Johnson,145,33.5,34,-0.5,72,82,-10,-10,0
21700336,203085,LAC,MIN,Austin Rivers,155,35.5166666666667,36,-0.483333333333334,76,90,-14,-11,-3
21700336,203186,LAC,MIN,Willie Reed,15,3.38333333333333,3,0.383333333333333,6,7,-1,0,-1
21700336,203710,LAC,MIN,C.J. Williams,51,13.3833333333333,13,0.383333333333333,27,24,3,0,3
21700336,203966,LAC,MIN,Jamil Wilson,121,27.85,29,-1.15,62,67,-5,-1,-4
21700336,1626149,LAC,MIN,Montrezl Harrell,60,12.5333333333333,13,-0.466666666666667,30,25,5,5,0
21700336,1626155,LAC,MIN,Sam Dekker,79,16.65,16,0.649999999999999,40,38,2,0,2
21700336,1628393,LAC,MIN,Jawun Evans,63,12.5333333333333,13,-0.466666666666667,30,26,4,5,-1
21700336,1628414,LAC,MIN,Sindarius Thornwell,67,13.8166666666667,14,-0.183333333333334,34,28,6,2,4
21700336,2037,MIN,LAC,Jamal Crawford,88,18.3666666666667,18,0.366666666666667,39,48,-9,-5,-4
21700336,201952,MIN,LAC,Jeff Teague,150,34.8666666666667,35,-0.133333333333333,83,76,7,9,-2
21700336,201959,MIN,LAC,Taj Gibson,175,39.3,40,-0.700000000000003,93,86,7,5,2
21700336,202710,MIN,LAC,Jimmy Butler,170,39.1,40,-0.899999999999999,95,83,12,12,0
21700336,203476,MIN,LAC,Gorgui Dieng,94,19.2166666666667,19,0.216666666666665,43,48,-5,-7,2
21700336,203952,MIN,LAC,Andrew Wiggins,170,37.7666666666667,38,-0.233333333333334,90,81,9,7,2
21700336,1626145,MIN,LAC,Tyus Jones,64,12.75,13,-0.25,29,30,-1,-3,2
21700336,1626157,MIN,LAC,Karl-Anthony Towns,159,36.7166666666667,37,-0.283333333333331,88,78,10,12,-2
21700337,2200,SAS,OKC,Pau Gasol,72,16.0333333333333,16,0.0333333333333314,27,37,-10,-9,-1
21700337,201980,SAS,OKC,Danny Green,73,17.2833333333333,18,-0.716666666666669,26,39,-13,-8,-5
21700337,201988,SAS,OKC,Patty Mills,42,8.98333333333333,9,-0.0166666666666657,18,23,-5,-5,0
21700337,202722,SAS,OKC,Davis Bertans,146,29.4833333333333,29,0.483333333333334,57,55,2,1,1
21700337,203464,SAS,OKC,Brandon Paul,149,33.2666666666667,33,0.266666666666666,45,58,-13,-12,-1
21700337,203530,SAS,OKC,Joffrey Lauvergne,110,22.75,23,-0.25,43,45,-2,-5,3
21700337,203937,SAS,OKC,Kyle Anderson,103,22.2833333333333,22,0.283333333333331,44,44,0,3,-3
21700337,1627749,SAS,OKC,Dejounte Murray,188,39.4166666666667,39,0.416666666666671,69,70,-1,-1,0
21700337,1627854,SAS,OKC,Bryn Forbes,160,32.7333333333333,33,-0.266666666666666,68,57,11,7,4
21700337,1628401,SAS,OKC,Derrick White,92,17.35,17,0.349999999999998,38,22,16,14,2
21700337,2546,OKC,SAS,Carmelo Anthony,141,30.7666666666667,31,-0.233333333333334,53,53,0,1,-1
21700337,101109,OKC,SAS,Raymond Felton,78,16.3333333333333,16,0.333333333333336,33,31,2,0,2
21700337,201566,OKC,SAS,Russell Westbrook,183,38.2166666666667,39,-0.783333333333331,70,64,6,8,-2
21700337,202331,OKC,SAS,Paul George,152,32.9833333333333,33,-0.0166666666666657,55,50,5,2,3
21700337,202335,OKC,SAS,Patrick Patterson,47,9.7,10,-0.300000000000001,13,20,-7,-7,0
21700337,203460,OKC,SAS,Andre Roberson,158,34.4833333333333,34,0.483333333333334,63,65,-2,-1,-1
21700337,203500,OKC,SAS,Steven Adams,153,32.7166666666667,33,-0.283333333333331,67,56,11,13,-2
21700337,203518,OKC,SAS,Alex Abrines,79,15.8666666666667,15,0.866666666666667,38,37,1,3,-2
21700337,203924,OKC,SAS,Jerami Grant,108,21.6666666666667,21,0.666666666666664,41,40,1,0,1
21700337,203962,OKC,SAS,Josh Huestis,36,6.85,7,-0.15,17,19,-2,-4,2
21700338,2403,HOU,LAL,Nene,76,14.85,15,-0.15,42,25,17,15,2
21700338,2772,HOU,LAL,Trevor Ariza,147,30,30,0,69,62,7,9,-2
21700338,101108,HOU,LAL,Chris Paul,157,32.6333333333333,33,-0.366666666666667,74,66,8,8,0
21700338,200782,HOU,LAL,PJ Tucker,136,28.2166666666667,28,0.216666666666669,75,58,17,15,2
21700338,201569,HOU,LAL,Eric Gordon,152,30.05,30,0.0499999999999972,86,49,37,37,0
21700338,201583,HOU,LAL,Ryan Anderson,58,11.5166666666667,12,-0.483333333333334,22,23,-1,1,-2
21700338,201601,HOU,LAL,Luc Mbah a Moute,137,27.8333333333333,27,0.833333333333336,79,49,30,28,2
21700338,201628,HOU,LAL,Bobby Brown,7,1.43333333333333,2,-0.566666666666667,4,5,-1,-1,0
21700338,201935,HOU,LAL,James Harden,171,35.3833333333333,35,0.383333333333333,85,74,11,11,0
21700338,203991,HOU,LAL,Clint Capela,113,22.6166666666667,23,-0.383333333333333,42,49,-7,-5,-2
21700338,204028,HOU,LAL,Tarik Black,7,1.43333333333333,2,-0.566666666666667,4,5,-1,-1,0
21700338,1627362,HOU,LAL,Briante Weber,7,1.43333333333333,2,-0.566666666666667,4,5,-1,-1,0
21700338,1627743,HOU,LAL,Demetrius Jackson,7,1.43333333333333,2,-0.566666666666667,4,5,-1,-1,0
21700338,201147,LAL,HOU,Corey Brewer,52,10.8833333333333,11,-0.116666666666667,16,32,-16,-16,0
21700338,201572,LAL,HOU,Brook Lopez,99,20,20,0,47,38,9,9,0
21700338,203484,LAL,HOU,Kentavious Caldwell-Pope,176,35.1666666666667,35,0.166666666666664,72,84,-12,-10,-2
21700338,203898,LAL,HOU,Tyler Ennis,14,3.13333333333333,3,0.133333333333333,7,12,-5,-5,0
21700338,203903,LAL,HOU,Jordan Clarkson,98,20.3666666666667,21,-0.633333333333333,36,44,-8,-8,0
21700338,203944,LAL,HOU,Julius Randle,78,15.7333333333333,16,-0.266666666666666,21,42,-21,-21,0
21700338,1626204,LAL,HOU,Larry Nance Jr.,150,29.7666666666667,30,-0.233333333333334,67,69,-2,-4,2
21700338,1627742,LAL,HOU,Brandon Ingram,183,36.8833333333333,37,-0.116666666666667,79,86,-7,-7,0
21700338,1627826,LAL,HOU,Ivica Zubac,12,2.65,3,-0.35,5,12,-7,-5,-2
21700338,1628366,LAL,HOU,Lonzo Ball,111,22.2166666666667,22,0.216666666666669,48,57,-9,-9,0
21700338,1628398,LAL,HOU,Kyle Kuzma,131,27.3833333333333,28,-0.616666666666667,50,75,-25,-25,0
21700338,1628404,LAL,HOU,Josh Hart,71,14.65,15,-0.35,27,39,-12,-14,2
21700339,201167,ORL,CHA,Arron Afflalo,90,18.3666666666667,18,0.366666666666667,32,34,-2,-1,-1
21700339,201571,ORL,CHA,D.J. Augustin,75,15.8666666666667,16,-0.133333333333333,28,30,-2,-4,2
21700339,201578,ORL,CHA,Marreese Speights,71,15.15,15,0.149999999999999,26,23,3,2,1
21700339,202687,ORL,CHA,Bismack Biyombo,79,16.7666666666667,17,-0.233333333333334,29,32,-3,-1,-2
21700339,202696,ORL,CHA,Nikola Vucevic,133,27.5833333333333,27,0.583333333333336,59,69,-10,-10,0
21700339,203095,ORL,CHA,Evan Fournier,141,29.7666666666667,30,-0.233333333333334,62,70,-8,-9,1
21700339,203613,ORL,CHA,Jonathon Simmons,170,34.1833333333333,34,0.183333333333337,66,75,-9,-9,0
21700339,203901,ORL,CHA,Elfrid Payton,156,32.15,32,0.149999999999999,68,74,-6,-6,0
21700339,203932,ORL,CHA,Aaron Gordon,173,35.8166666666667,35,0.816666666666663,72,82,-10,-9,-1
21700339,1626209,ORL,CHA,Mario Hezonja,33,8.1,8,0.0999999999999996,15,18,-3,-3,0
21700339,1628411,ORL,CHA,Wes Iwundu,29,6.08333333333333,6,0.083333333333333,13,13,0,0,0
21700339,2730,CHA,ORL,Dwight Howard,140,29.3,29,0.299999999999997,71,62,9,7,2
21700339,101107,CHA,ORL,Marvin Williams,118,24.25,24,0.25,58,56,2,1,1
21700339,201587,CHA,ORL,Nicolas Batum,179,37.1333333333333,37,0.133333333333333,84,74,10,9,1
21700339,202689,CHA,ORL,Kemba Walker,166,34.3833333333333,34,0.383333333333333,79,66,13,13,0
21700339,203077,CHA,ORL,Michael Kidd-Gilchrist,124,25.7833333333333,26,-0.216666666666669,62,56,6,8,-2
21700339,203087,CHA,ORL,Jeremy Lamb,106,22.1833333333333,22,0.18333333333333,42,38,4,2,2
21700339,203469,CHA,ORL,Cody Zeller,90,18.6666666666667,19,-0.333333333333336,33,32,1,3,-2
21700339,203487,CHA,ORL,Michael Carter-Williams,64,13.5833333333333,14,-0.416666666666666,25,28,-3,-3,0
21700339,1626163,CHA,ORL,Frank Kaminsky,112,23.7166666666667,24,-0.283333333333331,46,38,8,9,-1
21700339,1628407,CHA,ORL,Dwayne Bacon,51,10.8333333333333,11,-0.166666666666668,20,20,0,1,-1
21700340,101127,NYK,IND,Jarrett Jack,76,16.8333333333333,17,-0.166666666666668,30,49,-19,-19,0
21700340,201149,NYK,IND,Joakim Noah,42,8.05,8,0.0500000000000007,19,14,5,5,0
21700340,201196,NYK,IND,Ramon Sessions,69,13.8666666666667,14,-0.133333333333333,39,31,8,10,-2
21700340,201563,NYK,IND,Michael Beasley,66,14.35,14,0.35,23,38,-15,-15,0
21700340,201584,NYK,IND,Courtney Lee,88,19.6833333333333,20,-0.316666666666666,30,62,-32,-34,2
21700340,202498,NYK,IND,Lance Thomas,78,16.8,17,-0.200000000000003,32,34,-2,1,-3
21700340,202683,NYK,IND,Enes Kanter,85,19,19,0,30,62,-32,-34,2
21700340,203124,NYK,IND,Kyle O'Quinn,33,7.4,8,-0.6,10,10,0,0,0
21700340,203926,NYK,IND,Doug McDermott,141,29.1,29,0.100000000000001,62,74,-12,-15,3
21700340,1626195,NYK,IND,Willy Hernangomez,83,16.85,17,-0.149999999999999,41,41,0,2,-2
21700340,1627758,NYK,IND,Ron Baker,110,21.2,22,-0.800000000000001,57,43,14,16,-2
21700340,1628373,NYK,IND,Frank Ntilikina,131,26.5,27,-0.5,53,58,-5,-5,0
21700340,1628422,NYK,IND,Damyean Dotson,138,28.3666666666667,29,-0.633333333333333,59,59,0,-2,2
21700340,2863,IND,NYK,Damien Wilkins,20,3.55,4,-0.45,6,13,-7,-7,0
21700340,201152,IND,NYK,Thaddeus Young,123,26.7333333333333,27,-0.266666666666666,77,47,30,26,4
21700340,201954,IND,NYK,Darren Collison,120,26.05,26,0.0500000000000007,72,45,27,27,0
21700340,202362,IND,NYK,Lance Stephenson,139,29.0333333333333,29,0.0333333333333314,66,65,1,2,-1
21700340,202709,IND,NYK,Cory Joseph,104,21.8833333333333,22,-0.116666666666667,41,46,-5,-3,-2
21700340,202711,IND,NYK,Bojan Bogdanovic,137,28.8,29,-0.200000000000003,74,58,16,13,3
21700340,203506,IND,NYK,Victor Oladipo,141,29.6833333333333,30,-0.316666666666666,79,54,25,25,0
21700340,1626167,IND,NYK,Myles Turner,117,25.8,25,0.799999999999997,69,41,28,28,0
21700340,1626202,IND,NYK,Joe Young,38,6.8,7,-0.199999999999999,11,21,-10,-10,0
21700340,1627734,IND,NYK,Domantas Sabonis,118,23.6166666666667,24,-0.383333333333333,43,56,-13,-12,-1
21700340,1628388,IND,NYK,TJ Leaf,83,16.05,17,-0.949999999999999,37,39,-2,1,-3
21700341,101161,PHI,PHX,Amir Johnson,64,13.2333333333333,14,-0.766666666666668,36,39,-3,-3,0
21700341,200755,PHI,PHX,JJ Redick,162,33.75,33,0.75,66,82,-16,-19,3
21700341,201573,PHI,PHX,Jerryd Bayless,99,20.9833333333333,22,-1.01666666666667,40,47,-7,0,-7
21700341,203496,PHI,PHX,Robert Covington,161,33.65,34,-0.350000000000001,73,81,-8,-10,2
21700341,203917,PHI,PHX,Nik Stauskas,40,7.56666666666667,8,-0.433333333333334,12,17,-5,-7,2
21700341,203954,PHI,PHX,Joel Embiid,166,34.4833333333333,34,0.483333333333334,65,76,-11,-11,0
21700341,203967,PHI,PHX,Dario Saric,159,33.2,33,0.200000000000003,72,86,-14,-13,-1
21700341,1627732,PHI,PHX,Ben Simmons,174,36.3666666666667,36,0.366666666666667,81,91,-10,-10,0
21700341,1627789,PHI,PHX,Timothe Luwawu-Cabarrot,125,25.35,26,-0.649999999999999,60,56,4,3,1
21700341,2199,PHX,PHI,Tyson Chandler,177,36.5166666666667,37,-0.483333333333334,87,74,13,11,2
21700341,203458,PHX,PHI,Alex Len,53,11.2,11,0.199999999999999,28,27,1,3,-2
21700341,203584,PHX,PHI,Troy Daniels,28,5.56666666666667,5,0.566666666666666,13,4,9,7,2
21700341,203933,PHX,PHI,T.J. Warren,166,33.7333333333333,34,-0.266666666666666,87,73,14,15,-1
21700341,1626164,PHX,PHI,Devin Booker,184,38.3333333333333,39,-0.666666666666671,98,90,8,10,-2
21700341,1627733,PHX,PHI,Dragan Bender,126,25.2333333333333,25,0.233333333333334,56,54,2,2,0
21700341,1627737,PHX,PHI,Marquese Chriss,104,22.4833333333333,23,-0.516666666666666,59,47,12,12,0
21700341,1627755,PHX,PHI,Tyler Ulis,170,36.7666666666667,37,-0.233333333333334,90,80,10,10,0
21700341,1628367,PHX,PHI,Josh Jackson,116,23.6833333333333,23,0.683333333333334,46,52,-6,-7,1
21700341,1628455,PHX,PHI,Mike James,26,5.06666666666667,5,0.0666666666666664,11,4,7,7,0
21700342,101141,ATL,BKN,Ersan Ilyasova,98,20.4,20,0.399999999999999,35,41,-6,-11,5
21700342,201158,ATL,BKN,Marco Belinelli,92,19.5,19,0.5,38,46,-8,-9,1
21700342,202337,ATL,BKN,Luke Babbitt,79,15.95,16,-0.0500000000000007,38,47,-9,-7,-2
21700342,203101,ATL,BKN,Miles Plumlee,105,21.5166666666667,22,-0.483333333333334,31,50,-19,-14,-5
21700342,203145,ATL,BKN,Kent Bazemore,124,25.2,26,-0.800000000000001,37,53,-16,-17,1
21700342,203471,ATL,BKN,Dennis Schroder,149,30.7333333333333,30,0.733333333333334,54,71,-17,-19,2
21700342,1627098,ATL,BKN,Malcolm Delaney,20,4.1,5,-0.9,11,7,4,4,0
21700342,1627752,ATL,BKN,Taurean Prince,136,28.25,28,0.25,45,61,-16,-18,2
21700342,1627761,ATL,BKN,DeAndre' Bembry,132,26.4,27,-0.600000000000001,59,66,-7,-6,-1
21700342,1627819,ATL,BKN,Isaiah Taylor,93,19.5,20,-0.5,37,48,-11,-8,-3
21700342,1628416,ATL,BKN,Tyler Dorsey,20,4.1,5,-0.9,11,7,4,4,0
21700342,1628463,ATL,BKN,Tyler Cavanaugh,112,22.2666666666667,23,-0.733333333333334,54,53,1,1,0
21700342,201960,BKN,ATL,DeMarre Carroll,135,27.8666666666667,28,-0.133333333333333,64,47,17,19,-2
21700342,202344,BKN,ATL,Trevor Booker,95,19.0666666666667,19,0.0666666666666664,47,54,-7,-8,1
21700342,203092,BKN,ATL,Tyler Zeller,82,15.9166666666667,16,-0.0833333333333339,38,20,18,15,3
21700342,203112,BKN,ATL,Quincy Acy,44,9.95,10,-0.0500000000000007,15,24,-9,-9,0
21700342,203459,BKN,ATL,Allen Crabbe,118,22.4166666666667,23,-0.583333333333332,56,33,23,16,7
21700342,203915,BKN,ATL,Spencer Dinwiddie,150,30.95,30,0.949999999999999,74,59,15,19,-4
21700342,203925,BKN,ATL,Joe Harris,147,31,31,0,66,63,3,6,-3
21700342,203930,BKN,ATL,Sean Kilpatrick,20,4.1,5,-0.9,7,11,-4,-4,0
21700342,1626178,BKN,ATL,Rondae Hollis-Jefferson,141,28.8666666666667,29,-0.133333333333333,67,39,28,29,-1
21700342,1627747,BKN,ATL,Caris LeVert,129,27.4166666666667,28,-0.583333333333332,63,59,4,4,0
21700342,1628386,BKN,ATL,Jarrett Allen,99,20.3666666666667,21,-0.633333333333333,53,41,12,13,-1
21700343,201143,BOS,MIL,Al Horford,148,34.2,35,-0.799999999999997,89,68,21,21,0
21700343,202681,BOS,MIL,Kyrie Irving,155,33.5,34,-0.5,83,82,1,0,1
21700343,202694,BOS,MIL,Marcus Morris,97,24.4,24,0.399999999999999,49,50,-1,2,-3
21700343,203382,BOS,MIL,Aron Baynes,72,14.95,15,-0.0500000000000007,43,32,11,6,5
21700343,203935,BOS,MIL,Marcus Smart,120,29.4333333333333,30,-0.566666666666666,64,60,4,3,1
21700343,1626179,BOS,MIL,Terry Rozier,94,24.1166666666667,24,0.116666666666667,49,37,12,15,-3
21700343,1627759,BOS,MIL,Jaylen Brown,98,22.65,23,-0.350000000000001,51,44,7,6,1
21700343,1628369,BOS,MIL,Jayson Tatum,148,32.2833333333333,33,-0.716666666666669,86,78,8,8,0
21700343,1628400,BOS,MIL,Semi Ojeleye,55,12.6833333333333,13,-0.316666666666666,21,28,-7,-5,-2
21700343,1628464,BOS,MIL,Daniel Theis,43,10.2,10,0.199999999999999,20,21,-1,-1,0
21700343,1891,MIL,BOS,Jason Terry,47,12.6333333333333,13,-0.366666666666667,18,23,-5,-5,0
21700343,202339,MIL,BOS,Eric Bledsoe,155,34.0666666666667,34,0.06666666666667,81,86,-5,-3,-2
21700343,202732,MIL,BOS,DeAndre Liggins,44,12.1,12,0.0999999999999996,14,20,-6,-6,0
21700343,203089,MIL,BOS,John Henson,99,20.8666666666667,21,-0.133333333333333,47,56,-9,-8,-1
21700343,203114,MIL,BOS,Khris Middleton,183,40.7166666666667,41,-0.283333333333331,91,96,-5,-5,0
21700343,203503,MIL,BOS,Tony Snell,170,38.9666666666667,39,-0.0333333333333314,89,89,0,0,0
21700343,203507,MIL,BOS,Giannis Antetokounmpo,171,38.7166666666667,39,-0.283333333333331,87,98,-11,-11,0
21700343,1627748,MIL,BOS,Thon Maker,31,8.41666666666667,8,0.416666666666666,13,19,-6,-8,2
21700343,1627763,MIL,BOS,Malcolm Brogdon,130,31.9333333333333,32,-0.06666666666667,60,68,-8,-9,1
21700344,2544,CLE,CHI,LeBron James,143,34,34,0,85,58,27,27,0
21700344,2548,CLE,CHI,Dwyane Wade,115,25.95,26,-0.0500000000000007,73,54,19,20,-1
21700344,2594,CLE,CHI,Kyle Korver,99,22.6833333333333,23,-0.316666666666666,61,44,17,16,1
21700344,2747,CLE,CHI,JR Smith,108,25.7,26,-0.299999999999997,55,51,4,3,1
21700344,101112,CLE,CHI,Channing Frye,107,24.6833333333333,25,-0.31666666666667,62,50,12,13,-1
21700344,101181,CLE,CHI,Jose Calderon,114,26.8833333333333,27,-0.116666666666667,56,49,7,6,1
21700344,201145,CLE,CHI,Jeff Green,107,24.6833333333333,25,-0.31666666666667,62,50,12,13,-1
21700344,201567,CLE,CHI,Kevin Love,97,22.9666666666667,23,-0.033333333333335,51,41,10,9,1
21700344,203109,CLE,CHI,Jae Crowder,88,21.05,21,0.0499999999999972,47,39,8,9,-1
21700344,1626224,CLE,CHI,Cedi Osman,25,5.73333333333333,6,-0.266666666666668,8,11,-3,-3,0
21700344,1627790,CLE,CHI,Ante Zizic,17,3.91666666666667,4,-0.083333333333333,5,8,-3,-3,0
21700344,201577,CHI,CLE,Robin Lopez,109,25.6,26,-0.399999999999999,46,59,-13,-12,-1
21700344,202347,CHI,CLE,Quincy Pondexter,17,3.91666666666667,4,-0.083333333333333,8,5,3,3,0
21700344,203200,CHI,CLE,Justin Holiday,127,30.3,31,-0.699999999999999,61,68,-7,-6,-1
21700344,1626170,CHI,CLE,Jerian Grant,61,12.8166666666667,13,-0.183333333333334,26,40,-14,-11,-3
21700344,1626171,CHI,CLE,Bobby Portis,119,26.2333333333333,27,-0.766666666666666,56,69,-13,-13,0
21700344,1626245,CHI,CLE,Cristiano Felicio,49,11.5666666666667,12,-0.433333333333334,23,25,-2,-2,0
21700344,1627739,CHI,CLE,Kris Dunn,126,30.9166666666667,31,-0.0833333333333357,57,68,-11,-14,3
21700344,1627756,CHI,CLE,Denzel Valentine,126,29.7,30,-0.300000000000001,54,64,-10,-10,0
21700344,1627770,CHI,CLE,Kay Felder,17,3.91666666666667,4,-0.083333333333333,8,5,3,3,0
21700344,1627835,CHI,CLE,Paul Zipser,65,14.6,15,-0.4,24,43,-19,-20,1
21700344,1628021,CHI,CLE,David Nwaba,73,16.7833333333333,16,0.783333333333331,35,46,-11,-11,0
21700344,1628374,CHI,CLE,Lauri Markkanen,131,31.9,32,-0.100000000000001,57,73,-16,-17,1
21700345,2037,MIN,MEM,Jamal Crawford,89,19.6833333333333,20,-0.31666666666667,35,43,-8,-4,-4
21700345,201952,MIN,MEM,Jeff Teague,129,31.9,32,-0.100000000000001,63,60,3,2,1
21700345,201959,MIN,MEM,Taj Gibson,154,37.3666666666667,37,0.366666666666667,70,70,0,-1,1
21700345,202710,MIN,MEM,Jimmy Butler,164,39.8833333333333,40,-0.116666666666667,82,75,7,3,4
21700345,203476,MIN,MEM,Gorgui Dieng,92,21.3166666666667,21,0.316666666666666,41,51,-10,-10,0
21700345,203952,MIN,MEM,Andrew Wiggins,150,36.5833333333333,36,0.583333333333329,67,72,-5,-5,0
21700345,1626145,MIN,MEM,Tyus Jones,72,16.0833333333333,16,0.0833333333333357,29,35,-6,-5,-1
21700345,1626157,MIN,MEM,Karl-Anthony Towns,155,37.1,38,-0.900000000000006,73,69,4,5,-1
21700345,201188,MEM,MIN,Marc Gasol,142,34.9833333333333,35,-0.0166666666666657,63,68,-5,-5,0
21700345,201596,MEM,MIN,Mario Chalmers,88,20.45,20,0.449999999999999,39,40,-1,0,-1
21700345,201936,MEM,MIN,Tyreke Evans,142,33.55,33,0.549999999999997,67,58,9,8,1
21700345,203210,MEM,MIN,JaMychal Green,159,37.3166666666667,37,0.316666666666663,80,67,13,13,0
21700345,203463,MEM,MIN,Ben McLemore,78,18.15,18,0.149999999999999,45,40,5,-1,6
21700345,203516,MEM,MIN,James Ennis III,110,26.1,26,0.100000000000001,46,50,-4,2,-6
21700345,1626150,MEM,MIN,Andrew Harrison,72,18.1666666666667,18,0.166666666666664,32,36,-4,-3,-1
21700345,1626185,MEM,MIN,Jarell Martin,52,12.95,13,-0.0500000000000007,22,28,-6,-7,1
21700345,1627738,MEM,MIN,Deyonta Davis,49,10.7166666666667,11,-0.283333333333333,25,21,4,5,-1
21700345,1628415,MEM,MIN,Dillon Brooks,113,27.5333333333333,28,-0.466666666666669,56,52,4,3,1
21700346,2749,NOP,GSW,Jameer Nelson,100,20.0333333333333,20,0.0333333333333314,42,52,-10,-10,0
21700346,2754,NOP,GSW,Tony Allen,20,3.16666666666667,3,0.166666666666667,7,9,-2,-1,-1
21700346,200765,NOP,GSW,Rajon Rondo,151,27.85,28,-0.149999999999999,73,73,0,0,0
21700346,201600,NOP,GSW,Omer Asik,59,12.4,12,0.4,41,21,20,21,-1
21700346,201950,NOP,GSW,Jrue Holiday,204,37.9833333333333,38,-0.0166666666666657,97,96,1,1,0
21700346,201967,NOP,GSW,Dante Cunningham,166,31.8333333333333,32,-0.166666666666664,74,85,-11,-12,1
21700346,202326,NOP,GSW,DeMarcus Cousins,163,30.85,32,-1.15,58,93,-35,-32,-3
21700346,202734,NOP,GSW,E'Twaun Moore,197,37.5166666666667,38,-0.483333333333334,92,100,-8,-8,0
21700346,203121,NOP,GSW,Darius Miller,179,34.7166666666667,34,0.716666666666669,87,92,-5,-7,2
21700346,203546,NOP,GSW,Ian Clark,9,2.33333333333333,2,0.333333333333334,3,2,1,1,0
21700346,1627767,NOP,GSW,Cheick Diallo,2,0.15,0,0.15,1,2,-1,-3,2
21700346,2561,GSW,NOP,David West,57,12.8333333333333,13,-0.166666666666668,31,21,10,10,0
21700346,2738,GSW,NOP,Andre Iguodala,134,25.9,26,-0.100000000000001,69,60,9,11,-2
21700346,201142,GSW,NOP,Kevin Durant,179,34.7166666666667,35,-0.283333333333331,82,88,-6,-8,2
21700346,201156,GSW,NOP,Nick Young,62,13.8333333333333,14,-0.166666666666668,32,36,-4,-6,2
21700346,201580,GSW,NOP,JaVale McGee,60,11.1,11,0.0999999999999996,31,19,12,12,0
21700346,201939,GSW,NOP,Stephen Curry,188,34.6333333333333,34,0.633333333333333,89,92,-3,-1,-2
21700346,201956,GSW,NOP,Omri Casspi,70,12.75,13,-0.25,36,38,-2,0,-2
21700346,202691,GSW,NOP,Klay Thompson,185,35.2666666666667,36,-0.733333333333334,91,79,12,12,0
21700346,203110,GSW,NOP,Draymond Green,201,37.8666666666667,38,-0.133333333333333,111,82,29,27,2
21700346,1626172,GSW,NOP,Kevon Looney,17,3.25,3,0.25,8,15,-7,-8,1
21700346,1627775,GSW,NOP,Patrick McCaw,23,4.25,4,0.25,15,9,6,6,0
21700346,1628395,GSW,NOP,Jordan Bell,74,12.4333333333333,12,0.433333333333334,30,36,-6,-5,-1
21700347,1717,DAL,DEN,Dirk Nowitzki,94,20.6666666666667,21,-0.333333333333332,55,45,10,12,-2
21700347,2734,DAL,DEN,Devin Harris,105,22.8833333333333,23,-0.116666666666667,59,49,10,10,0
21700347,200826,DAL,DEN,J.J. Barea,89,19.35,19,0.350000000000001,52,41,11,11,0
21700347,202083,DAL,DEN,Wesley Matthews,148,32.9,33,-0.0999999999999943,84,72,12,12,0
21700347,203084,DAL,DEN,Harrison Barnes,159,35.8666666666667,36,-0.133333333333333,94,85,9,9,0
21700347,203939,DAL,DEN,Dwight Powell,103,23.0333333333333,23,0.0333333333333314,57,46,11,13,-2
21700347,1626257,DAL,DEN,Salah Mejri,42,9.06666666666667,9,0.0666666666666664,23,18,5,3,2
21700347,1627812,DAL,DEN,Yogi Ferrell,113,25.1833333333333,25,0.183333333333334,58,52,6,6,0
21700347,1628372,DAL,DEN,Dennis Smith Jr.,136,30.4666666666667,31,-0.533333333333335,76,72,4,4,0
21700347,1628467,DAL,DEN,Maxi Kleber,86,18.9166666666667,19,-0.0833333333333357,52,45,7,5,2
21700347,2210,DEN,DAL,Richard Jefferson,10,2.45,2,0.45,0,9,-9,-9,0
21700347,201163,DEN,DAL,Wilson Chandler,119,27.1333333333333,27,0.133333333333333,63,71,-8,-4,-4
21700347,202702,DEN,DAL,Kenneth Faried,124,27.8333333333333,28,-0.166666666666664,58,73,-15,-14,-1
21700347,203115,DEN,DAL,Will Barton,183,41.2833333333333,41,0.283333333333331,95,96,-1,-1,0
21700347,203486,DEN,DAL,Mason Plumlee,90,19.15,19,0.149999999999999,44,55,-11,-12,1
21700347,203914,DEN,DAL,Gary Harris,194,42.8166666666667,43,-0.183333333333337,101,105,-4,-2,-2
21700347,1626144,DEN,DAL,Emmanuel Mudiay,73,15.6833333333333,16,-0.316666666666666,31,41,-10,-12,2
21700347,1626168,DEN,DAL,Trey Lyles,72,15.45,16,-0.550000000000001,33,40,-7,-7,0
21700347,1627736,DEN,DAL,Malik Beasley,35,7.41666666666667,8,-0.583333333333334,16,14,2,2,0
21700347,1627750,DEN,DAL,Jamal Murray,120,27.5,28,-0.5,62,74,-12,-12,0
21700347,1627823,DEN,DAL,Juancho Hernangomez,55,11.6166666666667,12,-0.383333333333333,22,32,-10,-14,4
21700348,1938,SAS,DET,Manu Ginobili,123,26.5166666666667,26,0.516666666666666,60,47,13,13,0
21700348,2200,SAS,DET,Pau Gasol,130,28.9166666666667,29,-0.0833333333333357,60,59,1,0,1
21700348,2225,SAS,DET,Tony Parker,85,19.7,20,-0.299999999999997,35,38,-3,-3,0
21700348,200746,SAS,DET,LaMarcus Aldridge,156,34.8833333333333,35,-0.116666666666667,68,70,-2,-1,-1
21700348,200752,SAS,DET,Rudy Gay,142,32.0333333333333,32,0.0333333333333314,56,60,-4,-2,-2
21700348,201980,SAS,DET,Danny Green,155,34.25,34,0.25,60,67,-7,-9,2
21700348,201988,SAS,DET,Patty Mills,119,25.25,25,0.25,58,44,14,14,0
21700348,202722,SAS,DET,Davis Bertans,68,15.1333333333333,16,-0.866666666666667,34,27,7,7,0
21700348,203464,SAS,DET,Brandon Paul,9,1.7,2,-0.3,3,1,2,2,0
21700348,1627749,SAS,DET,Dejounte Murray,36,8.61666666666667,9,-0.383333333333333,21,17,4,4,0
21700348,1627854,SAS,DET,Bryn Forbes,57,12.8333333333333,13,-0.166666666666666,25,35,-10,-10,0
21700348,201229,DET,SAS,Anthony Tolliver,106,23.3333333333333,24,-0.666666666666668,49,45,4,2,2
21700348,202340,DET,SAS,Avery Bradley,149,33.2166666666667,33,0.216666666666669,67,59,8,10,-2
21700348,202397,DET,SAS,Ish Smith,65,14.2166666666667,14,0.216666666666667,24,32,-8,-8,0
21700348,202699,DET,SAS,Tobias Harris,176,39.5666666666667,40,-0.43333333333333,75,75,0,-4,4
21700348,202704,DET,SAS,Reggie Jackson,151,33.75,34,-0.25,69,64,5,5,0
21700348,203083,DET,SAS,Andre Drummond,142,31.2166666666667,32,-0.783333333333335,61,52,9,7,2
21700348,203961,DET,SAS,Eric Moreland,75,17.05,16,1.05,32,46,-14,-10,-4
21700348,204038,DET,SAS,Langston Galloway,41,8.73333333333333,9,-0.266666666666666,16,21,-5,-5,0
21700348,1626169,DET,SAS,Stanley Johnson,139,30.65,30,0.649999999999999,56,64,-8,-6,-2
21700348,1628379,DET,SAS,Luke Kennard,36,8.1,8,0.0999999999999996,16,22,-6,-6,0
21700349,200757,UTA,WAS,Thabo Sefolosha,52,12.3833333333333,12,0.383333333333333,38,8,30,26,4
21700349,201937,UTA,WAS,Ricky Rubio,105,23.9333333333333,24,-0.06666666666667,57,30,27,25,2
21700349,201973,UTA,WAS,Jonas Jerebko,133,29.5333333333333,30,-0.466666666666669,70,54,16,21,-5
21700349,202324,UTA,WAS,Derrick Favors,103,24.8666666666667,25,-0.133333333333333,59,33,26,26,0
21700349,202327,UTA,WAS,Ekpe Udoh,36,7.95,8,-0.0500000000000007,13,11,2,3,-1
21700349,202692,UTA,WAS,Alec Burks,117,27.3833333333333,28,-0.616666666666667,75,44,31,32,-1
21700349,203497,UTA,WAS,Rudy Gobert,94,20.6333333333333,21,-0.366666666666667,50,32,18,18,0
21700349,203526,UTA,WAS,Raul Neto,85,18.45,19,-0.550000000000001,43,20,23,26,-3
21700349,204060,UTA,WAS,Joe Ingles,101,22.9166666666667,23,-0.0833333333333357,46,36,10,10,0
21700349,1626220,UTA,WAS,Royce O'Neale,105,24.5166666666667,25,-0.483333333333334,66,33,33,35,-2
21700349,1628378,UTA,WAS,Donovan Mitchell,114,25.85,26,-0.149999999999999,58,44,14,13,1
21700349,101133,WAS,UTA,Ian Mahinmi,38,9.73333333333333,10,-0.266666666666666,10,28,-18,-16,-2
21700349,101162,WAS,UTA,Marcin Gortat,108,23.9166666666667,24,-0.0833333333333357,40,55,-15,-17,2
21700349,201160,WAS,UTA,Jason Smith,23,4.96666666666667,5,-0.0333333333333332,8,13,-5,-5,0
21700349,201975,WAS,UTA,Jodie Meeks,98,21.75,22,-0.25,25,59,-34,-35,1
21700349,202693,WAS,UTA,Markieff Morris,96,22.4333333333333,22,0.433333333333334,42,45,-3,-5,2
21700349,203078,WAS,UTA,Bradley Beal,124,28.0166666666667,28,0.0166666666666657,46,63,-17,-19,2
21700349,203107,WAS,UTA,Tomas Satoransky,100,23.45,24,-0.550000000000001,31,64,-33,-32,-1
21700349,203118,WAS,UTA,Mike Scott,85,19.4,20,-0.600000000000001,25,51,-26,-26,0
21700349,203490,WAS,UTA,Otto Porter Jr.,124,28.2833333333333,28,0.283333333333331,44,64,-20,-21,1
21700349,204025,WAS,UTA,Tim Frazier,86,20,20,0,31,41,-10,-8,-2
21700349,1626162,WAS,UTA,Kelly Oubre Jr.,123,27.4,28,-0.600000000000001,32,73,-41,-42,1
21700349,1626191,WAS,UTA,Chris McCullough,40,9.06666666666667,9,0.0666666666666664,11,19,-8,-9,1
21700350,201162,PHX,TOR,Jared Dudley,119,25.0666666666667,25,0.0666666666666664,66,61,5,5,0
21700350,202328,PHX,TOR,Greg Monroe,125,26.0666666666667,26,0.0666666666666664,63,62,1,1,0
21700350,203458,PHX,TOR,Alex Len,88,17.9333333333333,18,-0.0666666666666664,36,51,-15,-15,0
21700350,203584,PHX,TOR,Troy Daniels,106,21.15,21,0.149999999999999,55,57,-2,-2,0
21700350,203933,PHX,TOR,T.J. Warren,110,23.4,23,0.399999999999999,43,60,-17,-17,0
21700350,1626164,PHX,TOR,Devin Booker,191,39.3833333333333,39,0.383333333333333,97,93,4,2,2
21700350,1627733,PHX,TOR,Dragan Bender,65,12.4666666666667,13,-0.533333333333333,25,34,-9,-9,0
21700350,1627737,PHX,TOR,Marquese Chriss,53,10.4666666666667,10,0.466666666666667,22,31,-9,-9,0
21700350,1627755,PHX,TOR,Tyler Ulis,111,20.9833333333333,21,-0.0166666666666657,45,70,-25,-23,-2
21700350,1628367,PHX,TOR,Josh Jackson,140,27.1833333333333,27,0.18333333333333,70,76,-6,-6,0
21700350,1628455,PHX,TOR,Mike James,77,15.9,16,-0.100000000000001,43,35,8,8,0
21700350,101139,TOR,PHX,CJ Miles,92,18.3,18,0.299999999999997,47,42,5,5,0
21700350,200768,TOR,PHX,Kyle Lowry,172,35.05,35,0.0499999999999972,98,72,26,24,2
21700350,201586,TOR,PHX,Serge Ibaka,159,32.8,33,-0.200000000000003,86,72,14,10,4
21700350,201942,TOR,PHX,DeMar DeRozan,173,34.2833333333333,34,0.283333333333331,99,80,19,17,2
21700350,202685,TOR,PHX,Jonas Valanciunas,93,18.5333333333333,18,0.533333333333331,49,43,6,8,-2
21700350,203485,TOR,PHX,Lorenzo Brown,2,0.516666666666667,0,0.516666666666667,,4,,-2,
21700350,1626181,TOR,PHX,Norman Powell,75,16.25,16,0.25,29,41,-12,-14,2
21700350,1627751,TOR,PHX,Jakob Poeltl,108,22.6166666666667,23,-0.383333333333333,55,50,5,3,2
21700350,1627783,TOR,PHX,Pascal Siakam,78,15.2,15,0.199999999999999,40,41,-1,3,-4
21700350,1627832,TOR,PHX,Fred VanVleet,109,21.5166666666667,21,0.516666666666666,58,60,-2,0,-2
21700350,1628035,TOR,PHX,Alfonzo McKinnie,2,0.516666666666667,0,0.516666666666667,,4,,-2,
21700350,1628384,TOR,PHX,OG Anunoby,122,24.4166666666667,24,0.416666666666668,69,56,13,13,0
21700351,2546,OKC,UTA,Carmelo Anthony,158,34.2,35,-0.799999999999997,79,77,2,0,2
21700351,101109,OKC,UTA,Raymond Felton,47,10.3,10,0.300000000000001,11,9,2,0,2
21700351,201566,OKC,UTA,Russell Westbrook,176,38.0333333333333,38,0.0333333333333314,89,87,2,4,-2
21700351,202331,OKC,UTA,Paul George,180,39.5,40,-0.5,77,66,11,7,4
21700351,202335,OKC,UTA,Patrick Patterson,59,13.2666666666667,13,0.266666666666666,17,18,-1,1,-2
21700351,203460,OKC,UTA,Andre Roberson,152,33.85,34,-0.150000000000006,80,68,12,14,-2
21700351,203500,OKC,UTA,Steven Adams,155,32.95,33,-0.0499999999999972,80,71,9,9,0
21700351,203518,OKC,UTA,Alex Abrines,89,18.5833333333333,18,0.583333333333332,37,39,-2,0,-2
21700351,203924,OKC,UTA,Jerami Grant,84,18.4,19,-0.600000000000001,30,35,-5,-5,0
21700351,200757,UTA,OKC,Thabo Sefolosha,104,21.7,21,0.700000000000003,35,44,-9,-14,5
21700351,201937,UTA,OKC,Ricky Rubio,153,34.3166666666667,34,0.316666666666663,62,66,-4,-6,2
21700351,201973,UTA,OKC,Jonas Jerebko,95,21.0833333333333,21,0.0833333333333322,45,47,-2,3,-5
21700351,202324,UTA,OKC,Derrick Favors,101,22.95,23,-0.0499999999999972,47,44,3,1,2
21700351,202327,UTA,OKC,Ekpe Udoh,16,3.58333333333333,4,-0.416666666666667,4,3,1,1,0
21700351,202692,UTA,OKC,Alec Burks,106,21.45,22,-0.550000000000001,45,47,-2,-2,0
21700351,203497,UTA,OKC,Rudy Gobert,124,26.3166666666667,27,-0.683333333333334,57,62,-5,-3,-2
21700351,204060,UTA,OKC,Joe Ingles,155,34.1333333333333,34,0.133333333333333,77,78,-1,-2,1
21700351,1626220,UTA,OKC,Royce O'Neale,83,17.6666666666667,17,0.666666666666668,24,34,-10,-10,0
21700351,1628378,UTA,OKC,Donovan Mitchell,163,35.8833333333333,36,-0.116666666666667,74,75,-1,2,-3
21700352,202323,POR,WAS,Evan Turner,76,17.45,18,-0.550000000000001,24,40,-16,-19,3
21700352,202329,POR,WAS,Al-Farouq Aminu,156,35.15,36,-0.850000000000001,78,80,-2,-2,0
21700352,202334,POR,WAS,Ed Davis,46,10.3666666666667,10,0.366666666666667,11,24,-13,-13,0
21700352,203081,POR,WAS,Damian Lillard,196,42.6166666666667,43,-0.383333333333333,88,93,-5,-5,0
21700352,203086,POR,WAS,Meyers Leonard,16,3.43333333333333,3,0.433333333333334,5,11,-6,-6,0
21700352,203090,POR,WAS,Maurice Harkless,51,11.9333333333333,12,-0.0666666666666664,18,22,-4,-3,-1
21700352,203468,POR,WAS,CJ McCollum,162,36.9333333333333,37,-0.0666666666666629,75,74,1,3,-2
21700352,203894,POR,WAS,Shabazz Napier,41,8.23333333333333,8,0.233333333333333,15,24,-9,-9,0
21700352,203943,POR,WAS,Noah Vonleh,71,14.8833333333333,15,-0.116666666666667,24,30,-6,-6,0
21700352,203994,POR,WAS,Jusuf Nurkic,127,28.35,29,-0.649999999999999,55,58,-3,-3,0
21700352,1626192,POR,WAS,Pat Connaughton,125,26.0833333333333,26,0.0833333333333322,56,65,-9,-9,0
21700352,1628380,POR,WAS,Zach Collins,18,3.31666666666667,4,-0.683333333333334,11,9,2,2,0
21700352,101133,WAS,POR,Ian Mahinmi,84,18.2333333333333,18,0.233333333333334,41,28,13,11,2
21700352,101162,WAS,POR,Marcin Gortat,96,22.4333333333333,23,-0.566666666666666,49,38,11,11,0
21700352,201975,WAS,POR,Jodie Meeks,21,4.71666666666667,5,-0.283333333333333,9,7,2,2,0
21700352,202693,WAS,POR,Markieff Morris,139,30.15,30,0.149999999999999,65,60,5,7,-2
21700352,203078,WAS,POR,Bradley Beal,196,43.0333333333333,43,0.0333333333333314,97,85,12,12,0
21700352,203107,WAS,POR,Tomas Satoransky,114,24.0166666666667,24,0.0166666666666657,58,54,4,6,-2
21700352,203118,WAS,POR,Mike Scott,71,15.8666666666667,16,-0.133333333333333,41,27,14,14,0
21700352,203490,WAS,POR,Otto Porter Jr.,134,30.2833333333333,30,0.283333333333331,60,67,-7,-7,0
21700352,204025,WAS,POR,Tim Frazier,103,23.7333333333333,24,-0.266666666666666,48,38,10,8,2
21700352,1626162,WAS,POR,Kelly Oubre Jr.,127,26.2833333333333,27,-0.716666666666669,62,56,6,6,0
21700353,2544,CLE,SAC,LeBron James,180,41.1666666666667,41,0.166666666666671,81,80,1,2,-1
21700353,2548,CLE,SAC,Dwyane Wade,113,25.4833333333333,25,0.483333333333334,63,57,6,7,-1
21700353,2594,CLE,SAC,Kyle Korver,112,25.7833333333333,26,-0.216666666666669,62,51,11,10,1
21700353,2747,CLE,SAC,JR Smith,151,33.55,34,-0.450000000000003,66,66,0,0,0
21700353,101112,CLE,SAC,Channing Frye,77,18.0333333333333,18,0.0333333333333314,46,36,10,8,2
21700353,101181,CLE,SAC,Jose Calderon,65,14.95,15,-0.0500000000000007,23,23,0,0,0
21700353,201145,CLE,SAC,Jeff Green,103,23.8166666666667,24,-0.183333333333334,52,47,5,5,0
21700353,201567,CLE,SAC,Kevin Love,131,29.7,30,-0.300000000000001,54,59,-5,-3,-2
21700353,203109,CLE,SAC,Jae Crowder,107,23.8,24,-0.200000000000003,46,48,-2,-2,0
21700353,1626224,CLE,SAC,Cedi Osman,16,3.71666666666667,4,-0.283333333333333,12,8,4,3,1
21700353,1713,SAC,CLE,Vince Carter,80,18.4666666666667,19,-0.533333333333331,38,49,-11,-9,-2
21700353,2216,SAC,CLE,Zach Randolph,138,31.95,32,-0.0500000000000007,61,60,1,1,0
21700353,201585,SAC,CLE,Kosta Koufos,75,16.3666666666667,16,0.366666666666667,34,41,-7,-7,0
21700353,201588,SAC,CLE,George Hill,131,29.95,30,-0.0500000000000007,61,58,3,1,2
21700353,202066,SAC,CLE,Garrett Temple,84,19.0666666666667,19,0.0666666666666664,30,33,-3,-3,0
21700353,203960,SAC,CLE,JaKarr Sampson,147,32.9333333333333,33,-0.06666666666667,62,60,2,2,0
21700353,203992,SAC,CLE,Bogdan Bogdanovic,75,17.6833333333333,18,-0.316666666666666,37,43,-6,-6,0
21700353,1627741,SAC,CLE,Buddy Hield,114,25.5833333333333,26,-0.416666666666664,57,60,-3,-3,0
21700353,1628368,SAC,CLE,De'Aaron Fox,122,28.6,29,-0.399999999999999,49,52,-3,-3,0
21700353,1628412,SAC,CLE,Frank Mason,89,19.4,19,0.399999999999999,46,49,-3,-3,0
21700354,201577,CHI,IND,Robin Lopez,153,33.65,34,-0.349999999999994,71,71,0,0,0
21700354,203200,CHI,IND,Justin Holiday,165,36.3166666666667,36,0.316666666666663,73,76,-3,-3,0
21700354,1626170,CHI,IND,Jerian Grant,58,13.8,14,-0.199999999999999,29,22,7,7,0
21700354,1626171,CHI,IND,Bobby Portis,86,19.35,19,0.350000000000001,41,34,7,7,0
21700354,1627739,CHI,IND,Kris Dunn,157,34.2,34,0.200000000000003,67,76,-9,-9,0
21700354,1627756,CHI,IND,Denzel Valentine,145,32.6666666666667,33,-0.333333333333329,59,72,-13,-12,-1
21700354,1627835,CHI,IND,Paul Zipser,71,16.7666666666667,17,-0.233333333333334,35,26,9,9,0
21700354,1628021,CHI,IND,David Nwaba,99,22.25,22,0.25,49,42,7,6,1
21700354,1628374,CHI,IND,Lauri Markkanen,141,31,31,0,56,71,-15,-15,0
21700354,201152,IND,CHI,Thaddeus Young,169,37.9166666666667,38,-0.0833333333333286,80,67,13,15,-2
21700354,201954,IND,CHI,Darren Collison,91,20.55,21,-0.449999999999999,47,47,0,-1,1
21700354,202362,IND,CHI,Lance Stephenson,64,14.6166666666667,15,-0.383333333333333,22,36,-14,-13,-1
21700354,202709,IND,CHI,Cory Joseph,142,31.45,31,0.449999999999999,59,61,-2,-2,0
21700354,202711,IND,CHI,Bojan Bogdanovic,168,37.75,38,-0.25,81,67,14,14,0
21700354,203506,IND,CHI,Victor Oladipo,176,38.8166666666667,39,-0.183333333333337,83,75,8,8,0
21700354,1626167,IND,CHI,Myles Turner,142,31.7166666666667,32,-0.283333333333331,68,65,3,5,-2
21700354,1626202,IND,CHI,Joe Young,4,0.816666666666667,1,-0.183333333333333,2,2,0,0,0
21700354,1627734,IND,CHI,Domantas Sabonis,97,21.3333333333333,21,0.333333333333332,40,45,-5,-9,4
21700354,1628388,IND,CHI,TJ Leaf,22,5.03333333333333,5,0.0333333333333332,8,15,-7,-7,0
21700355,101141,ATL,ORL,Ersan Ilyasova,130,27.3666666666667,28,-0.633333333333333,59,64,-5,-4,-1
21700355,201158,ATL,ORL,Marco Belinelli,125,28.2166666666667,28,0.216666666666669,57,48,9,15,-6
21700355,202337,ATL,ORL,Luke Babbitt,59,13.1833333333333,13,0.183333333333334,22,24,-2,0,-2
21700355,203101,ATL,ORL,Miles Plumlee,56,12.4666666666667,13,-0.533333333333335,25,25,0,0,0
21700355,203145,ATL,ORL,Kent Bazemore,173,36.7666666666667,36,0.766666666666666,76,81,-5,-7,2
21700355,203471,ATL,ORL,Dennis Schroder,184,39.5833333333333,39,0.583333333333329,82,89,-7,-5,-2
21700355,1627752,ATL,ORL,Taurean Prince,168,35.1166666666667,36,-0.883333333333333,66,81,-15,-13,-2
21700355,1627761,ATL,ORL,DeAndre' Bembry,151,32.9166666666667,27,5.91666666666667,68,61,7,-5,12
21700355,1627819,ATL,ORL,Isaiah Taylor,68,14.8833333333333,15,-0.116666666666667,26,23,3,1,2
21700355,1628463,ATL,ORL,Tyler Cavanaugh,164,34.7,30,4.7,77,74,3,-2,5
21700355,201167,ORL,ATL,Arron Afflalo,57,13.1333333333333,13,0.133333333333333,22,26,-4,-2,-2
21700355,201571,ORL,ATL,D.J. Augustin,101,21.9333333333333,22,-0.0666666666666664,46,43,3,3,0
21700355,202687,ORL,ATL,Bismack Biyombo,57,13.4,13,0.399999999999999,20,30,-10,-8,-2
21700355,202696,ORL,ATL,Nikola Vucevic,189,39.6,40,-0.400000000000006,90,76,14,12,2
21700355,202714,ORL,ATL,Shelvin Mack,16,4.06666666666667,4,0.0666666666666664,4,6,-2,-4,2
21700355,203095,ORL,ATL,Evan Fournier,194,40.8666666666667,41,-0.133333333333333,90,82,8,8,0
21700355,203613,ORL,ATL,Jonathon Simmons,189,40.4833333333333,41,-0.516666666666666,84,85,-1,0,-1
21700355,203901,ORL,ATL,Elfrid Payton,165,35.15,40,-4.85,71,70,1,2,-1
21700355,203932,ORL,ATL,Aaron Gordon,187,39.7333333333333,45,-5.26666666666667,89,78,11,15,-4
21700355,1628411,ORL,ATL,Wes Iwundu,27,6.43333333333333,6,0.433333333333334,6,14,-8,-8,0
21700356,201143,BOS,DAL,Al Horford,147,32.8666666666667,33,-0.133333333333333,68,61,7,9,-2
21700356,202681,BOS,DAL,Kyrie Irving,142,31.8,32,-0.200000000000003,67,55,12,11,1
21700356,203382,BOS,DAL,Aron Baynes,43,10.1,10,0.100000000000001,27,13,14,14,0
21700356,203499,BOS,DAL,Shane Larkin,65,15.0833333333333,15,0.0833333333333322,28,32,-4,-1,-3
21700356,203935,BOS,DAL,Marcus Smart,151,34.1666666666667,34,0.166666666666671,61,56,5,5,0
21700356,1626179,BOS,DAL,Terry Rozier,121,27.45,28,-0.550000000000001,53,47,6,4,2
21700356,1627824,BOS,DAL,Guerschon Yabusele,27,6.35,7,-0.65,14,13,1,-1,2
21700356,1627846,BOS,DAL,Abdel Nader,29,6.86666666666667,7,-0.133333333333333,17,23,-6,-6,0
21700356,1628369,BOS,DAL,Jayson Tatum,150,33.2,33,0.200000000000003,77,61,16,16,0
21700356,1628400,BOS,DAL,Semi Ojeleye,109,24.5,25,-0.5,41,55,-14,-14,0
21700356,1628464,BOS,DAL,Daniel Theis,76,17.6166666666667,17,0.616666666666667,32,34,-2,-2,0
21700356,1717,DAL,BOS,Dirk Nowitzki,121,27.6,28,-0.399999999999999,43,68,-25,-21,-4
21700356,2734,DAL,BOS,Devin Harris,83,18.7,19,-0.299999999999997,38,32,6,7,-1
21700356,200826,DAL,BOS,J.J. Barea,105,24.8333333333333,25,-0.166666666666664,45,48,-3,-2,-1
21700356,202083,DAL,BOS,Wesley Matthews,137,30.8,30,0.800000000000001,55,69,-14,-16,2
21700356,203084,DAL,BOS,Harrison Barnes,147,32.95,33,-0.0499999999999972,61,64,-3,-5,2
21700356,203939,DAL,BOS,Dwight Powell,58,13.1,13,0.0999999999999996,21,31,-10,-4,-6
21700356,1626257,DAL,BOS,Salah Mejri,17,3.95,4,-0.0499999999999998,10,5,5,3,2
21700356,1627812,DAL,BOS,Yogi Ferrell,151,34.1333333333333,34,0.133333333333333,75,60,15,15,0
21700356,1628372,DAL,BOS,Dennis Smith Jr.,114,24.85,25,-0.149999999999999,44,53,-9,-9,0
21700356,1628467,DAL,BOS,Maxi Kleber,126,28.7833333333333,29,-0.216666666666669,57,55,2,-3,5
21700356,1628499,DAL,BOS,Antonius Cleveland,1,0.3,0,0.3,1,,,0,
21700357,101127,NYK,MEM,Jarrett Jack,113,27.2833333333333,27,0.283333333333331,65,46,19,19,0
21700357,201563,NYK,MEM,Michael Beasley,74,17.7666666666667,18,-0.233333333333334,42,24,18,19,-1
21700357,201584,NYK,MEM,Courtney Lee,157,37.7666666666667,38,-0.233333333333334,82,66,16,18,-2
21700357,202498,NYK,MEM,Lance Thomas,127,31.3,32,-0.699999999999999,77,50,27,26,1
21700357,202683,NYK,MEM,Enes Kanter,112,27.5,28,-0.5,55,51,4,2,2
21700357,203124,NYK,MEM,Kyle O'Quinn,67,16.2333333333333,17,-0.766666666666666,33,35,-2,0,-2
21700357,203926,NYK,MEM,Doug McDermott,89,21.6166666666667,21,0.616666666666667,34,45,-11,-12,1
21700357,204001,NYK,MEM,Kristaps Porzingis,140,33.7333333333333,34,-0.266666666666666,68,66,2,1,1
21700357,1628373,NYK,MEM,Frank Ntilikina,84,20.55,21,-0.449999999999999,34,42,-8,-8,0
21700357,1628422,NYK,MEM,Damyean Dotson,22,5.41666666666667,5,0.416666666666666,5,15,-10,-10,0
21700357,201188,MEM,NYK,Marc Gasol,143,34.3666666666667,34,0.36666666666666,67,69,-2,3,-5
21700357,201596,MEM,NYK,Mario Chalmers,91,22.3166666666667,23,-0.683333333333334,46,40,6,6,0
21700357,201936,MEM,NYK,Tyreke Evans,133,32.8833333333333,33,-0.116666666666667,53,77,-24,-28,4
21700357,202718,MEM,NYK,Chandler Parsons,90,21.6166666666667,22,-0.383333333333333,44,34,10,11,-1
21700357,203210,MEM,NYK,JaMychal Green,108,26.3333333333333,27,-0.666666666666664,44,63,-19,-17,-2
21700357,203463,MEM,NYK,Ben McLemore,34,8.05,8,0.0500000000000007,12,26,-14,-14,0
21700357,203516,MEM,NYK,James Ennis III,82,20.1333333333333,21,-0.866666666666667,38,37,1,5,-4
21700357,1626150,MEM,NYK,Andrew Harrison,118,28.9666666666667,29,-0.0333333333333314,63,49,14,16,-2
21700357,1626185,MEM,NYK,Jarell Martin,57,13.6666666666667,13,0.666666666666666,25,23,2,1,1
21700357,1627738,MEM,NYK,Deyonta Davis,49,12.1333333333333,12,0.133333333333333,17,30,-13,-18,5
21700357,1628415,MEM,NYK,Dillon Brooks,80,18.7,18,0.699999999999999,31,47,-16,-20,4
21700358,2561,GSW,CHA,David West,89,20.1,20,0.100000000000001,40,39,1,1,0
21700358,2585,GSW,CHA,Zaza Pachulia,20,4.23333333333333,5,-0.766666666666667,8,6,2,2,0
21700358,2733,GSW,CHA,Shaun Livingston,69,15.65,16,-0.350000000000001,31,27,4,4,0
21700358,2738,GSW,CHA,Andre Iguodala,139,29.8333333333333,30,-0.166666666666664,65,52,13,11,2
21700358,201142,GSW,CHA,Kevin Durant,176,35.8166666666667,36,-0.183333333333337,79,72,7,7,0
21700358,201156,GSW,CHA,Nick Young,90,19.7,20,-0.299999999999997,39,23,16,16,0
21700358,201580,GSW,CHA,JaVale McGee,37,7.6,8,-0.4,22,15,7,7,0
21700358,201956,GSW,CHA,Omri Casspi,84,16.7,17,-0.300000000000001,36,32,4,2,2
21700358,202691,GSW,CHA,Klay Thompson,168,36.05,36,0.0499999999999972,83,65,18,18,0
21700358,1626172,GSW,CHA,Kevon Looney,50,10.85,11,-0.149999999999999,21,19,2,2,0
21700358,1626188,GSW,CHA,Quinn Cook,109,21.9166666666667,22,-0.0833333333333322,43,47,-4,-2,-2
21700358,1628395,GSW,CHA,Jordan Bell,99,20.1333333333333,20,0.133333333333333,38,38,0,2,-2
21700358,2730,CHA,GSW,Dwight Howard,137,29.4,30,-0.600000000000001,49,66,-17,-17,0
21700358,101107,CHA,GSW,Marvin Williams,144,29.3333333333333,29,0.333333333333336,53,74,-21,-23,2
21700358,201587,CHA,GSW,Nicolas Batum,174,35.7333333333333,36,-0.266666666666666,72,81,-9,-13,4
21700358,202689,CHA,GSW,Kemba Walker,178,36.85,37,-0.149999999999999,75,81,-6,-6,0
21700358,203077,CHA,GSW,Michael Kidd-Gilchrist,125,25.0166666666667,25,0.0166666666666657,54,63,-9,-9,0
21700358,203087,CHA,GSW,Jeremy Lamb,88,20.05,20,0.0499999999999972,29,36,-7,-7,0
21700358,203469,CHA,GSW,Cody Zeller,76,15.6666666666667,16,-0.333333333333332,34,33,1,1,0
21700358,203487,CHA,GSW,Michael Carter-Williams,64,14.95,15,-0.0500000000000007,19,24,-5,-1,-4
21700358,203948,CHA,GSW,Johnny O'Bryant III,13,2.65,3,-0.35,4,2,2,2,0
21700358,1626163,CHA,GSW,Frank Kaminsky,25,5.8,6,-0.2,8,10,-2,-2,0
21700358,1626203,CHA,GSW,Treveon Graham,57,12.5833333333333,13,-0.416666666666668,26,17,9,11,-2
21700358,1628370,CHA,GSW,Malik Monk,23,4.56666666666667,5,-0.433333333333334,6,6,0,0,0
21700358,1628407,CHA,GSW,Dwayne Bacon,26,5.98333333333333,6,-0.0166666666666666,6,12,-6,-6,0
21700359,202339,MIL,DET,Eric Bledsoe,146,31,31,0,61,73,-12,-10,-2
21700359,202732,MIL,DET,DeAndre Liggins,109,23.5333333333333,24,-0.466666666666669,56,44,12,9,3
21700359,203089,MIL,DET,John Henson,110,24,24,0,52,52,0,1,-1
21700359,203114,MIL,DET,Khris Middleton,175,36.6333333333333,37,-0.366666666666667,80,87,-7,-7,0
21700359,203503,MIL,DET,Tony Snell,94,20.35,20,0.350000000000001,43,47,-4,-2,-2
21700359,203507,MIL,DET,Giannis Antetokounmpo,169,37.45,38,-0.549999999999997,79,77,2,4,-2
21700359,1626173,MIL,DET,Rashad Vaughn,74,17.4,17,0.399999999999999,41,21,20,18,2
21700359,1627748,MIL,DET,Thon Maker,103,23.4666666666667,23,0.466666666666669,47,42,5,5,0
21700359,1627763,MIL,DET,Malcolm Brogdon,120,26.1666666666667,26,0.166666666666664,61,57,4,2,2
21700359,201229,DET,MIL,Anthony Tolliver,92,20.1166666666667,20,0.116666666666667,34,52,-18,-14,-4
21700359,202340,DET,MIL,Avery Bradley,157,32.95,33,-0.0499999999999972,78,63,15,15,0
21700359,202397,DET,MIL,Ish Smith,71,16.1666666666667,16,0.166666666666668,27,39,-12,-13,1
21700359,202699,DET,MIL,Tobias Harris,177,39,39,0,82,81,1,-1,2
21700359,202704,DET,MIL,Reggie Jackson,149,31.8333333333333,32,-0.166666666666664,73,65,8,9,-1
21700359,203083,DET,MIL,Andre Drummond,166,37.0666666666667,37,0.0666666666666629,89,78,11,9,2
21700359,203961,DET,MIL,Eric Moreland,54,10.9333333333333,11,-0.0666666666666664,11,26,-15,-13,-2
21700359,1626169,DET,MIL,Stanley Johnson,157,34.1,34,0.100000000000001,77,72,5,4,1
21700359,1628379,DET,MIL,Luke Kennard,77,17.8333333333333,18,-0.166666666666664,29,44,-15,-16,1
21700360,2749,NOP,DEN,Jameer Nelson,97,22.05,22,0.0500000000000007,54,42,12,12,0
21700360,2754,NOP,DEN,Tony Allen,63,14.3166666666667,14,0.316666666666666,36,28,8,8,0
21700360,200765,NOP,DEN,Rajon Rondo,132,25.8,26,-0.199999999999999,68,72,-4,-3,-1
21700360,201600,NOP,DEN,Omer Asik,37,8.16666666666667,8,0.166666666666668,25,15,10,8,2
21700360,201950,NOP,DEN,Jrue Holiday,173,34.9166666666667,35,-0.0833333333333357,95,89,6,7,-1
21700360,201967,NOP,DEN,Dante Cunningham,142,28.5833333333333,29,-0.416666666666668,78,73,5,2,3
21700360,202326,NOP,DEN,DeMarcus Cousins,191,39.4666666666667,40,-0.533333333333331,95,99,-4,1,-5
21700360,202734,NOP,DEN,E'Twaun Moore,184,38.5166666666667,39,-0.483333333333334,96,95,1,2,-1
21700360,203121,NOP,DEN,Darius Miller,126,27.4333333333333,27,0.433333333333334,63,57,6,8,-2
21700360,201163,DEN,NOP,Wilson Chandler,119,24.1666666666667,24,0.166666666666664,65,65,0,-3,3
21700360,202702,DEN,NOP,Kenneth Faried,116,23.6333333333333,24,-0.366666666666667,58,70,-12,-13,1
21700360,203115,DEN,NOP,Will Barton,163,33.7333333333333,34,-0.266666666666666,78,102,-24,-21,-3
21700360,203486,DEN,NOP,Mason Plumlee,105,22.9333333333333,23,-0.0666666666666664,51,50,1,1,0
21700360,203914,DEN,NOP,Gary Harris,175,36.9333333333333,37,-0.0666666666666629,89,91,-2,-3,1
21700360,1626144,DEN,NOP,Emmanuel Mudiay,130,26.6333333333333,27,-0.366666666666667,60,77,-17,-18,1
21700360,1626168,DEN,NOP,Trey Lyles,126,27.2,27,0.200000000000003,56,66,-10,-10,0
21700360,1627736,DEN,NOP,Malik Beasley,83,17.9333333333333,17,0.93333333333333,44,38,6,4,2
21700360,1627750,DEN,NOP,Jamal Murray,107,22.5,23,-0.5,59,47,12,12,0
21700360,1627823,DEN,NOP,Juancho Hernangomez,21,3.58333333333333,4,-0.416666666666667,10,4,6,6,0
21700361,201609,MIA,SAS,Goran Dragic,122,28.9166666666667,29,-0.0833333333333357,57,78,-21,-26,5
21700361,201949,MIA,SAS,James Johnson,102,23.2833333333333,24,-0.716666666666669,58,61,-3,-3,0
21700361,201961,MIA,SAS,Wayne Ellington,80,18.7666666666667,19,-0.233333333333334,30,52,-22,-20,-2
21700361,203079,MIA,SAS,Dion Waiters,144,34.1166666666667,35,-0.883333333333333,83,76,7,10,-3
21700361,203482,MIA,SAS,Kelly Olynyk,135,31.8166666666667,33,-1.18333333333333,80,82,-2,-1,-1
21700361,204020,MIA,SAS,Tyler Johnson,131,30.1833333333333,30,0.183333333333334,67,71,-4,-6,2
21700361,1626159,MIA,SAS,Justise Winslow,92,22.1833333333333,22,0.183333333333334,40,48,-8,-8,0
21700361,1626196,MIA,SAS,Josh Richardson,129,30.7166666666667,31,-0.283333333333331,78,74,4,6,-2
21700361,1628389,MIA,SAS,Bam Adebayo,75,17.85,18,-0.149999999999999,32,43,-11,-12,1
21700361,1938,SAS,MIA,Manu Ginobili,106,25.4,25,0.399999999999999,59,61,-2,0,-2
21700361,2200,SAS,MIA,Pau Gasol,85,20.4666666666667,20,0.466666666666669,50,42,8,10,-2
21700361,2225,SAS,MIA,Tony Parker,85,19.9666666666667,20,-0.0333333333333314,51,43,8,10,-2
21700361,200746,SAS,MIA,LaMarcus Aldridge,138,32.3666666666667,33,-0.633333333333333,84,82,2,0,2
21700361,200752,SAS,MIA,Rudy Gay,139,32.3333333333333,33,-0.666666666666664,88,64,24,24,0
21700361,201980,SAS,MIA,Danny Green,129,30,30,0,90,57,33,31,2
21700361,201988,SAS,MIA,Patty Mills,114,27.0166666666667,27,0.0166666666666657,66,62,4,2,2
21700361,202722,SAS,MIA,Davis Bertans,71,16.6833333333333,17,-0.31666666666667,32,45,-13,-13,0
21700361,203464,SAS,MIA,Brandon Paul,26,5.86666666666667,6,-0.133333333333333,7,12,-5,-5,0
21700361,1627749,SAS,MIA,Dejounte Murray,3,0.583333333333333,1,-0.416666666666667,0,0,0,0,0
21700361,1627854,SAS,MIA,Bryn Forbes,114,27.15,28,-0.850000000000001,58,57,1,1,0
21700362,101150,LAC,MIN,Lou Williams,176,36.15,37,-0.850000000000001,88,84,4,8,-4
21700362,201568,LAC,MIN,Danilo Gallinari,117,26.1,26,0.100000000000001,50,59,-9,-11,2
21700362,201599,LAC,MIN,DeAndre Jordan,163,34.2333333333333,34,0.233333333333334,70,77,-7,-5,-2
21700362,202325,LAC,MIN,Wesley Johnson,152,31.9833333333333,32,-0.0166666666666657,68,76,-8,-6,-2
21700362,203085,LAC,MIN,Austin Rivers,176,37.1,37,0.100000000000001,80,86,-6,-5,-1
21700362,203710,LAC,MIN,C.J. Williams,52,11.8166666666667,11,0.816666666666666,22,29,-7,-11,4
21700362,203966,LAC,MIN,Jamil Wilson,82,16.0833333333333,16,0.0833333333333357,46,39,7,10,-3
21700362,1626149,LAC,MIN,Montrezl Harrell,60,13.3,13,0.300000000000001,33,34,-1,-1,0
21700362,1626155,LAC,MIN,Sam Dekker,32,6.18333333333333,6,0.183333333333334,15,17,-2,-5,3
21700362,1628393,LAC,MIN,Jawun Evans,52,10.9666666666667,11,-0.033333333333335,24,29,-5,-7,2
21700362,1628414,LAC,MIN,Sindarius Thornwell,73,15.8333333333333,16,-0.166666666666668,39,35,4,3,1
21700362,2037,MIN,LAC,Jamal Crawford,79,16.65,17,-0.350000000000001,43,45,-2,-2,0
21700362,201952,MIN,LAC,Jeff Teague,181,37.4833333333333,37,0.483333333333334,88,84,4,4,0
21700362,201959,MIN,LAC,Taj Gibson,178,36.6,36,0.600000000000001,83,78,5,5,0
21700362,202710,MIN,LAC,Jimmy Butler,197,42.65,43,-0.350000000000001,100,91,9,9,0
21700362,203476,MIN,LAC,Gorgui Dieng,97,20.2333333333333,21,-0.766666666666666,52,54,-2,-2,0
21700362,203952,MIN,LAC,Andrew Wiggins,178,36.6,36,0.600000000000001,83,78,5,5,0
21700362,1626145,MIN,LAC,Tyus Jones,46,10.4666666666667,11,-0.533333333333333,25,23,2,2,0
21700362,1626157,MIN,LAC,Karl-Anthony Towns,179,39.0666666666667,39,0.0666666666666629,91,82,9,9,0
21700363,101106,LAL,PHI,Andrew Bogut,55,11.4,11,0.4,24,33,-9,-8,-1
21700363,201147,LAL,PHI,Corey Brewer,4,0.85,1,-0.15,0,0,0,0,0
21700363,201572,LAL,PHI,Brook Lopez,90,19.6833333333333,20,-0.316666666666666,38,31,7,5,2
21700363,203484,LAL,PHI,Kentavious Caldwell-Pope,182,37.5333333333333,37,0.533333333333331,83,75,8,7,1
21700363,203903,LAL,PHI,Jordan Clarkson,71,14.2,14,0.199999999999999,28,31,-3,-2,-1
21700363,203944,LAL,PHI,Julius Randle,149,29.7833333333333,30,-0.216666666666669,73,77,-4,-5,1
21700363,1626204,LAL,PHI,Larry Nance Jr.,102,22.4166666666667,22,0.416666666666664,47,42,5,6,-1
21700363,1627742,LAL,PHI,Brandon Ingram,183,37.9833333333333,38,-0.0166666666666657,85,80,5,5,0
21700363,1628366,LAL,PHI,Lonzo Ball,188,38.4833333333333,38,0.483333333333334,87,80,7,7,0
21700363,1628398,LAL,PHI,Kyle Kuzma,91,18.5,19,-0.5,48,47,1,2,-1
21700363,1628404,LAL,PHI,Josh Hart,45,9.16666666666667,9,0.166666666666666,22,24,-2,-2,0
21700363,101161,PHI,LAL,Amir Johnson,52,9.61666666666667,10,-0.383333333333333,16,28,-12,-14,2
21700363,200755,PHI,LAL,JJ Redick,159,32.9333333333333,33,-0.0666666666666629,67,73,-6,-10,4
21700363,201573,PHI,LAL,Jerryd Bayless,139,30.15,30,0.149999999999999,65,61,4,4,0
21700363,203496,PHI,LAL,Robert Covington,172,36.1333333333333,36,0.133333333333333,79,83,-4,-2,-2
21700363,203954,PHI,LAL,Joel Embiid,169,36.4333333333333,36,0.433333333333337,88,76,12,14,-2
21700363,204456,PHI,LAL,T.J. McConnell,95,17.95,18,-0.0499999999999972,31,46,-15,-15,0
21700363,1626158,PHI,LAL,Richaun Holmes,107,21.9833333333333,22,-0.0166666666666657,54,46,8,7,1
21700363,1627732,PHI,LAL,Ben Simmons,204,42.4833333333333,43,-0.516666666666666,97,90,7,9,-2
21700363,1627789,PHI,LAL,Timothe Luwawu-Cabarrot,63,12.3166666666667,12,0.316666666666666,23,32,-9,-8,-1
21700364,201162,PHX,WAS,Jared Dudley,69,16.6833333333333,17,-0.31666666666667,34,36,-2,0,-2
21700364,202328,PHX,WAS,Greg Monroe,121,27.15,27,0.149999999999999,63,64,-1,0,-1
21700364,203458,PHX,WAS,Alex Len,91,20.65,21,-0.350000000000001,36,45,-9,-10,1
21700364,203584,PHX,WAS,Troy Daniels,127,28.4666666666667,28,0.466666666666669,50,70,-20,-18,-2
21700364,203933,PHX,WAS,T.J. Warren,192,43.8333333333333,44,-0.166666666666671,90,100,-10,-8,-2
21700364,1627733,PHX,WAS,Dragan Bender,33,6.93333333333333,7,-0.0666666666666664,4,20,-16,-17,1
21700364,1627737,PHX,WAS,Marquese Chriss,110,24.1833333333333,24,0.18333333333333,61,53,8,7,1
21700364,1627755,PHX,WAS,Tyler Ulis,152,34.05,34,0.0499999999999972,80,77,3,5,-2
21700364,1628367,PHX,WAS,Josh Jackson,105,23.3,24,-0.699999999999999,58,48,10,6,4
21700364,1628455,PHX,WAS,Mike James,60,13.75,14,-0.25,19,32,-13,-15,2
21700364,101133,WAS,PHX,Ian Mahinmi,111,24.5833333333333,25,-0.416666666666664,59,45,14,10,4
21700364,101162,WAS,PHX,Marcin Gortat,101,23.2166666666667,23,0.216666666666665,50,54,-4,0,-4
21700364,201975,WAS,PHX,Jodie Meeks,61,13.8333333333333,14,-0.166666666666668,30,24,6,7,-1
21700364,202693,WAS,PHX,Markieff Morris,138,31.55,32,-0.450000000000003,73,71,2,1,1
21700364,203078,WAS,PHX,Bradley Beal,166,36.8166666666667,37,-0.183333333333337,84,82,2,3,-1
21700364,203107,WAS,PHX,Tomas Satoransky,99,22.3166666666667,22,0.316666666666666,47,37,10,9,1
21700364,203118,WAS,PHX,Mike Scott,48,11.4,12,-0.6,26,17,9,9,0
21700364,203490,WAS,PHX,Otto Porter Jr.,147,32.1166666666667,32,0.116666666666667,74,70,4,4,0
21700364,204025,WAS,PHX,Tim Frazier,91,20.8833333333333,21,-0.116666666666667,47,51,-4,-2,-2
21700364,1626162,WAS,PHX,Kelly Oubre Jr.,98,22.2833333333333,22,0.283333333333331,55,44,11,9,2
21700365,201960,BKN,OKC,DeMarre Carroll,161,32.0666666666667,32,0.0666666666666629,57,63,-6,-7,1
21700365,202389,BKN,OKC,Timofey Mozgov,37,7.2,7,0.199999999999999,17,13,4,4,0
21700365,203092,BKN,OKC,Tyler Zeller,97,20.5833333333333,20,0.583333333333336,38,30,8,8,0
21700365,203112,BKN,OKC,Quincy Acy,88,19.8333333333333,20,-0.166666666666668,41,48,-7,-10,3
21700365,203459,BKN,OKC,Allen Crabbe,162,31.8,32,-0.200000000000003,74,53,21,21,0
21700365,203915,BKN,OKC,Spencer Dinwiddie,98,19.5333333333333,19,0.533333333333331,32,25,7,7,0
21700365,203925,BKN,OKC,Joe Harris,124,26.3333333333333,26,0.333333333333332,62,65,-3,-5,2
21700365,1626178,BKN,OKC,Rondae Hollis-Jefferson,174,34.8833333333333,35,-0.116666666666667,72,61,11,16,-5
21700365,1627747,BKN,OKC,Caris LeVert,152,30.1666666666667,30,0.166666666666664,68,69,-1,0,-1
21700365,1628386,BKN,OKC,Jarrett Allen,82,17.6,18,-0.399999999999999,39,48,-9,-9,0
21700365,2546,OKC,BKN,Carmelo Anthony,184,36.9833333333333,37,-0.0166666666666657,68,66,2,3,-1
21700365,2555,OKC,BKN,Nick Collison,37,7.85,8,-0.15,19,15,4,4,0
21700365,101109,OKC,BKN,Raymond Felton,68,14.6666666666667,14,0.666666666666666,35,31,4,4,0
21700365,201566,OKC,BKN,Russell Westbrook,180,35.6,36,-0.400000000000006,65,74,-9,-9,0
21700365,202335,OKC,BKN,Patrick Patterson,89,19.7666666666667,20,-0.233333333333334,49,48,1,2,-1
21700365,202713,OKC,BKN,Kyle Singler,102,22.3833333333333,23,-0.616666666666667,48,47,1,2,-1
21700365,203460,OKC,BKN,Andre Roberson,164,33.2166666666667,33,0.216666666666669,54,65,-11,-11,0
21700365,203500,OKC,BKN,Steven Adams,155,30.05,30,0.0499999999999972,54,65,-11,-13,2
21700365,203518,OKC,BKN,Alex Abrines,134,25.6333333333333,26,-0.366666666666667,49,56,-7,-8,1
21700365,1628390,OKC,BKN,Terrance Ferguson,62,13.85,14,-0.15,34,33,1,1,0
21700366,2772,HOU,UTA,Trevor Ariza,157,34.9,35,-0.0999999999999943,82,77,5,4,1
21700366,101108,HOU,UTA,Chris Paul,160,36.95,37,-0.0499999999999972,88,77,11,12,-1
21700366,200782,HOU,UTA,PJ Tucker,80,16.9333333333333,17,-0.06666666666667,35,38,-3,0,-3
21700366,201569,HOU,UTA,Eric Gordon,148,32.4166666666667,32,0.416666666666664,76,73,3,5,-2
21700366,201583,HOU,UTA,Ryan Anderson,163,34.8833333333333,35,-0.116666666666667,87,73,14,12,2
21700366,201601,HOU,UTA,Luc Mbah a Moute,99,21.35,22,-0.649999999999999,46,44,2,1,1
21700366,201935,HOU,UTA,James Harden,163,34.8833333333333,35,-0.116666666666667,87,73,14,12,2
21700366,203991,HOU,UTA,Clint Capela,75,17.1166666666667,17,0.116666666666667,38,25,13,9,4
21700366,204028,HOU,UTA,Tarik Black,45,9.98333333333333,9,0.983333333333334,21,25,-4,0,-4
21700366,200757,UTA,HOU,Thabo Sefolosha,113,25.9833333333333,26,-0.0166666666666657,60,46,14,12,2
21700366,201937,UTA,HOU,Ricky Rubio,133,30.15,30,0.149999999999999,65,71,-6,-6,0
21700366,201973,UTA,HOU,Jonas Jerebko,56,11.35,12,-0.649999999999999,21,27,-6,-4,-2
21700366,202324,UTA,HOU,Derrick Favors,122,27.3666666666667,28,-0.633333333333333,58,83,-25,-27,2
21700366,202692,UTA,HOU,Alec Burks,122,26.65,27,-0.350000000000001,57,61,-4,-1,-3
21700366,203497,UTA,HOU,Rudy Gobert,130,27.7166666666667,28,-0.283333333333331,53,56,-3,-1,-2
21700366,203526,UTA,HOU,Raul Neto,44,9.56666666666667,10,-0.433333333333334,22,18,4,4,0
21700366,204060,UTA,HOU,Joe Ingles,153,32.85,33,-0.149999999999999,68,83,-15,-14,-1
21700366,1626220,UTA,HOU,Royce O'Neale,54,12.4666666666667,12,0.466666666666665,29,25,4,0,4
21700366,1628378,UTA,HOU,Donovan Mitchell,163,35.3166666666667,35,0.316666666666663,72,90,-18,-18,0
21700367,201577,CHI,CHA,Robin Lopez,200,42.5833333333333,43,-0.416666666666671,93,93,0,0,0
21700367,202703,CHI,CHA,Nikola Mirotic,73,14.8666666666667,15,-0.133333333333333,35,27,8,9,-1
21700367,203200,CHI,CHA,Justin Holiday,189,38.7833333333333,39,-0.216666666666669,86,78,8,9,-1
21700367,1626170,CHI,CHA,Jerian Grant,55,11.7666666666667,12,-0.233333333333334,28,22,6,5,1
21700367,1626171,CHI,CHA,Bobby Portis,72,15.05,15,0.0499999999999989,38,32,6,5,1
21700367,1627739,CHI,CHA,Kris Dunn,198,41.1833333333333,41,0.183333333333337,91,89,2,3,-1
21700367,1627756,CHI,CHA,Denzel Valentine,114,24.65,25,-0.350000000000001,51,56,-5,-3,-2
21700367,1627835,CHI,CHA,Paul Zipser,46,9.91666666666667,10,-0.0833333333333322,19,18,1,1,0
21700367,1628021,CHI,CHA,David Nwaba,155,32.4166666666667,32,0.416666666666664,81,70,11,8,3
21700367,1628374,CHI,CHA,Lauri Markkanen,163,33.5333333333333,34,-0.466666666666669,73,70,3,3,0
21700367,2730,CHA,CHI,Dwight Howard,206,43.4166666666667,43,0.416666666666671,95,95,0,-2,2
21700367,101107,CHA,CHI,Marvin Williams,192,39.9,40,-0.0999999999999943,86,83,3,1,2
21700367,201587,CHA,CHI,Nicolas Batum,201,42.3166666666667,42,0.316666666666663,93,92,1,-1,2
21700367,202689,CHA,CHI,Kemba Walker,201,42.3166666666667,42,0.316666666666663,93,92,1,-1,2
21700367,203077,CHA,CHI,Michael Kidd-Gilchrist,160,32.8166666666667,33,-0.18333333333333,71,67,4,4,0
21700367,203087,CHA,CHI,Jeremy Lamb,45,8.38333333333333,8,0.383333333333333,17,22,-5,-5,0
21700367,203487,CHA,CHI,Michael Carter-Williams,58,12.3333333333333,13,-0.666666666666666,23,34,-11,-9,-2
21700367,203948,CHA,CHI,Johnny O'Bryant III,47,9.53333333333333,10,-0.466666666666667,16,24,-8,-6,-2
21700367,1626203,CHA,CHI,Treveon Graham,83,18.45,19,-0.550000000000001,37,46,-9,-7,-2
21700367,1628370,CHA,CHI,Malik Monk,54,10.75,11,-0.25,18,27,-9,-7,-2
21700367,1628407,CHA,CHI,Dwayne Bacon,18,4.53333333333333,5,-0.466666666666667,6,13,-7,-7,0
21700368,2561,GSW,DET,David West,59,13.7666666666667,14,-0.233333333333334,20,29,-9,-9,0
21700368,2733,GSW,DET,Shaun Livingston,117,24.4666666666667,25,-0.533333333333331,58,58,0,1,-1
21700368,2738,GSW,DET,Andre Iguodala,134,29.1333333333333,29,0.133333333333333,59,56,3,2,1
21700368,201142,GSW,DET,Kevin Durant,178,38.6,39,-0.400000000000006,91,79,12,12,0
21700368,201156,GSW,DET,Nick Young,36,8.3,9,-0.700000000000001,11,22,-11,-11,0
21700368,201580,GSW,DET,JaVale McGee,67,14.2666666666667,15,-0.733333333333334,37,30,7,8,-1
21700368,201956,GSW,DET,Omri Casspi,31,6.9,7,-0.0999999999999996,14,12,2,2,0
21700368,202691,GSW,DET,Klay Thompson,174,36.15,36,0.150000000000006,77,71,6,6,0
21700368,203110,GSW,DET,Draymond Green,179,38.3666666666667,38,0.366666666666667,81,78,3,3,0
21700368,1626172,GSW,DET,Kevon Looney,17,4.01666666666667,4,0.0166666666666666,6,9,-3,-3,0
21700368,1626188,GSW,DET,Quinn Cook,68,16.1333333333333,16,0.133333333333333,32,35,-3,-3,0
21700368,1628395,GSW,DET,Jordan Bell,45,9.73333333333333,9,0.733333333333334,24,11,13,12,1
21700368,201229,DET,GSW,Anthony Tolliver,126,28.2666666666667,28,0.266666666666666,61,55,6,4,2
21700368,202340,DET,GSW,Avery Bradley,149,31.6166666666667,31,0.616666666666667,66,71,-5,-4,-1
21700368,202397,DET,GSW,Ish Smith,89,21.05,21,0.0500000000000007,40,38,2,2,0
21700368,202699,DET,GSW,Tobias Harris,152,31.9833333333333,32,-0.0166666666666657,62,78,-16,-16,0
21700368,202704,DET,GSW,Reggie Jackson,132,26.9166666666667,27,-0.0833333333333357,58,64,-6,-6,0
21700368,203083,DET,GSW,Andre Drummond,162,34.2,34,0.200000000000003,69,82,-13,-13,0
21700368,204038,DET,GSW,Langston Galloway,60,13.8166666666667,14,-0.183333333333334,29,20,9,11,-2
21700368,1626169,DET,GSW,Stanley Johnson,108,22.9333333333333,23,-0.06666666666667,47,53,-6,-8,2
21700368,1626246,DET,GSW,Boban Marjanovic,60,14.0166666666667,14,0.0166666666666657,29,22,7,9,-2
21700368,1628379,DET,GSW,Luke Kennard,67,15.0333333333333,15,0.0333333333333332,29,27,2,1,1
21700369,2544,CLE,IND,LeBron James,182,39.4666666666667,39,0.466666666666669,88,85,3,3,0
21700369,2548,CLE,IND,Dwyane Wade,116,25.5166666666667,26,-0.483333333333334,47,57,-10,-12,2
21700369,2594,CLE,IND,Kyle Korver,97,22.35,22,0.350000000000001,39,43,-4,-4,0
21700369,2747,CLE,IND,JR Smith,161,33.9833333333333,34,-0.0166666666666657,78,80,-2,-2,0
21700369,101112,CLE,IND,Channing Frye,38,8.43333333333333,9,-0.566666666666666,14,21,-7,-7,0
21700369,101181,CLE,IND,Jose Calderon,100,21.8666666666667,22,-0.133333333333333,53,49,4,8,-4
21700369,201145,CLE,IND,Jeff Green,106,23.8166666666667,24,-0.183333333333334,38,51,-13,-17,4
21700369,201567,CLE,IND,Kevin Love,124,25.8333333333333,26,-0.166666666666668,69,62,7,11,-4
21700369,203109,CLE,IND,Jae Crowder,113,23.8,24,-0.200000000000003,58,56,2,2,0
21700369,1626224,CLE,IND,Cedi Osman,63,14.4333333333333,14,0.433333333333334,26,26,0,-2,2
21700369,2863,IND,CLE,Damien Wilkins,36,7.86666666666667,8,-0.133333333333333,21,14,7,7,0
21700369,201152,IND,CLE,Thaddeus Young,172,38.5666666666667,39,-0.433333333333337,77,81,-4,-6,2
21700369,201954,IND,CLE,Darren Collison,99,21.2,22,-0.799999999999997,47,53,-6,-10,4
21700369,202362,IND,CLE,Lance Stephenson,93,21.7833333333333,22,-0.216666666666669,38,38,0,-1,1
21700369,202709,IND,CLE,Cory Joseph,106,22.65,22,0.649999999999999,56,44,12,16,-4
21700369,202711,IND,CLE,Bojan Bogdanovic,163,35.65,35,0.649999999999999,76,79,-3,-2,-1
21700369,203506,IND,CLE,Victor Oladipo,168,36.2666666666667,36,0.266666666666666,82,81,1,1,0
21700369,1626167,IND,CLE,Myles Turner,154,32.0166666666667,32,0.0166666666666657,78,73,5,5,0
21700369,1627734,IND,CLE,Domantas Sabonis,90,20.05,20,0.0499999999999972,44,37,7,8,-1
21700369,1628388,IND,CLE,TJ Leaf,19,3.45,3,0.45,11,10,1,2,-1
21700370,201163,DEN,ORL,Wilson Chandler,110,25.5333333333333,26,-0.466666666666669,51,48,3,3,0
21700370,202702,DEN,ORL,Kenneth Faried,138,30.1666666666667,30,0.166666666666664,65,54,11,11,0
21700370,203115,DEN,ORL,Will Barton,195,42.8333333333333,43,-0.166666666666671,97,81,16,14,2
21700370,203486,DEN,ORL,Mason Plumlee,79,17.8333333333333,18,-0.166666666666668,38,35,3,3,0
21700370,203914,DEN,ORL,Gary Harris,103,24.2166666666667,24,0.216666666666669,48,47,1,3,-2
21700370,1626144,DEN,ORL,Emmanuel Mudiay,144,31.35,31,0.350000000000001,66,54,12,11,1
21700370,1626168,DEN,ORL,Trey Lyles,107,22.4666666666667,22,0.466666666666669,52,41,11,11,0
21700370,1627736,DEN,ORL,Malik Beasley,136,28.95,29,-0.0500000000000007,61,50,11,11,0
21700370,1627750,DEN,ORL,Jamal Murray,73,16.65,17,-0.350000000000001,37,35,2,3,-1
21700370,201167,ORL,DEN,Arron Afflalo,116,26.1166666666667,26,0.116666666666667,52,56,-4,-5,1
21700370,201571,ORL,DEN,D.J. Augustin,116,24.8666666666667,25,-0.133333333333333,42,55,-13,-13,0
21700370,201578,ORL,DEN,Marreese Speights,53,12.2333333333333,12,0.233333333333334,21,24,-3,-3,0
21700370,202687,ORL,DEN,Bismack Biyombo,59,12.8166666666667,13,-0.183333333333334,23,25,-2,-2,0
21700370,202696,ORL,DEN,Nikola Vucevic,147,32.1,32,0.100000000000001,62,75,-13,-13,0
21700370,202714,ORL,DEN,Shelvin Mack,50,12,12,0,19,22,-3,-3,0
21700370,203613,ORL,DEN,Jonathon Simmons,152,33.7,34,-0.299999999999997,66,67,-1,-1,0
21700370,203901,ORL,DEN,Elfrid Payton,143,31,31,0,62,76,-14,-14,0
21700370,203932,ORL,DEN,Aaron Gordon,132,28.4166666666667,29,-0.583333333333336,55,62,-7,-7,0
21700370,1626209,ORL,DEN,Mario Hezonja,43,10.4333333333333,10,0.433333333333334,17,20,-3,-3,0
21700370,1628411,ORL,DEN,Wes Iwundu,74,16.3166666666667,16,0.316666666666666,26,33,-7,-6,-1
21700371,101139,TOR,MEM,CJ Miles,34,8,8,0,14,23,-9,-9,0
21700371,200768,TOR,MEM,Kyle Lowry,168,36.8,37,-0.200000000000003,92,74,18,18,0
21700371,201586,TOR,MEM,Serge Ibaka,118,26.2333333333333,27,-0.766666666666666,63,61,2,4,-2
21700371,201942,TOR,MEM,DeMar DeRozan,171,35.9333333333333,36,-0.0666666666666629,90,89,1,5,-4
21700371,202685,TOR,MEM,Jonas Valanciunas,82,17.85,18,-0.149999999999999,51,47,4,8,-4
21700371,1626181,TOR,MEM,Norman Powell,65,14.8,15,-0.199999999999999,36,28,8,4,4
21700371,1627751,TOR,MEM,Jakob Poeltl,115,24.5166666666667,24,0.516666666666666,60,54,6,4,2
21700371,1627783,TOR,MEM,Pascal Siakam,91,19.35,20,-0.649999999999999,50,42,8,4,4
21700371,1627832,TOR,MEM,Fred VanVleet,96,21.4666666666667,22,-0.533333333333331,41,45,-4,-6,2
21700371,1628384,TOR,MEM,OG Anunoby,155,33.8833333333333,34,-0.116666666666667,83,72,11,13,-2
21700371,201188,MEM,TOR,Marc Gasol,163,35.2166666666667,36,-0.783333333333331,74,90,-16,-18,2
21700371,201596,MEM,TOR,Mario Chalmers,126,26.1,26,0.100000000000001,50,69,-19,-18,-1
21700371,201936,MEM,TOR,Tyreke Evans,118,26.75,27,-0.25,66,59,7,4,3
21700371,202718,MEM,TOR,Chandler Parsons,123,25.3833333333333,26,-0.616666666666667,55,65,-10,-10,0
21700371,203210,MEM,TOR,JaMychal Green,141,32.5166666666667,32,0.516666666666666,75,78,-3,-3,0
21700371,203463,MEM,TOR,Ben McLemore,82,16.7166666666667,17,-0.283333333333331,41,36,5,5,0
21700371,203516,MEM,TOR,James Ennis III,87,17.2166666666667,17,0.216666666666665,42,48,-6,-5,-1
21700371,1626150,MEM,TOR,Andrew Harrison,128,28.9833333333333,29,-0.0166666666666657,62,67,-5,-3,-2
21700371,1627738,MEM,TOR,Deyonta Davis,56,12.55,12,0.550000000000001,33,26,7,9,-2
21700371,1628415,MEM,TOR,Dillon Brooks,71,17.4,17,0.399999999999999,37,42,-5,-6,1
21700372,1717,DAL,MIL,Dirk Nowitzki,119,27.4833333333333,28,-0.516666666666666,60,57,3,7,-4
21700372,2734,DAL,MIL,Devin Harris,105,23.4333333333333,24,-0.56666666666667,47,62,-15,-13,-2
21700372,200826,DAL,MIL,J.J. Barea,136,29.5333333333333,29,0.533333333333331,52,70,-18,-12,-6
21700372,202083,DAL,MIL,Wesley Matthews,167,37.6166666666667,38,-0.383333333333333,83,91,-8,-5,-3
21700372,203084,DAL,MIL,Harrison Barnes,162,37.1333333333333,37,0.133333333333333,75,85,-10,-10,0
21700372,203939,DAL,MIL,Dwight Powell,131,29.75,30,-0.25,67,72,-5,-11,6
21700372,1626257,DAL,MIL,Salah Mejri,6,1.46666666666667,1,0.466666666666667,2,4,-2,0,-2
21700372,1627812,DAL,MIL,Yogi Ferrell,91,22.1666666666667,23,-0.833333333333336,52,47,5,1,4
21700372,1628467,DAL,MIL,Maxi Kleber,95,23.4666666666667,24,-0.533333333333331,51,41,10,8,2
21700372,1628499,DAL,MIL,Antonius Cleveland,33,7.53333333333333,8,-0.466666666666667,21,16,5,0,5
21700372,202339,MIL,DAL,Eric Bledsoe,153,35.0666666666667,35,0.0666666666666629,79,77,2,2,0
21700372,202732,MIL,DAL,DeAndre Liggins,82,18.75,19,-0.25,47,40,7,4,3
21700372,203089,MIL,DAL,John Henson,92,21.35,21,0.350000000000001,46,46,0,-4,4
21700372,203114,MIL,DAL,Khris Middleton,168,38.35,38,0.350000000000001,89,85,4,4,0
21700372,203507,MIL,DAL,Giannis Antetokounmpo,188,42.5666666666667,43,-0.433333333333337,99,82,17,18,-1
21700372,1626173,MIL,DAL,Rashad Vaughn,44,10.9666666666667,11,-0.0333333333333332,17,27,-10,-10,0
21700372,1627748,MIL,DAL,Thon Maker,117,26.5666666666667,27,-0.433333333333334,63,56,7,11,-4
21700372,1627763,MIL,DAL,Malcolm Brogdon,180,40.9333333333333,41,-0.0666666666666629,95,89,6,6,0
21700372,1627780,MIL,DAL,Gary Payton II,21,5.03333333333333,5,0.0333333333333332,10,8,2,4,-2
21700373,2749,NOP,SAC,Jameer Nelson,137,30.6666666666667,30,0.666666666666664,51,65,-14,-16,2
21700373,201600,NOP,SAC,Omer Asik,41,9.35,9,0.35,12,17,-5,-5,0
21700373,201950,NOP,SAC,Jrue Holiday,172,37.5833333333333,38,-0.416666666666671,86,87,-1,-1,0
21700373,201967,NOP,SAC,Dante Cunningham,118,25.5666666666667,25,0.566666666666666,53,48,5,5,0
21700373,202326,NOP,SAC,DeMarcus Cousins,183,40.9333333333333,41,-0.0666666666666629,91,93,-2,-2,0
21700373,202734,NOP,SAC,E'Twaun Moore,179,39.1,40,-0.899999999999999,77,91,-14,-14,0
21700373,203076,NOP,SAC,Anthony Davis,136,30.15,31,-0.850000000000001,62,74,-12,-12,0
21700373,203121,NOP,SAC,Darius Miller,106,23.45,23,0.450000000000003,40,47,-7,-5,-2
21700373,203546,NOP,SAC,Ian Clark,123,28.2,28,0.199999999999999,73,58,15,15,0
21700373,1713,SAC,NOP,Vince Carter,146,32.1666666666667,32,0.166666666666664,72,50,22,21,1
21700373,2216,SAC,NOP,Zach Randolph,155,34.1666666666667,34,0.166666666666664,83,78,5,4,1
21700373,201585,SAC,NOP,Kosta Koufos,82,18.2,18,0.200000000000003,28,32,-4,-6,2
21700373,201588,SAC,NOP,George Hill,81,17.9833333333333,18,-0.0166666666666657,39,51,-12,-10,-2
21700373,202066,SAC,NOP,Garrett Temple,92,20.0833333333333,20,0.0833333333333357,44,60,-16,-14,-2
21700373,203960,SAC,NOP,JaKarr Sampson,54,12.2833333333333,12,0.283333333333333,24,32,-8,-8,0
21700373,203992,SAC,NOP,Bogdan Bogdanovic,113,25.35,25,0.350000000000001,47,44,3,1,2
21700373,1627741,SAC,NOP,Buddy Hield,151,33.5833333333333,33,0.583333333333329,75,52,23,21,2
21700373,1627834,SAC,NOP,Georgios Papagiannis,41,9.18333333333333,9,0.183333333333334,25,26,-1,3,-4
21700373,1628368,SAC,NOP,De'Aaron Fox,163,36.2166666666667,36,0.216666666666669,87,82,5,5,0
21700373,1628412,SAC,NOP,Frank Mason,117,25.7833333333333,26,-0.216666666666669,56,38,18,18,0
21700374,201143,BOS,SAS,Al Horford,151,35.2833333333333,35,0.283333333333331,79,71,8,8,0
21700374,202681,BOS,SAS,Kyrie Irving,154,35.9333333333333,36,-0.0666666666666629,77,75,2,8,-6
21700374,202694,BOS,SAS,Marcus Morris,111,24.5666666666667,25,-0.433333333333334,55,62,-7,-7,0
21700374,203382,BOS,SAS,Aron Baynes,60,13.4,14,-0.600000000000001,30,28,2,4,-2
21700374,203935,BOS,SAS,Marcus Smart,103,22.0166666666667,22,0.0166666666666657,44,52,-8,-9,1
21700374,1626179,BOS,SAS,Terry Rozier,110,23.3666666666667,23,0.366666666666667,41,59,-18,-11,-7
21700374,1627759,BOS,SAS,Jaylen Brown,133,30.9833333333333,31,-0.0166666666666657,72,54,18,14,4
21700374,1628369,BOS,SAS,Jayson Tatum,153,35.5833333333333,36,-0.416666666666671,72,77,-5,-7,2
21700374,1628400,BOS,SAS,Semi Ojeleye,36,7.4,7,0.399999999999999,19,17,2,-4,6
21700374,1628464,BOS,SAS,Daniel Theis,54,11.2166666666667,11,0.216666666666667,21,30,-9,-11,2
21700374,1938,SAS,BOS,Manu Ginobili,112,24.4833333333333,24,0.483333333333334,60,50,10,12,-2
21700374,2200,SAS,BOS,Pau Gasol,114,25.1333333333333,25,0.133333333333333,48,50,-2,0,-2
21700374,2225,SAS,BOS,Tony Parker,87,19.0333333333333,19,0.0333333333333314,34,41,-7,-7,0
21700374,200746,SAS,BOS,LaMarcus Aldridge,147,34.25,35,-0.75,74,77,-3,-3,0
21700374,200752,SAS,BOS,Rudy Gay,127,29.1,29,0.100000000000001,51,64,-13,-11,-2
21700374,201980,SAS,BOS,Danny Green,87,18.9666666666667,19,-0.0333333333333314,36,43,-7,-11,4
21700374,201988,SAS,BOS,Patty Mills,118,26.8833333333333,27,-0.116666666666667,62,59,3,7,-4
21700374,202722,SAS,BOS,Davis Bertans,92,20.9166666666667,21,-0.0833333333333357,49,45,4,4,0
21700374,203464,SAS,BOS,Brandon Paul,22,5.38333333333333,5,0.383333333333333,13,9,4,0,4
21700374,1627749,SAS,BOS,Dejounte Murray,3,0.216666666666667,0,0.216666666666667,5,0,5,3,2
21700374,1627854,SAS,BOS,Bryn Forbes,156,35.3833333333333,35,0.383333333333333,93,72,21,21,0
21700375,101150,LAC,WAS,Lou Williams,168,37.6166666666667,37,0.616666666666667,102,87,15,14,1
21700375,201568,LAC,WAS,Danilo Gallinari,161,36.2166666666667,36,0.216666666666669,78,83,-5,-2,-3
21700375,201599,LAC,WAS,DeAndre Jordan,154,33.65,34,-0.350000000000001,70,73,-3,-4,1
21700375,202325,LAC,WAS,Wesley Johnson,107,23.9333333333333,24,-0.0666666666666664,46,55,-9,-4,-5
21700375,203085,LAC,WAS,Austin Rivers,154,35.9833333333333,36,-0.0166666666666657,74,88,-14,-11,-3
21700375,203710,LAC,WAS,C.J. Williams,52,10.1333333333333,10,0.133333333333333,31,21,10,6,4
21700375,203966,LAC,WAS,Jamil Wilson,51,11.7,12,-0.300000000000001,35,27,8,6,2
21700375,1626149,LAC,WAS,Montrezl Harrell,60,14.35,14,0.35,43,39,4,5,-1
21700375,1628393,LAC,WAS,Jawun Evans,78,17.0333333333333,17,0.0333333333333314,52,43,9,10,-1
21700375,1628414,LAC,WAS,Sindarius Thornwell,85,19.3833333333333,20,-0.616666666666667,34,44,-10,-15,5
21700375,101133,WAS,LAC,Ian Mahinmi,103,23.8333333333333,24,-0.166666666666668,59,59,0,-1,1
21700375,101162,WAS,LAC,Marcin Gortat,111,24.1666666666667,24,0.166666666666664,53,54,-1,0,-1
21700375,201975,WAS,LAC,Jodie Meeks,30,7.63333333333333,8,-0.366666666666667,18,22,-4,-6,2
21700375,202693,WAS,LAC,Markieff Morris,64,15.45,16,-0.550000000000001,31,25,6,3,3
21700375,203078,WAS,LAC,Bradley Beal,168,37.3166666666667,37,0.316666666666663,85,79,6,9,-3
21700375,203107,WAS,LAC,Tomas Satoransky,122,27.0333333333333,27,0.0333333333333314,69,70,-1,-3,2
21700375,203118,WAS,LAC,Mike Scott,126,27.85,28,-0.149999999999999,75,70,5,6,-1
21700375,203490,WAS,LAC,Otto Porter Jr.,162,35.3166666666667,35,0.316666666666663,84,84,0,2,-2
21700375,204025,WAS,LAC,Tim Frazier,92,20.9666666666667,21,-0.0333333333333314,43,43,0,2,-2
21700375,1626162,WAS,LAC,Kelly Oubre Jr.,92,20.4333333333333,20,0.433333333333334,43,59,-16,-17,1
21700376,201609,MIA,BKN,Goran Dragic,126,28.1833333333333,28,0.183333333333334,59,47,12,16,-4
21700376,201949,MIA,BKN,James Johnson,137,30.6833333333333,31,-0.31666666666667,62,58,4,7,-3
21700376,201961,MIA,BKN,Wayne Ellington,95,23.0833333333333,23,0.0833333333333357,51,35,16,16,0
21700376,203079,MIA,BKN,Dion Waiters,110,25.3333333333333,25,0.333333333333332,45,55,-10,-12,2
21700376,203482,MIA,BKN,Kelly Olynyk,125,27.8333333333333,28,-0.166666666666664,54,60,-6,-8,2
21700376,204020,MIA,BKN,Tyler Johnson,117,26.7833333333333,27,-0.216666666666669,60,54,6,2,4
21700376,1626159,MIA,BKN,Justise Winslow,104,24.6666666666667,25,-0.333333333333332,52,41,11,11,0
21700376,1626196,MIA,BKN,Josh Richardson,143,31.5333333333333,32,-0.466666666666669,75,66,9,8,1
21700376,1628389,MIA,BKN,Bam Adebayo,83,19.7333333333333,20,-0.266666666666666,47,29,18,20,-2
21700376,201960,BKN,MIA,DeMarre Carroll,103,25.0166666666667,25,0.0166666666666657,39,53,-14,-15,1
21700376,202389,BKN,MIA,Timofey Mozgov,23,6.28333333333333,6,0.283333333333333,8,11,-3,-1,-2
21700376,203092,BKN,MIA,Tyler Zeller,98,22.05,22,0.0499999999999972,48,46,2,0,2
21700376,203112,BKN,MIA,Quincy Acy,69,16.0166666666667,16,0.0166666666666657,28,37,-9,-10,1
21700376,203459,BKN,MIA,Allen Crabbe,139,31.75,32,-0.25,54,62,-8,-6,-2
21700376,203915,BKN,MIA,Spencer Dinwiddie,139,32.1166666666667,32,0.116666666666667,60,67,-7,-7,0
21700376,1626178,BKN,MIA,Rondae Hollis-Jefferson,155,34.1833333333333,35,-0.816666666666663,74,67,7,7,0
21700376,1627747,BKN,MIA,Caris LeVert,140,30.9,31,-0.100000000000001,59,75,-16,-18,2
21700376,1627785,BKN,MIA,Isaiah Whitehead,75,16.9,17,-0.100000000000001,39,34,5,7,-2
21700376,1628386,BKN,MIA,Jarrett Allen,96,22.1166666666667,22,0.116666666666667,34,51,-17,-17,0
21700376,1628451,BKN,MIA,Jacob Wiley,3,0.5,1,-0.5,2,2,0,0,0
21700377,201147,LAL,CHA,Corey Brewer,18,4.93333333333333,5,-0.0666666666666664,12,12,0,2,-2
21700377,201572,LAL,CHA,Brook Lopez,88,19,19,0,45,43,2,3,-1
21700377,203484,LAL,CHA,Kentavious Caldwell-Pope,150,32.0666666666667,32,0.0666666666666629,76,70,6,3,3
21700377,203898,LAL,CHA,Tyler Ennis,30,6.35,6,0.35,14,7,7,7,0
21700377,203903,LAL,CHA,Jordan Clarkson,126,26.9666666666667,27,-0.0333333333333314,62,50,12,13,-1
21700377,203944,LAL,CHA,Julius Randle,123,26.3166666666667,26,0.316666666666666,63,47,16,16,0
21700377,1626204,LAL,CHA,Larry Nance Jr.,74,16.1166666666667,16,0.116666666666667,32,41,-9,-10,1
21700377,1627742,LAL,CHA,Brandon Ingram,171,35.6666666666667,36,-0.333333333333336,84,76,8,6,2
21700377,1628366,LAL,CHA,Lonzo Ball,127,26.5166666666667,27,-0.483333333333334,56,62,-6,-6,0
21700377,1628398,LAL,CHA,Kyle Kuzma,149,31.65,32,-0.350000000000001,78,58,20,21,-1
21700377,1628404,LAL,CHA,Josh Hart,59,13.25,13,0.25,28,29,-1,0,-1
21700377,2730,CHA,LAL,Dwight Howard,149,31.8166666666667,32,-0.183333333333334,70,75,-5,-3,-2
21700377,101107,CHA,LAL,Marvin Williams,130,27.7833333333333,28,-0.216666666666669,64,71,-7,-7,0
21700377,201587,CHA,LAL,Nicolas Batum,90,18.8833333333333,19,-0.116666666666667,46,41,5,5,0
21700377,202689,CHA,LAL,Kemba Walker,134,28.85,29,-0.149999999999999,65,69,-4,-2,-2
21700377,203077,CHA,LAL,Michael Kidd-Gilchrist,117,25.7833333333333,26,-0.216666666666669,59,59,0,0,0
21700377,203487,CHA,LAL,Michael Carter-Williams,89,18.9166666666667,19,-0.0833333333333357,34,41,-7,-9,2
21700377,203948,CHA,LAL,Johnny O'Bryant III,74,15.95,16,-0.0500000000000007,29,35,-6,-8,2
21700377,1626203,CHA,LAL,Treveon Graham,121,26.0666666666667,26,0.0666666666666664,48,57,-9,-9,0
21700377,1628370,CHA,LAL,Malik Monk,93,19.8,20,-0.200000000000003,35,45,-10,-10,0
21700377,1628407,CHA,LAL,Dwayne Bacon,118,24.9833333333333,25,-0.0166666666666657,45,57,-12,-12,0
21700378,101141,ATL,ORL,Ersan Ilyasova,120,27.7666666666667,28,-0.233333333333334,70,62,8,11,-3
21700378,201158,ATL,ORL,Marco Belinelli,103,23.05,23,0.0500000000000007,48,51,-3,-1,-2
21700378,202337,ATL,ORL,Luke Babbitt,67,15.45,16,-0.550000000000001,34,31,3,6,-3
21700378,203101,ATL,ORL,Miles Plumlee,71,15.7666666666667,16,-0.233333333333334,33,29,4,4,0
21700378,203145,ATL,ORL,Kent Bazemore,126,27.65,27,0.649999999999999,79,67,12,10,2
21700378,203471,ATL,ORL,Dennis Schroder,155,34.8666666666667,35,-0.13333333333334,88,84,4,4,0
21700378,1627752,ATL,ORL,Taurean Prince,145,32.9666666666667,33,-0.0333333333333314,85,74,11,13,-2
21700378,1627761,ATL,ORL,DeAndre' Bembry,109,23.0166666666667,23,0.0166666666666657,50,53,-3,-6,3
21700378,1627819,ATL,ORL,Isaiah Taylor,57,12.5,12,0.5,26,26,0,1,-1
21700378,1628463,ATL,ORL,Tyler Cavanaugh,117,26.7166666666667,27,-0.283333333333331,67,73,-6,-7,1
21700378,201167,ORL,ATL,Arron Afflalo,108,25.0666666666667,25,0.0666666666666664,60,73,-13,-12,-1
21700378,201571,ORL,ATL,D.J. Augustin,128,27.35,27,0.350000000000001,66,67,-1,-1,0
21700378,202687,ORL,ATL,Bismack Biyombo,45,10.3666666666667,10,0.366666666666667,16,22,-6,-6,0
21700378,202696,ORL,ATL,Nikola Vucevic,169,37.5833333333333,38,-0.416666666666664,94,94,0,-1,1
21700378,202714,ORL,ATL,Shelvin Mack,117,25.9,26,-0.100000000000001,56,54,2,2,0
21700378,203613,ORL,ATL,Jonathon Simmons,146,32.9166666666667,33,-0.0833333333333286,73,85,-12,-13,1
21700378,203901,ORL,ATL,Elfrid Payton,106,23.7833333333333,24,-0.216666666666669,51,61,-10,-10,0
21700378,1626209,ORL,ATL,Mario Hezonja,135,30.3833333333333,31,-0.616666666666667,76,63,13,8,5
21700378,1628411,ORL,ATL,Wes Iwundu,116,26.4,26,0.399999999999999,58,61,-3,-2,-1
21700379,2544,CLE,PHI,LeBron James,167,38.5166666666667,39,-0.483333333333334,80,83,-3,-3,0
21700379,2548,CLE,PHI,Dwyane Wade,109,23.5166666666667,24,-0.483333333333334,58,40,18,15,3
21700379,2594,CLE,PHI,Kyle Korver,122,27.7,28,-0.299999999999997,68,50,18,18,0
21700379,2747,CLE,PHI,JR Smith,102,23.0833333333333,23,0.0833333333333357,46,52,-6,-7,1
21700379,101112,CLE,PHI,Channing Frye,83,18.8833333333333,19,-0.116666666666667,38,38,0,-1,1
21700379,101181,CLE,PHI,Jose Calderon,119,27.85,28,-0.149999999999999,52,67,-15,-12,-3
21700379,201145,CLE,PHI,Jeff Green,135,30.4,30,0.399999999999999,79,56,23,25,-2
21700379,203109,CLE,PHI,Jae Crowder,146,33.2166666666667,33,0.216666666666669,71,64,7,7,0
21700379,1626224,CLE,PHI,Cedi Osman,52,11.1166666666667,11,0.116666666666667,30,27,3,3,0
21700379,1627790,CLE,PHI,Ante Zizic,20,4.63333333333333,5,-0.366666666666667,3,13,-10,-10,0
21700379,101161,PHI,CLE,Amir Johnson,92,21.2166666666667,21,0.216666666666665,46,45,1,1,0
21700379,200755,PHI,CLE,JJ Redick,156,35.9666666666667,36,-0.0333333333333314,73,80,-7,-11,4
21700379,201573,PHI,CLE,Jerryd Bayless,85,18.8833333333333,19,-0.116666666666667,38,43,-5,-5,0
21700379,202344,PHI,CLE,Trevor Booker,90,20.35,20,0.350000000000001,42,48,-6,-5,-1
21700379,203496,PHI,CLE,Robert Covington,161,36.0666666666667,36,0.0666666666666629,78,70,8,10,-2
21700379,203967,PHI,CLE,Dario Saric,152,33.8166666666667,34,-0.18333333333333,73,70,3,5,-2
21700379,1626158,PHI,CLE,Richaun Holmes,85,19.5666666666667,20,-0.433333333333334,35,44,-9,-10,1
21700379,1627732,PHI,CLE,Ben Simmons,154,35.2833333333333,36,-0.716666666666669,71,75,-4,-6,2
21700379,1627789,PHI,CLE,Timothe Luwawu-Cabarrot,80,17.7666666666667,18,-0.233333333333334,34,50,-16,-14,-2
21700380,201577,CHI,NYK,Robin Lopez,144,30.6166666666667,31,-0.383333333333333,63,55,8,7,1
21700380,202703,CHI,NYK,Nikola Mirotic,88,19.8666666666667,20,-0.133333333333333,42,53,-11,-8,-3
21700380,203200,CHI,NYK,Justin Holiday,138,29.05,29,0.0500000000000007,57,55,2,1,1
21700380,1626170,CHI,NYK,Jerian Grant,82,18.2833333333333,18,0.283333333333331,47,42,5,4,1
21700380,1626171,CHI,NYK,Bobby Portis,67,15.4333333333333,16,-0.566666666666666,41,36,5,4,1
21700380,1627739,CHI,NYK,Kris Dunn,138,29.7,30,-0.300000000000001,57,60,-3,-2,-1
21700380,1627756,CHI,NYK,Denzel Valentine,82,18.5,19,-0.5,33,29,4,4,0
21700380,1627835,CHI,NYK,Paul Zipser,78,17.4833333333333,18,-0.516666666666666,47,40,7,6,1
21700380,1628021,CHI,NYK,David Nwaba,142,30.85,31,-0.149999999999999,69,80,-11,-9,-2
21700380,1628374,CHI,NYK,Lauri Markkanen,141,30.1333333333333,30,0.133333333333333,64,60,4,3,1
21700380,101127,NYK,CHI,Jarrett Jack,134,28.8,28,0.800000000000001,56,60,-4,-4,0
21700380,201563,NYK,CHI,Michael Beasley,65,14.55,15,-0.449999999999999,38,37,1,1,0
21700380,201584,NYK,CHI,Courtney Lee,141,30.0333333333333,30,0.0333333333333314,60,61,-1,-1,0
21700380,202498,NYK,CHI,Lance Thomas,115,25.35,25,0.350000000000001,52,56,-4,-5,1
21700380,202683,NYK,CHI,Enes Kanter,131,28.5333333333333,28,0.533333333333331,48,62,-14,-12,-2
21700380,203124,NYK,CHI,Kyle O'Quinn,61,13.95,15,-1.05,33,32,1,3,-2
21700380,203926,NYK,CHI,Doug McDermott,120,25.7833333333333,26,-0.216666666666669,62,52,10,8,2
21700380,204001,NYK,CHI,Kristaps Porzingis,171,36.6666666666667,36,0.666666666666664,75,75,0,-2,2
21700380,1628373,NYK,CHI,Frank Ntilikina,93,20.9666666666667,21,-0.0333333333333314,53,46,7,7,0
21700380,1628422,NYK,CHI,Damyean Dotson,69,15.2833333333333,15,0.283333333333335,33,39,-6,-5,-1
21700381,202339,MIL,UTA,Eric Bledsoe,164,35.35,35,0.350000000000001,89,76,13,14,-1
21700381,202732,MIL,UTA,DeAndre Liggins,64,13.8166666666667,14,-0.183333333333334,25,32,-7,-8,1
21700381,203089,MIL,UTA,John Henson,127,25.9,26,-0.100000000000001,69,55,14,10,4
21700381,203114,MIL,UTA,Khris Middleton,174,37.8166666666667,38,-0.183333333333337,98,76,22,23,-1
21700381,203507,MIL,UTA,Giannis Antetokounmpo,184,39.3833333333333,39,0.383333333333333,98,82,16,17,-1
21700381,1626173,MIL,UTA,Rashad Vaughn,70,15.7333333333333,16,-0.266666666666666,35,31,4,2,2
21700381,1627748,MIL,UTA,Thon Maker,91,21.4666666666667,21,0.466666666666665,46,43,3,7,-4
21700381,1627763,MIL,UTA,Malcolm Brogdon,122,26.2833333333333,27,-0.716666666666669,62,62,0,0,0
21700381,1627780,MIL,UTA,Gary Payton II,110,23.2833333333333,23,0.283333333333331,61,41,20,20,0
21700381,1628391,MIL,UTA,D.J. Wilson,4,0.55,1,-0.45,2,2,0,0,0
21700381,200757,UTA,MIL,Thabo Sefolosha,115,24.5666666666667,24,0.566666666666666,56,70,-14,-12,-2
21700381,201937,UTA,MIL,Ricky Rubio,149,31.7166666666667,32,-0.283333333333331,63,76,-13,-15,2
21700381,201973,UTA,MIL,Jonas Jerebko,75,15.6833333333333,16,-0.316666666666666,36,30,6,7,-1
21700381,202324,UTA,MIL,Derrick Favors,122,27,27,0,49,60,-11,-13,2
21700381,202692,UTA,MIL,Alec Burks,128,27.2833333333333,27,0.283333333333331,65,68,-3,1,-4
21700381,203497,UTA,MIL,Rudy Gobert,132,28.5833333333333,29,-0.416666666666668,59,74,-15,-16,1
21700381,203526,UTA,MIL,Raul Neto,8,2.06666666666667,2,0.0666666666666664,2,3,-1,-1,0
21700381,204060,UTA,MIL,Joe Ingles,145,31.2833333333333,31,0.283333333333331,60,79,-19,-21,2
21700381,1626220,UTA,MIL,Royce O'Neale,67,14.6666666666667,15,-0.333333333333334,34,34,0,2,-2
21700381,1628378,UTA,MIL,Donovan Mitchell,169,36.7333333333333,37,-0.266666666666666,76,91,-15,-17,2
21700382,2546,OKC,MEM,Carmelo Anthony,165,36.6166666666667,37,-0.383333333333333,77,67,10,8,2
21700382,101109,OKC,MEM,Raymond Felton,85,19.9666666666667,20,-0.0333333333333314,32,40,-8,-4,-4
21700382,201566,OKC,MEM,Russell Westbrook,190,43.0666666666667,43,0.0666666666666629,84,73,11,11,0
21700382,202335,OKC,MEM,Patrick Patterson,61,14.8333333333333,15,-0.166666666666668,23,32,-9,-9,0
21700382,202713,OKC,MEM,Kyle Singler,28,5.73333333333333,6,-0.266666666666668,6,15,-9,-9,0
21700382,203460,OKC,MEM,Andre Roberson,174,40.7333333333333,41,-0.266666666666666,87,78,9,7,2
21700382,203500,OKC,MEM,Steven Adams,188,43.1166666666667,43,0.116666666666667,91,82,9,9,0
21700382,203518,OKC,MEM,Alex Abrines,191,42.5,43,-0.5,81,77,4,4,0
21700382,203924,OKC,MEM,Jerami Grant,55,11.8,12,-0.199999999999999,15,23,-8,-8,0
21700382,203962,OKC,MEM,Josh Huestis,23,6.63333333333333,7,-0.366666666666667,14,18,-4,-4,0
21700382,201188,MEM,OKC,Marc Gasol,184,42.4666666666667,42,0.466666666666669,82,91,-9,-9,0
21700382,201596,MEM,OKC,Mario Chalmers,60,13.3166666666667,13,0.316666666666666,22,28,-6,-7,1
21700382,201936,MEM,OKC,Tyreke Evans,172,40.05,41,-0.950000000000003,81,79,2,3,-1
21700382,203210,MEM,OKC,JaMychal Green,149,33.8666666666667,34,-0.133333333333333,68,67,1,1,0
21700382,203463,MEM,OKC,Ben McLemore,123,28.5,28,0.5,61,47,14,15,-1
21700382,203516,MEM,OKC,James Ennis III,98,22.3333333333333,22,0.333333333333336,40,39,1,1,0
21700382,1626150,MEM,OKC,Andrew Harrison,116,25.6,26,-0.399999999999999,41,54,-13,-14,1
21700382,1626185,MEM,OKC,Jarell Martin,50,11.0333333333333,11,0.0333333333333332,22,18,4,2,2
21700382,1627738,MEM,OKC,Deyonta Davis,48,10.5333333333333,11,-0.466666666666667,19,11,8,8,0
21700382,1628415,MEM,OKC,Dillon Brooks,160,37.3,38,-0.700000000000003,69,76,-7,-5,-2
21700383,2199,PHX,SAS,Tyson Chandler,115,26.0666666666667,26,0.0666666666666664,51,51,0,1,-1
21700383,201162,PHX,SAS,Jared Dudley,78,16.8333333333333,17,-0.166666666666664,36,35,1,-1,2
21700383,202328,PHX,SAS,Greg Monroe,105,21.9333333333333,22,-0.0666666666666664,50,53,-3,-4,1
21700383,203584,PHX,SAS,Troy Daniels,114,24.25,24,0.25,53,54,-1,0,-1
21700383,203933,PHX,SAS,T.J. Warren,144,31.2666666666667,31,0.266666666666666,72,67,5,4,1
21700383,1627733,PHX,SAS,Dragan Bender,26,5.93333333333333,6,-0.0666666666666664,10,16,-6,-6,0
21700383,1627737,PHX,SAS,Marquese Chriss,116,25.2333333333333,25,0.233333333333334,55,53,2,4,-2
21700383,1627755,PHX,SAS,Tyler Ulis,79,18.1333333333333,19,-0.866666666666667,28,36,-8,-8,0
21700383,1627863,PHX,SAS,Danuel House Jr.,49,11.2166666666667,11,0.216666666666667,20,26,-6,-5,-1
21700383,1628367,PHX,SAS,Josh Jackson,133,29.2666666666667,29,0.266666666666666,57,61,-4,-5,1
21700383,1628455,PHX,SAS,Mike James,141,29.8666666666667,29,0.866666666666667,73,68,5,5,0
21700383,200746,SAS,PHX,LaMarcus Aldridge,163,36.0333333333333,36,0.0333333333333314,74,75,-1,-4,3
21700383,200752,SAS,PHX,Rudy Gay,144,31.9166666666667,33,-1.08333333333334,69,60,9,9,0
21700383,201988,SAS,PHX,Patty Mills,113,24.5166666666667,24,0.516666666666666,55,60,-5,-3,-2
21700383,202722,SAS,PHX,Davis Bertans,98,21.5,20,1.5,48,50,-2,0,-2
21700383,203464,SAS,PHX,Brandon Paul,134,29.9166666666667,30,-0.0833333333333357,60,64,-4,-5,1
21700383,203530,SAS,PHX,Joffrey Lauvergne,57,11.9666666666667,12,-0.0333333333333332,30,26,4,7,-3
21700383,1626199,SAS,PHX,Darrun Hilliard,63,13.0666666666667,13,0.0666666666666664,34,30,4,4,0
21700383,1627749,SAS,PHX,Dejounte Murray,122,25.8166666666667,27,-1.18333333333333,53,46,7,3,4
21700383,1627854,SAS,PHX,Bryn Forbes,164,36.7333333333333,36,0.733333333333334,78,75,3,5,-2
21700383,1628401,SAS,PHX,Derrick White,42,8.53333333333333,9,-0.466666666666667,19,19,0,-1,1
21700384,2403,HOU,POR,Nene,52,10.3,10,0.300000000000001,16,31,-15,-15,0
21700384,2772,HOU,POR,Trevor Ariza,146,33.5166666666667,34,-0.483333333333334,96,81,15,19,-4
21700384,101108,HOU,POR,Chris Paul,153,34.7166666666667,35,-0.283333333333331,96,85,11,14,-3
21700384,200782,HOU,POR,PJ Tucker,141,31.0666666666667,31,0.0666666666666664,79,66,13,14,-1
21700384,201569,HOU,POR,Eric Gordon,142,30.1666666666667,30,0.166666666666664,72,68,4,3,1
21700384,201583,HOU,POR,Ryan Anderson,78,16.9333333333333,17,-0.0666666666666664,43,51,-8,-7,-1
21700384,201601,HOU,POR,Luc Mbah a Moute,110,24.1,24,0.100000000000001,55,53,2,0,2
21700384,201935,HOU,POR,James Harden,171,37.2833333333333,37,0.283333333333331,99,92,7,9,-2
21700384,203991,HOU,POR,Clint Capela,102,21.9166666666667,22,-0.0833333333333322,54,58,-4,-2,-2
21700384,202323,POR,HOU,Evan Turner,126,27.2833333333333,27,0.283333333333331,73,78,-5,-8,3
21700384,202329,POR,HOU,Al-Farouq Aminu,143,31.75,32,-0.25,75,85,-10,-12,2
21700384,202334,POR,HOU,Ed Davis,71,14.65,15,-0.350000000000001,40,30,10,11,-1
21700384,203081,POR,HOU,Damian Lillard,176,37.85,38,-0.149999999999999,97,97,0,-2,2
21700384,203086,POR,HOU,Meyers Leonard,90,19.8833333333333,20,-0.116666666666667,55,49,6,1,5
21700384,203468,POR,HOU,CJ McCollum,176,38.6666666666667,39,-0.333333333333329,89,103,-14,-16,2
21700384,203943,POR,HOU,Noah Vonleh,43,11.7666666666667,12,-0.233333333333334,26,32,-6,-5,-1
21700384,1626192,POR,HOU,Pat Connaughton,113,24.5666666666667,25,-0.433333333333334,56,61,-5,-6,1
21700384,1627774,POR,HOU,Jake Layman,65,14.7666666666667,15,-0.233333333333334,29,37,-8,-4,-4
21700384,1628380,POR,HOU,Zach Collins,92,18.8166666666667,19,-0.183333333333334,45,38,7,6,1
21700385,1713,SAC,TOR,Vince Carter,34,8,8,0,22,22,0,0,0
21700385,2216,SAC,TOR,Zach Randolph,148,33.1333333333333,34,-0.866666666666667,56,83,-27,-27,0
21700385,201585,SAC,TOR,Kosta Koufos,66,14.6333333333333,14,0.633333333333333,31,19,12,12,0
21700385,202066,SAC,TOR,Garrett Temple,50,10.9833333333333,11,-0.0166666666666657,19,25,-6,-8,2
21700385,203960,SAC,TOR,JaKarr Sampson,90,19.4166666666667,19,0.416666666666668,33,29,4,6,-2
21700385,203992,SAC,TOR,Bogdan Bogdanovic,129,29.1833333333333,30,-0.816666666666666,48,74,-26,-25,-1
21700385,1627741,SAC,TOR,Buddy Hield,128,28.0333333333333,28,0.0333333333333314,55,57,-2,-3,1
21700385,1627746,SAC,TOR,Skal Labissiere,64,14.0833333333333,14,0.0833333333333322,21,35,-14,-16,2
21700385,1628368,SAC,TOR,De'Aaron Fox,106,23.15,23,0.149999999999999,41,53,-12,-11,-1
21700385,1628382,SAC,TOR,Justin Jackson,147,33.6,33,0.600000000000001,63,64,-1,1,-2
21700385,1628412,SAC,TOR,Frank Mason,108,24.6166666666667,25,-0.383333333333333,46,49,-3,-4,1
21700385,101139,TOR,SAC,CJ Miles,97,21.2,21,0.199999999999999,35,44,-9,-9,0
21700385,200768,TOR,SAC,Kyle Lowry,155,34.7,35,-0.299999999999997,83,61,22,23,-1
21700385,201586,TOR,SAC,Serge Ibaka,124,28.3166666666667,29,-0.683333333333334,72,48,24,25,-1
21700385,201942,TOR,SAC,DeMar DeRozan,158,34.7,35,-0.299999999999997,79,59,20,19,1
21700385,202685,TOR,SAC,Jonas Valanciunas,97,21.8666666666667,22,-0.133333333333333,54,37,17,17,0
21700385,1626181,TOR,SAC,Norman Powell,36,8.73333333333333,9,-0.266666666666666,11,19,-8,-10,2
21700385,1627751,TOR,SAC,Jakob Poeltl,100,22.05,22,0.0500000000000007,34,46,-12,-13,1
21700385,1627783,TOR,SAC,Pascal Siakam,91,19.6333333333333,19,0.633333333333333,32,39,-7,-7,0
21700385,1627832,TOR,SAC,Fred VanVleet,95,21.0666666666667,21,0.0666666666666664,43,39,4,6,-2
21700385,1628384,TOR,SAC,OG Anunoby,117,26.5666666666667,27,-0.433333333333334,67,43,24,24,0
21700386,201143,BOS,DET,Al Horford,142,33.2,34,-0.799999999999997,66,59,7,7,0
21700386,202681,BOS,DET,Kyrie Irving,144,33.1333333333333,34,-0.866666666666667,69,58,11,13,-2
21700386,203382,BOS,DET,Aron Baynes,113,26.3666666666667,27,-0.633333333333333,60,43,17,13,4
21700386,203499,BOS,DET,Shane Larkin,57,12.7666666666667,13,-0.233333333333334,11,17,-6,-6,0
21700386,203935,BOS,DET,Marcus Smart,105,24.8,25,-0.199999999999999,52,43,9,11,-2
21700386,1626179,BOS,DET,Terry Rozier,101,23.3333333333333,23,0.333333333333332,33,44,-11,-13,2
21700386,1627759,BOS,DET,Jaylen Brown,130,30.0333333333333,31,-0.966666666666669,65,47,18,16,2
21700386,1628369,BOS,DET,Jayson Tatum,127,29.1833333333333,30,-0.81666666666667,58,47,11,12,-1
21700386,1628400,BOS,DET,Semi Ojeleye,58,13.4166666666667,13,0.416666666666666,26,24,2,5,-3
21700386,1628464,BOS,DET,Daniel Theis,53,12.0166666666667,12,0.0166666666666657,15,23,-8,-8,0
21700386,201229,DET,BOS,Anthony Tolliver,97,22.1,22,0.100000000000001,38,45,-7,-7,0
21700386,202340,DET,BOS,Avery Bradley,135,31.25,32,-0.75,49,67,-18,-20,2
21700386,202397,DET,BOS,Ish Smith,122,28.5166666666667,29,-0.483333333333334,57,45,12,12,0
21700386,202699,DET,BOS,Tobias Harris,161,37.45,38,-0.549999999999997,65,71,-6,-4,-2
21700386,202704,DET,BOS,Reggie Jackson,84,19.1333333333333,19,0.133333333333333,24,46,-22,-22,0
21700386,203083,DET,BOS,Andre Drummond,128,30.4666666666667,31,-0.533333333333335,49,65,-16,-14,-2
21700386,203493,DET,BOS,Reggie Bullock,32,7.11666666666667,7,0.116666666666667,16,12,4,4,0
21700386,203961,DET,BOS,Eric Moreland,56,12.1,12,0.100000000000001,24,20,4,2,2
21700386,204038,DET,BOS,Langston Galloway,27,5.91666666666667,6,-0.083333333333333,8,7,1,1,0
21700386,1626169,DET,BOS,Stanley Johnson,63,14.65,15,-0.35,21,30,-9,-9,0
21700386,1626246,DET,BOS,Boban Marjanovic,22,5.08333333333333,5,0.083333333333333,8,6,2,2,0
21700386,1628379,DET,BOS,Luke Kennard,103,24.4666666666667,24,0.466666666666669,46,41,5,5,0
21700387,201163,DEN,IND,Wilson Chandler,166,37.4,37,0.400000000000006,70,92,-22,-20,-2
21700387,202702,DEN,IND,Kenneth Faried,147,32.25,32,0.25,68,73,-5,-7,2
21700387,203115,DEN,IND,Will Barton,200,44.3166666666667,45,-0.683333333333337,95,109,-14,-14,0
21700387,203486,DEN,IND,Mason Plumlee,97,20.5333333333333,21,-0.466666666666669,48,53,-5,-3,-2
21700387,203914,DEN,IND,Gary Harris,198,44.1333333333333,44,0.133333333333333,94,108,-14,-14,0
21700387,1626144,DEN,IND,Emmanuel Mudiay,81,15.5,15,0.5,37,37,0,-2,2
21700387,1626168,DEN,IND,Trey Lyles,121,26.2166666666667,26,0.216666666666669,56,58,-2,-4,2
21700387,1627736,DEN,IND,Malik Beasley,90,17.1166666666667,17,0.116666666666667,43,35,8,8,0
21700387,1627750,DEN,IND,Jamal Murray,120,26.45,27,-0.550000000000001,69,65,4,6,-2
21700387,201152,IND,DEN,Thaddeus Young,173,39.4833333333333,40,-0.516666666666666,95,82,13,12,1
21700387,202362,IND,DEN,Lance Stephenson,167,35.4,36,-0.599999999999994,86,76,10,10,0
21700387,202709,IND,DEN,Cory Joseph,144,31.7,31,0.699999999999996,74,81,-7,-9,2
21700387,202711,IND,DEN,Bojan Bogdanovic,158,34.6666666666667,35,-0.333333333333329,83,70,13,16,-3
21700387,203506,IND,DEN,Victor Oladipo,203,45.1666666666667,45,0.166666666666671,108,96,12,12,0
21700387,1626167,IND,DEN,Myles Turner,183,40.9333333333333,41,-0.0666666666666629,104,82,22,18,4
21700387,1626202,IND,DEN,Joe Young,66,12.45,13,-0.550000000000001,29,30,-1,1,-2
21700387,1627734,IND,DEN,Domantas Sabonis,104,19.7833333333333,20,-0.216666666666669,45,49,-4,-4,0
21700387,1628388,IND,DEN,TJ Leaf,22,4.33333333333333,4,0.333333333333333,6,14,-8,-6,-2
21700388,1717,DAL,MIN,Dirk Nowitzki,111,25.65,25,0.649999999999999,51,56,-5,-4,-1
21700388,2734,DAL,MIN,Devin Harris,73,16.3833333333333,16,0.383333333333333,31,37,-6,-6,0
21700388,200826,DAL,MIN,J.J. Barea,91,22.0166666666667,22,0.0166666666666657,41,47,-6,-6,0
21700388,202083,DAL,MIN,Wesley Matthews,152,37.7333333333333,38,-0.266666666666666,74,73,1,1,0
21700388,203084,DAL,MIN,Harrison Barnes,130,32,32,0,63,63,0,0,0
21700388,203939,DAL,MIN,Dwight Powell,61,13.4666666666667,13,0.466666666666667,23,26,-3,-5,2
21700388,1626257,DAL,MIN,Salah Mejri,33,8.13333333333333,8,0.133333333333333,21,16,5,7,-2
21700388,1627812,DAL,MIN,Yogi Ferrell,127,32.2666666666667,33,-0.733333333333334,61,60,1,-1,2
21700388,1628467,DAL,MIN,Maxi Kleber,135,34.2333333333333,34,0.233333333333334,67,69,-2,0,-2
21700388,1628499,DAL,MIN,Antonius Cleveland,82,17.95,18,-0.0500000000000007,28,38,-10,-11,1
21700388,2037,MIN,DAL,Jamal Crawford,83,19.4666666666667,20,-0.533333333333331,44,34,10,10,0
21700388,201952,MIN,DAL,Jeff Teague,146,36.1333333333333,36,0.133333333333333,73,73,0,0,0
21700388,201959,MIN,DAL,Taj Gibson,141,33.9166666666667,34,-0.0833333333333357,66,66,0,-1,1
21700388,202710,MIN,DAL,Jimmy Butler,166,40.85,41,-0.150000000000006,82,77,5,5,0
21700388,203476,MIN,DAL,Gorgui Dieng,103,24.3833333333333,24,0.383333333333333,49,48,1,0,1
21700388,203952,MIN,DAL,Andrew Wiggins,150,35.75,36,-0.25,70,73,-3,-3,0
21700388,1626145,MIN,DAL,Tyus Jones,53,11.8333333333333,12,-0.166666666666666,24,19,5,5,0
21700388,1626157,MIN,DAL,Karl-Anthony Towns,153,37.5,38,-0.5,77,70,7,9,-2
21700389,2754,NOP,PHI,Tony Allen,4,1.08333333333333,1,0.0833333333333335,2,1,1,-1,2
21700389,200765,NOP,PHI,Rajon Rondo,186,36.8833333333333,37,-0.116666666666667,106,99,7,7,0
21700389,201600,NOP,PHI,Omer Asik,20,3.21666666666667,3,0.216666666666667,6,11,-5,-3,-2
21700389,201950,NOP,PHI,Jrue Holiday,207,40.9833333333333,41,-0.0166666666666657,114,104,10,14,-4
21700389,201967,NOP,PHI,Dante Cunningham,111,21.8833333333333,22,-0.116666666666667,58,46,12,12,0
21700389,202326,NOP,PHI,DeMarcus Cousins,143,28.2833333333333,29,-0.716666666666669,79,85,-6,-3,-3
21700389,202734,NOP,PHI,E'Twaun Moore,186,36.8833333333333,37,-0.116666666666667,106,99,7,7,0
21700389,203076,NOP,PHI,Anthony Davis,206,40.6666666666667,40,0.666666666666664,115,105,10,9,1
21700389,203121,NOP,PHI,Darius Miller,78,14.9,15,-0.0999999999999996,31,34,-3,-5,2
21700389,203546,NOP,PHI,Ian Clark,69,13.05,13,0.0500000000000007,33,36,-3,-2,-1
21700389,101161,PHI,NOP,Amir Johnson,117,24.3833333333333,24,0.383333333333333,63,69,-6,-6,0
21700389,200755,PHI,NOP,JJ Redick,179,34.85,35,-0.149999999999999,97,100,-3,-3,0
21700389,201573,PHI,NOP,Jerryd Bayless,127,25.1666666666667,25,0.166666666666664,63,65,-2,-5,3
21700389,202344,PHI,NOP,Trevor Booker,121,24.5833333333333,25,-0.416666666666664,57,65,-8,-9,1
21700389,203967,PHI,NOP,Dario Saric,139,27.2166666666667,28,-0.783333333333335,79,79,0,0,0
21700389,1626158,PHI,NOP,Richaun Holmes,125,23.1833333333333,24,-0.816666666666666,61,61,0,-1,1
21700389,1627732,PHI,NOP,Ben Simmons,181,35.35,36,-0.650000000000006,90,95,-5,-4,-1
21700389,1627788,PHI,NOP,Furkan Korkmaz,102,19.7833333333333,20,-0.216666666666669,47,49,-2,-2,0
21700389,1627789,PHI,NOP,Timothe Luwawu-Cabarrot,119,23.3166666666667,23,0.316666666666666,63,67,-4,-5,1
21700390,101141,ATL,NYK,Ersan Ilyasova,146,30.7666666666667,31,-0.233333333333334,76,75,1,2,-1
21700390,201158,ATL,NYK,Marco Belinelli,121,25.4833333333333,25,0.483333333333334,60,62,-2,4,-6
21700390,202337,ATL,NYK,Luke Babbitt,90,20.65,21,-0.350000000000001,46,46,0,-2,2
21700390,203101,ATL,NYK,Miles Plumlee,71,15.9,16,-0.100000000000001,29,32,-3,-3,0
21700390,203145,ATL,NYK,Kent Bazemore,136,29.0333333333333,28,1.03333333333333,65,67,-2,-3,1
21700390,203471,ATL,NYK,Dennis Schroder,102,21.9666666666667,22,-0.033333333333335,50,47,3,5,-2
21700390,1627098,ATL,NYK,Malcolm Delaney,39,8.48333333333333,8,0.483333333333334,22,22,0,0,0
21700390,1627752,ATL,NYK,Taurean Prince,180,38.5,39,-0.5,92,88,4,5,-1
21700390,1627761,ATL,NYK,DeAndre' Bembry,73,15.75,16,-0.25,25,38,-13,-16,3
21700390,1627819,ATL,NYK,Isaiah Taylor,79,16.8,17,-0.199999999999999,36,41,-5,-4,-1
21700390,1628463,ATL,NYK,Tyler Cavanaugh,73,16.6666666666667,17,-0.333333333333336,29,37,-8,-8,0
21700390,101127,NYK,ATL,Jarrett Jack,117,25.95,26,-0.0500000000000007,58,66,-8,-11,3
21700390,201563,NYK,ATL,Michael Beasley,50,10,10,0,27,16,11,11,0
21700390,201584,NYK,ATL,Courtney Lee,99,21.9166666666667,22,-0.0833333333333357,45,51,-6,-5,-1
21700390,202498,NYK,ATL,Lance Thomas,107,22.45,22,0.449999999999999,52,61,-9,-10,1
21700390,202683,NYK,ATL,Enes Kanter,77,17.7666666666667,18,-0.233333333333334,37,37,0,-2,2
21700390,203124,NYK,ATL,Kyle O'Quinn,69,15.85,15,0.85,35,25,10,14,-4
21700390,203926,NYK,ATL,Doug McDermott,148,31.05,31,0.0499999999999972,79,68,11,10,1
21700390,204001,NYK,ATL,Kristaps Porzingis,166,37.3166666666667,38,-0.683333333333337,80,85,-5,-1,-4
21700390,1627758,NYK,ATL,Ron Baker,150,31.3833333333333,31,0.383333333333333,76,69,7,3,4
21700390,1628373,NYK,ATL,Frank Ntilikina,127,26.3166666666667,26,0.316666666666663,66,52,14,11,3
21700391,201143,BOS,CHI,Al Horford,139,31.0333333333333,31,0.0333333333333314,57,62,-5,-7,2
21700391,203382,BOS,CHI,Aron Baynes,72,16.6166666666667,17,-0.383333333333333,26,33,-7,-7,0
21700391,203499,BOS,CHI,Shane Larkin,69,17.2333333333333,17,0.233333333333334,28,50,-22,-24,2
21700391,203935,BOS,CHI,Marcus Smart,139,31.2833333333333,31,0.283333333333331,54,66,-12,-16,4
21700391,1626179,BOS,CHI,Terry Rozier,126,27.9833333333333,28,-0.0166666666666657,56,70,-14,-12,-2
21700391,1627759,BOS,CHI,Jaylen Brown,128,28.6666666666667,29,-0.333333333333336,46,56,-10,-8,-2
21700391,1627824,BOS,CHI,Guerschon Yabusele,33,7.38333333333333,8,-0.616666666666667,12,18,-6,-6,0
21700391,1627846,BOS,CHI,Abdel Nader,65,15.6666666666667,16,-0.333333333333332,24,45,-21,-21,0
21700391,1628369,BOS,CHI,Jayson Tatum,130,29.0166666666667,29,0.0166666666666657,54,55,-1,-3,2
21700391,1628400,BOS,CHI,Semi Ojeleye,51,11.8333333333333,12,-0.166666666666666,28,33,-5,-5,0
21700391,1628443,BOS,CHI,Kadeem Allen,23,4.8,5,-0.2,10,11,-1,1,-2
21700391,1628444,BOS,CHI,Jabari Bird,23,4.8,5,-0.2,10,11,-1,1,-2
21700391,1628464,BOS,CHI,Daniel Theis,47,11.1833333333333,11,0.183333333333334,20,30,-10,-8,-2
21700391,201577,CHI,BOS,Robin Lopez,108,24.15,24,0.149999999999999,43,45,-2,0,-2
21700391,202347,CHI,BOS,Quincy Pondexter,18,3.66666666666667,4,-0.333333333333334,6,10,-4,-4,0
21700391,202703,CHI,BOS,Nikola Mirotic,139,31.2833333333333,32,-0.716666666666669,70,57,13,13,0
21700391,203200,CHI,BOS,Justin Holiday,110,24.5333333333333,25,-0.466666666666669,43,45,-2,0,-2
21700391,1626170,CHI,BOS,Jerian Grant,96,22.7,23,-0.299999999999997,63,38,25,23,2
21700391,1626171,CHI,BOS,Bobby Portis,98,22.9,23,-0.100000000000001,67,36,31,29,2
21700391,1626245,CHI,BOS,Cristiano Felicio,18,3.66666666666667,4,-0.333333333333334,6,10,-4,-4,0
21700391,1627739,CHI,BOS,Kris Dunn,113,24.8,25,-0.200000000000003,45,47,-2,0,-2
21700391,1627756,CHI,BOS,Denzel Valentine,122,29.1166666666667,30,-0.883333333333333,65,44,21,20,1
21700391,1627770,CHI,BOS,Kay Felder,16,3.36666666666667,3,0.366666666666666,6,8,-2,-3,1
21700391,1627835,CHI,BOS,Paul Zipser,91,20.4833333333333,21,-0.516666666666666,48,35,13,11,2
21700391,1628021,CHI,BOS,David Nwaba,116,26.8333333333333,27,-0.166666666666668,78,50,28,30,-2
21700392,200765,NOP,HOU,Rajon Rondo,189,41.9,42,-0.0999999999999943,109,123,-14,-15,1
21700392,201600,NOP,HOU,Omer Asik,59,12.2166666666667,12,0.216666666666665,27,39,-12,-12,0
21700392,201950,NOP,HOU,Jrue Holiday,192,41.2166666666667,41,0.216666666666669,115,104,11,10,1
21700392,202326,NOP,HOU,DeMarcus Cousins,151,32.8333333333333,33,-0.166666666666671,94,82,12,11,1
21700392,202734,NOP,HOU,E'Twaun Moore,192,41.8666666666667,42,-0.13333333333334,114,112,2,0,2
21700392,203121,NOP,HOU,Darius Miller,181,38.7833333333333,39,-0.216666666666669,102,107,-5,-5,0
21700392,203546,NOP,HOU,Ian Clark,100,20.4,21,-0.600000000000001,37,57,-20,-17,-3
21700392,1627883,NOP,HOU,Jalen Jones,40,9.48333333333333,9,0.483333333333334,17,25,-8,-7,-1
21700392,1628429,NOP,HOU,Charles Cooke,1,0.133333333333333,0,0.133333333333333,,1,,0,
21700392,2403,HOU,NOP,Nene,57,12.5333333333333,13,-0.466666666666665,22,33,-11,-11,0
21700392,2772,HOU,NOP,Trevor Ariza,178,38.1333333333333,38,0.133333333333333,114,101,13,13,0
21700392,101108,HOU,NOP,Chris Paul,149,32.5833333333333,33,-0.416666666666664,84,80,4,4,0
21700392,200782,HOU,NOP,PJ Tucker,104,22.8833333333333,23,-0.116666666666667,64,43,21,21,0
21700392,201569,HOU,NOP,Eric Gordon,160,35.6,36,-0.399999999999999,103,81,22,23,-1
21700392,201583,HOU,NOP,Ryan Anderson,81,17.1,18,-0.899999999999999,44,57,-13,-13,0
21700392,201601,HOU,NOP,Luc Mbah a Moute,104,21.8,21,0.800000000000001,48,57,-9,-9,0
21700392,201935,HOU,NOP,James Harden,160,34.25,35,-0.75,95,96,-1,-2,1
21700392,203991,HOU,NOP,Clint Capela,112,23.95,24,-0.0500000000000007,76,67,9,9,0
21700393,2617,MIA,MEM,Udonis Haslem,9,2.05,2,0.0499999999999998,7,5,2,1,1
21700393,201609,MIA,MEM,Goran Dragic,105,25.6666666666667,25,0.666666666666664,56,34,22,24,-2
21700393,201949,MIA,MEM,James Johnson,125,31.0166666666667,31,0.0166666666666657,68,48,20,20,0
21700393,201961,MIA,MEM,Wayne Ellington,121,30.6166666666667,31,-0.383333333333333,77,56,21,21,0
21700393,203079,MIA,MEM,Dion Waiters,96,23.6666666666667,24,-0.333333333333332,42,45,-3,-5,2
21700393,203482,MIA,MEM,Kelly Olynyk,72,17.65,18,-0.350000000000001,35,31,4,2,2
21700393,204020,MIA,MEM,Tyler Johnson,127,32.3333333333333,32,0.333333333333329,75,58,17,18,-1
21700393,1626159,MIA,MEM,Justise Winslow,89,22.95,23,-0.0500000000000007,55,38,17,17,0
21700393,1626175,MIA,MEM,Jordan Mickey,8,1.86666666666667,2,-0.133333333333333,6,5,1,1,0
21700393,1626196,MIA,MEM,Josh Richardson,115,29.6666666666667,30,-0.333333333333336,64,48,16,16,0
21700393,1628389,MIA,MEM,Bam Adebayo,88,22.5166666666667,23,-0.483333333333334,50,42,8,10,-2
21700393,201188,MEM,MIA,Marc Gasol,136,34.5666666666667,35,-0.433333333333337,54,82,-28,-27,-1
21700393,201596,MEM,MIA,Mario Chalmers,45,10.9666666666667,11,-0.0333333333333332,14,34,-20,-18,-2
21700393,201936,MEM,MIA,Tyreke Evans,130,33.15,33,0.150000000000006,55,68,-13,-16,3
21700393,202718,MEM,MIA,Chandler Parsons,96,24.1,24,0.100000000000001,37,54,-17,-20,3
21700393,203210,MEM,MIA,JaMychal Green,124,31.8,32,-0.200000000000003,55,70,-15,-14,-1
21700393,203463,MEM,MIA,Ben McLemore,61,14.9833333333333,15,-0.0166666666666675,27,28,-1,-1,0
21700393,203516,MEM,MIA,James Ennis III,90,22.2333333333333,22,0.233333333333334,44,48,-4,-2,-2
21700393,1626150,MEM,MIA,Andrew Harrison,120,30.2833333333333,30,0.283333333333331,53,71,-18,-17,-1
21700393,1626185,MEM,MIA,Jarell Martin,9,2.05,2,0.0499999999999998,5,7,-2,-1,-1
21700393,1626205,MEM,MIA,Vincent Hunter,9,2.05,2,0.0499999999999998,5,7,-2,-1,-1
21700393,1627738,MEM,MIA,Deyonta Davis,55,13.4333333333333,13,0.433333333333334,28,25,3,2,1
21700393,1628397,MEM,MIA,Ivan Rabb,9,2.05,2,0.0499999999999998,5,7,-2,-1,-1
21700393,1628415,MEM,MIA,Dillon Brooks,71,18.3333333333333,19,-0.666666666666664,28,34,-6,-9,3
21700394,2546,OKC,CHA,Carmelo Anthony,158,34.3,34,0.299999999999997,77,98,-21,-21,0
21700394,2555,OKC,CHA,Nick Collison,11,1.83333333333333,2,-0.166666666666667,4,9,-5,-3,-2
21700394,101109,OKC,CHA,Raymond Felton,81,18.4166666666667,18,0.416666666666664,35,33,2,0,2
21700394,201566,OKC,CHA,Russell Westbrook,167,35.8833333333333,36,-0.116666666666667,85,97,-12,-12,0
21700394,202331,OKC,CHA,Paul George,157,33.8166666666667,34,-0.18333333333333,81,84,-3,-5,2
21700394,202335,OKC,CHA,Patrick Patterson,62,13.4666666666667,13,0.466666666666667,24,18,6,6,0
21700394,202713,OKC,CHA,Kyle Singler,2,0.466666666666667,1,-0.533333333333333,2,0,2,2,0
21700394,203500,OKC,CHA,Steven Adams,127,28.2166666666667,29,-0.783333333333331,66,76,-10,-15,5
21700394,203518,OKC,CHA,Alex Abrines,123,26.15,26,0.149999999999999,57,77,-20,-22,2
21700394,203924,OKC,CHA,Jerami Grant,89,19.85,20,-0.149999999999999,33,41,-8,-8,0
21700394,203962,OKC,CHA,Josh Huestis,59,12.8833333333333,13,-0.116666666666667,24,26,-2,3,-5
21700394,1626177,OKC,CHA,Dakari Johnson,2,0.466666666666667,1,-0.533333333333333,2,0,2,2,0
21700394,1628390,OKC,CHA,Terrance Ferguson,57,12.0833333333333,13,-0.916666666666666,25,21,4,8,-4
21700394,2730,CHA,OKC,Dwight Howard,135,29.2833333333333,30,-0.716666666666669,79,72,7,10,-3
21700394,101107,CHA,OKC,Marvin Williams,145,31.3833333333333,32,-0.616666666666667,80,72,8,6,2
21700394,202689,CHA,OKC,Kemba Walker,174,38.3833333333333,39,-0.616666666666667,106,87,19,19,0
21700394,203077,CHA,OKC,Michael Kidd-Gilchrist,158,33.8166666666667,34,-0.18333333333333,97,78,19,17,2
21700394,203087,CHA,OKC,Jeremy Lamb,147,32.6833333333333,33,-0.316666666666663,94,73,21,22,-1
21700394,203487,CHA,OKC,Michael Carter-Williams,68,14.95,15,-0.0500000000000007,22,28,-6,-4,-2
21700394,203948,CHA,OKC,Johnny O'Bryant III,19,4.13333333333333,4,0.133333333333333,3,6,-3,-3,0
21700394,1626163,CHA,OKC,Frank Kaminsky,84,18.2833333333333,18,0.283333333333331,37,31,6,3,3
21700394,1626203,CHA,OKC,Treveon Graham,96,20.55,20,0.549999999999997,40,40,0,1,-1
21700394,1628370,CHA,OKC,Malik Monk,32,6.83333333333333,7,-0.166666666666666,5,11,-6,-6,0
21700394,1628407,CHA,OKC,Dwayne Bacon,37,7.53333333333333,8,-0.466666666666667,17,17,0,0,0
21700395,2561,GSW,POR,David West,74,17.2166666666667,18,-0.783333333333335,34,32,2,-2,4
21700395,2733,GSW,POR,Shaun Livingston,107,23.5333333333333,24,-0.466666666666669,62,54,8,6,2
21700395,2738,GSW,POR,Andre Iguodala,136,31.8833333333333,32,-0.116666666666667,67,68,-1,3,-4
21700395,201142,GSW,POR,Kevin Durant,166,36.5833333333333,36,0.583333333333329,89,83,6,8,-2
21700395,201156,GSW,POR,Nick Young,56,13.3166666666667,13,0.316666666666666,32,23,9,11,-2
21700395,201956,GSW,POR,Omri Casspi,116,24.3666666666667,25,-0.633333333333333,61,55,6,2,4
21700395,202691,GSW,POR,Klay Thompson,168,37.3833333333333,37,0.383333333333333,87,86,1,5,-4
21700395,1626172,GSW,POR,Kevon Looney,12,3.23333333333333,3,0.233333333333333,5,8,-3,-3,0
21700395,1626188,GSW,POR,Quinn Cook,40,9.96666666666667,10,-0.0333333333333332,17,22,-5,-5,0
21700395,1627775,GSW,POR,Patrick McCaw,72,16.6166666666667,17,-0.383333333333333,32,34,-2,-4,2
21700395,1628395,GSW,POR,Jordan Bell,118,25.4,26,-0.600000000000001,69,55,14,14,0
21700395,202323,POR,GSW,Evan Turner,139,30.4833333333333,30,0.483333333333334,69,78,-9,-9,0
21700395,202329,POR,GSW,Al-Farouq Aminu,115,25.3,25,0.300000000000001,57,67,-10,-10,0
21700395,202334,POR,GSW,Ed Davis,31,7.85,8,-0.15,12,20,-8,-8,0
21700395,203081,POR,GSW,Damian Lillard,188,41.7833333333333,42,-0.216666666666669,94,96,-2,-2,0
21700395,203086,POR,GSW,Meyers Leonard,84,18.3166666666667,18,0.316666666666666,43,53,-10,-10,0
21700395,203468,POR,GSW,CJ McCollum,155,34.2,34,0.200000000000003,72,91,-19,-21,2
21700395,203943,POR,GSW,Noah Vonleh,66,15.4,15,0.4,33,25,8,10,-2
21700395,1626192,POR,GSW,Pat Connaughton,95,22.7333333333333,23,-0.266666666666666,45,45,0,2,-2
21700395,1627774,POR,GSW,Jake Layman,76,17.2166666666667,17,0.216666666666669,36,28,8,8,0
21700395,1628380,POR,GSW,Zach Collins,112,25.2,25,0.199999999999999,55,52,3,1,2
21700395,1628403,POR,GSW,Caleb Swanigan,4,1.01666666666667,1,0.0166666666666666,4,0,4,4,0
21700396,101150,LAC,TOR,Lou Williams,167,35.5333333333333,36,-0.466666666666669,75,67,8,11,-3
21700396,201599,LAC,TOR,DeAndre Jordan,150,32.2,33,-0.799999999999997,68,64,4,2,2
21700396,202325,LAC,TOR,Wesley Johnson,90,19.2666666666667,20,-0.733333333333334,29,39,-10,-10,0
21700396,203085,LAC,TOR,Austin Rivers,151,32.6833333333333,33,-0.316666666666663,70,65,5,5,0
21700396,203710,LAC,TOR,C.J. Williams,49,9.55,9,0.550000000000001,22,20,2,-1,3
21700396,203966,LAC,TOR,Jamil Wilson,41,9.06666666666667,9,0.0666666666666664,9,16,-7,-6,-1
21700396,1626149,LAC,TOR,Montrezl Harrell,77,16.2166666666667,16,0.216666666666669,30,27,3,3,0
21700396,1626155,LAC,TOR,Sam Dekker,126,27.0166666666667,27,0.0166666666666657,62,51,11,12,-1
21700396,1628393,LAC,TOR,Jawun Evans,68,14.4833333333333,15,-0.516666666666666,24,22,2,2,0
21700396,1628414,LAC,TOR,Sindarius Thornwell,117,23.6,23,0.600000000000001,52,48,4,1,3
21700396,1628462,LAC,TOR,Milos Teodosic,89,20.2166666666667,21,-0.783333333333331,39,36,3,6,-3
21700396,101139,TOR,LAC,CJ Miles,92,18.4333333333333,18,0.433333333333334,32,39,-7,-5,-2
21700396,200768,TOR,LAC,Kyle Lowry,164,35.25,35,0.25,73,72,1,0,1
21700396,201586,TOR,LAC,Serge Ibaka,151,32.7166666666667,33,-0.283333333333331,62,67,-5,-1,-4
21700396,201942,TOR,LAC,DeMar DeRozan,167,35.9333333333333,36,-0.0666666666666629,75,75,0,0,0
21700396,202685,TOR,LAC,Jonas Valanciunas,127,27.5333333333333,28,-0.466666666666669,57,55,2,3,-1
21700396,203485,TOR,LAC,Lorenzo Brown,11,2.2,2,0.2,5,7,-2,-2,0
21700396,1626181,TOR,LAC,Norman Powell,56,11.7,12,-0.300000000000001,12,27,-15,-15,0
21700396,1627751,TOR,LAC,Jakob Poeltl,61,12.8833333333333,13,-0.116666666666667,19,24,-5,-9,4
21700396,1627783,TOR,LAC,Pascal Siakam,64,13.6,13,0.6,27,22,5,3,2
21700396,1627832,TOR,LAC,Fred VanVleet,111,23.4666666666667,24,-0.533333333333331,40,48,-8,-7,-1
21700396,1628384,TOR,LAC,OG Anunoby,121,26.1166666666667,26,0.116666666666667,53,44,9,8,1
21700397,101141,ATL,CLE,Ersan Ilyasova,100,22.3166666666667,23,-0.683333333333334,49,66,-17,-15,-2
21700397,201158,ATL,CLE,Marco Belinelli,103,20.6666666666667,20,0.666666666666664,42,58,-16,-18,2
21700397,202337,ATL,CLE,Luke Babbitt,103,20.9666666666667,22,-1.03333333333333,48,55,-7,-9,2
21700397,203101,ATL,CLE,Miles Plumlee,59,14.35,15,-0.65,45,33,12,10,2
21700397,203145,ATL,CLE,Kent Bazemore,121,27.8666666666667,28,-0.133333333333333,67,70,-3,1,-4
21700397,203471,ATL,CLE,Dennis Schroder,120,27,27,0,58,73,-15,-15,0
21700397,1627098,ATL,CLE,Malcolm Delaney,19,4.9,5,-0.0999999999999996,15,9,6,6,0
21700397,1627752,ATL,CLE,Taurean Prince,129,29.6333333333333,30,-0.366666666666667,74,72,2,4,-2
21700397,1627761,ATL,CLE,DeAndre' Bembry,106,21.4833333333333,22,-0.516666666666666,50,64,-14,-16,2
21700397,1627819,ATL,CLE,Isaiah Taylor,88,18,18,0,50,43,7,7,0
21700397,1628416,ATL,CLE,Tyler Dorsey,10,2.28333333333333,3,-0.716666666666667,9,2,7,7,0
21700397,1628463,ATL,CLE,Tyler Cavanaugh,127,28.6166666666667,29,-0.383333333333333,63,70,-7,-7,0
21700397,2544,CLE,ATL,LeBron James,154,34.5833333333333,35,-0.416666666666664,98,77,21,19,2
21700397,2594,CLE,ATL,Kyle Korver,112,23.2333333333333,23,0.233333333333334,60,56,4,4,0
21700397,2747,CLE,ATL,JR Smith,114,25.5,26,-0.5,71,58,13,13,0
21700397,101112,CLE,ATL,Channing Frye,74,15.1,15,0.100000000000001,40,34,6,6,0
21700397,101181,CLE,ATL,Jose Calderon,137,31.2333333333333,32,-0.766666666666666,81,72,9,7,2
21700397,201145,CLE,ATL,Jeff Green,118,25.5666666666667,26,-0.433333333333334,57,67,-10,-8,-2
21700397,201567,CLE,ATL,Kevin Love,124,28.4,28,0.399999999999999,75,65,10,10,0
21700397,202684,CLE,ATL,Tristan Thompson,25,5.81666666666667,6,-0.183333333333334,14,16,-2,-2,0
21700397,203109,CLE,ATL,Jae Crowder,123,26.7333333333333,27,-0.266666666666666,74,60,14,14,0
21700397,1626224,CLE,ATL,Cedi Osman,84,17.35,18,-0.649999999999999,41,47,-6,-4,-2
21700397,1627790,CLE,ATL,Ante Zizic,10,2.28333333333333,3,-0.716666666666667,2,9,-7,-7,0
21700397,1628506,CLE,ATL,London Perrantes,10,2.28333333333333,3,-0.716666666666667,2,9,-7,-7,0
21700398,201163,DEN,DET,Wilson Chandler,123,26.35,27,-0.649999999999999,62,32,30,34,-4
21700398,201589,DEN,DET,Darrell Arthur,62,14.55,15,-0.449999999999999,24,37,-13,-13,0
21700398,203115,DEN,DET,Will Barton,155,34.7,34,0.700000000000003,76,52,24,26,-2
21700398,203486,DEN,DET,Mason Plumlee,132,28.7666666666667,29,-0.233333333333334,69,38,31,29,2
21700398,203914,DEN,DET,Gary Harris,142,30.9166666666667,31,-0.0833333333333357,75,50,25,25,0
21700398,1626144,DEN,DET,Emmanuel Mudiay,62,14.95,15,-0.0500000000000007,26,33,-7,-7,0
21700398,1626168,DEN,DET,Trey Lyles,121,27.8666666666667,27,0.866666666666667,55,58,-3,-7,4
21700398,1627736,DEN,DET,Malik Beasley,104,24.0166666666667,24,0.0166666666666657,48,57,-9,-9,0
21700398,1627750,DEN,DET,Jamal Murray,147,31.7,32,-0.300000000000001,74,49,25,25,0
21700398,1627823,DEN,DET,Juancho Hernangomez,16,3.05,3,0.0499999999999998,3,7,-4,-4,0
21700398,1628420,DEN,DET,Monte Morris,16,3.05,3,0.0499999999999998,3,7,-4,-4,0
21700398,201229,DET,DEN,Anthony Tolliver,60,13.4833333333333,14,-0.516666666666668,32,29,3,5,-2
21700398,202340,DET,DEN,Avery Bradley,110,23.9,24,-0.100000000000001,30,55,-25,-25,0
21700398,202397,DET,DEN,Ish Smith,101,23.3,23,0.299999999999997,49,47,2,4,-2
21700398,202699,DET,DEN,Tobias Harris,134,29.9,30,-0.100000000000001,42,64,-22,-24,2
21700398,202704,DET,DEN,Reggie Jackson,115,24.6833333333333,25,-0.316666666666666,35,56,-21,-23,2
21700398,203083,DET,DEN,Andre Drummond,117,26.6166666666667,27,-0.383333333333333,29,56,-27,-29,2
21700398,203493,DET,DEN,Reggie Bullock,106,22.4333333333333,22,0.433333333333334,28,50,-22,-22,0
21700398,203961,DET,DEN,Eric Moreland,22,4.6,4,0.6,10,10,0,0,0
21700398,204038,DET,DEN,Langston Galloway,97,22,22,0,50,42,8,8,0
21700398,1626169,DET,DEN,Stanley Johnson,64,14.7666666666667,14,0.766666666666666,30,29,1,3,-2
21700398,1626246,DET,DEN,Boban Marjanovic,61,13.0833333333333,13,0.0833333333333322,34,28,6,8,-2
21700398,1627740,DET,DEN,Henry Ellenson,38,8.28333333333333,8,0.283333333333333,21,19,2,2,0
21700398,1628379,DET,DEN,Luke Kennard,55,12.8666666666667,13,-0.133333333333333,30,30,0,-2,2
21700399,101106,LAL,NYK,Andrew Bogut,1,0.0166666666666667,0,0.0166666666666667,,2,,0,
21700399,201147,LAL,NYK,Corey Brewer,40,9,9,0,16,17,-1,-1,0
21700399,201572,LAL,NYK,Brook Lopez,115,23.2,23,0.199999999999999,50,55,-5,-5,0
21700399,203484,LAL,NYK,Kentavious Caldwell-Pope,186,38.4166666666667,38,0.416666666666664,83,85,-2,-4,2
21700399,203903,LAL,NYK,Jordan Clarkson,93,20.5666666666667,20,0.566666666666666,45,37,8,9,-1
21700399,203944,LAL,NYK,Julius Randle,126,27.7333333333333,27,0.733333333333334,52,54,-2,-2,0
21700399,1626204,LAL,NYK,Larry Nance Jr.,124,25.2666666666667,26,-0.733333333333334,57,59,-2,-2,0
21700399,1627742,LAL,NYK,Brandon Ingram,194,41.2833333333333,41,0.283333333333331,81,88,-7,-8,1
21700399,1628366,LAL,NYK,Lonzo Ball,189,39.3,40,-0.700000000000003,82,93,-11,-11,0
21700399,1628398,LAL,NYK,Kyle Kuzma,135,29.8,30,-0.199999999999999,59,58,1,1,0
21700399,1628404,LAL,NYK,Josh Hart,47,10.4166666666667,10,0.416666666666668,20,17,3,3,0
21700399,101127,NYK,LAL,Jarrett Jack,130,25.7166666666667,26,-0.283333333333331,59,55,4,4,0
21700399,201563,NYK,LAL,Michael Beasley,98,22.65,22,0.649999999999999,45,40,5,5,0
21700399,201584,NYK,LAL,Courtney Lee,192,39.95,40,-0.0499999999999972,95,84,11,11,0
21700399,202498,NYK,LAL,Lance Thomas,110,23.3,23,0.300000000000001,57,48,9,9,0
21700399,202683,NYK,LAL,Enes Kanter,128,26.5333333333333,27,-0.466666666666669,61,54,7,7,0
21700399,203124,NYK,LAL,Kyle O'Quinn,65,13.7166666666667,14,-0.283333333333333,25,32,-7,-7,0
21700399,203926,NYK,LAL,Doug McDermott,153,32.7,33,-0.299999999999997,58,67,-9,-9,0
21700399,204001,NYK,LAL,Kristaps Porzingis,191,39.8166666666667,40,-0.183333333333337,91,86,5,5,0
21700399,1627758,NYK,LAL,Ron Baker,51,11.6333333333333,11,0.633333333333333,18,21,-3,-3,0
21700399,1628373,NYK,LAL,Frank Ntilikina,132,28.9833333333333,29,-0.0166666666666657,56,58,-2,-2,0
21700400,201960,BKN,WAS,DeMarre Carroll,140,28.6833333333333,29,-0.316666666666666,64,47,17,15,2
21700400,202389,BKN,WAS,Timofey Mozgov,22,4.81666666666667,5,-0.183333333333334,6,11,-5,-5,0
21700400,203092,BKN,WAS,Tyler Zeller,111,22.7166666666667,23,-0.283333333333331,51,43,8,10,-2
21700400,203112,BKN,WAS,Quincy Acy,82,16.9166666666667,17,-0.0833333333333357,33,49,-16,-9,-7
21700400,203459,BKN,WAS,Allen Crabbe,153,31.4333333333333,31,0.433333333333334,62,56,6,9,-3
21700400,203915,BKN,WAS,Spencer Dinwiddie,154,32.2333333333333,32,0.233333333333334,76,65,11,11,0
21700400,203925,BKN,WAS,Joe Harris,134,26.8833333333333,27,-0.116666666666667,58,69,-11,-9,-2
21700400,1626178,BKN,WAS,Rondae Hollis-Jefferson,132,27.05,27,0.0499999999999972,63,46,17,8,9
21700400,1627747,BKN,WAS,Caris LeVert,141,28.7333333333333,29,-0.266666666666666,56,60,-4,-5,1
21700400,1628386,BKN,WAS,Jarrett Allen,101,20.45,20,0.449999999999999,46,44,2,0,2
21700400,101162,WAS,BKN,Marcin Gortat,90,17.9166666666667,18,-0.0833333333333357,32,45,-13,-13,0
21700400,201160,WAS,BKN,Jason Smith,137,28.1666666666667,28,0.166666666666664,62,55,7,7,0
21700400,201975,WAS,BKN,Jodie Meeks,132,26.4833333333333,26,0.483333333333334,64,43,21,17,4
21700400,202693,WAS,BKN,Markieff Morris,91,18.65,19,-0.350000000000001,36,46,-10,-10,0
21700400,203078,WAS,BKN,Bradley Beal,178,36.4166666666667,36,0.416666666666664,70,83,-13,-10,-3
21700400,203107,WAS,BKN,Tomas Satoransky,106,21.3166666666667,22,-0.683333333333334,50,40,10,12,-2
21700400,203118,WAS,BKN,Mike Scott,70,14.55,15,-0.449999999999999,31,25,6,3,3
21700400,203490,WAS,BKN,Otto Porter Jr.,146,30.05,30,0.0500000000000007,53,74,-21,-17,-4
21700400,204025,WAS,BKN,Tim Frazier,74,16,16,0,28,45,-17,-19,2
21700400,1626162,WAS,BKN,Kelly Oubre Jr.,146,30.3666666666667,30,0.366666666666667,64,59,5,5,0
21700401,2037,MIN,PHI,Jamal Crawford,93,20.8833333333333,20,0.883333333333333,44,38,6,4,2
21700401,201952,MIN,PHI,Jeff Teague,182,37.6166666666667,38,-0.38333333333334,80,84,-4,-4,0
21700401,201959,MIN,PHI,Taj Gibson,192,39.7166666666667,40,-0.283333333333331,84,89,-5,-3,-2
21700401,202710,MIN,PHI,Jimmy Butler,219,45.1166666666667,46,-0.883333333333333,95,102,-7,-6,-1
21700401,203476,MIN,PHI,Gorgui Dieng,90,18.4166666666667,18,0.416666666666668,39,36,3,1,2
21700401,203952,MIN,PHI,Andrew Wiggins,198,40,40,0,85,96,-11,-10,-1
21700401,1626145,MIN,PHI,Tyus Jones,73,15.3833333333333,15,0.383333333333333,32,34,-2,-2,0
21700401,1626157,MIN,PHI,Karl-Anthony Towns,228,47.8666666666667,48,-0.133333333333333,101,111,-10,-10,0
21700401,101161,PHI,MIN,Amir Johnson,59,13.0666666666667,13,0.0666666666666664,17,23,-6,-10,4
21700401,200755,PHI,MIN,JJ Redick,169,34.7,35,-0.299999999999997,92,80,12,11,1
21700401,201573,PHI,MIN,Jerryd Bayless,70,15.4,15,0.4,27,25,2,3,-1
21700401,202344,PHI,MIN,Trevor Booker,95,19.7166666666667,20,-0.283333333333331,46,37,9,8,1
21700401,203954,PHI,MIN,Joel Embiid,189,38.9833333333333,39,-0.0166666666666657,97,84,13,19,-6
21700401,203967,PHI,MIN,Dario Saric,193,39.3833333333333,40,-0.616666666666667,94,89,5,3,2
21700401,204456,PHI,MIN,T.J. McConnell,128,26.3166666666667,26,0.316666666666666,51,53,-2,-1,-1
21700401,1626158,PHI,MIN,Richaun Holmes,159,33.25,33,0.25,70,75,-5,-6,1
21700401,1627732,PHI,MIN,Ben Simmons,195,40.15,40,0.150000000000006,88,84,4,3,1
21700401,1627789,PHI,MIN,Timothe Luwawu-Cabarrot,18,4.03333333333333,4,0.0333333333333332,8,10,-2,0,-2
21700402,1717,DAL,SAS,Dirk Nowitzki,119,26.5,27,-0.5,45,47,-2,0,-2
21700402,2734,DAL,SAS,Devin Harris,89,19.6666666666667,19,0.666666666666664,42,36,6,6,0
21700402,200826,DAL,SAS,J.J. Barea,113,24.8333333333333,25,-0.166666666666664,53,44,9,8,1
21700402,202083,DAL,SAS,Wesley Matthews,147,35.1166666666667,35,0.116666666666667,67,69,-2,-3,1
21700402,203084,DAL,SAS,Harrison Barnes,145,34.6333333333333,35,-0.366666666666667,71,69,2,1,1
21700402,203939,DAL,SAS,Dwight Powell,84,17.3166666666667,17,0.316666666666666,37,29,8,8,0
21700402,1626257,DAL,SAS,Salah Mejri,35,9.16666666666667,9,0.166666666666666,17,16,1,1,0
21700402,1627812,DAL,SAS,Yogi Ferrell,150,35.3333333333333,35,0.333333333333329,73,63,10,9,1
21700402,1628467,DAL,SAS,Maxi Kleber,123,30.1666666666667,30,0.166666666666664,58,56,2,1,1
21700402,1628499,DAL,SAS,Antonius Cleveland,40,7.01666666666667,7,0.0166666666666666,12,11,1,-1,2
21700402,1938,SAS,DAL,Manu Ginobili,113,26.95,27,-0.0499999999999972,56,63,-7,-6,-1
21700402,2200,SAS,DAL,Pau Gasol,103,22.0333333333333,22,0.0333333333333314,35,38,-3,-1,-2
21700402,2225,SAS,DAL,Tony Parker,105,23.3166666666667,24,-0.683333333333334,35,36,-1,1,-2
21700402,200746,SAS,DAL,LaMarcus Aldridge,161,38.0333333333333,38,0.0333333333333314,70,66,4,5,-1
21700402,200752,SAS,DAL,Rudy Gay,114,26.6,27,-0.399999999999999,52,65,-13,-16,3
21700402,201980,SAS,DAL,Danny Green,105,24,24,0,40,39,1,1,0
21700402,201988,SAS,DAL,Patty Mills,104,24.6333333333333,24,0.633333333333333,53,59,-6,-7,1
21700402,202695,SAS,DAL,Kawhi Leonard,73,15.7166666666667,16,-0.283333333333335,28,20,8,8,0
21700402,202722,SAS,DAL,Davis Bertans,15,3.76666666666667,4,-0.233333333333333,4,8,-4,-2,-2
21700402,203464,SAS,DAL,Brandon Paul,19,3.46666666666667,3,0.466666666666667,4,6,-2,-2,0
21700402,203530,SAS,DAL,Joffrey Lauvergne,26,5.56666666666667,6,-0.433333333333334,12,15,-3,-3,0
21700402,1627749,SAS,DAL,Dejounte Murray,18,4.66666666666667,5,-0.333333333333334,11,8,3,3,0
21700402,1627854,SAS,DAL,Bryn Forbes,89,21,21,0,40,52,-12,-11,-1
21700403,2199,PHX,SAC,Tyson Chandler,135,29.1666666666667,29,0.166666666666664,45,57,-12,-12,0
21700403,203458,PHX,SAC,Alex Len,83,18.5666666666667,19,-0.433333333333334,47,42,5,5,0
21700403,203584,PHX,SAC,Troy Daniels,129,27.8666666666667,28,-0.133333333333333,69,57,12,9,3
21700403,203933,PHX,SAC,T.J. Warren,172,38.1333333333333,39,-0.866666666666667,63,71,-8,-7,-1
21700403,1627733,PHX,SAC,Dragan Bender,92,20.6,21,-0.399999999999999,47,46,1,1,0
21700403,1627737,PHX,SAC,Marquese Chriss,106,22.9833333333333,23,-0.0166666666666657,38,40,-2,-2,0
21700403,1627755,PHX,SAC,Tyler Ulis,137,31.0666666666667,32,-0.933333333333334,46,57,-11,-12,1
21700403,1628367,PHX,SAC,Josh Jackson,141,29.9333333333333,30,-0.0666666666666664,55,73,-18,-16,-2
21700403,1628455,PHX,SAC,Mike James,95,20.35,20,0.350000000000001,50,52,-2,-1,-1
21700403,2216,SAC,PHX,Zach Randolph,126,26.95,28,-1.05,54,47,7,8,-1
21700403,201585,SAC,PHX,Kosta Koufos,92,20.7833333333333,20,0.783333333333331,45,45,0,-1,1
21700403,201588,SAC,PHX,George Hill,130,27.4333333333333,28,-0.566666666666666,60,49,11,12,-1
21700403,202066,SAC,PHX,Garrett Temple,71,15.0833333333333,15,0.0833333333333322,26,26,0,0,0
21700403,203992,SAC,PHX,Bogdan Bogdanovic,147,32.65,33,-0.350000000000001,73,66,7,7,0
21700403,1626161,SAC,PHX,Willie Cauley-Stein,135,30,30,0,62,61,1,-1,2
21700403,1627741,SAC,PHX,Buddy Hield,112,25.15,25,0.149999999999999,56,50,6,5,1
21700403,1627746,SAC,PHX,Skal Labissiere,59,12.8833333333333,13,-0.116666666666667,20,24,-4,-2,-2
21700403,1628368,SAC,PHX,De'Aaron Fox,99,21.2166666666667,21,0.216666666666665,38,40,-2,-2,0
21700403,1628412,SAC,PHX,Frank Mason,119,26.5166666666667,27,-0.483333333333334,61,52,9,9,0
21700404,201152,IND,OKC,Thaddeus Young,183,37.9666666666667,38,-0.0333333333333314,78,74,4,4,0
21700404,201954,IND,OKC,Darren Collison,144,28.9666666666667,29,-0.0333333333333314,64,61,3,3,0
21700404,202362,IND,OKC,Lance Stephenson,93,21.7833333333333,22,-0.216666666666669,36,41,-5,-5,0
21700404,202709,IND,OKC,Cory Joseph,78,18.9333333333333,19,-0.0666666666666664,31,39,-8,-8,0
21700404,202711,IND,OKC,Bojan Bogdanovic,166,35.7166666666667,36,-0.283333333333331,78,81,-3,-3,0
21700404,203506,IND,OKC,Victor Oladipo,185,38.3,38,0.299999999999997,76,78,-2,-2,0
21700404,1626167,IND,OKC,Myles Turner,160,35.0333333333333,35,0.0333333333333314,74,73,1,-1,2
21700404,1627734,IND,OKC,Domantas Sabonis,82,18.65,19,-0.350000000000001,31,40,-9,-9,0
21700404,1628388,IND,OKC,TJ Leaf,19,4.15,4,0.15,7,13,-6,-4,-2
21700404,2546,OKC,IND,Carmelo Anthony,168,34.4,35,-0.600000000000001,71,70,1,1,0
21700404,101109,OKC,IND,Raymond Felton,48,12.25,12,0.25,26,23,3,3,0
21700404,201566,OKC,IND,Russell Westbrook,174,35.65,36,-0.349999999999994,74,72,2,2,0
21700404,202331,OKC,IND,Paul George,159,33.3333333333333,33,0.333333333333336,67,70,-3,-3,0
21700404,202335,OKC,IND,Patrick Patterson,54,13.5,13,0.5,29,25,4,4,0
21700404,203500,OKC,IND,Steven Adams,169,34.7666666666667,35,-0.233333333333334,71,70,1,1,0
21700404,203518,OKC,IND,Alex Abrines,149,31.1666666666667,32,-0.833333333333332,67,63,4,4,0
21700404,203924,OKC,IND,Jerami Grant,77,17.7666666666667,18,-0.233333333333334,36,33,3,3,0
21700404,203962,OKC,IND,Josh Huestis,73,16.7333333333333,16,0.733333333333334,33,32,1,1,0
21700404,1628390,OKC,IND,Terrance Ferguson,39,9.93333333333333,10,-0.0666666666666664,26,17,9,9,0
21700405,101150,LAC,ORL,Lou Williams,147,32.2166666666667,32,0.216666666666669,79,68,11,13,-2
21700405,201599,LAC,ORL,DeAndre Jordan,168,36.2166666666667,36,0.216666666666669,86,77,9,9,0
21700405,202325,LAC,ORL,Wesley Johnson,65,13.5333333333333,14,-0.466666666666667,20,32,-12,-12,0
21700405,203085,LAC,ORL,Austin Rivers,86,17.6666666666667,18,-0.333333333333336,37,31,6,3,3
21700405,203710,LAC,ORL,C.J. Williams,96,21.7,22,-0.299999999999997,58,48,10,11,-1
21700405,203966,LAC,ORL,Jamil Wilson,103,21.9,22,-0.100000000000001,45,39,6,4,2
21700405,1626149,LAC,ORL,Montrezl Harrell,50,11.4666666666667,12,-0.533333333333335,19,18,1,2,-1
21700405,1626155,LAC,ORL,Sam Dekker,115,25.7833333333333,26,-0.216666666666669,60,56,4,7,-3
21700405,1628393,LAC,ORL,Jawun Evans,114,25.35,25,0.350000000000001,61,53,8,10,-2
21700405,1628414,LAC,ORL,Sindarius Thornwell,33,6.96666666666667,7,-0.0333333333333332,12,10,2,2,0
21700405,1628462,LAC,ORL,Milos Teodosic,113,25.6166666666667,25,0.616666666666667,48,43,5,6,-1
21700405,201571,ORL,LAC,D.J. Augustin,79,17.7166666666667,18,-0.283333333333331,32,38,-6,-9,3
21700405,201578,ORL,LAC,Marreese Speights,58,13.0833333333333,13,0.0833333333333322,23,29,-6,-7,1
21700405,202687,ORL,LAC,Bismack Biyombo,73,16.4166666666667,16,0.416666666666664,28,36,-8,-9,1
21700405,202696,ORL,LAC,Nikola Vucevic,140,30.35,31,-0.649999999999999,65,65,0,-2,2
21700405,202714,ORL,LAC,Shelvin Mack,92,21.1333333333333,21,0.133333333333333,43,56,-13,-16,3
21700405,203613,ORL,LAC,Jonathon Simmons,176,38.3166666666667,39,-0.683333333333337,81,83,-2,-4,2
21700405,203901,ORL,LAC,Elfrid Payton,143,31.0333333333333,31,0.0333333333333314,68,63,5,5,0
21700405,203920,ORL,LAC,Khem Birch,5,0.916666666666667,1,-0.0833333333333334,2,4,-2,0,-2
21700405,203940,ORL,LAC,Adreian Payne,5,0.916666666666667,1,-0.0833333333333334,2,4,-2,0,-2
21700405,1626209,ORL,LAC,Mario Hezonja,160,34.6,35,-0.400000000000006,72,76,-4,-4,0
21700405,1628411,ORL,LAC,Wes Iwundu,154,33.0166666666667,33,0.0166666666666657,57,67,-10,-9,-1
21700405,1628503,ORL,LAC,Jamel Artis,5,0.916666666666667,1,-0.0833333333333334,2,4,-2,0,-2
21700406,201188,MEM,WAS,Marc Gasol,165,37.5166666666667,38,-0.483333333333334,69,73,-4,-4,0
21700406,201596,MEM,WAS,Mario Chalmers,104,21.6,22,-0.399999999999999,44,46,-2,-2,0
21700406,202718,MEM,WAS,Chandler Parsons,117,26.5833333333333,27,-0.416666666666668,49,56,-7,-8,1
21700406,203210,MEM,WAS,JaMychal Green,168,37.2,37,0.200000000000003,67,75,-8,-8,0
21700406,203463,MEM,WAS,Ben McLemore,111,23.15,23,0.149999999999999,47,39,8,9,-1
21700406,203516,MEM,WAS,James Ennis III,110,23.6333333333333,24,-0.366666666666667,47,46,1,3,-2
21700406,1626150,MEM,WAS,Andrew Harrison,131,29.2666666666667,30,-0.733333333333334,54,57,-3,-3,0
21700406,1626185,MEM,WAS,Jarell Martin,37,7.95,8,-0.0499999999999998,11,14,-3,-3,0
21700406,1627738,MEM,WAS,Deyonta Davis,49,9.33333333333333,9,0.333333333333332,18,19,-1,-1,0
21700406,1628415,MEM,WAS,Dillon Brooks,93,22.2666666666667,22,0.266666666666666,29,40,-11,-13,2
21700406,101162,WAS,MEM,Marcin Gortat,134,29.5,29,0.5,54,48,6,6,0
21700406,201160,WAS,MEM,Jason Smith,80,17.9,18,-0.100000000000001,37,35,2,2,0
21700406,201975,WAS,MEM,Jodie Meeks,89,18.9166666666667,19,-0.0833333333333322,38,27,11,10,1
21700406,202322,WAS,MEM,John Wall,124,27.55,28,-0.450000000000003,58,49,9,11,-2
21700406,203078,WAS,MEM,Bradley Beal,170,38.4,39,-0.599999999999994,76,70,6,7,-1
21700406,203107,WAS,MEM,Tomas Satoransky,72,15.0833333333333,15,0.0833333333333339,24,32,-8,-8,0
21700406,203118,WAS,MEM,Mike Scott,120,26.8833333333333,27,-0.116666666666667,56,49,7,2,5
21700406,203490,WAS,MEM,Otto Porter Jr.,152,32.9666666666667,33,-0.0333333333333314,63,59,4,8,-4
21700406,204025,WAS,MEM,Tim Frazier,22,5.16666666666667,5,0.166666666666666,7,9,-2,-4,2
21700406,1626162,WAS,MEM,Kelly Oubre Jr.,122,26.1333333333333,26,0.133333333333333,52,57,-5,-4,-1
21700407,202681,BOS,DEN,Kyrie Irving,161,32.95,33,-0.0499999999999972,82,92,-10,-5,-5
21700407,203382,BOS,DEN,Aron Baynes,94,18.65,28,-9.35,46,49,-3,-6,3
21700407,203499,BOS,DEN,Shane Larkin,79,17.2833333333333,18,-0.716666666666665,49,32,17,14,3
21700407,203935,BOS,DEN,Marcus Smart,164,33.6,34,-0.400000000000006,94,85,9,7,2
21700407,1626179,BOS,DEN,Terry Rozier,90,19.35,20,-0.649999999999999,50,39,11,9,2
21700407,1627759,BOS,DEN,Jaylen Brown,163,32.5,33,-0.5,85,90,-5,-5,0
21700407,1628369,BOS,DEN,Jayson Tatum,135,27.9333333333333,28,-0.0666666666666664,74,71,3,4,-1
21700407,1628400,BOS,DEN,Semi Ojeleye,138,28.85,29,-0.149999999999999,68,71,-3,-2,-1
21700407,1628464,BOS,DEN,Daniel Theis,126,27.8833333333333,18,9.88333333333333,72,61,11,14,-3
21700407,201163,DEN,BOS,Wilson Chandler,174,36.5333333333333,37,-0.466666666666669,91,93,-2,-4,2
21700407,202702,DEN,BOS,Kenneth Faried,78,16.1833333333333,16,0.183333333333334,28,40,-12,-9,-3
21700407,203486,DEN,BOS,Mason Plumlee,152,31.6166666666667,32,-0.383333333333333,90,84,6,1,5
21700407,203914,DEN,BOS,Gary Harris,180,37.5333333333333,38,-0.466666666666669,106,94,12,10,2
21700407,1626144,DEN,BOS,Emmanuel Mudiay,84,17.0833333333333,17,0.0833333333333322,31,51,-20,-20,0
21700407,1626168,DEN,BOS,Trey Lyles,156,33.0333333333333,33,0.0333333333333314,93,84,9,8,1
21700407,1627736,DEN,BOS,Malik Beasley,86,17.5666666666667,18,-0.433333333333334,33,47,-14,-16,2
21700407,1627750,DEN,BOS,Jamal Murray,171,35.3833333333333,35,0.383333333333333,97,89,8,6,2
21700407,1627823,DEN,BOS,Juancho Hernangomez,69,14.0666666666667,14,0.0666666666666664,21,38,-17,-16,-1
21700408,201609,MIA,POR,Goran Dragic,125,29.9666666666667,30,-0.0333333333333314,50,61,-11,-10,-1
21700408,201949,MIA,POR,James Johnson,152,36.3166666666667,37,-0.683333333333337,70,76,-6,-6,0
21700408,201961,MIA,POR,Wayne Ellington,129,31.4333333333333,32,-0.566666666666666,71,71,0,0,0
21700408,203079,MIA,POR,Dion Waiters,154,37.7666666666667,38,-0.233333333333334,74,89,-15,-15,0
21700408,203482,MIA,POR,Kelly Olynyk,112,27.6833333333333,28,-0.316666666666666,58,60,-2,-2,0
21700408,1626159,MIA,POR,Justise Winslow,37,8.66666666666667,9,-0.333333333333332,22,12,10,10,0
21700408,1626196,MIA,POR,Josh Richardson,152,36.95,37,-0.0499999999999972,75,76,-1,-2,1
21700408,1628389,MIA,POR,Bam Adebayo,124,30.2166666666667,30,0.216666666666669,55,65,-10,-10,0
21700408,202323,POR,MIA,Evan Turner,94,23.2333333333333,23,0.233333333333334,48,50,-2,-3,1
21700408,202329,POR,MIA,Al-Farouq Aminu,153,37.1833333333333,37,0.183333333333337,85,74,11,11,0
21700408,202334,POR,MIA,Ed Davis,108,26.1,26,0.100000000000001,57,46,11,9,2
21700408,203081,POR,MIA,Damian Lillard,152,36.95,37,-0.0499999999999972,76,75,1,2,-1
21700408,203090,POR,MIA,Maurice Harkless,39,8.96666666666667,9,-0.0333333333333332,15,22,-7,-7,0
21700408,203468,POR,MIA,CJ McCollum,170,41.1833333333333,41,0.183333333333337,92,77,15,15,0
21700408,203894,POR,MIA,Shabazz Napier,96,23.1666666666667,23,0.166666666666664,50,39,11,11,0
21700408,203943,POR,MIA,Noah Vonleh,25,6.65,6,0.65,15,12,3,4,-1
21700408,1626192,POR,MIA,Pat Connaughton,44,10.2333333333333,10,0.233333333333334,20,23,-3,-5,2
21700408,1627774,POR,MIA,Jake Layman,17,3.9,4,-0.1,9,8,1,2,-1
21700408,1628380,POR,MIA,Zach Collins,87,21.4333333333333,21,0.433333333333334,43,49,-6,-4,-2
21700409,201577,CHI,UTA,Robin Lopez,172,36.7333333333333,36,0.733333333333334,76,79,-3,-2,-1
21700409,202703,CHI,UTA,Nikola Mirotic,165,35.4,35,0.399999999999999,72,70,2,3,-1
21700409,203200,CHI,UTA,Justin Holiday,115,23.8166666666667,24,-0.183333333333334,50,55,-5,-5,0
21700409,1626170,CHI,UTA,Jerian Grant,67,14.65,14,0.65,31,33,-2,0,-2
21700409,1626171,CHI,UTA,Bobby Portis,104,21.9,22,-0.100000000000001,51,46,5,5,0
21700409,1627739,CHI,UTA,Kris Dunn,158,33.35,34,-0.649999999999999,71,67,4,3,1
21700409,1627756,CHI,UTA,Denzel Valentine,169,35.8666666666667,36,-0.133333333333333,73,84,-11,-9,-2
21700409,1627835,CHI,UTA,Paul Zipser,44,9.93333333333333,10,-0.0666666666666664,19,14,5,5,0
21700409,1628021,CHI,UTA,David Nwaba,131,28.35,28,0.350000000000001,67,52,15,15,0
21700409,200757,UTA,CHI,Thabo Sefolosha,77,16.2833333333333,16,0.283333333333331,36,36,0,2,-2
21700409,201937,UTA,CHI,Ricky Rubio,125,26.8666666666667,27,-0.133333333333333,55,49,6,3,3
21700409,201973,UTA,CHI,Jonas Jerebko,87,19.4833333333333,19,0.483333333333334,33,42,-9,-12,3
21700409,202324,UTA,CHI,Derrick Favors,138,29.9333333333333,30,-0.06666666666667,60,70,-10,-11,1
21700409,202692,UTA,CHI,Alec Burks,120,25.65,25,0.649999999999999,48,57,-9,-13,4
21700409,203497,UTA,CHI,Rudy Gobert,127,26.2166666666667,26,0.216666666666669,61,47,14,14,0
21700409,203918,UTA,CHI,Rodney Hood,115,25.2666666666667,25,0.266666666666666,60,65,-5,-4,-1
21700409,204060,UTA,CHI,Joe Ingles,147,30.9,31,-0.100000000000001,71,58,13,15,-2
21700409,1626220,UTA,CHI,Royce O'Neale,12,2.33333333333333,2,0.333333333333333,0,4,-4,-4,0
21700409,1628378,UTA,CHI,Donovan Mitchell,177,37.0666666666667,37,0.0666666666666629,76,82,-6,-5,-1
21700410,2749,NOP,MIL,Jameer Nelson,133,29.65,30,-0.350000000000001,72,62,10,10,0
21700410,200765,NOP,MIL,Rajon Rondo,91,18.35,18,0.350000000000001,43,46,-3,-3,0
21700410,201600,NOP,MIL,Omer Asik,9,2.33333333333333,2,0.333333333333333,7,8,-1,1,-2
21700410,201950,NOP,MIL,Jrue Holiday,181,38.5,38,0.5,94,84,10,10,0
21700410,201967,NOP,MIL,Dante Cunningham,103,21.45,21,0.450000000000003,52,54,-2,-2,0
21700410,202326,NOP,MIL,DeMarcus Cousins,169,35.8833333333333,37,-1.11666666666667,85,79,6,4,2
21700410,202734,NOP,MIL,E'Twaun Moore,166,34.85,35,-0.149999999999999,81,81,0,0,0
21700410,203076,NOP,MIL,Anthony Davis,167,36.3333333333333,36,0.333333333333329,86,75,11,11,0
21700410,203121,NOP,MIL,Darius Miller,101,22.65,23,-0.350000000000001,55,51,4,4,0
21700410,202339,MIL,NOP,Eric Bledsoe,157,32.2333333333333,32,0.233333333333334,76,73,3,3,0
21700410,202732,MIL,NOP,DeAndre Liggins,78,18.1,18,0.100000000000001,36,47,-11,-12,1
21700410,203089,MIL,NOP,John Henson,140,29.45,30,-0.550000000000001,61,66,-5,-5,0
21700410,203114,MIL,NOP,Khris Middleton,175,36.6333333333333,37,-0.366666666666667,85,84,1,1,0
21700410,203507,MIL,NOP,Giannis Antetokounmpo,191,41.1833333333333,42,-0.816666666666663,91,98,-7,-7,0
21700410,1626173,MIL,NOP,Rashad Vaughn,80,17.6666666666667,17,0.666666666666664,45,47,-2,-2,0
21700410,1627748,MIL,NOP,Thon Maker,60,12.6666666666667,12,0.666666666666666,32,31,1,1,0
21700410,1627762,MIL,NOP,Joel Bolomboy,30,7.25,7,0.25,16,21,-5,-5,0
21700410,1627763,MIL,NOP,Malcolm Brogdon,126,28.1333333333333,28,0.133333333333333,58,73,-15,-15,0
21700410,1627780,MIL,NOP,Gary Payton II,83,16.6833333333333,17,-0.316666666666666,40,35,5,6,-1
21700411,202328,PHX,TOR,Greg Monroe,141,30.2666666666667,30,0.266666666666666,58,69,-11,-15,4
21700411,203458,PHX,TOR,Alex Len,86,17.6666666666667,18,-0.333333333333336,50,46,4,9,-5
21700411,203584,PHX,TOR,Troy Daniels,154,31.9166666666667,32,-0.0833333333333357,78,72,6,6,0
21700411,203933,PHX,TOR,T.J. Warren,119,24.55,24,0.550000000000001,60,71,-11,-12,1
21700411,1627733,PHX,TOR,Dragan Bender,126,27.8666666666667,28,-0.133333333333333,62,52,10,5,5
21700411,1627737,PHX,TOR,Marquese Chriss,85,17.4,18,-0.600000000000001,37,52,-15,-9,-6
21700411,1627755,PHX,TOR,Tyler Ulis,144,29.5666666666667,29,0.566666666666666,64,80,-16,-17,1
21700411,1627863,PHX,TOR,Danuel House Jr.,89,19.7166666666667,20,-0.283333333333331,45,36,9,8,1
21700411,1628367,PHX,TOR,Josh Jackson,106,22.2666666666667,22,0.266666666666666,42,60,-18,-16,-2
21700411,1628455,PHX,TOR,Mike James,85,18.45,19,-0.550000000000001,44,37,7,11,-4
21700411,101139,TOR,PHX,CJ Miles,83,17.0333333333333,17,0.0333333333333314,39,44,-5,-1,-4
21700411,200768,TOR,PHX,Kyle Lowry,163,34.45,34,0.450000000000003,87,75,12,12,0
21700411,201586,TOR,PHX,Serge Ibaka,164,34.2333333333333,34,0.233333333333334,91,73,18,18,0
21700411,201942,TOR,PHX,DeMar DeRozan,177,36.8333333333333,37,-0.166666666666671,100,82,18,18,0
21700411,202685,TOR,PHX,Jonas Valanciunas,147,30.7666666666667,30,0.766666666666666,79,66,13,16,-3
21700411,203485,TOR,PHX,Lorenzo Brown,12,2.65,2,0.65,6,4,2,0,2
21700411,1626181,TOR,PHX,Norman Powell,45,9.75,10,-0.25,13,24,-11,-14,3
21700411,1627751,TOR,PHX,Jakob Poeltl,80,17.1666666666667,18,-0.833333333333332,36,42,-6,-10,4
21700411,1627783,TOR,PHX,Pascal Siakam,63,13.7,14,-0.300000000000001,24,35,-11,-12,1
21700411,1627832,TOR,PHX,Fred VanVleet,115,24.0166666666667,24,0.0166666666666657,48,55,-7,-9,2
21700411,1628384,TOR,PHX,OG Anunoby,86,19.0666666666667,19,0.0666666666666629,52,40,12,12,0
21700412,2403,HOU,CHA,Nene,83,18.05,18,0.0500000000000007,60,30,30,32,-2
21700412,2772,HOU,CHA,Trevor Ariza,160,34.65,34,0.650000000000006,69,70,-1,0,-1
21700412,101108,HOU,CHA,Chris Paul,167,35.2333333333333,35,0.233333333333334,86,67,19,19,0
21700412,200782,HOU,CHA,PJ Tucker,97,20.2166666666667,20,0.216666666666665,53,40,13,12,1
21700412,201569,HOU,CHA,Eric Gordon,128,26.7333333333333,27,-0.266666666666666,69,50,19,21,-2
21700412,201583,HOU,CHA,Ryan Anderson,151,32.9166666666667,33,-0.0833333333333286,66,68,-2,-1,-1
21700412,201601,HOU,CHA,Luc Mbah a Moute,45,8.88333333333333,9,-0.116666666666667,30,14,16,13,3
21700412,201628,HOU,CHA,Bobby Brown,9,2.36666666666667,2,0.366666666666667,0,7,-7,-7,0
21700412,201935,HOU,CHA,James Harden,150,31.3833333333333,31,0.383333333333333,63,67,-4,-6,2
21700412,203991,HOU,CHA,Clint Capela,117,24.75,25,-0.25,44,53,-9,-9,0
21700412,204028,HOU,CHA,Tarik Black,9,2.36666666666667,2,0.366666666666667,0,7,-7,-7,0
21700412,1627753,HOU,CHA,Zhou Qi,9,2.36666666666667,2,0.366666666666667,0,7,-7,-7,0
21700412,2730,CHA,HOU,Dwight Howard,166,34.1166666666667,34,0.116666666666667,75,66,9,10,-1
21700412,101107,CHA,HOU,Marvin Williams,142,29.55,29,0.550000000000001,65,50,15,17,-2
21700412,201587,CHA,HOU,Nicolas Batum,164,34.55,34,0.549999999999997,77,64,13,13,0
21700412,202689,CHA,HOU,Kemba Walker,174,36.7333333333333,37,-0.266666666666666,75,77,-2,-3,1
21700412,203077,CHA,HOU,Michael Kidd-Gilchrist,132,28.2333333333333,29,-0.766666666666666,59,58,1,0,1
21700412,203087,CHA,HOU,Jeremy Lamb,99,21.4666666666667,21,0.466666666666669,34,66,-32,-32,0
21700412,203487,CHA,HOU,Michael Carter-Williams,64,13.3666666666667,13,0.366666666666667,27,33,-6,-5,-1
21700412,203948,CHA,HOU,Johnny O'Bryant III,19,4.48333333333333,5,-0.516666666666667,7,10,-3,-4,1
21700412,1626163,CHA,HOU,Frank Kaminsky,70,15.5,15,0.5,22,58,-36,-38,2
21700412,1626203,CHA,HOU,Treveon Graham,63,14.4333333333333,15,-0.566666666666666,23,42,-19,-20,1
21700412,1628370,CHA,HOU,Malik Monk,23,5.11666666666667,5,0.116666666666667,9,16,-7,-5,-2
21700412,1628407,CHA,HOU,Dwayne Bacon,9,2.36666666666667,2,0.366666666666667,7,0,7,7,0
21700413,101141,ATL,DET,Ersan Ilyasova,123,26.7833333333333,27,-0.216666666666669,56,61,-5,-6,1
21700413,201158,ATL,DET,Marco Belinelli,48,10.4666666666667,10,0.466666666666667,14,32,-18,-16,-2
21700413,202337,ATL,DET,Luke Babbitt,74,17.0166666666667,17,0.0166666666666657,25,39,-14,-17,3
21700413,203101,ATL,DET,Miles Plumlee,103,22.8,23,-0.200000000000003,41,60,-19,-20,1
21700413,203145,ATL,DET,Kent Bazemore,101,22.95,23,-0.0499999999999972,46,50,-4,-7,3
21700413,203471,ATL,DET,Dennis Schroder,128,27.8333333333333,28,-0.166666666666668,56,63,-7,-8,1
21700413,1627098,ATL,DET,Malcolm Delaney,71,15.7,16,-0.300000000000001,36,29,7,9,-2
21700413,1627752,ATL,DET,Taurean Prince,107,23.4666666666667,23,0.466666666666669,47,55,-8,-9,1
21700413,1627761,ATL,DET,DeAndre' Bembry,86,19.9666666666667,20,-0.0333333333333314,38,40,-2,-2,0
21700413,1627819,ATL,DET,Isaiah Taylor,59,13.4166666666667,13,0.416666666666668,12,29,-17,-19,2
21700413,1628381,ATL,DET,John Collins,91,20.3166666666667,20,0.316666666666666,37,35,2,3,-1
21700413,1628416,ATL,DET,Tyler Dorsey,43,9.88333333333333,10,-0.116666666666667,24,17,7,7,0
21700413,1628463,ATL,DET,Tyler Cavanaugh,31,7.4,8,-0.6,23,15,8,10,-2
21700413,201229,DET,ATL,Anthony Tolliver,67,15.3333333333333,15,0.333333333333334,23,26,-3,-1,-2
21700413,202340,DET,ATL,Avery Bradley,123,26.5166666666667,27,-0.483333333333334,65,57,8,10,-2
21700413,202397,DET,ATL,Ish Smith,46,10.0166666666667,10,0.0166666666666675,17,19,-2,-2,0
21700413,202699,DET,ATL,Tobias Harris,140,30.5333333333333,31,-0.466666666666669,80,60,20,19,1
21700413,202704,DET,ATL,Reggie Jackson,126,28.2333333333333,28,0.233333333333334,66,61,5,7,-2
21700413,203083,DET,ATL,Andre Drummond,143,31.8166666666667,32,-0.183333333333334,76,71,5,5,0
21700413,203493,DET,ATL,Reggie Bullock,109,23.5,24,-0.5,56,49,7,7,0
21700413,203961,DET,ATL,Eric Moreland,69,15.45,15,0.449999999999999,29,18,11,10,1
21700413,204038,DET,ATL,Langston Galloway,98,21.6333333333333,22,-0.366666666666667,46,29,17,16,1
21700413,1626169,DET,ATL,Stanley Johnson,59,14.4333333333333,15,-0.566666666666666,29,32,-3,0,-3
21700413,1627740,DET,ATL,Henry Ellenson,6,1.73333333333333,2,-0.266666666666667,2,5,-3,-3,0
21700413,1628379,DET,ATL,Luke Kennard,79,18.8,19,-0.199999999999999,36,28,8,7,1
21700414,201960,BKN,NYK,DeMarre Carroll,154,32.15,32,0.149999999999999,83,76,7,6,1
21700414,202389,BKN,NYK,Timofey Mozgov,37,8.31666666666667,8,0.316666666666666,10,14,-4,-4,0
21700414,203092,BKN,NYK,Tyler Zeller,103,23.55,24,-0.449999999999999,62,54,8,10,-2
21700414,203112,BKN,NYK,Quincy Acy,39,7.9,8,-0.100000000000001,10,23,-13,-13,0
21700414,203459,BKN,NYK,Allen Crabbe,174,34.9166666666667,35,-0.0833333333333286,78,84,-6,-4,-2
21700414,203915,BKN,NYK,Spencer Dinwiddie,159,34.8,35,-0.200000000000003,85,72,13,12,1
21700414,203925,BKN,NYK,Joe Harris,107,21.9,22,-0.100000000000001,38,56,-18,-18,0
21700414,1626178,BKN,NYK,Rondae Hollis-Jefferson,168,36.8833333333333,37,-0.116666666666667,89,78,11,11,0
21700414,1627747,BKN,NYK,Caris LeVert,144,28.9166666666667,28,0.916666666666664,49,69,-20,-20,0
21700414,1628386,BKN,NYK,Jarrett Allen,55,10.3333333333333,10,0.333333333333332,16,29,-13,-15,2
21700414,101127,NYK,BKN,Jarrett Jack,98,22.4833333333333,22,0.483333333333334,49,58,-9,-9,0
21700414,201563,NYK,BKN,Michael Beasley,99,19.85,20,-0.149999999999999,43,40,3,2,1
21700414,201584,NYK,BKN,Courtney Lee,173,36.0833333333333,36,0.0833333333333357,88,82,6,6,0
21700414,202498,NYK,BKN,Lance Thomas,114,24.5666666666667,25,-0.433333333333334,62,61,1,1,0
21700414,202683,NYK,BKN,Enes Kanter,116,26.8666666666667,27,-0.133333333333333,62,65,-3,-3,0
21700414,203124,NYK,BKN,Kyle O'Quinn,109,20.7333333333333,20,0.733333333333334,47,38,9,9,0
21700414,203926,NYK,BKN,Doug McDermott,130,25.7166666666667,25,0.716666666666669,58,52,6,6,0
21700414,204001,NYK,BKN,Kristaps Porzingis,77,17.6333333333333,18,-0.366666666666667,44,41,3,4,-1
21700414,1627758,NYK,BKN,Ron Baker,87,18.6333333333333,18,0.633333333333333,38,33,5,5,0
21700414,1628373,NYK,BKN,Frank Ntilikina,137,27.1,27,0.0999999999999979,64,50,14,14,0
21700415,2544,CLE,LAL,LeBron James,189,38.25,39,-0.75,101,87,14,14,0
21700415,2548,CLE,LAL,Dwyane Wade,109,22.35,23,-0.649999999999999,52,52,0,0,0
21700415,2594,CLE,LAL,Kyle Korver,105,21.4166666666667,22,-0.583333333333336,51,49,2,2,0
21700415,2747,CLE,LAL,JR Smith,156,31.4666666666667,32,-0.533333333333335,84,71,13,13,0
21700415,101112,CLE,LAL,Channing Frye,39,7.6,7,0.6,17,18,-1,1,-2
21700415,101181,CLE,LAL,Jose Calderon,118,23.2166666666667,23,0.216666666666665,63,56,7,7,0
21700415,201145,CLE,LAL,Jeff Green,126,24.6333333333333,25,-0.366666666666667,59,65,-6,-4,-2
21700415,201567,CLE,LAL,Kevin Love,167,34,35,-1,88,78,10,8,2
21700415,203109,CLE,LAL,Jae Crowder,119,24.55,25,-0.449999999999999,66,59,7,5,2
21700415,1626224,CLE,LAL,Cedi Osman,52,10.1,10,0.0999999999999996,24,25,-1,-1,0
21700415,201147,LAL,CLE,Corey Brewer,42,8.26666666666667,8,0.266666666666666,23,18,5,5,0
21700415,201572,LAL,CLE,Brook Lopez,106,21.3666666666667,22,-0.633333333333333,53,59,-6,-4,-2
21700415,203903,LAL,CLE,Jordan Clarkson,130,25.2666666666667,25,0.266666666666666,65,71,-6,-4,-2
21700415,203944,LAL,CLE,Julius Randle,105,21.55,22,-0.450000000000003,48,50,-2,-1,-1
21700415,1626204,LAL,CLE,Larry Nance Jr.,106,21.1,21,0.100000000000001,48,52,-4,-5,1
21700415,1627742,LAL,CLE,Brandon Ingram,194,39.25,40,-0.75,89,103,-14,-14,0
21700415,1628366,LAL,CLE,Lonzo Ball,185,37.6666666666667,38,-0.333333333333336,85,96,-11,-11,0
21700415,1628398,LAL,CLE,Kyle Kuzma,155,31.0166666666667,31,0.0166666666666657,75,81,-6,-8,2
21700415,1628404,LAL,CLE,Josh Hart,157,32.1,33,-0.899999999999999,74,75,-1,-3,2
21700416,2037,MIN,SAC,Jamal Crawford,71,16.4333333333333,17,-0.566666666666666,28,31,-3,1,-4
21700416,201166,MIN,SAC,Aaron Brooks,12,2.3,3,-0.7,9,5,4,4,0
21700416,201952,MIN,SAC,Jeff Teague,135,30.3666666666667,30,0.366666666666667,77,65,12,12,0
21700416,201959,MIN,SAC,Taj Gibson,103,23.9833333333333,24,-0.0166666666666657,54,54,0,0,0
21700416,202332,MIN,SAC,Cole Aldrich,12,2.3,3,-0.7,9,5,4,4,0
21700416,202710,MIN,SAC,Jimmy Butler,155,35.5166666666667,36,-0.483333333333334,88,75,13,13,0
21700416,203476,MIN,SAC,Gorgui Dieng,110,23.7833333333333,24,-0.216666666666669,58,32,26,22,4
21700416,203952,MIN,SAC,Andrew Wiggins,156,34.3,34,0.299999999999997,93,70,23,19,4
21700416,1626145,MIN,SAC,Tyus Jones,77,17.25,18,-0.75,42,31,11,11,0
21700416,1626157,MIN,SAC,Karl-Anthony Towns,157,35.3166666666667,35,0.316666666666663,98,79,19,22,-3
21700416,1627875,MIN,SAC,Marcus Georges-Hunt,72,16.5333333333333,17,-0.466666666666665,39,33,6,7,-1
21700416,1713,SAC,MIN,Vince Carter,64,15.1666666666667,15,0.166666666666666,40,29,11,13,-2
21700416,2216,SAC,MIN,Zach Randolph,113,24.4666666666667,24,0.466666666666669,47,70,-23,-23,0
21700416,201585,SAC,MIN,Kosta Koufos,80,18.2833333333333,19,-0.716666666666669,31,40,-9,-10,1
21700416,201588,SAC,MIN,George Hill,135,30.0333333333333,30,0.0333333333333314,62,82,-20,-22,2
21700416,202066,SAC,MIN,Garrett Temple,79,17.1333333333333,18,-0.866666666666667,28,50,-22,-22,0
21700416,203992,SAC,MIN,Bogdan Bogdanovic,144,32.75,33,-0.25,70,78,-8,-8,0
21700416,1626161,SAC,MIN,Willie Cauley-Stein,89,19.7,20,-0.300000000000001,33,50,-17,-16,-1
21700416,1627741,SAC,MIN,Buddy Hield,91,21.45,22,-0.549999999999997,51,45,6,6,0
21700416,1627746,SAC,MIN,Skal Labissiere,53,12.25,13,-0.75,29,33,-4,-6,2
21700416,1627781,SAC,MIN,Malachi Richardson,25,5.36666666666667,6,-0.633333333333333,12,16,-4,-4,0
21700416,1628368,SAC,MIN,De'Aaron Fox,31,7.46666666666667,7,0.466666666666667,17,21,-4,-4,0
21700416,1628382,SAC,MIN,Justin Jackson,61,12.4833333333333,13,-0.516666666666666,21,36,-15,-15,0
21700416,1628412,SAC,MIN,Frank Mason,95,21.5333333333333,22,-0.466666666666669,39,45,-6,-4,-2
21700417,1717,DAL,GSW,Dirk Nowitzki,115,26.45,27,-0.550000000000001,65,65,0,2,-2
21700417,2734,DAL,GSW,Devin Harris,101,23.7333333333333,24,-0.266666666666666,49,58,-9,-10,1
21700417,200826,DAL,GSW,J.J. Barea,108,25.65,26,-0.350000000000001,52,64,-12,-12,0
21700417,202083,DAL,GSW,Wesley Matthews,125,29.5833333333333,30,-0.416666666666664,56,70,-14,-13,-1
21700417,203084,DAL,GSW,Harrison Barnes,138,32.7333333333333,33,-0.266666666666666,62,79,-17,-19,2
21700417,203481,DAL,GSW,Jeff Withey,16,4.01666666666667,4,0.0166666666666666,9,6,3,5,-2
21700417,203939,DAL,GSW,Dwight Powell,92,22.2833333333333,22,0.283333333333331,49,52,-3,-3,0
21700417,1627812,DAL,GSW,Yogi Ferrell,103,24.3166666666667,24,0.316666666666666,43,50,-7,-6,-1
21700417,1628405,DAL,GSW,Johnathan Motley,9,2.06666666666667,2,0.0666666666666664,6,2,4,4,0
21700417,1628467,DAL,GSW,Maxi Kleber,121,28.35,29,-0.649999999999999,53,68,-15,-17,2
21700417,1628499,DAL,GSW,Antonius Cleveland,87,20.65,21,-0.350000000000001,41,46,-5,-6,1
21700417,2561,GSW,DAL,David West,59,14.1666666666667,15,-0.833333333333334,37,27,10,12,-2
21700417,2733,GSW,DAL,Shaun Livingston,93,20.8333333333333,21,-0.166666666666668,48,39,9,9,0
21700417,2738,GSW,DAL,Andre Iguodala,121,29.5,30,-0.5,73,57,16,16,0
21700417,201142,GSW,DAL,Kevin Durant,145,34.5666666666667,34,0.566666666666663,81,69,12,14,-2
21700417,201580,GSW,DAL,JaVale McGee,16,4.01666666666667,4,0.0166666666666666,6,9,-3,-5,2
21700417,201956,GSW,DAL,Omri Casspi,131,29.8,30,-0.199999999999999,68,62,6,4,2
21700417,202691,GSW,DAL,Klay Thompson,154,36.35,37,-0.649999999999999,90,70,20,20,0
21700417,1626172,GSW,DAL,Kevon Looney,31,7.66666666666667,8,-0.333333333333334,16,20,-4,-6,2
21700417,1626188,GSW,DAL,Quinn Cook,37,9.03333333333333,9,0.0333333333333332,18,24,-6,-4,-2
21700417,1627775,GSW,DAL,Patrick McCaw,122,29.7166666666667,30,-0.283333333333331,68,61,7,7,0
21700417,1628395,GSW,DAL,Jordan Bell,106,24.1833333333333,24,0.183333333333334,55,47,8,8,0
21700418,201609,MIA,CHA,Goran Dragic,124,26.55,26,0.550000000000001,43,53,-10,-6,-4
21700418,201949,MIA,CHA,James Johnson,153,33.3833333333333,34,-0.616666666666667,70,73,-3,-2,-1
21700418,201961,MIA,CHA,Wayne Ellington,110,24.6333333333333,25,-0.366666666666667,65,53,12,13,-1
21700418,203079,MIA,CHA,Dion Waiters,155,33.6166666666667,34,-0.38333333333334,63,67,-4,-4,0
21700418,203482,MIA,CHA,Kelly Olynyk,110,24.8166666666667,25,-0.18333333333333,54,47,7,6,1
21700418,204020,MIA,CHA,Tyler Johnson,114,26.2333333333333,26,0.233333333333334,70,55,15,12,3
21700418,1626175,MIA,CHA,Jordan Mickey,73,15.4666666666667,15,0.466666666666665,37,31,6,6,0
21700418,1626196,MIA,CHA,Josh Richardson,151,32.8666666666667,33,-0.133333333333333,71,66,5,5,0
21700418,1628389,MIA,CHA,Bam Adebayo,100,22.2666666666667,22,0.266666666666666,47,45,2,0,2
21700418,2730,CHA,MIA,Dwight Howard,154,32.8666666666667,33,-0.133333333333333,74,60,14,9,5
21700418,101107,CHA,MIA,Marvin Williams,129,27.05,27,0.0500000000000007,54,52,2,2,0
21700418,201587,CHA,MIA,Nicolas Batum,165,37.0166666666667,37,0.0166666666666657,79,75,4,2,2
21700418,202689,CHA,MIA,Kemba Walker,152,33.35,33,0.349999999999994,73,67,6,2,4
21700418,203077,CHA,MIA,Michael Kidd-Gilchrist,129,27.8166666666667,28,-0.183333333333334,58,50,8,6,2
21700418,203087,CHA,MIA,Jeremy Lamb,97,21.5333333333333,21,0.533333333333331,44,55,-11,-9,-2
21700418,203487,CHA,MIA,Michael Carter-Williams,66,14.6166666666667,15,-0.383333333333333,25,37,-12,-8,-4
21700418,203948,CHA,MIA,Johnny O'Bryant III,39,8.73333333333333,9,-0.266666666666666,16,27,-11,-8,-3
21700418,1626163,CHA,MIA,Frank Kaminsky,89,20.9166666666667,21,-0.0833333333333322,44,52,-8,-8,0
21700418,1626203,CHA,MIA,Treveon Graham,25,6.36666666666667,6,0.366666666666666,8,17,-9,-7,-2
21700418,1628370,CHA,MIA,Malik Monk,45,9.56666666666667,10,-0.433333333333334,15,28,-13,-11,-2
21700419,201152,IND,DET,Thaddeus Young,174,37.3833333333333,38,-0.616666666666667,81,72,9,9,0
21700419,201954,IND,DET,Darren Collison,140,30.85,31,-0.150000000000002,61,69,-8,-8,0
21700419,202362,IND,DET,Lance Stephenson,132,28.4166666666667,28,0.416666666666664,67,55,12,12,0
21700419,202709,IND,DET,Cory Joseph,123,24.7333333333333,25,-0.266666666666666,48,53,-5,-5,0
21700419,202711,IND,DET,Bojan Bogdanovic,120,25.6166666666667,26,-0.383333333333333,42,66,-24,-24,0
21700419,203506,IND,DET,Victor Oladipo,178,37.3666666666667,38,-0.633333333333333,81,81,0,0,0
21700419,1626167,IND,DET,Myles Turner,162,34.0166666666667,34,0.0166666666666657,75,75,0,-2,2
21700419,1627734,IND,DET,Domantas Sabonis,79,17,17,0,27,39,-12,-10,-2
21700419,1628388,IND,DET,TJ Leaf,22,3.86666666666667,4,-0.133333333333333,8,10,-2,-2,0
21700419,201229,DET,IND,Anthony Tolliver,90,19.5,20,-0.5,45,38,7,3,4
21700419,202397,DET,IND,Ish Smith,122,23.9666666666667,24,-0.033333333333335,63,56,7,11,-4
21700419,202699,DET,IND,Tobias Harris,136,28.35,28,0.350000000000001,59,60,-1,3,-4
21700419,202704,DET,IND,Reggie Jackson,104,23.8833333333333,24,-0.116666666666667,41,42,-1,-5,4
21700419,203083,DET,IND,Andre Drummond,148,31.2833333333333,32,-0.716666666666665,62,66,-4,-5,1
21700419,203493,DET,IND,Reggie Bullock,154,32.6833333333333,33,-0.316666666666663,67,73,-6,-6,0
21700419,203961,DET,IND,Eric Moreland,78,16.5666666666667,16,0.566666666666666,42,32,10,11,-1
21700419,204038,DET,IND,Langston Galloway,85,18.0166666666667,18,0.0166666666666657,39,30,9,11,-2
21700419,1626169,DET,IND,Stanley Johnson,129,26.9166666666667,27,-0.0833333333333357,57,66,-9,-11,2
21700419,1628379,DET,IND,Luke Kennard,84,18.0833333333333,18,0.0833333333333322,45,27,18,18,0
21700420,201571,ORL,POR,D.J. Augustin,124,28.0166666666667,28,0.0166666666666657,49,47,2,-3,5
21700420,201578,ORL,POR,Marreese Speights,83,18.7666666666667,19,-0.233333333333334,29,28,1,-2,3
21700420,202687,ORL,POR,Bismack Biyombo,58,13.5333333333333,13,0.533333333333333,19,22,-3,-5,2
21700420,202696,ORL,POR,Nikola Vucevic,160,34.4666666666667,35,-0.533333333333331,69,73,-4,-5,1
21700420,202714,ORL,POR,Shelvin Mack,98,20.6,20,0.600000000000001,36,38,-2,-4,2
21700420,203613,ORL,POR,Jonathon Simmons,149,32.9,33,-0.100000000000001,65,65,0,-3,3
21700420,203901,ORL,POR,Elfrid Payton,127,27.65,28,-0.350000000000001,60,62,-2,-3,1
21700420,203932,ORL,POR,Aaron Gordon,113,24.5666666666667,25,-0.433333333333334,44,57,-13,-11,-2
21700420,1626209,ORL,POR,Mario Hezonja,97,20.9333333333333,21,-0.0666666666666664,38,52,-14,-14,0
21700420,1628411,ORL,POR,Wes Iwundu,81,18.5666666666667,19,-0.433333333333334,31,31,0,0,0
21700420,202323,POR,ORL,Evan Turner,125,26.75,27,-0.25,58,57,1,1,0
21700420,202329,POR,ORL,Al-Farouq Aminu,136,29.7833333333333,30,-0.216666666666669,60,62,-2,-2,0
21700420,202334,POR,ORL,Ed Davis,79,17.75,18,-0.25,32,31,1,1,0
21700420,203081,POR,ORL,Damian Lillard,164,35.9666666666667,36,-0.0333333333333314,71,76,-5,-9,4
21700420,203468,POR,ORL,CJ McCollum,173,36.9666666666667,37,-0.0333333333333314,77,60,17,21,-4
21700420,203894,POR,ORL,Shabazz Napier,88,20.0833333333333,20,0.0833333333333357,40,28,12,12,0
21700420,203943,POR,ORL,Noah Vonleh,40,8.9,9,-0.100000000000001,21,13,8,8,0
21700420,203994,POR,ORL,Jusuf Nurkic,115,24.5,25,-0.5,51,50,1,1,0
21700420,1626192,POR,ORL,Pat Connaughton,87,20.1833333333333,20,0.183333333333334,31,37,-6,-6,0
21700420,1628380,POR,ORL,Zach Collins,83,19.1166666666667,19,0.116666666666667,34,26,8,8,0
21700421,101161,PHI,OKC,Amir Johnson,32,6.8,7,-0.199999999999999,10,23,-13,-11,-2
21700421,200755,PHI,OKC,JJ Redick,214,50.75,51,-0.25,90,93,-3,-3,0
21700421,201573,PHI,OKC,Jerryd Bayless,93,20.2666666666667,21,-0.733333333333334,40,45,-5,-1,-4
21700421,202344,PHI,OKC,Trevor Booker,63,13.15,13,0.149999999999999,29,30,-1,1,-2
21700421,203496,PHI,OKC,Robert Covington,212,49.15,49,0.149999999999999,92,83,9,3,6
21700421,203954,PHI,OKC,Joel Embiid,203,48.5833333333333,49,-0.416666666666671,90,82,8,6,2
21700421,203967,PHI,OKC,Dario Saric,206,48.9166666666667,49,-0.0833333333333286,90,92,-2,-2,0
21700421,204456,PHI,OKC,T.J. McConnell,75,15.45,16,-0.550000000000001,30,34,-4,-2,-2
21700421,1626158,PHI,OKC,Richaun Holmes,51,10.4,10,0.399999999999999,19,17,2,2,0
21700421,1627732,PHI,OKC,Ben Simmons,216,51.45,52,-0.549999999999997,95,96,-1,-3,2
21700421,2546,OKC,PHI,Carmelo Anthony,200,47.0833333333333,47,0.0833333333333286,87,85,2,2,0
21700421,101109,OKC,PHI,Raymond Felton,83,19.15,19,0.149999999999999,40,36,4,6,-2
21700421,201566,OKC,PHI,Russell Westbrook,223,51.9666666666667,52,-0.0333333333333314,94,96,-2,-4,2
21700421,202331,OKC,PHI,Paul George,187,44.8833333333333,45,-0.116666666666667,84,84,0,0,0
21700421,202335,OKC,PHI,Patrick Patterson,67,14.8666666666667,15,-0.133333333333333,33,24,9,9,0
21700421,203460,OKC,PHI,Andre Roberson,142,33.8166666666667,34,-0.183333333333337,57,58,-1,-1,0
21700421,203500,OKC,PHI,Steven Adams,218,51.0666666666667,51,0.0666666666666629,90,93,-3,-3,0
21700421,203518,OKC,PHI,Alex Abrines,78,17.1,17,0.100000000000001,32,38,-6,-6,0
21700421,203924,OKC,PHI,Jerami Grant,61,12.95,13,-0.0500000000000007,28,32,-4,-4,0
21700421,203962,OKC,PHI,Josh Huestis,95,19.65,20,-0.350000000000001,38,37,1,1,0
21700421,1628390,OKC,PHI,Terrance Ferguson,11,2.38333333333333,3,-0.616666666666667,12,2,10,10,0
21700422,101150,LAC,WAS,Lou Williams,169,32.8166666666667,33,-0.183333333333337,61,81,-20,-21,1
21700422,201599,LAC,WAS,DeAndre Jordan,174,33.7333333333333,34,-0.266666666666666,60,83,-23,-24,1
21700422,202325,LAC,WAS,Wesley Johnson,107,19.9,20,-0.100000000000001,34,39,-5,-3,-2
21700422,203186,LAC,WAS,Willie Reed,9,2.23333333333333,2,0.233333333333333,0,5,-5,-5,0
21700422,203710,LAC,WAS,C.J. Williams,126,26,26,0,53,55,-2,-2,0
21700422,203966,LAC,WAS,Jamil Wilson,122,22.6166666666667,23,-0.383333333333333,44,51,-7,-8,1
21700422,1626149,LAC,WAS,Montrezl Harrell,75,15.5,16,-0.5,32,21,11,11,0
21700422,1626155,LAC,WAS,Sam Dekker,100,20.5,21,-0.5,45,39,6,7,-1
21700422,1627744,LAC,WAS,Brice Johnson,29,5.58333333333333,6,-0.416666666666667,17,5,12,13,-1
21700422,1628393,LAC,WAS,Jawun Evans,205,40.1,40,0.0999999999999943,77,86,-9,-9,0
21700422,1628414,LAC,WAS,Sindarius Thornwell,94,19.2666666666667,19,0.266666666666666,32,35,-3,-4,1
21700422,101133,WAS,LAC,Ian Mahinmi,81,17.05,17,0.0499999999999972,31,31,0,2,-2
21700422,101162,WAS,LAC,Marcin Gortat,145,27.1833333333333,27,0.183333333333334,62,49,13,12,1
21700422,201160,WAS,LAC,Jason Smith,26,4.53333333333333,5,-0.466666666666667,5,15,-10,-9,-1
21700422,201975,WAS,LAC,Jodie Meeks,88,18.55,19,-0.450000000000003,29,42,-13,-12,-1
21700422,202322,WAS,LAC,John Wall,157,29.1166666666667,30,-0.883333333333333,63,57,6,4,2
21700422,202693,WAS,LAC,Markieff Morris,106,20.8166666666667,21,-0.183333333333334,44,39,5,3,2
21700422,203078,WAS,LAC,Bradley Beal,192,36.6833333333333,37,-0.316666666666663,84,71,13,14,-1
21700422,203107,WAS,LAC,Tomas Satoransky,90,19.5,20,-0.5,38,38,0,1,-1
21700422,203118,WAS,LAC,Mike Scott,116,23.7833333333333,24,-0.216666666666669,56,40,16,18,-2
21700422,203490,WAS,LAC,Otto Porter Jr.,14,2.93333333333333,3,-0.0666666666666664,6,5,1,1,0
21700422,204025,WAS,LAC,Tim Frazier,15,3.33333333333333,3,0.333333333333333,2,8,-6,-6,0
21700422,1626162,WAS,LAC,Kelly Oubre Jr.,175,33.8,34,-0.200000000000003,79,56,23,21,2
21700422,1626191,WAS,LAC,Chris McCullough,5,0.966666666666667,1,-0.0333333333333333,1,4,-3,-4,1
21700423,201143,BOS,UTA,Al Horford,156,34.3,34,0.299999999999997,76,80,-4,-2,-2
21700423,202681,BOS,UTA,Kyrie Irving,167,36.8,37,-0.200000000000003,81,89,-8,-10,2
21700423,203382,BOS,UTA,Aron Baynes,75,15.8666666666667,16,-0.133333333333333,27,35,-8,-9,1
21700423,203499,BOS,UTA,Shane Larkin,71,16.1833333333333,16,0.183333333333334,25,31,-6,-8,2
21700423,203935,BOS,UTA,Marcus Smart,143,32.8666666666667,33,-0.133333333333333,64,74,-10,-7,-3
21700423,1626179,BOS,UTA,Terry Rozier,83,19.0166666666667,19,0.0166666666666657,28,45,-17,-16,-1
21700423,1627759,BOS,UTA,Jaylen Brown,144,32.1333333333333,32,0.133333333333333,72,70,2,1,1
21700423,1627824,BOS,UTA,Guerschon Yabusele,24,5.2,5,0.199999999999999,7,13,-6,-8,2
21700423,1627846,BOS,UTA,Abdel Nader,5,0.9,1,-0.1,5,6,-1,-3,2
21700423,1628369,BOS,UTA,Jayson Tatum,116,25.6166666666667,26,-0.383333333333333,46,56,-10,-7,-3
21700423,1628400,BOS,UTA,Semi Ojeleye,84,19.6666666666667,20,-0.333333333333336,43,36,7,8,-1
21700423,1628464,BOS,UTA,Daniel Theis,2,0.45,1,-0.55,1,0,1,1,0
21700423,2207,UTA,BOS,Joe Johnson,63,14.95,15,-0.0500000000000007,26,26,0,0,0
21700423,201937,UTA,BOS,Ricky Rubio,154,33.1833333333333,34,-0.81666666666667,81,62,19,15,4
21700423,201973,UTA,BOS,Jonas Jerebko,109,24.2166666666667,24,0.216666666666665,59,51,8,8,0
21700423,202324,UTA,BOS,Derrick Favors,59,12.6166666666667,12,0.616666666666667,26,27,-1,-1,0
21700423,202327,UTA,BOS,Ekpe Udoh,127,28.2333333333333,29,-0.766666666666666,67,53,14,12,2
21700423,202692,UTA,BOS,Alec Burks,81,19.6166666666667,19,0.616666666666667,36,34,2,6,-4
21700423,203497,UTA,BOS,Rudy Gobert,8,1.81666666666667,2,-0.183333333333333,2,3,-1,-1,0
21700423,203918,UTA,BOS,Rodney Hood,132,30.4,30,0.399999999999999,58,65,-7,-3,-4
21700423,204060,UTA,BOS,Joe Ingles,169,37.3,38,-0.700000000000003,89,75,14,12,2
21700423,1628378,UTA,BOS,Donovan Mitchell,168,36.6666666666667,37,-0.333333333333336,91,79,12,12,0
21700424,202389,BKN,TOR,Timofey Mozgov,78,16.45,16,0.449999999999999,33,43,-10,-12,2
21700424,203092,BKN,TOR,Tyler Zeller,73,14.5833333333333,15,-0.416666666666666,27,37,-10,-8,-2
21700424,203112,BKN,TOR,Quincy Acy,118,25.6,26,-0.399999999999999,50,51,-1,0,-1
21700424,203915,BKN,TOR,Spencer Dinwiddie,95,22.1333333333333,22,0.133333333333333,30,58,-28,-28,0
21700424,203917,BKN,TOR,Nik Stauskas,132,27.7666666666667,28,-0.233333333333334,57,64,-7,-7,0
21700424,203925,BKN,TOR,Joe Harris,136,29.75,30,-0.25,45,82,-37,-36,-1
21700424,1626143,BKN,TOR,Jahlil Okafor,100,22.1666666666667,23,-0.833333333333336,40,60,-20,-21,1
21700424,1626178,BKN,TOR,Rondae Hollis-Jefferson,96,21.2666666666667,21,0.266666666666666,33,58,-25,-26,1
21700424,1627747,BKN,TOR,Caris LeVert,120,26.4666666666667,26,0.466666666666669,52,69,-17,-17,0
21700424,1627785,BKN,TOR,Isaiah Whitehead,152,32.3166666666667,33,-0.68333333333333,68,78,-10,-10,0
21700424,200768,TOR,BKN,Kyle Lowry,144,30.9166666666667,31,-0.0833333333333322,87,50,37,37,0
21700424,201586,TOR,BKN,Serge Ibaka,129,28.2666666666667,28,0.266666666666666,79,46,33,33,0
21700424,201942,TOR,BKN,DeMar DeRozan,136,29.35,29,0.350000000000001,82,44,38,38,0
21700424,202685,TOR,BKN,Jonas Valanciunas,99,21.95,22,-0.0500000000000007,60,27,33,33,0
21700424,203485,TOR,BKN,Lorenzo Brown,16,3.71666666666667,4,-0.283333333333333,7,6,1,0,1
21700424,1626153,TOR,BKN,Delon Wright,70,15.3333333333333,16,-0.666666666666666,33,37,-4,-4,0
21700424,1626181,TOR,BKN,Norman Powell,105,22.0333333333333,22,0.0333333333333314,53,54,-1,0,-1
21700424,1627751,TOR,BKN,Jakob Poeltl,121,25.75,26,-0.25,60,60,0,0,0
21700424,1627783,TOR,BKN,Pascal Siakam,91,19.4333333333333,20,-0.566666666666666,41,41,0,0,0
21700424,1627832,TOR,BKN,Fred VanVleet,58,12.9666666666667,13,-0.0333333333333332,19,29,-10,-10,0
21700424,1628035,TOR,BKN,Alfonzo McKinnie,32,6.83333333333333,7,-0.166666666666666,19,14,5,5,0
21700424,1628384,TOR,BKN,OG Anunoby,99,21.95,22,-0.0500000000000007,60,27,33,33,0
21700425,101141,ATL,MEM,Ersan Ilyasova,135,31.4333333333333,31,0.433333333333337,66,56,10,8,2
21700425,201158,ATL,MEM,Marco Belinelli,96,21.0666666666667,21,0.0666666666666664,38,50,-12,-9,-3
21700425,202337,ATL,MEM,Luke Babbitt,61,12.55,13,-0.449999999999999,19,35,-16,-12,-4
21700425,203101,ATL,MEM,Miles Plumlee,100,21.65,22,-0.350000000000001,39,40,-1,-1,0
21700425,203145,ATL,MEM,Kent Bazemore,147,33.1666666666667,33,0.166666666666664,68,54,14,9,5
21700425,203471,ATL,MEM,Dennis Schroder,157,37.1,37,0.0999999999999943,76,67,9,6,3
21700425,1627752,ATL,MEM,Taurean Prince,151,35.1833333333333,36,-0.816666666666663,73,61,12,10,2
21700425,1627761,ATL,MEM,DeAndre' Bembry,66,14.0833333333333,14,0.0833333333333339,30,40,-10,-6,-4
21700425,1627819,ATL,MEM,Isaiah Taylor,51,10.0166666666667,10,0.0166666666666657,16,25,-9,-8,-1
21700425,1628381,ATL,MEM,John Collins,101,23.75,24,-0.25,45,52,-7,-7,0
21700425,201188,MEM,ATL,Marc Gasol,145,33.0666666666667,33,0.0666666666666629,64,63,1,1,0
21700425,201596,MEM,ATL,Mario Chalmers,138,31.25,32,-0.75,69,67,2,-1,3
21700425,201936,MEM,ATL,Tyreke Evans,133,30.5666666666667,30,0.566666666666663,51,59,-8,-4,-4
21700425,202718,MEM,ATL,Chandler Parsons,110,25.2666666666667,25,0.266666666666666,54,51,3,0,3
21700425,203210,MEM,ATL,JaMychal Green,127,29.1833333333333,29,0.183333333333334,51,59,-8,-8,0
21700425,203463,MEM,ATL,Ben McLemore,55,11.7833333333333,12,-0.216666666666667,27,20,7,8,-1
21700425,1626150,MEM,ATL,Andrew Harrison,104,23.1833333333333,23,0.183333333333334,46,49,-3,-2,-1
21700425,1626185,MEM,ATL,Jarell Martin,87,18.9666666666667,19,-0.0333333333333314,45,35,10,10,0
21700425,1627738,MEM,ATL,Deyonta Davis,68,14.9333333333333,15,-0.0666666666666664,32,31,1,1,0
21700425,1628415,MEM,ATL,Dillon Brooks,98,21.8,22,-0.200000000000003,41,36,5,5,0
21700426,201577,CHI,MIL,Robin Lopez,145,28.85,29,-0.149999999999999,69,66,3,3,0
21700426,202703,CHI,MIL,Nikola Mirotic,137,28.7666666666667,29,-0.233333333333334,74,71,3,0,3
21700426,203200,CHI,MIL,Justin Holiday,185,38.1,38,0.100000000000001,99,86,13,13,0
21700426,1626170,CHI,MIL,Jerian Grant,105,23.1833333333333,23,0.183333333333334,45,50,-5,-2,-3
21700426,1626171,CHI,MIL,Bobby Portis,139,29.6,29,0.600000000000001,75,63,12,13,-1
21700426,1627739,CHI,MIL,Kris Dunn,123,24.8,25,-0.200000000000003,70,59,11,8,3
21700426,1627756,CHI,MIL,Denzel Valentine,82,18.45,18,0.449999999999999,32,49,-17,-13,-4
21700426,1627835,CHI,MIL,Paul Zipser,54,13.1333333333333,13,0.133333333333333,24,27,-3,-3,0
21700426,1628021,CHI,MIL,David Nwaba,170,35.0333333333333,35,0.0333333333333314,87,74,13,11,2
21700426,202339,MIL,CHI,Eric Bledsoe,160,34.15,34,0.149999999999999,79,86,-7,-6,-1
21700426,202732,MIL,CHI,DeAndre Liggins,14,2.76666666666667,3,-0.233333333333333,1,11,-10,-11,1
21700426,203089,MIL,CHI,John Henson,97,19.2166666666667,20,-0.783333333333335,48,45,3,1,2
21700426,203114,MIL,CHI,Khris Middleton,203,42.0166666666667,42,0.0166666666666657,95,103,-8,-8,0
21700426,203507,MIL,CHI,Giannis Antetokounmpo,189,39.45,40,-0.549999999999997,94,93,1,1,0
21700426,1626173,MIL,CHI,Rashad Vaughn,138,28.6666666666667,29,-0.333333333333336,70,65,5,5,0
21700426,1627748,MIL,CHI,Thon Maker,93,20.6,20,0.600000000000001,41,47,-6,-4,-2
21700426,1627763,MIL,CHI,Malcolm Brogdon,147,32.3,32,0.299999999999997,65,74,-9,-10,1
21700426,1627780,MIL,CHI,Gary Payton II,50,10.0833333333333,10,0.0833333333333322,30,27,3,4,-1
21700426,1628391,MIL,CHI,D.J. Wilson,24,4.7,4,0.699999999999999,8,12,-4,-4,0
21700426,1628425,MIL,CHI,Sterling Brown,25,5.96666666666667,6,-0.0333333333333332,14,12,2,2,0
21700427,2749,NOP,DEN,Jameer Nelson,107,23.7666666666667,24,-0.233333333333334,56,50,6,7,-1
21700427,200765,NOP,DEN,Rajon Rondo,134,28.7666666666667,29,-0.233333333333334,56,65,-9,-13,4
21700427,201950,NOP,DEN,Jrue Holiday,199,43.0166666666667,43,0.0166666666666657,92,92,0,-2,2
21700427,201967,NOP,DEN,Dante Cunningham,137,28.7166666666667,29,-0.283333333333331,62,63,-1,-4,3
21700427,202326,NOP,DEN,DeMarcus Cousins,149,33.2166666666667,33,0.216666666666669,70,75,-5,-9,4
21700427,202734,NOP,DEN,E'Twaun Moore,180,39.5166666666667,40,-0.483333333333334,73,88,-15,-20,5
21700427,203076,NOP,DEN,Anthony Davis,200,43.8333333333333,44,-0.166666666666671,92,92,0,1,-1
21700427,203121,NOP,DEN,Darius Miller,109,23.5833333333333,24,-0.416666666666664,59,50,9,10,-1
21700427,201163,DEN,NOP,Wilson Chandler,114,25.5333333333333,26,-0.466666666666669,59,54,5,7,-2
21700427,202702,DEN,NOP,Kenneth Faried,27,5.5,6,-0.5,13,11,2,2,0
21700427,203115,DEN,NOP,Will Barton,150,32.1666666666667,32,0.166666666666664,69,68,1,2,-1
21700427,203486,DEN,NOP,Mason Plumlee,140,30.65,31,-0.350000000000001,67,58,9,10,-1
21700427,203914,DEN,NOP,Gary Harris,197,42.55,43,-0.450000000000003,91,92,-1,4,-5
21700427,203999,DEN,NOP,Nikola Jokic,103,22.2333333333333,22,0.233333333333334,48,54,-6,-4,-2
21700427,1626144,DEN,NOP,Emmanuel Mudiay,41,8.43333333333333,8,0.433333333333334,16,17,-1,-1,0
21700427,1626168,DEN,NOP,Trey Lyles,143,30.0166666666667,30,0.0166666666666657,61,62,-1,2,-3
21700427,1627736,DEN,NOP,Malik Beasley,46,10.3333333333333,10,0.333333333333332,24,20,4,2,2
21700427,1627750,DEN,NOP,Jamal Murray,177,38.8666666666667,39,-0.13333333333334,86,85,1,4,-3
21700427,1628470,DEN,NOP,Torrey Craig,77,18.1333333333333,19,-0.866666666666667,41,39,2,2,0
21700428,2403,HOU,SAS,Nene,65,13.8833333333333,14,-0.116666666666667,30,32,-2,-7,5
21700428,2772,HOU,SAS,Trevor Ariza,205,41.3666666666667,42,-0.633333333333333,110,101,9,9,0
21700428,101108,HOU,SAS,Chris Paul,163,32.2666666666667,32,0.266666666666666,88,57,31,29,2
21700428,200782,HOU,SAS,PJ Tucker,129,25.6666666666667,26,-0.333333333333336,68,69,-1,0,-1
21700428,201569,HOU,SAS,Eric Gordon,146,27.7666666666667,28,-0.233333333333334,77,70,7,7,0
21700428,201583,HOU,SAS,Ryan Anderson,140,29.45,30,-0.550000000000001,72,58,14,14,0
21700428,201628,HOU,SAS,Bobby Brown,17,3.18333333333333,3,0.183333333333334,8,13,-5,-5,0
21700428,201935,HOU,SAS,James Harden,159,33.0333333333333,33,0.0333333333333314,80,70,10,12,-2
21700428,203991,HOU,SAS,Clint Capela,127,25.1833333333333,25,0.183333333333334,71,49,22,26,-4
21700428,204028,HOU,SAS,Tarik Black,17,3.18333333333333,3,0.183333333333334,8,13,-5,-5,0
21700428,1627753,HOU,SAS,Zhou Qi,17,3.18333333333333,3,0.183333333333334,8,13,-5,-5,0
21700428,1938,SAS,HOU,Manu Ginobili,33,6.61666666666667,7,-0.383333333333334,6,16,-10,-10,0
21700428,2200,SAS,HOU,Pau Gasol,82,17.1333333333333,18,-0.866666666666667,23,49,-26,-29,3
21700428,2225,SAS,HOU,Tony Parker,80,16.5,17,-0.5,27,43,-16,-16,0
21700428,200746,SAS,HOU,LaMarcus Aldridge,126,26.5833333333333,27,-0.416666666666664,55,62,-7,-6,-1
21700428,200752,SAS,HOU,Rudy Gay,91,17.9166666666667,18,-0.0833333333333357,42,40,2,6,-4
21700428,201980,SAS,HOU,Danny Green,92,18.9,19,-0.100000000000001,32,54,-22,-22,0
21700428,201988,SAS,HOU,Patty Mills,107,21.6666666666667,21,0.666666666666664,51,55,-4,-4,0
21700428,202695,SAS,HOU,Kawhi Leonard,77,16.5666666666667,17,-0.433333333333334,31,40,-9,-9,0
21700428,202722,SAS,HOU,Davis Bertans,86,16.8333333333333,17,-0.166666666666664,44,48,-4,-5,1
21700428,203464,SAS,HOU,Brandon Paul,96,18.4666666666667,19,-0.533333333333331,54,55,-1,4,-5
21700428,203530,SAS,HOU,Joffrey Lauvergne,78,14.5166666666667,15,-0.483333333333334,47,43,4,3,1
21700428,1627749,SAS,HOU,Dejounte Murray,93,16.95,17,-0.0500000000000007,56,45,11,11,0
21700428,1627854,SAS,HOU,Bryn Forbes,144,29.5166666666667,30,-0.483333333333334,77,70,7,2,5
21700429,202323,POR,CHA,Evan Turner,157,33.3833333333333,34,-0.616666666666667,60,69,-9,-9,0
21700429,202329,POR,CHA,Al-Farouq Aminu,113,22.6666666666667,23,-0.333333333333336,49,41,8,7,1
21700429,202334,POR,CHA,Ed Davis,107,22.8333333333333,22,0.833333333333332,49,40,9,9,0
21700429,203081,POR,CHA,Damian Lillard,181,38.1666666666667,38,0.166666666666671,73,71,2,2,0
21700429,203468,POR,CHA,CJ McCollum,187,38.65,39,-0.350000000000001,79,80,-1,-1,0
21700429,203894,POR,CHA,Shabazz Napier,86,18.45,18,0.449999999999999,31,30,1,1,0
21700429,203943,POR,CHA,Noah Vonleh,40,8.83333333333333,9,-0.166666666666668,17,16,1,0,1
21700429,203994,POR,CHA,Jusuf Nurkic,118,24.8333333333333,25,-0.166666666666664,44,51,-7,-7,0
21700429,1626192,POR,CHA,Pat Connaughton,81,17.0833333333333,17,0.0833333333333357,36,29,7,8,-1
21700429,1628380,POR,CHA,Zach Collins,65,15.1,15,0.100000000000001,27,28,-1,0,-1
21700429,2730,CHA,POR,Dwight Howard,158,33.9166666666667,34,-0.0833333333333357,68,62,6,6,0
21700429,101107,CHA,POR,Marvin Williams,119,25.8666666666667,26,-0.133333333333333,52,53,-1,0,-1
21700429,201587,CHA,POR,Nicolas Batum,181,38.3333333333333,38,0.333333333333329,72,76,-4,-4,0
21700429,202689,CHA,POR,Kemba Walker,178,37.35,38,-0.650000000000006,76,72,4,5,-1
21700429,203077,CHA,POR,Michael Kidd-Gilchrist,127,28.2333333333333,28,0.233333333333334,56,48,8,8,0
21700429,203087,CHA,POR,Jeremy Lamb,117,23.8166666666667,24,-0.183333333333334,42,47,-5,-5,0
21700429,203487,CHA,POR,Michael Carter-Williams,80,16.65,16,0.649999999999999,27,36,-9,-10,1
21700429,203948,CHA,POR,Johnny O'Bryant III,38,8.08333333333333,8,0.0833333333333339,11,16,-5,-5,0
21700429,1626163,CHA,POR,Frank Kaminsky,113,22.8166666666667,23,-0.183333333333334,40,46,-6,-7,1
21700429,1626203,CHA,POR,Treveon Graham,24,4.93333333333333,5,-0.0666666666666664,11,9,2,2,0
21700430,2544,CLE,UTA,LeBron James,151,36.4,37,-0.600000000000001,85,82,3,0,3
21700430,2548,CLE,UTA,Dwyane Wade,87,19.5333333333333,20,-0.466666666666669,48,34,14,14,0
21700430,2594,CLE,UTA,Kyle Korver,109,25.0666666666667,25,0.0666666666666664,63,48,15,15,0
21700430,2747,CLE,UTA,JR Smith,143,34.2166666666667,35,-0.783333333333331,75,79,-4,-4,0
21700430,101112,CLE,UTA,Channing Frye,22,5.43333333333333,5,0.433333333333334,11,9,2,2,0
21700430,101181,CLE,UTA,Jose Calderon,91,22.5666666666667,23,-0.433333333333334,46,52,-6,-6,0
21700430,201145,CLE,UTA,Jeff Green,75,17.2666666666667,17,0.266666666666666,45,26,19,18,1
21700430,201567,CLE,UTA,Kevin Love,111,27.7333333333333,28,-0.266666666666666,58,68,-10,-8,-2
21700430,202684,CLE,UTA,Tristan Thompson,34,7.31666666666667,7,0.316666666666666,15,9,6,6,0
21700430,203109,CLE,UTA,Jae Crowder,79,20.0166666666667,20,0.0166666666666657,42,47,-5,-5,0
21700430,1626224,CLE,UTA,Cedi Osman,98,22.6166666666667,23,-0.383333333333333,57,46,11,13,-2
21700430,2207,UTA,CLE,Joe Johnson,119,29.1166666666667,30,-0.883333333333333,63,65,-2,-1,-1
21700430,200757,UTA,CLE,Thabo Sefolosha,81,18.5166666666667,19,-0.483333333333334,37,44,-7,-8,1
21700430,201937,UTA,CLE,Ricky Rubio,101,24.65,25,-0.350000000000001,48,52,-4,-6,2
21700430,201973,UTA,CLE,Jonas Jerebko,72,15.8,15,0.800000000000001,28,38,-10,-10,0
21700430,202327,UTA,CLE,Ekpe Udoh,128,31.8333333333333,33,-1.16666666666666,72,71,1,1,0
21700430,202692,UTA,CLE,Alec Burks,42,10.3,10,0.300000000000001,17,28,-11,-11,0
21700430,203918,UTA,CLE,Rodney Hood,112,26.55,26,0.550000000000001,55,68,-13,-13,0
21700430,204060,UTA,CLE,Joe Ingles,139,33.4666666666667,34,-0.533333333333331,73,74,-1,-2,1
21700430,1626220,UTA,CLE,Royce O'Neale,55,11.9333333333333,12,-0.0666666666666664,25,24,1,3,-2
21700430,1628378,UTA,CLE,Donovan Mitchell,151,36,36,0,82,81,1,2,-1
21700431,101127,NYK,OKC,Jarrett Jack,150,34.45,35,-0.549999999999997,79,67,12,13,-1
21700431,201563,NYK,OKC,Michael Beasley,159,36.9833333333333,38,-1.01666666666667,88,77,11,13,-2
21700431,201584,NYK,OKC,Courtney Lee,140,31.4833333333333,32,-0.516666666666666,75,66,9,11,-2
21700431,202498,NYK,OKC,Lance Thomas,112,25.0666666666667,25,0.0666666666666664,59,49,10,8,2
21700431,202683,NYK,OKC,Enes Kanter,97,22.6666666666667,23,-0.333333333333336,48,53,-5,-2,-3
21700431,203124,NYK,OKC,Kyle O'Quinn,102,24.2333333333333,25,-0.766666666666666,59,41,18,16,2
21700431,203926,NYK,OKC,Doug McDermott,137,32.3333333333333,32,0.333333333333336,77,62,15,13,2
21700431,1627758,NYK,OKC,Ron Baker,73,17.6333333333333,18,-0.366666666666667,38,32,6,1,5
21700431,1628373,NYK,OKC,Frank Ntilikina,55,13.15,13,0.15,32,28,4,2,2
21700431,2546,OKC,NYK,Carmelo Anthony,142,31.7833333333333,32,-0.216666666666669,66,73,-7,-8,1
21700431,2555,OKC,NYK,Nick Collison,41,9.45,9,0.449999999999999,20,25,-5,-4,-1
21700431,101109,OKC,NYK,Raymond Felton,63,15.5333333333333,15,0.533333333333331,25,42,-17,-14,-3
21700431,201566,OKC,NYK,Russell Westbrook,157,35.0333333333333,36,-0.966666666666669,77,80,-3,-4,1
21700431,202331,OKC,NYK,Paul George,161,36.4333333333333,37,-0.566666666666663,68,89,-21,-20,-1
21700431,202335,OKC,NYK,Patrick Patterson,98,24.3666666666667,25,-0.633333333333333,44,51,-7,-6,-1
21700431,203460,OKC,NYK,Andre Roberson,92,20.5333333333333,21,-0.466666666666669,45,45,0,-2,2
21700431,203518,OKC,NYK,Alex Abrines,35,8.61666666666667,8,0.616666666666667,23,22,1,3,-2
21700431,203924,OKC,NYK,Jerami Grant,92,21.5833333333333,22,-0.416666666666664,38,51,-13,-11,-2
21700431,203962,OKC,NYK,Josh Huestis,55,13.95,14,-0.0500000000000007,29,34,-5,-5,0
21700431,1626177,OKC,NYK,Dakari Johnson,63,13.6666666666667,14,-0.333333333333334,31,33,-2,-3,1
21700431,1628390,OKC,NYK,Terrance Ferguson,26,7.05,7,0.0499999999999998,9,10,-1,-1,0
21700432,101150,LAC,MIA,Lou Williams,159,35.8,36,-0.200000000000003,66,71,-5,-2,-3
21700432,201599,LAC,MIA,DeAndre Jordan,144,33.2,33,0.200000000000003,58,66,-8,-7,-1
21700432,202325,LAC,MIA,Wesley Johnson,55,11.7666666666667,12,-0.233333333333334,20,28,-8,-8,0
21700432,203186,LAC,MIA,Willie Reed,13,3.81666666666667,4,-0.183333333333333,10,12,-2,-2,0
21700432,203710,LAC,MIA,C.J. Williams,122,29.2333333333333,29,0.233333333333334,49,41,8,5,3
21700432,203966,LAC,MIA,Jamil Wilson,103,23.6666666666667,24,-0.333333333333336,41,44,-3,-1,-2
21700432,1626149,LAC,MIA,Montrezl Harrell,69,16.05,16,0.0500000000000007,29,28,1,0,1
21700432,1626155,LAC,MIA,Sam Dekker,85,19.1333333333333,19,0.133333333333333,32,30,2,2,0
21700432,1628393,LAC,MIA,Jawun Evans,110,25.45,26,-0.550000000000001,45,44,1,2,-1
21700432,1628414,LAC,MIA,Sindarius Thornwell,55,13.85,14,-0.149999999999999,25,26,-1,-3,2
21700432,1628462,LAC,MIA,Milos Teodosic,120,27.7,28,-0.300000000000001,50,60,-10,-11,1
21700432,201609,MIA,LAC,Goran Dragic,124,29.7833333333333,30,-0.216666666666669,56,53,3,5,-2
21700432,201949,MIA,LAC,James Johnson,29,5.71666666666667,6,-0.283333333333333,13,6,7,7,0
21700432,201961,MIA,LAC,Wayne Ellington,108,24.05,24,0.0500000000000007,44,39,5,3,2
21700432,203079,MIA,LAC,Dion Waiters,128,30.05,30,0.0500000000000007,59,56,3,3,0
21700432,203482,MIA,LAC,Kelly Olynyk,150,34.1333333333333,34,0.133333333333333,68,63,5,7,-2
21700432,204020,MIA,LAC,Tyler Johnson,105,24.6,24,0.600000000000001,42,42,0,0,0
21700432,1626175,MIA,LAC,Jordan Mickey,115,27.5833333333333,27,0.583333333333336,45,48,-3,-3,0
21700432,1626196,MIA,LAC,Josh Richardson,160,35.7166666666667,36,-0.283333333333331,73,65,8,8,0
21700432,1628389,MIA,LAC,Bam Adebayo,116,28.0333333333333,28,0.0333333333333314,50,53,-3,-5,2
21700433,2403,HOU,MIL,Nene,101,20.2166666666667,20,0.216666666666665,44,51,-7,-8,1
21700433,2772,HOU,MIL,Trevor Ariza,195,41.65,42,-0.350000000000001,95,90,5,3,2
21700433,101108,HOU,MIL,Chris Paul,171,36.15,36,0.150000000000006,90,88,2,7,-5
21700433,200782,HOU,MIL,PJ Tucker,175,37.6333333333333,38,-0.366666666666667,90,80,10,10,0
21700433,201569,HOU,MIL,Eric Gordon,147,29.7833333333333,30,-0.216666666666669,72,69,3,0,3
21700433,201583,HOU,MIL,Ryan Anderson,106,23.0666666666667,23,0.06666666666667,56,49,7,8,-1
21700433,201935,HOU,MIL,James Harden,187,39.4333333333333,39,0.433333333333337,97,96,1,1,0
21700433,204028,HOU,MIL,Tarik Black,58,11.9833333333333,12,-0.0166666666666657,31,32,-1,-1,0
21700433,202339,MIL,HOU,Eric Bledsoe,169,36.2833333333333,36,0.283333333333331,81,91,-10,-6,-4
21700433,202732,MIL,HOU,DeAndre Liggins,71,16.6333333333333,17,-0.366666666666667,26,36,-10,-12,2
21700433,203089,MIL,HOU,John Henson,151,31.4833333333333,32,-0.516666666666666,79,76,3,2,1
21700433,203114,MIL,HOU,Khris Middleton,160,34.3,34,0.299999999999997,75,91,-16,-10,-6
21700433,203507,MIL,HOU,Giannis Antetokounmpo,199,41.6333333333333,42,-0.366666666666667,96,99,-3,-5,2
21700433,1626173,MIL,HOU,Rashad Vaughn,33,6.95,7,-0.0499999999999998,15,11,4,2,2
21700433,1627748,MIL,HOU,Thon Maker,79,16.5166666666667,17,-0.483333333333334,32,40,-8,-7,-1
21700433,1627763,MIL,HOU,Malcolm Brogdon,183,37.0666666666667,36,1.06666666666666,96,87,9,9,0
21700433,1627780,MIL,HOU,Gary Payton II,27,5.43333333333333,5,0.433333333333334,20,14,6,2,4
21700433,1628425,MIL,HOU,Sterling Brown,68,13.6166666666667,14,-0.383333333333333,35,30,5,5,0
21700434,2037,MIN,PHX,Jamal Crawford,81,17.4166666666667,18,-0.583333333333332,32,45,-13,-17,4
21700434,201952,MIN,PHX,Jeff Teague,163,34.85,35,-0.150000000000006,82,73,9,3,6
21700434,201959,MIN,PHX,Taj Gibson,187,40.2,40,0.200000000000003,88,88,0,-3,3
21700434,202710,MIN,PHX,Jimmy Butler,175,36.6333333333333,37,-0.366666666666667,84,76,8,7,1
21700434,203476,MIN,PHX,Gorgui Dieng,68,15.45,16,-0.550000000000001,30,44,-14,-17,3
21700434,203952,MIN,PHX,Andrew Wiggins,172,36.8,37,-0.200000000000003,84,83,1,0,1
21700434,1626145,MIN,PHX,Tyus Jones,64,13.15,13,0.15,24,35,-11,-8,-3
21700434,1626157,MIN,PHX,Karl-Anthony Towns,197,40.25,40,0.25,94,84,10,10,0
21700434,1627875,MIN,PHX,Marcus Georges-Hunt,28,5.25,6,-0.75,12,12,0,0,0
21700434,2199,PHX,MIN,Tyson Chandler,95,19.8,20,-0.199999999999999,30,48,-18,-18,0
21700434,201162,PHX,MIN,Jared Dudley,12,1.81666666666667,2,-0.183333333333333,7,2,5,7,-2
21700434,203458,PHX,MIN,Alex Len,132,28.2,28,0.199999999999999,78,58,20,23,-3
21700434,203477,PHX,MIN,Isaiah Canaan,122,26.85,27,-0.149999999999999,69,54,15,22,-7
21700434,203584,PHX,MIN,Troy Daniels,125,27.5333333333333,28,-0.466666666666669,69,53,16,22,-6
21700434,203933,PHX,MIN,T.J. Warren,154,32.1166666666667,32,0.116666666666667,65,73,-8,-8,0
21700434,1627733,PHX,MIN,Dragan Bender,133,29.8666666666667,30,-0.133333333333333,77,59,18,25,-7
21700434,1627737,PHX,MIN,Marquese Chriss,80,16.2166666666667,16,0.216666666666669,24,45,-21,-27,6
21700434,1627755,PHX,MIN,Tyler Ulis,103,21.05,21,0.0499999999999972,39,52,-13,-17,4
21700434,1627863,PHX,MIN,Danuel House Jr.,67,14.3166666666667,15,-0.683333333333334,43,29,14,17,-3
21700434,1628367,PHX,MIN,Josh Jackson,112,22.2333333333333,22,0.233333333333334,39,57,-18,-21,3
21700435,1717,DAL,SAS,Dirk Nowitzki,104,25.0166666666667,25,0.0166666666666657,59,57,2,4,-2
21700435,2734,DAL,SAS,Devin Harris,76,18,18,0,40,37,3,3,0
21700435,200826,DAL,SAS,J.J. Barea,106,25.7666666666667,26,-0.233333333333334,52,54,-2,-2,0
21700435,202083,DAL,SAS,Wesley Matthews,159,38.5333333333333,39,-0.466666666666669,66,78,-12,-11,-1
21700435,203084,DAL,SAS,Harrison Barnes,151,36.8166666666667,37,-0.183333333333337,72,73,-1,-1,0
21700435,203939,DAL,SAS,Dwight Powell,75,18.1666666666667,18,0.166666666666668,37,43,-6,-6,0
21700435,1626257,DAL,SAS,Salah Mejri,17,4.18333333333333,4,0.183333333333334,14,3,11,11,0
21700435,1627812,DAL,SAS,Yogi Ferrell,158,38.3166666666667,39,-0.683333333333337,76,74,2,2,0
21700435,1628467,DAL,SAS,Maxi Kleber,139,33.8833333333333,34,-0.116666666666667,62,66,-4,-6,2
21700435,1628499,DAL,SAS,Antonius Cleveland,5,1.31666666666667,1,0.316666666666667,2,5,-3,-4,1
21700435,1938,SAS,DAL,Manu Ginobili,94,22.7666666666667,23,-0.233333333333334,51,41,10,13,-3
21700435,2200,SAS,DAL,Pau Gasol,58,14.6666666666667,15,-0.333333333333332,25,36,-11,-10,-1
21700435,200746,SAS,DAL,LaMarcus Aldridge,143,34.15,34,0.149999999999999,66,71,-5,-3,-2
21700435,200752,SAS,DAL,Rudy Gay,113,27.7666666666667,28,-0.233333333333334,55,63,-8,-8,0
21700435,201988,SAS,DAL,Patty Mills,95,22.7333333333333,22,0.733333333333334,53,44,9,6,3
21700435,202722,SAS,DAL,Davis Bertans,107,26.75,27,-0.25,60,46,14,17,-3
21700435,203464,SAS,DAL,Brandon Paul,57,13.0333333333333,13,0.0333333333333332,23,31,-8,-10,2
21700435,203530,SAS,DAL,Joffrey Lauvergne,57,13.6666666666667,14,-0.333333333333332,30,26,4,2,2
21700435,1626199,SAS,DAL,Darrun Hilliard,29,6.93333333333333,7,-0.0666666666666664,16,12,4,4,0
21700435,1627749,SAS,DAL,Dejounte Murray,98,23.65,24,-0.350000000000001,44,45,-1,0,-1
21700435,1627854,SAS,DAL,Bryn Forbes,138,33.75,34,-0.25,65,65,0,-1,1
21700435,1628401,SAS,DAL,Derrick White,1,0.133333333333333,0,0.133333333333333,2,,,0,
21700436,201143,BOS,MEM,Al Horford,140,32.35,32,0.350000000000001,66,64,2,-3,5
21700436,202681,BOS,MEM,Kyrie Irving,123,30.2833333333333,30,0.283333333333331,75,53,22,20,2
21700436,203382,BOS,MEM,Aron Baynes,111,27.6166666666667,28,-0.383333333333333,64,54,10,13,-3
21700436,203499,BOS,MEM,Shane Larkin,60,12.7166666666667,13,-0.283333333333333,23,25,-2,0,-2
21700436,203935,BOS,MEM,Marcus Smart,136,30.1666666666667,30,0.166666666666668,66,63,3,5,-2
21700436,1626179,BOS,MEM,Terry Rozier,93,19.8,20,-0.199999999999999,36,44,-8,-9,1
21700436,1627759,BOS,MEM,Jaylen Brown,134,33.0333333333333,33,0.0333333333333314,70,66,4,4,0
21700436,1627824,BOS,MEM,Guerschon Yabusele,1,0.0333333333333333,0,0.0333333333333333,,2,,0,
21700436,1627846,BOS,MEM,Abdel Nader,1,0.0333333333333333,0,0.0333333333333333,,2,,0,
21700436,1628369,BOS,MEM,Jayson Tatum,150,33.3833333333333,34,-0.616666666666667,78,55,23,21,2
21700436,1628400,BOS,MEM,Semi Ojeleye,15,4.03333333333333,4,0.0333333333333332,5,8,-3,-3,0
21700436,1628464,BOS,MEM,Daniel Theis,71,14.2166666666667,14,0.216666666666667,27,29,-2,-3,1
21700436,201188,MEM,BOS,Marc Gasol,137,32.85,33,-0.150000000000006,68,76,-8,-8,0
21700436,201596,MEM,BOS,Mario Chalmers,119,25.9166666666667,26,-0.0833333333333357,45,63,-18,-16,-2
21700436,201936,MEM,BOS,Tyreke Evans,170,38.05,38,0.0499999999999972,81,74,7,9,-2
21700436,203210,MEM,BOS,JaMychal Green,115,28.4,28,0.399999999999999,54,63,-9,-11,2
21700436,203463,MEM,BOS,Ben McLemore,23,5.65,5,0.65,5,17,-12,-12,0
21700436,203516,MEM,BOS,James Ennis III,62,13.1,13,0.100000000000001,18,32,-14,-14,0
21700436,1626150,MEM,BOS,Andrew Harrison,51,13.9166666666667,14,-0.0833333333333322,27,30,-3,-3,0
21700436,1626185,MEM,BOS,Jarell Martin,92,19.1333333333333,20,-0.866666666666667,39,39,0,2,-2
21700436,1626205,MEM,BOS,Vincent Hunter,1,0.0333333333333333,0,0.0333333333333333,2,,,0,
21700436,1627738,MEM,BOS,Deyonta Davis,58,12.0833333333333,13,-0.916666666666666,23,22,1,-1,2
21700436,1628415,MEM,BOS,Dillon Brooks,146,34.4666666666667,35,-0.533333333333331,73,70,3,5,-2
21700436,1628424,MEM,BOS,Kobi Simmons,61,14.0666666666667,15,-0.933333333333334,30,24,6,4,2
21700437,1713,SAC,TOR,Vince Carter,116,25.4,25,0.399999999999999,58,68,-10,-8,-2
21700437,201585,SAC,TOR,Kosta Koufos,115,24.95,25,-0.0499999999999972,55,57,-2,0,-2
21700437,201588,SAC,TOR,George Hill,150,33.2333333333333,33,0.233333333333334,68,80,-12,-12,0
21700437,202066,SAC,TOR,Garrett Temple,125,27.55,28,-0.449999999999999,52,62,-10,-12,2
21700437,203992,SAC,TOR,Bogdan Bogdanovic,127,29.1,29,0.100000000000001,53,63,-10,-10,0
21700437,1626161,SAC,TOR,Willie Cauley-Stein,145,33.2166666666667,33,0.216666666666669,63,71,-8,-10,2
21700437,1627741,SAC,TOR,Buddy Hield,72,16.9166666666667,17,-0.0833333333333357,25,37,-12,-10,-2
21700437,1627746,SAC,TOR,Skal Labissiere,38,8.85,9,-0.15,12,18,-6,-8,2
21700437,1627834,SAC,TOR,Georgios Papagiannis,49,11.8,12,-0.200000000000001,22,28,-6,-6,0
21700437,1628382,SAC,TOR,Justin Jackson,65,13.4833333333333,14,-0.516666666666666,32,28,4,4,0
21700437,1628412,SAC,TOR,Frank Mason,63,14.5833333333333,15,-0.416666666666668,25,28,-3,-3,0
21700437,101139,TOR,SAC,CJ Miles,94,20.9833333333333,22,-1.01666666666667,45,47,-2,0,-2
21700437,200768,TOR,SAC,Kyle Lowry,144,31.9833333333333,33,-1.01666666666667,75,73,2,4,-2
21700437,201942,TOR,SAC,DeMar DeRozan,150,33.4666666666667,34,-0.533333333333331,86,72,14,14,0
21700437,202685,TOR,SAC,Jonas Valanciunas,125,27.1833333333333,27,0.183333333333334,68,64,4,4,0
21700437,1626153,TOR,SAC,Delon Wright,58,13.0833333333333,13,0.0833333333333322,22,18,4,4,0
21700437,1626181,TOR,SAC,Norman Powell,90,21.45,21,0.449999999999999,44,31,13,13,0
21700437,1627751,TOR,SAC,Jakob Poeltl,88,20.6333333333333,21,-0.366666666666667,40,29,11,11,0
21700437,1627783,TOR,SAC,Pascal Siakam,82,19.4,19,0.399999999999999,39,37,2,2,0
21700437,1627832,TOR,SAC,Fred VanVleet,103,22.4833333333333,22,0.483333333333334,52,38,14,10,4
21700437,1628384,TOR,SAC,OG Anunoby,131,28.4166666666667,29,-0.583333333333336,69,56,13,13,0
21700438,201571,ORL,DET,D.J. Augustin,137,30.2333333333333,30,0.233333333333334,61,60,1,1,0
21700438,202687,ORL,DET,Bismack Biyombo,53,11.9,12,-0.0999999999999996,12,22,-10,-10,0
21700438,202696,ORL,DET,Nikola Vucevic,167,36.1,36,0.0999999999999943,96,92,4,6,-2
21700438,202714,ORL,DET,Shelvin Mack,118,27.1833333333333,27,0.183333333333334,61,65,-4,-2,-2
21700438,203613,ORL,DET,Jonathon Simmons,172,36.8,37,-0.200000000000003,92,99,-7,-5,-2
21700438,203901,ORL,DET,Elfrid Payton,148,31.2666666666667,31,0.266666666666666,84,90,-6,-4,-2
21700438,1626209,ORL,DET,Mario Hezonja,148,31.3333333333333,31,0.333333333333336,87,78,9,9,0
21700438,1628371,ORL,DET,Jonathan Isaac,72,16.6666666666667,17,-0.333333333333332,21,36,-15,-13,-2
21700438,1628411,ORL,DET,Wes Iwundu,58,13.2333333333333,13,0.233333333333334,16,21,-5,-5,0
21700438,1628503,ORL,DET,Jamel Artis,27,5.28333333333333,5,0.283333333333333,10,7,3,3,0
21700438,201229,DET,ORL,Anthony Tolliver,108,24.1666666666667,24,0.166666666666668,58,48,10,6,4
21700438,202397,DET,ORL,Ish Smith,104,22.2666666666667,22,0.266666666666666,58,47,11,12,-1
21700438,202699,DET,ORL,Tobias Harris,116,24.25,24,0.25,59,63,-4,-2,-2
21700438,202704,DET,ORL,Reggie Jackson,116,25.7333333333333,26,-0.266666666666666,56,61,-5,-8,3
21700438,203083,DET,ORL,Andre Drummond,129,28.6666666666667,29,-0.333333333333336,73,72,1,1,0
21700438,203493,DET,ORL,Reggie Bullock,146,30.5666666666667,31,-0.433333333333334,83,77,6,4,2
21700438,203961,DET,ORL,Eric Moreland,83,18.5833333333333,18,0.583333333333336,34,28,6,8,-2
21700438,204038,DET,ORL,Langston Galloway,91,20.2166666666667,20,0.216666666666669,50,39,11,9,2
21700438,1626169,DET,ORL,Stanley Johnson,143,31.15,31,0.149999999999999,65,65,0,-6,6
21700438,1628379,DET,ORL,Luke Kennard,64,14.4,15,-0.6,34,40,-6,-4,-2
21700439,201960,BKN,IND,DeMarre Carroll,90,22.3833333333333,23,-0.616666666666667,39,47,-8,-9,1
21700439,203092,BKN,IND,Tyler Zeller,90,21.0166666666667,21,0.0166666666666657,38,46,-8,-7,-1
21700439,203112,BKN,IND,Quincy Acy,100,22.8,23,-0.199999999999999,54,48,6,4,2
21700439,203459,BKN,IND,Allen Crabbe,125,29.1,29,0.100000000000001,66,61,5,2,3
21700439,203915,BKN,IND,Spencer Dinwiddie,108,24.2333333333333,25,-0.766666666666666,48,56,-8,-7,-1
21700439,203917,BKN,IND,Nik Stauskas,72,15.8166666666667,15,0.816666666666666,31,41,-10,-10,0
21700439,203925,BKN,IND,Joe Harris,107,24.9,25,-0.100000000000001,43,62,-19,-14,-5
21700439,1626178,BKN,IND,Rondae Hollis-Jefferson,130,29.9833333333333,30,-0.0166666666666657,66,66,0,-3,3
21700439,1627747,BKN,IND,Caris LeVert,134,31.6666666666667,31,0.666666666666668,69,72,-3,-8,5
21700439,1628386,BKN,IND,Jarrett Allen,74,17.2666666666667,17,0.266666666666666,31,41,-10,-8,-2
21700439,201152,IND,BKN,Thaddeus Young,124,29.55,30,-0.450000000000003,64,61,3,6,-3
21700439,201954,IND,BKN,Darren Collison,141,33.7333333333333,34,-0.266666666666666,71,72,-1,0,-1
21700439,202362,IND,BKN,Lance Stephenson,75,16.3,16,0.300000000000001,40,34,6,6,0
21700439,202709,IND,BKN,Cory Joseph,129,30.2,30,0.199999999999999,74,60,14,12,2
21700439,202711,IND,BKN,Bojan Bogdanovic,129,28.65,29,-0.350000000000001,62,54,8,11,-3
21700439,203506,IND,BKN,Victor Oladipo,174,40.6166666666667,41,-0.383333333333333,91,83,8,9,-1
21700439,1626167,IND,BKN,Myles Turner,137,32.4833333333333,33,-0.516666666666666,73,74,-1,0,-1
21700439,1627734,IND,BKN,Domantas Sabonis,95,21.7833333333333,21,0.783333333333331,53,39,14,12,2
21700439,1627816,IND,BKN,Alex Poythress,26,5.85,6,-0.15,12,8,4,4,0
21700440,2544,CLE,WAS,LeBron James,190,40.6833333333333,41,-0.316666666666663,94,90,4,4,0
21700440,2594,CLE,WAS,Kyle Korver,106,23.3666666666667,24,-0.633333333333333,58,52,6,5,1
21700440,2747,CLE,WAS,JR Smith,134,28.85,29,-0.149999999999999,60,59,1,1,0
21700440,101112,CLE,WAS,Channing Frye,46,9.78333333333333,9,0.783333333333333,26,25,1,3,-2
21700440,101181,CLE,WAS,Jose Calderon,95,20.2,20,0.199999999999999,42,41,1,1,0
21700440,201145,CLE,WAS,Jeff Green,124,28.6166666666667,29,-0.383333333333333,66,60,6,5,1
21700440,201567,CLE,WAS,Kevin Love,145,31.7333333333333,32,-0.266666666666666,69,62,7,6,1
21700440,202684,CLE,WAS,Tristan Thompson,56,14.8,15,-0.199999999999999,29,26,3,0,3
21700440,203109,CLE,WAS,Jae Crowder,100,22.1833333333333,23,-0.81666666666667,46,43,3,3,0
21700440,1626224,CLE,WAS,Cedi Osman,69,17.0333333333333,17,0.0333333333333314,40,32,8,7,1
21700440,101133,WAS,CLE,Ian Mahinmi,53,12.5666666666667,13,-0.433333333333334,20,29,-9,-8,-1
21700440,101162,WAS,CLE,Marcin Gortat,113,23.5,24,-0.5,55,51,4,4,0
21700440,201975,WAS,CLE,Jodie Meeks,58,14.5666666666667,15,-0.433333333333334,28,35,-7,-6,-1
21700440,202322,WAS,CLE,John Wall,153,31.5833333333333,32,-0.416666666666664,65,67,-2,-2,0
21700440,202693,WAS,CLE,Markieff Morris,111,26.05,27,-0.949999999999999,48,59,-11,-11,0
21700440,203078,WAS,CLE,Bradley Beal,188,42.6666666666667,43,-0.333333333333329,94,97,-3,-2,-1
21700440,203107,WAS,CLE,Tomas Satoransky,105,24.8166666666667,25,-0.183333333333334,44,60,-16,-15,-1
21700440,203118,WAS,CLE,Mike Scott,149,32.7833333333333,33,-0.216666666666669,73,73,0,1,-1
21700440,1626162,WAS,CLE,Kelly Oubre Jr.,135,28.7166666666667,29,-0.283333333333335,63,59,4,4,0
21700441,101127,NYK,CHA,Jarrett Jack,113,24.6333333333333,25,-0.366666666666667,46,55,-9,-9,0
21700441,201149,NYK,CHA,Joakim Noah,33,6.48333333333333,7,-0.516666666666668,14,8,6,6,0
21700441,201196,NYK,CHA,Ramon Sessions,33,6.48333333333333,7,-0.516666666666668,14,8,6,6,0
21700441,201563,NYK,CHA,Michael Beasley,151,31.45,31,0.449999999999999,57,70,-13,-16,3
21700441,201584,NYK,CHA,Courtney Lee,111,24.1833333333333,24,0.183333333333334,43,57,-14,-14,0
21700441,202498,NYK,CHA,Lance Thomas,111,23.8,24,-0.200000000000003,45,57,-12,-12,0
21700441,202683,NYK,CHA,Enes Kanter,103,22.7166666666667,23,-0.283333333333331,41,53,-12,-12,0
21700441,203124,NYK,CHA,Kyle O'Quinn,82,15.8833333333333,16,-0.116666666666667,31,41,-10,-11,1
21700441,203926,NYK,CHA,Doug McDermott,121,24.2333333333333,24,0.233333333333334,49,60,-11,-10,-1
21700441,1626195,NYK,CHA,Willy Hernangomez,27,5.11666666666667,5,0.116666666666666,12,6,6,6,0
21700441,1627758,NYK,CHA,Ron Baker,96,18.7833333333333,19,-0.216666666666669,31,45,-14,-15,1
21700441,1628373,NYK,CHA,Frank Ntilikina,119,23.0833333333333,23,0.0833333333333322,45,53,-8,-9,1
21700441,1628422,NYK,CHA,Damyean Dotson,60,11.7333333333333,12,-0.266666666666666,27,27,0,0,0
21700441,2730,CHA,NYK,Dwight Howard,135,29.2833333333333,29,0.283333333333331,65,56,9,10,-1
21700441,101107,CHA,NYK,Marvin Williams,86,18.5833333333333,19,-0.416666666666664,35,37,-2,0,-2
21700441,201587,CHA,NYK,Nicolas Batum,151,30.8666666666667,31,-0.133333333333333,71,58,13,9,4
21700441,202689,CHA,NYK,Kemba Walker,138,29.7,30,-0.300000000000001,63,58,5,9,-4
21700441,202933,CHA,NYK,Julyan Stone,12,2.01666666666667,2,0.0166666666666666,4,4,0,0,0
21700441,203077,CHA,NYK,Michael Kidd-Gilchrist,158,33.5666666666667,34,-0.433333333333337,69,65,4,6,-2
21700441,203087,CHA,NYK,Jeremy Lamb,146,29.7333333333333,30,-0.266666666666666,74,56,18,20,-2
21700441,203487,CHA,NYK,Michael Carter-Williams,77,14.9,15,-0.100000000000001,41,27,14,11,3
21700441,203948,CHA,NYK,Johnny O'Bryant III,82,15.6666666666667,16,-0.333333333333332,37,30,7,9,-2
21700441,1626163,CHA,NYK,Frank Kaminsky,134,27.1166666666667,27,0.116666666666667,69,50,19,18,1
21700441,1628370,CHA,NYK,Malik Monk,17,3.11666666666667,3,0.116666666666667,4,6,-2,-2,0
21700441,1628407,CHA,NYK,Dwayne Bacon,12,2.01666666666667,2,0.0166666666666666,4,4,0,0,0
21700441,1628493,CHA,NYK,Mangok Mathiang,12,2.01666666666667,2,0.0166666666666666,4,4,0,0,0
21700442,201143,BOS,IND,Al Horford,167,35.8,36,-0.200000000000003,94,79,15,13,2
21700442,202681,BOS,IND,Kyrie Irving,138,29.6666666666667,29,0.666666666666664,67,71,-4,-5,1
21700442,203382,BOS,IND,Aron Baynes,95,21.5333333333333,22,-0.466666666666669,56,48,8,9,-1
21700442,203499,BOS,IND,Shane Larkin,46,11.6,12,-0.4,22,24,-2,-4,2
21700442,203935,BOS,IND,Marcus Smart,141,28.55,28,0.549999999999997,67,72,-5,-4,-1
21700442,1626179,BOS,IND,Terry Rozier,109,23.2,23,0.200000000000003,55,55,0,5,-5
21700442,1627759,BOS,IND,Jaylen Brown,120,27.25,27,0.25,66,58,8,5,3
21700442,1628369,BOS,IND,Jayson Tatum,144,30.6333333333333,31,-0.366666666666667,80,75,5,6,-1
21700442,1628400,BOS,IND,Semi Ojeleye,63,14.6333333333333,15,-0.366666666666667,25,37,-12,-9,-3
21700442,1628464,BOS,IND,Daniel Theis,72,17.1333333333333,17,0.133333333333333,28,36,-8,-11,3
21700442,2744,IND,BOS,Al Jefferson,21,4.31666666666667,4,0.316666666666666,6,9,-3,-3,0
21700442,201152,IND,BOS,Thaddeus Young,135,30.1333333333333,31,-0.866666666666667,69,74,-5,-5,0
21700442,201954,IND,BOS,Darren Collison,112,23.7333333333333,24,-0.266666666666666,51,60,-9,-8,-1
21700442,202362,IND,BOS,Lance Stephenson,125,28.0166666666667,28,0.0166666666666657,73,63,10,10,0
21700442,202709,IND,BOS,Cory Joseph,129,28.5,28,0.5,69,60,9,9,0
21700442,202711,IND,BOS,Bojan Bogdanovic,131,28.5,29,-0.5,59,71,-12,-11,-1
21700442,203506,IND,BOS,Victor Oladipo,165,35.5833333333333,35,0.583333333333329,81,84,-3,-3,0
21700442,1626167,IND,BOS,Myles Turner,118,26.0166666666667,27,-0.983333333333334,58,66,-8,-8,0
21700442,1626202,IND,BOS,Joe Young,20,4.98333333333333,5,-0.0166666666666666,11,9,2,2,0
21700442,1627734,IND,BOS,Domantas Sabonis,139,30.2166666666667,29,1.21666666666667,78,64,14,12,2
21700443,101141,ATL,MIA,Ersan Ilyasova,145,31.4166666666667,32,-0.583333333333336,78,69,9,11,-2
21700443,201158,ATL,MIA,Marco Belinelli,33,6.76666666666667,7,-0.233333333333333,10,22,-12,-10,-2
21700443,202337,ATL,MIA,Luke Babbitt,22,4.4,5,-0.6,4,15,-11,-11,0
21700443,203101,ATL,MIA,Miles Plumlee,99,23.0833333333333,23,0.0833333333333322,50,49,1,6,-5
21700443,203145,ATL,MIA,Kent Bazemore,149,32.8333333333333,32,0.833333333333329,77,69,8,13,-5
21700443,203471,ATL,MIA,Dennis Schroder,165,35.1166666666667,35,0.116666666666667,86,73,13,13,0
21700443,1627098,ATL,MIA,Malcolm Delaney,123,24.1333333333333,25,-0.866666666666667,56,55,1,-2,3
21700443,1627752,ATL,MIA,Taurean Prince,174,36.9166666666667,37,-0.0833333333333286,90,75,15,15,0
21700443,1627761,ATL,MIA,DeAndre' Bembry,94,17.6166666666667,18,-0.383333333333333,33,42,-9,-14,5
21700443,1627819,ATL,MIA,Isaiah Taylor,39,9.05,9,0.0500000000000007,20,13,7,5,2
21700443,1628381,ATL,MIA,John Collins,92,18,18,0,46,38,8,4,4
21700443,2617,MIA,ATL,Udonis Haslem,5,1.43333333333333,1,0.433333333333333,2,4,-2,0,-2
21700443,201961,MIA,ATL,Wayne Ellington,161,32.95,33,-0.0499999999999972,74,70,4,3,1
21700443,203079,MIA,ATL,Dion Waiters,171,36.1,36,0.100000000000001,78,77,1,-2,3
21700443,203482,MIA,ATL,Kelly Olynyk,130,28.3833333333333,29,-0.616666666666667,55,67,-12,-12,0
21700443,204020,MIA,ATL,Tyler Johnson,188,39.9166666666667,40,-0.0833333333333286,82,95,-13,-14,1
21700443,1626175,MIA,ATL,Jordan Mickey,113,23.6166666666667,24,-0.383333333333333,52,55,-3,-4,1
21700443,1626196,MIA,ATL,Josh Richardson,192,40.1833333333333,41,-0.816666666666663,87,91,-4,-2,-2
21700443,1628389,MIA,ATL,Bam Adebayo,144,30.4333333333333,30,0.433333333333334,71,71,0,-1,1
21700443,1628476,MIA,ATL,Derrick Walton Jr.,31,6.31666666666667,7,-0.683333333333334,19,20,-1,2,-3
21700444,201577,CHI,PHI,Robin Lopez,101,21.75,22,-0.25,53,49,4,5,-1
21700444,202703,CHI,PHI,Nikola Mirotic,135,26.4666666666667,26,0.466666666666669,64,55,9,8,1
21700444,203200,CHI,PHI,Justin Holiday,191,37.9166666666667,38,-0.0833333333333357,101,89,12,12,0
21700444,1626170,CHI,PHI,Jerian Grant,68,13.9833333333333,14,-0.0166666666666657,31,34,-3,-5,2
21700444,1626171,CHI,PHI,Bobby Portis,119,22.4,22,0.399999999999999,46,56,-10,-13,3
21700444,1627739,CHI,PHI,Kris Dunn,173,34.0166666666667,34,0.0166666666666657,86,81,5,7,-2
21700444,1627756,CHI,PHI,Denzel Valentine,101,21.2666666666667,22,-0.733333333333334,52,56,-4,-4,0
21700444,1627835,CHI,PHI,Paul Zipser,51,10.55,10,0.550000000000001,16,26,-10,-10,0
21700444,1628021,CHI,PHI,David Nwaba,139,26.2666666666667,26,0.266666666666666,65,59,6,6,0
21700444,1628374,CHI,PHI,Lauri Markkanen,127,25.3833333333333,26,-0.616666666666667,71,70,1,4,-3
21700444,101161,PHI,CHI,Amir Johnson,69,14.1166666666667,14,0.116666666666667,36,41,-5,-4,-1
21700444,200755,PHI,CHI,JJ Redick,174,35.1333333333333,35,0.133333333333333,80,101,-21,-18,-3
21700444,201573,PHI,CHI,Jerryd Bayless,114,20.8333333333333,21,-0.166666666666664,58,48,10,6,4
21700444,203496,PHI,CHI,Robert Covington,149,30.95,31,-0.0499999999999972,72,80,-8,-10,2
21700444,203967,PHI,CHI,Dario Saric,158,31.15,31,0.149999999999999,73,74,-1,3,-4
21700444,204456,PHI,CHI,T.J. McConnell,160,31.25,31,0.25,74,67,7,6,1
21700444,1626158,PHI,CHI,Richaun Holmes,108,22.6166666666667,23,-0.383333333333333,50,51,-1,-3,2
21700444,1627732,PHI,CHI,Ben Simmons,177,34.95,35,-0.0499999999999972,84,84,0,1,-1
21700444,1627789,PHI,CHI,Timothe Luwawu-Cabarrot,96,19,19,0,48,39,9,9,0
21700445,2772,HOU,UTA,Trevor Ariza,186,40.6666666666667,41,-0.333333333333329,101,79,22,25,-3
21700445,101108,HOU,UTA,Chris Paul,160,34.55,35,-0.450000000000003,92,69,23,20,3
21700445,200782,HOU,UTA,PJ Tucker,153,33.6666666666667,34,-0.333333333333336,86,77,9,11,-2
21700445,201569,HOU,UTA,Eric Gordon,154,35.15,36,-0.850000000000001,87,73,14,14,0
21700445,201583,HOU,UTA,Ryan Anderson,83,18.6166666666667,19,-0.383333333333333,42,50,-8,-8,0
21700445,201935,HOU,UTA,James Harden,173,37.45,38,-0.549999999999997,89,76,13,13,0
21700445,203991,HOU,UTA,Clint Capela,159,34.5833333333333,35,-0.416666666666671,99,62,37,35,2
21700445,204028,HOU,UTA,Tarik Black,17,3.48333333333333,3,0.483333333333333,4,9,-5,-5,0
21700445,2207,UTA,HOU,Joe Johnson,136,28.3833333333333,29,-0.616666666666667,46,78,-32,-32,0
21700445,200757,UTA,HOU,Thabo Sefolosha,96,22.7833333333333,23,-0.216666666666669,56,54,2,2,0
21700445,201937,UTA,HOU,Ricky Rubio,159,35.8333333333333,36,-0.166666666666671,71,100,-29,-32,3
21700445,201973,UTA,HOU,Jonas Jerebko,78,16.6,17,-0.399999999999999,30,40,-10,-9,-1
21700445,202327,UTA,HOU,Ekpe Udoh,124,27.5,27,0.5,66,68,-2,-3,1
21700445,202692,UTA,HOU,Alec Burks,70,16.0333333333333,16,0.033333333333335,44,41,3,6,-3
21700445,203918,UTA,HOU,Rodney Hood,133,30.5666666666667,31,-0.43333333333333,73,74,-1,-1,0
21700445,204060,UTA,HOU,Joe Ingles,175,37,38,-1,73,93,-20,-21,1
21700445,1626220,UTA,HOU,Royce O'Neale,10,2.21666666666667,2,0.216666666666667,0,0,0,0,0
21700445,1628378,UTA,HOU,Donovan Mitchell,104,21.25,21,0.25,36,52,-16,-15,-1
21700446,2037,MIN,POR,Jamal Crawford,101,22.9833333333333,23,-0.0166666666666657,48,53,-5,-1,-4
21700446,201952,MIN,POR,Jeff Teague,170,37.5,37,0.5,83,80,3,3,0
21700446,201959,MIN,POR,Taj Gibson,157,34.0333333333333,34,0.0333333333333314,77,76,1,-3,4
21700446,202710,MIN,POR,Jimmy Butler,163,35.0833333333333,35,0.0833333333333357,86,71,15,15,0
21700446,203476,MIN,POR,Gorgui Dieng,85,18.8833333333333,19,-0.116666666666667,37,45,-8,-8,0
21700446,203952,MIN,POR,Andrew Wiggins,153,33.5,33,0.5,69,72,-3,-3,0
21700446,1626145,MIN,POR,Tyus Jones,48,10.5,11,-0.5,25,27,-2,-2,0
21700446,1626157,MIN,POR,Karl-Anthony Towns,183,40.1833333333333,41,-0.816666666666663,99,91,8,8,0
21700446,1627875,MIN,POR,Marcus Georges-Hunt,30,7.33333333333333,7,0.333333333333334,16,20,-4,-4,0
21700446,202323,POR,MIN,Evan Turner,169,36.7,37,-0.299999999999997,84,92,-8,-8,0
21700446,202329,POR,MIN,Al-Farouq Aminu,163,35.9,36,-0.100000000000001,76,78,-2,-2,0
21700446,202334,POR,MIN,Ed Davis,89,19.9,20,-0.100000000000001,44,37,7,7,0
21700446,203081,POR,MIN,Damian Lillard,170,37.5,37,0.5,80,83,-3,-3,0
21700446,203468,POR,MIN,CJ McCollum,164,36.65,37,-0.350000000000001,83,86,-3,-3,0
21700446,203894,POR,MIN,Shabazz Napier,91,19.1833333333333,19,0.18333333333333,44,43,1,1,0
21700446,203994,POR,MIN,Jusuf Nurkic,129,28.1,28,0.100000000000001,63,71,-8,-8,0
21700446,1626192,POR,MIN,Pat Connaughton,21,5.26666666666667,5,0.266666666666667,12,9,3,3,0
21700446,1628380,POR,MIN,Zach Collins,94,20.8,21,-0.199999999999999,49,41,8,8,0
21700447,201163,DEN,OKC,Wilson Chandler,154,35.8166666666667,36,-0.183333333333337,64,71,-7,-7,0
21700447,203115,DEN,OKC,Will Barton,111,25.35,26,-0.649999999999999,57,50,7,7,0
21700447,203486,DEN,OKC,Mason Plumlee,96,23.25,23,0.25,41,45,-4,-4,0
21700447,203914,DEN,OKC,Gary Harris,171,40.5333333333333,41,-0.466666666666669,78,83,-5,-5,0
21700447,203999,DEN,OKC,Nikola Jokic,109,25.2333333333333,25,0.233333333333334,53,51,2,3,-1
21700447,1626168,DEN,OKC,Trey Lyles,103,24.8333333333333,25,-0.166666666666668,48,42,6,6,0
21700447,1627736,DEN,OKC,Malik Beasley,42,9.66666666666667,10,-0.333333333333334,24,17,7,7,0
21700447,1627750,DEN,OKC,Jamal Murray,106,24.9333333333333,25,-0.0666666666666664,47,55,-8,-9,1
21700447,1628470,DEN,OKC,Torrey Craig,128,30.3833333333333,30,0.383333333333333,58,61,-3,-3,0
21700447,2546,OKC,DEN,Carmelo Anthony,131,31.0333333333333,31,0.0333333333333314,63,52,11,11,0
21700447,101109,OKC,DEN,Raymond Felton,71,16.6666666666667,17,-0.333333333333336,30,36,-6,-6,0
21700447,201566,OKC,DEN,Russell Westbrook,159,37.2333333333333,37,0.233333333333334,82,69,13,13,0
21700447,202331,OKC,DEN,Paul George,166,38.8,39,-0.200000000000003,79,77,2,4,-2
21700447,202335,OKC,DEN,Patrick Patterson,92,21.55,22,-0.449999999999999,37,44,-7,-7,0
21700447,203460,OKC,DEN,Andre Roberson,104,24.7,25,-0.300000000000001,42,38,4,3,1
21700447,203518,OKC,DEN,Alex Abrines,58,13.5166666666667,14,-0.483333333333334,33,31,2,2,0
21700447,203924,OKC,DEN,Jerami Grant,106,24.7833333333333,25,-0.216666666666669,56,54,2,2,0
21700447,203962,OKC,DEN,Josh Huestis,54,13.0833333333333,13,0.0833333333333339,19,31,-12,-13,1
21700447,1626177,OKC,DEN,Dakari Johnson,79,18.6333333333333,18,0.633333333333333,34,38,-4,-4,0
21700448,1717,DAL,PHX,Dirk Nowitzki,113,24.5,25,-0.5,40,50,-10,-15,5
21700448,2734,DAL,PHX,Devin Harris,107,21.5833333333333,22,-0.416666666666668,38,50,-12,-15,3
21700448,200826,DAL,PHX,J.J. Barea,109,24.7,24,0.699999999999999,43,54,-11,-15,4
21700448,202083,DAL,PHX,Wesley Matthews,167,37.1833333333333,37,0.183333333333337,72,69,3,4,-1
21700448,203084,DAL,PHX,Harrison Barnes,169,35.7666666666667,35,0.766666666666666,77,67,10,13,-3
21700448,203939,DAL,PHX,Dwight Powell,50,11.8166666666667,13,-1.18333333333333,13,27,-14,-18,4
21700448,1626257,DAL,PHX,Salah Mejri,56,10.5833333333333,10,0.583333333333332,22,22,0,3,-3
21700448,1627812,DAL,PHX,Yogi Ferrell,197,42.4166666666667,43,-0.583333333333336,85,82,3,7,-4
21700448,1628467,DAL,PHX,Maxi Kleber,136,30.1,30,0.100000000000001,65,52,13,14,-1
21700448,1628499,DAL,PHX,Antonius Cleveland,6,1.35,1,0.35,0,7,-7,-8,1
21700448,2199,PHX,DAL,Tyson Chandler,89,19.55,20,-0.449999999999999,33,44,-11,-13,2
21700448,203458,PHX,DAL,Alex Len,128,28.2666666666667,28,0.266666666666666,61,47,14,16,-2
21700448,203477,PHX,DAL,Isaiah Canaan,125,26.75,27,-0.25,65,44,21,26,-5
21700448,203584,PHX,DAL,Troy Daniels,90,18.7,19,-0.300000000000001,43,32,11,9,2
21700448,203933,PHX,DAL,T.J. Warren,152,32.4,32,0.399999999999999,61,64,-3,-1,-2
21700448,1627733,PHX,DAL,Dragan Bender,133,28.9666666666667,29,-0.0333333333333314,64,47,17,20,-3
21700448,1627737,PHX,DAL,Marquese Chriss,83,17.6333333333333,18,-0.366666666666667,25,38,-13,-17,4
21700448,1627755,PHX,DAL,Tyler Ulis,103,22.65,23,-0.350000000000001,38,53,-15,-17,2
21700448,1627863,PHX,DAL,Danuel House Jr.,59,12.6166666666667,13,-0.383333333333333,29,20,9,10,-1
21700448,1628367,PHX,DAL,Josh Jackson,104,22.95,23,-0.0499999999999972,38,52,-14,-15,1
21700448,1628455,PHX,DAL,Mike James,44,9.51666666666667,9,0.516666666666666,23,14,9,12,-3
21700449,201599,LAC,SAS,DeAndre Jordan,130,28.1166666666667,28,0.116666666666667,49,71,-22,-12,-10
21700449,203085,LAC,SAS,Austin Rivers,149,32.3333333333333,33,-0.666666666666664,56,88,-32,-24,-8
21700449,203186,LAC,SAS,Willie Reed,61,13.3833333333333,14,-0.616666666666667,33,24,9,7,2
21700449,203710,LAC,SAS,C.J. Williams,124,26.65,27,-0.350000000000001,44,49,-5,-7,2
21700449,203966,LAC,SAS,Jamil Wilson,128,27.3333333333333,27,0.333333333333336,47,60,-13,-7,-6
21700449,1626149,LAC,SAS,Montrezl Harrell,70,15.1666666666667,15,0.166666666666666,32,38,-6,-4,-2
21700449,1626155,LAC,SAS,Sam Dekker,88,18.2333333333333,19,-0.766666666666666,45,37,8,8,0
21700449,1627744,LAC,SAS,Brice Johnson,17,3.7,4,-0.3,7,7,0,0,0
21700449,1628393,LAC,SAS,Jawun Evans,128,27.8,29,-1.2,52,73,-21,-13,-8
21700449,1628414,LAC,SAS,Sindarius Thornwell,80,16.6833333333333,16,0.683333333333334,33,42,-9,1,-10
21700449,1628462,LAC,SAS,Milos Teodosic,130,27.5166666666667,28,-0.483333333333334,57,56,1,1,0
21700449,1938,SAS,LAC,Manu Ginobili,91,19.3833333333333,19,0.383333333333333,56,37,19,18,1
21700449,2200,SAS,LAC,Pau Gasol,104,22.3,22,0.299999999999997,43,39,4,2,2
21700449,2225,SAS,LAC,Tony Parker,103,22.5166666666667,23,-0.483333333333334,47,45,2,3,-1
21700449,200746,SAS,LAC,LaMarcus Aldridge,146,31.4333333333333,32,-0.566666666666666,78,60,18,20,-2
21700449,200752,SAS,LAC,Rudy Gay,121,26.05,26,0.0500000000000007,60,62,-2,-2,0
21700449,201988,SAS,LAC,Patty Mills,109,22.65,23,-0.350000000000001,57,50,7,7,0
21700449,202695,SAS,LAC,Kawhi Leonard,76,15.3833333333333,16,-0.616666666666667,30,33,-3,-3,0
21700449,202722,SAS,LAC,Davis Bertans,76,15.8166666666667,16,-0.183333333333334,40,25,15,15,0
21700449,203464,SAS,LAC,Brandon Paul,57,12.3833333333333,13,-0.616666666666667,26,22,4,4,0
21700449,203530,SAS,LAC,Joffrey Lauvergne,17,3.7,4,-0.3,7,7,0,0,0
21700449,1627749,SAS,LAC,Dejounte Murray,89,19.5333333333333,20,-0.466666666666669,51,30,21,21,0
21700449,1627854,SAS,LAC,Bryn Forbes,116,25.7666666666667,26,-0.233333333333334,50,45,5,5,0
21700450,2561,GSW,LAL,David West,82,17.0333333333333,17,0.0333333333333314,32,30,2,5,-3
21700450,2738,GSW,LAL,Andre Iguodala,173,36.7333333333333,37,-0.266666666666666,94,74,20,19,1
21700450,201142,GSW,LAL,Kevin Durant,200,40.8333333333333,41,-0.166666666666671,94,93,1,1,0
21700450,201156,GSW,LAL,Nick Young,85,18.1333333333333,18,0.133333333333333,44,35,9,8,1
21700450,201580,GSW,LAL,JaVale McGee,58,11.2,12,-0.800000000000001,14,24,-10,-13,3
21700450,201956,GSW,LAL,Omri Casspi,132,25.9166666666667,26,-0.0833333333333357,60,55,5,7,-2
21700450,202691,GSW,LAL,Klay Thompson,201,41.9333333333333,42,-0.0666666666666629,83,93,-10,-10,0
21700450,1626172,GSW,LAL,Kevon Looney,107,21.4,21,0.399999999999999,56,42,14,13,1
21700450,1626188,GSW,LAL,Quinn Cook,28,5.03333333333333,5,0.0333333333333332,8,8,0,0,0
21700450,1627775,GSW,LAL,Patrick McCaw,117,22.8333333333333,23,-0.166666666666668,44,54,-10,-10,0
21700450,1628395,GSW,LAL,Jordan Bell,117,23.7833333333333,24,-0.216666666666669,51,62,-11,-10,-1
21700450,201147,LAL,GSW,Corey Brewer,36,6.23333333333333,6,0.233333333333333,10,22,-12,-10,-2
21700450,201572,LAL,GSW,Brook Lopez,63,10.7833333333333,11,-0.216666666666667,29,22,7,6,1
21700450,203484,LAL,GSW,Kentavious Caldwell-Pope,203,41.0166666666667,41,0.0166666666666657,95,94,1,1,0
21700450,203903,LAL,GSW,Jordan Clarkson,96,19.25,19,0.25,34,49,-15,-13,-2
21700450,203944,LAL,GSW,Julius Randle,138,30.9,31,-0.100000000000001,59,71,-12,-12,0
21700450,1626204,LAL,GSW,Larry Nance Jr.,111,20.4,21,-0.600000000000001,52,38,14,14,0
21700450,1627742,LAL,GSW,Brandon Ingram,189,39.1,39,0.0999999999999943,83,70,13,11,2
21700450,1628366,LAL,GSW,Lonzo Ball,189,38.2166666666667,39,-0.783333333333331,86,74,12,10,2
21700450,1628398,LAL,GSW,Kyle Kuzma,190,39.95,40,-0.0499999999999972,83,99,-16,-17,1
21700450,1628404,LAL,GSW,Josh Hart,85,18.9833333333333,19,-0.0166666666666657,39,41,-2,0,-2
21700451,101161,PHI,SAC,Amir Johnson,84,17.9833333333333,18,-0.0166666666666657,29,36,-7,-6,-1
21700451,200755,PHI,SAC,JJ Redick,98,19.9833333333333,20,-0.0166666666666657,42,30,12,13,-1
21700451,201573,PHI,SAC,Jerryd Bayless,129,26.4333333333333,26,0.43333333333333,53,66,-13,-13,0
21700451,202344,PHI,SAC,Trevor Booker,72,15.4166666666667,16,-0.583333333333334,32,39,-7,-8,1
21700451,203496,PHI,SAC,Robert Covington,162,32.8666666666667,32,0.86666666666666,68,63,5,2,3
21700451,203967,PHI,SAC,Dario Saric,150,30.3833333333333,31,-0.616666666666667,60,58,2,1,1
21700451,204456,PHI,SAC,T.J. McConnell,104,21.7,21,0.699999999999999,38,56,-18,-17,-1
21700451,1626158,PHI,SAC,Richaun Holmes,127,26.9333333333333,26,0.93333333333333,60,58,2,2,0
21700451,1627732,PHI,SAC,Ben Simmons,159,32.4833333333333,33,-0.516666666666666,63,60,3,0,3
21700451,1627789,PHI,SAC,Timothe Luwawu-Cabarrot,75,15.7333333333333,16,-0.266666666666666,30,39,-9,-4,-5
21700451,1713,SAC,PHI,Vince Carter,74,14.0166666666667,14,0.0166666666666657,27,26,1,1,0
21700451,2216,SAC,PHI,Zach Randolph,141,28.2666666666667,28,0.266666666666666,56,59,-3,-5,2
21700451,201585,SAC,PHI,Kosta Koufos,53,11.75,11,0.75,30,28,2,0,2
21700451,202066,SAC,PHI,Garrett Temple,159,32.4833333333333,33,-0.516666666666666,60,63,-3,0,-3
21700451,203992,SAC,PHI,Bogdan Bogdanovic,90,18.1333333333333,18,0.133333333333333,28,44,-16,-15,-1
21700451,1626161,SAC,PHI,Willie Cauley-Stein,137,29.1666666666667,30,-0.833333333333336,59,54,5,7,-2
21700451,1627741,SAC,PHI,Buddy Hield,137,28.35,28,0.350000000000001,72,57,15,14,1
21700451,1627746,SAC,PHI,Skal Labissiere,20,4.23333333333333,4,0.233333333333333,8,10,-2,0,-2
21700451,1627781,SAC,PHI,Malachi Richardson,91,19,19,0,47,30,17,17,0
21700451,1628368,SAC,PHI,De'Aaron Fox,58,11.6,11,0.6,17,24,-7,-4,-3
21700451,1628382,SAC,PHI,Justin Jackson,97,20.5333333333333,21,-0.466666666666669,44,39,5,3,2
21700451,1628412,SAC,PHI,Frank Mason,103,22.3833333333333,22,0.383333333333333,57,41,16,12,4
21700452,2749,NOP,WAS,Jameer Nelson,68,15.1666666666667,15,0.166666666666668,24,53,-29,-26,-3
21700452,200765,NOP,WAS,Rajon Rondo,66,13.95,14,-0.0500000000000007,24,34,-10,-10,0
21700452,201600,NOP,WAS,Omer Asik,22,3.43333333333333,4,-0.566666666666666,11,5,6,6,0
21700452,201950,NOP,WAS,Jrue Holiday,171,35.2333333333333,35,0.233333333333334,77,80,-3,1,-4
21700452,201967,NOP,WAS,Dante Cunningham,76,17.0333333333333,17,0.0333333333333314,34,48,-14,-9,-5
21700452,202326,NOP,WAS,DeMarcus Cousins,171,35.3166666666667,36,-0.683333333333337,81,82,-1,2,-3
21700452,202734,NOP,WAS,E'Twaun Moore,155,32.0833333333333,32,0.0833333333333286,71,82,-11,-10,-1
21700452,203076,NOP,WAS,Anthony Davis,178,36.8,37,-0.200000000000003,79,93,-14,-13,-1
21700452,203121,NOP,WAS,Darius Miller,123,25.3666666666667,25,0.366666666666667,62,62,0,1,-1
21700452,203546,NOP,WAS,Ian Clark,87,16.9666666666667,17,-0.0333333333333314,43,31,12,11,1
21700452,1627767,NOP,WAS,Cheick Diallo,24,3.61666666666667,4,-0.383333333333334,12,5,7,6,1
21700452,1628429,NOP,WAS,Charles Cooke,24,3.61666666666667,4,-0.383333333333334,12,5,7,6,1
21700452,101133,WAS,NOP,Ian Mahinmi,83,16.8166666666667,17,-0.183333333333334,50,47,3,4,-1
21700452,101162,WAS,NOP,Marcin Gortat,139,29.4666666666667,30,-0.533333333333331,66,54,12,8,4
21700452,201160,WAS,NOP,Jason Smith,29,4.86666666666667,5,-0.133333333333333,5,19,-14,-15,1
21700452,201975,WAS,NOP,Jodie Meeks,82,16.6666666666667,17,-0.333333333333336,39,43,-4,-6,2
21700452,202322,WAS,NOP,John Wall,162,33.2,33,0.200000000000003,76,72,4,1,3
21700452,202693,WAS,NOP,Markieff Morris,97,20.0666666666667,20,0.0666666666666664,49,39,10,8,2
21700452,203078,WAS,NOP,Bradley Beal,175,36.3666666666667,36,0.36666666666666,94,78,16,13,3
21700452,203107,WAS,NOP,Tomas Satoransky,107,21.8,22,-0.200000000000003,61,44,17,14,3
21700452,203118,WAS,NOP,Mike Scott,107,22.7833333333333,23,-0.216666666666669,62,48,14,14,0
21700452,204025,WAS,NOP,Tim Frazier,27,5.08333333333333,5,0.0833333333333339,11,14,-3,-3,0
21700452,1626162,WAS,NOP,Kelly Oubre Jr.,146,30.0333333333333,30,0.0333333333333314,67,67,0,2,-2
21700452,1626191,WAS,NOP,Chris McCullough,11,1.43333333333333,2,-0.566666666666667,0,5,-5,-5,0
21700453,2544,CLE,MIL,LeBron James,156,34,34,0,83,91,-8,-7,-1
21700453,2548,CLE,MIL,Dwyane Wade,119,26.4666666666667,26,0.466666666666669,63,62,1,3,-2
21700453,2594,CLE,MIL,Kyle Korver,105,23.4833333333333,23,0.483333333333334,56,46,10,10,0
21700453,2747,CLE,MIL,JR Smith,83,17.65,18,-0.350000000000001,42,50,-8,-9,1
21700453,101181,CLE,MIL,Jose Calderon,109,23.5666666666667,24,-0.433333333333334,58,63,-5,-6,1
21700453,201145,CLE,MIL,Jeff Green,114,24.8666666666667,25,-0.133333333333333,59,60,-1,1,-2
21700453,201567,CLE,MIL,Kevin Love,136,29.6333333333333,30,-0.366666666666667,71,80,-9,-9,0
21700453,202684,CLE,MIL,Tristan Thompson,84,18.4833333333333,18,0.483333333333334,47,40,7,7,0
21700453,203109,CLE,MIL,Jae Crowder,169,36.2,36,0.200000000000003,92,85,7,5,2
21700453,1626224,CLE,MIL,Cedi Osman,25,5.65,5,0.65,9,18,-9,-10,1
21700453,202339,MIL,CLE,Eric Bledsoe,146,31.6833333333333,32,-0.316666666666666,78,79,-1,1,-2
21700453,202732,MIL,CLE,DeAndre Liggins,72,15.85,16,-0.15,40,37,3,1,2
21700453,203089,MIL,CLE,John Henson,132,28.5166666666667,29,-0.483333333333334,71,73,-2,-2,0
21700453,203114,MIL,CLE,Khris Middleton,184,40.2333333333333,40,0.233333333333334,100,96,4,2,2
21700453,203503,MIL,CLE,Tony Snell,108,23.3333333333333,23,0.333333333333332,57,52,5,4,1
21700453,203507,MIL,CLE,Giannis Antetokounmpo,184,39.9166666666667,40,-0.0833333333333357,98,99,-1,3,-4
21700453,203521,MIL,CLE,Matthew Dellavedova,47,10.6166666666667,11,-0.383333333333333,23,29,-6,-5,-1
21700453,1627748,MIL,CLE,Thon Maker,65,14.3,14,0.300000000000001,34,34,0,0,0
21700453,1627763,MIL,CLE,Malcolm Brogdon,137,29.95,30,-0.0499999999999972,75,72,3,3,0
21700453,1628425,MIL,CLE,Sterling Brown,25,5.6,6,-0.4,19,9,10,8,2
21700454,200768,TOR,CHA,Kyle Lowry,118,24.4166666666667,24,0.416666666666664,70,56,14,13,1
21700454,201586,TOR,CHA,Serge Ibaka,137,27.1166666666667,27,0.116666666666667,77,62,15,17,-2
21700454,201942,TOR,CHA,DeMar DeRozan,144,29.35,29,0.349999999999998,81,70,11,11,0
21700454,202685,TOR,CHA,Jonas Valanciunas,71,15.6833333333333,16,-0.316666666666666,46,28,18,14,4
21700454,1626153,TOR,CHA,Delon Wright,88,18.4333333333333,19,-0.566666666666666,48,41,7,7,0
21700454,1626181,TOR,CHA,Norman Powell,113,23.3,23,0.300000000000001,53,58,-5,-1,-4
21700454,1626259,TOR,CHA,Malcolm Miller,24,4.53333333333333,5,-0.466666666666667,9,12,-3,-3,0
21700454,1627751,TOR,CHA,Jakob Poeltl,111,22.9,23,-0.100000000000001,57,58,-1,3,-4
21700454,1627783,TOR,CHA,Pascal Siakam,85,17.55,18,-0.449999999999999,44,45,-1,-3,2
21700454,1627832,TOR,CHA,Fred VanVleet,118,24.6333333333333,25,-0.366666666666667,62,59,3,4,-1
21700454,1628384,TOR,CHA,OG Anunoby,151,31,31,0,98,66,32,28,4
21700454,2730,CHA,TOR,Dwight Howard,129,26.6666666666667,27,-0.333333333333336,61,78,-17,-15,-2
21700454,101107,CHA,TOR,Marvin Williams,101,20.3166666666667,20,0.316666666666666,39,60,-21,-21,0
21700454,201587,CHA,TOR,Nicolas Batum,122,25.7666666666667,26,-0.233333333333334,52,70,-18,-18,0
21700454,202689,CHA,TOR,Kemba Walker,133,27.6833333333333,28,-0.31666666666667,63,83,-20,-21,1
21700454,202933,CHA,TOR,Julyan Stone,24,4.53333333333333,5,-0.466666666666667,12,9,3,3,0
21700454,203077,CHA,TOR,Michael Kidd-Gilchrist,105,21.8333333333333,22,-0.166666666666664,46,58,-12,-12,0
21700454,203087,CHA,TOR,Jeremy Lamb,134,28.3333333333333,28,0.333333333333336,70,83,-13,-14,1
21700454,203487,CHA,TOR,Michael Carter-Williams,75,15.5666666666667,15,0.566666666666666,36,37,-1,0,-1
21700454,203948,CHA,TOR,Johnny O'Bryant III,103,21.1166666666667,21,0.116666666666667,50,51,-1,-3,2
21700454,1626163,CHA,TOR,Frank Kaminsky,107,22.9333333333333,23,-0.0666666666666664,60,60,0,0,0
21700454,1628370,CHA,TOR,Malik Monk,74,14.0333333333333,14,0.0333333333333332,38,36,2,3,-1
21700454,1628407,CHA,TOR,Dwayne Bacon,29,5.6,6,-0.4,16,11,5,5,0
21700454,1628493,CHA,TOR,Mangok Mathiang,24,4.53333333333333,5,-0.466666666666667,12,9,3,3,0
21700455,101141,ATL,IND,Ersan Ilyasova,121,26.4166666666667,26,0.416666666666664,50,57,-7,-9,2
21700455,201158,ATL,IND,Marco Belinelli,97,23.7166666666667,23,0.716666666666669,40,58,-18,-16,-2
21700455,202337,ATL,IND,Luke Babbitt,40,8.5,9,-0.5,19,16,3,6,-3
21700455,203101,ATL,IND,Miles Plumlee,84,20.3666666666667,21,-0.633333333333333,42,43,-1,-1,0
21700455,203145,ATL,IND,Kent Bazemore,116,26.95,27,-0.0500000000000007,55,59,-4,-6,2
21700455,203471,ATL,IND,Dennis Schroder,142,31.6,32,-0.399999999999999,63,72,-9,-7,-2
21700455,1627098,ATL,IND,Malcolm Delaney,50,11.45,12,-0.550000000000001,29,24,5,5,0
21700455,1627752,ATL,IND,Taurean Prince,129,28.05,28,0.0499999999999972,56,64,-8,-9,1
21700455,1627761,ATL,IND,DeAndre' Bembry,74,18.0166666666667,18,0.0166666666666657,36,37,-1,-1,0
21700455,1627819,ATL,IND,Isaiah Taylor,67,16.1,16,0.100000000000001,32,33,-1,-3,2
21700455,1628381,ATL,IND,John Collins,125,27.3333333333333,27,0.333333333333336,53,62,-9,-9,0
21700455,2863,IND,ATL,Damien Wilkins,12,1.9,2,-0.1,0,10,-10,-10,0
21700455,201152,IND,ATL,Thaddeus Young,131,29.1333333333333,29,0.133333333333333,64,52,12,12,0
21700455,201954,IND,ATL,Darren Collison,100,22.2333333333333,23,-0.766666666666666,46,47,-1,1,-2
21700455,202362,IND,ATL,Lance Stephenson,114,25.7166666666667,26,-0.283333333333335,59,53,6,6,0
21700455,202709,IND,ATL,Cory Joseph,121,28.5666666666667,28,0.566666666666666,67,54,13,7,6
21700455,202711,IND,ATL,Bojan Bogdanovic,138,33.1833333333333,33,0.183333333333337,72,61,11,13,-2
21700455,203506,IND,ATL,Victor Oladipo,143,31.6,32,-0.399999999999999,76,67,9,11,-2
21700455,1626167,IND,ATL,Myles Turner,132,29.8166666666667,30,-0.183333333333334,64,56,8,8,0
21700455,1626202,IND,ATL,Joe Young,50,12.7,13,-0.300000000000001,21,25,-4,-4,0
21700455,1627734,IND,ATL,Domantas Sabonis,92,21.75,22,-0.25,56,40,16,16,0
21700455,1627816,IND,ATL,Alex Poythress,12,1.9,2,-0.1,0,10,-10,-10,0
21700456,201143,BOS,MIA,Al Horford,108,26,27,-1,36,49,-13,-13,0
21700456,202681,BOS,MIA,Kyrie Irving,157,36.8833333333333,37,-0.116666666666667,74,71,3,4,-1
21700456,203382,BOS,MIA,Aron Baynes,72,16.5166666666667,17,-0.483333333333334,29,19,10,6,4
21700456,203499,BOS,MIA,Shane Larkin,34,8.13333333333333,8,0.133333333333333,7,11,-4,-4,0
21700456,203935,BOS,MIA,Marcus Smart,160,37.5,37,0.5,73,75,-2,0,-2
21700456,1626179,BOS,MIA,Terry Rozier,77,17.85,17,0.850000000000001,35,33,2,-1,3
21700456,1627759,BOS,MIA,Jaylen Brown,133,31.35,32,-0.649999999999999,63,55,8,9,-1
21700456,1627824,BOS,MIA,Guerschon Yabusele,35,8.01666666666667,8,0.0166666666666675,18,19,-1,-1,0
21700456,1628369,BOS,MIA,Jayson Tatum,119,27.5666666666667,28,-0.433333333333334,55,56,-1,3,-4
21700456,1628400,BOS,MIA,Semi Ojeleye,46,10.2666666666667,10,0.266666666666666,15,20,-5,-4,-1
21700456,1628464,BOS,MIA,Daniel Theis,84,19.9166666666667,20,-0.0833333333333357,40,42,-2,-4,2
21700456,2617,MIA,BOS,Udonis Haslem,35,7.73333333333333,8,-0.266666666666667,12,13,-1,1,-2
21700456,201961,MIA,BOS,Wayne Ellington,139,32,32,0,60,66,-6,-7,1
21700456,203079,MIA,BOS,Dion Waiters,155,36.5,37,-0.5,69,73,-4,-2,-2
21700456,203482,MIA,BOS,Kelly Olynyk,160,37.5,38,-0.5,73,70,3,5,-2
21700456,204020,MIA,BOS,Tyler Johnson,157,36.7166666666667,37,-0.283333333333331,68,65,3,-1,4
21700456,1626175,MIA,BOS,Jordan Mickey,103,24.3166666666667,24,0.316666666666666,46,45,1,-1,2
21700456,1626196,MIA,BOS,Josh Richardson,163,38.15,38,0.149999999999999,77,70,7,7,0
21700456,1628389,MIA,BOS,Bam Adebayo,84,20.5,20,0.5,36,32,4,5,-1
21700456,1628476,MIA,BOS,Derrick Walton Jr.,29,6.58333333333333,7,-0.416666666666666,9,11,-2,-2,0
21700457,201960,BKN,SAC,DeMarre Carroll,107,24.8,25,-0.200000000000003,50,55,-5,-9,4
21700457,203092,BKN,SAC,Tyler Zeller,84,20.2833333333333,21,-0.716666666666669,47,49,-2,-4,2
21700457,203112,BKN,SAC,Quincy Acy,91,19.4666666666667,19,0.466666666666665,36,42,-6,-5,-1
21700457,203459,BKN,SAC,Allen Crabbe,139,32.45,33,-0.549999999999997,63,74,-11,-8,-3
21700457,203915,BKN,SAC,Spencer Dinwiddie,132,31.1,31,0.100000000000001,63,59,4,2,2
21700457,203917,BKN,SAC,Nik Stauskas,15,3.28333333333333,3,0.283333333333333,12,10,2,0,2
21700457,203925,BKN,SAC,Joe Harris,112,25.3833333333333,25,0.383333333333333,53,54,-1,6,-7
21700457,1626178,BKN,SAC,Rondae Hollis-Jefferson,155,36.3,36,0.299999999999997,78,76,2,2,0
21700457,1627747,BKN,SAC,Caris LeVert,123,26.8166666666667,27,-0.183333333333334,55,61,-6,-7,1
21700457,1628386,BKN,SAC,Jarrett Allen,87,19.95,20,-0.0499999999999972,38,40,-2,-2,0
21700457,2216,SAC,BKN,Zach Randolph,110,26.4666666666667,26,0.466666666666669,65,57,8,8,0
21700457,201585,SAC,BKN,Kosta Koufos,97,21.3833333333333,21,0.383333333333333,39,42,-3,-3,0
21700457,201588,SAC,BKN,George Hill,148,34.8333333333333,35,-0.166666666666664,78,75,3,3,0
21700457,202066,SAC,BKN,Garrett Temple,117,27.7,28,-0.300000000000001,60,63,-3,-5,2
21700457,203992,SAC,BKN,Bogdan Bogdanovic,139,32.8166666666667,33,-0.183333333333337,74,70,4,4,0
21700457,1626161,SAC,BKN,Willie Cauley-Stein,127,30.5,31,-0.5,66,64,2,2,0
21700457,1627741,SAC,BKN,Buddy Hield,78,16.7833333333333,16,0.783333333333331,35,31,4,4,0
21700457,1627746,SAC,BKN,Skal Labissiere,61,12.5666666666667,12,0.566666666666666,28,23,5,5,0
21700457,1628382,SAC,BKN,Justin Jackson,94,20.5166666666667,20,0.516666666666666,41,38,3,5,-2
21700457,1628412,SAC,BKN,Frank Mason,74,16.2666666666667,16,0.266666666666666,34,32,2,2,0
21700458,201577,CHI,ORL,Robin Lopez,121,26.8,27,-0.199999999999999,64,46,18,17,1
21700458,202347,CHI,ORL,Quincy Pondexter,27,6.23333333333333,6,0.233333333333333,10,20,-10,-10,0
21700458,202703,CHI,ORL,Nikola Mirotic,99,21.7166666666667,22,-0.283333333333331,53,42,11,11,0
21700458,203200,CHI,ORL,Justin Holiday,129,28.1333333333333,28,0.133333333333333,69,49,20,23,-3
21700458,1626170,CHI,ORL,Jerian Grant,111,24.0833333333333,24,0.0833333333333322,55,53,2,2,0
21700458,1626171,CHI,ORL,Bobby Portis,72,14.7166666666667,15,-0.283333333333333,38,28,10,11,-1
21700458,1626245,CHI,ORL,Cristiano Felicio,27,6.23333333333333,6,0.233333333333333,10,20,-10,-10,0
21700458,1627739,CHI,ORL,Kris Dunn,109,23.6666666666667,24,-0.333333333333336,57,41,16,16,0
21700458,1627756,CHI,ORL,Denzel Valentine,131,28.05,29,-0.950000000000003,74,50,24,24,0
21700458,1627835,CHI,ORL,Paul Zipser,91,19.6166666666667,20,-0.383333333333333,43,45,-2,-5,3
21700458,1628021,CHI,ORL,David Nwaba,89,19.7,19,0.699999999999999,38,44,-6,-6,0
21700458,1628374,CHI,ORL,Lauri Markkanen,94,19.8,20,-0.200000000000003,49,32,17,17,0
21700458,201167,ORL,CHI,Arron Afflalo,43,9.26666666666667,9,0.266666666666666,18,31,-13,-10,-3
21700458,201571,ORL,CHI,D.J. Augustin,132,28.2833333333333,28,0.283333333333331,57,65,-8,-8,0
21700458,202687,ORL,CHI,Bismack Biyombo,47,10.1833333333333,10,0.183333333333334,18,36,-18,-15,-3
21700458,202696,ORL,CHI,Nikola Vucevic,146,31.3333333333333,31,0.333333333333336,56,66,-10,-13,3
21700458,202714,ORL,CHI,Shelvin Mack,84,17.95,18,-0.0499999999999972,42,42,0,0,0
21700458,203613,ORL,CHI,Jonathon Simmons,157,33.4,33,0.399999999999999,58,78,-20,-22,2
21700458,203901,ORL,CHI,Elfrid Payton,136,29.8,30,-0.200000000000003,52,70,-18,-18,0
21700458,203940,ORL,CHI,Adreian Payne,27,6.23333333333333,6,0.233333333333333,20,10,10,10,0
21700458,1626209,ORL,CHI,Mario Hezonja,109,23.9833333333333,24,-0.0166666666666657,48,54,-6,-6,0
21700458,1628371,ORL,CHI,Jonathan Isaac,64,13.7333333333333,14,-0.266666666666668,29,35,-6,-7,1
21700458,1628411,ORL,CHI,Wes Iwundu,88,19.4666666666667,20,-0.533333333333335,37,47,-10,-10,0
21700458,1628503,ORL,CHI,Jamel Artis,67,15.1166666666667,15,0.116666666666667,35,26,9,9,0
21700459,2403,HOU,LAL,Nene,128,25.7333333333333,26,-0.266666666666666,76,63,13,17,-4
21700459,2772,HOU,LAL,Trevor Ariza,223,44.8833333333333,45,-0.116666666666667,114,110,4,3,1
21700459,101108,HOU,LAL,Chris Paul,118,24.85,25,-0.149999999999999,51,68,-17,-16,-1
21700459,200782,HOU,LAL,PJ Tucker,169,35.25,35,0.25,79,83,-4,-7,3
21700459,201569,HOU,LAL,Eric Gordon,186,35.6666666666667,36,-0.333333333333336,89,92,-3,-2,-1
21700459,201583,HOU,LAL,Ryan Anderson,132,25.75,25,0.75,50,68,-18,-22,4
21700459,201935,HOU,LAL,James Harden,221,43.35,43,0.349999999999994,112,110,2,4,-2
21700459,204028,HOU,LAL,Tarik Black,28,4.35,4,0.35,9,16,-7,-7,0
21700459,101106,LAL,HOU,Andrew Bogut,80,17.2166666666667,17,0.216666666666669,48,38,10,4,6
21700459,201147,LAL,HOU,Corey Brewer,123,25,25,0,69,50,19,18,1
21700459,203903,LAL,HOU,Jordan Clarkson,89,18.2666666666667,18,0.266666666666666,48,37,11,15,-4
21700459,203944,LAL,HOU,Julius Randle,34,8.15,8,0.15,15,27,-12,-12,0
21700459,1626204,LAL,HOU,Larry Nance Jr.,126,22.5166666666667,22,0.516666666666666,57,51,6,12,-6
21700459,1627742,LAL,HOU,Brandon Ingram,200,40.1666666666667,40,0.166666666666671,98,101,-3,-5,2
21700459,1627936,LAL,HOU,Alex Caruso,13,2.96666666666667,3,-0.0333333333333332,9,4,5,7,-2
21700459,1628366,LAL,HOU,Lonzo Ball,196,37.9833333333333,38,-0.0166666666666657,101,95,6,6,0
21700459,1628398,LAL,HOU,Kyle Kuzma,204,39.7666666666667,40,-0.233333333333334,103,95,8,9,-1
21700459,1628404,LAL,HOU,Josh Hart,140,27.8,28,-0.200000000000003,62,82,-20,-24,4
21700460,2546,OKC,UTA,Carmelo Anthony,110,25.7333333333333,26,-0.266666666666666,66,36,30,30,0
21700460,2555,OKC,UTA,Nick Collison,23,5.75,6,-0.25,11,13,-2,0,-2
21700460,101109,OKC,UTA,Raymond Felton,76,16.8166666666667,17,-0.183333333333334,27,35,-8,-8,0
21700460,201566,OKC,UTA,Russell Westbrook,116,27.0666666666667,27,0.0666666666666664,73,37,36,36,0
21700460,202331,OKC,UTA,Paul George,129,29.9833333333333,30,-0.0166666666666657,77,46,31,31,0
21700460,202335,OKC,UTA,Patrick Patterson,69,15.2666666666667,15,0.266666666666666,25,33,-8,-8,0
21700460,203460,OKC,UTA,Andre Roberson,97,22.8166666666667,23,-0.183333333333337,63,28,35,37,-2
21700460,203500,OKC,UTA,Steven Adams,109,25.65,26,-0.350000000000001,71,33,38,38,0
21700460,203518,OKC,UTA,Alex Abrines,100,22.6833333333333,23,-0.31666666666667,40,45,-5,-9,4
21700460,203924,OKC,UTA,Jerami Grant,87,19.05,19,0.0499999999999972,34,36,-2,-4,2
21700460,203962,OKC,UTA,Josh Huestis,77,17.5833333333333,18,-0.416666666666664,30,33,-3,-3,0
21700460,1626177,OKC,UTA,Dakari Johnson,14,3.68333333333333,4,-0.316666666666666,7,7,0,0,0
21700460,1628390,OKC,UTA,Terrance Ferguson,23,5.75,6,-0.25,11,13,-2,0,-2
21700460,2207,UTA,OKC,Joe Johnson,75,18.0666666666667,18,0.0666666666666664,23,45,-22,-24,2
21700460,200757,UTA,OKC,Thabo Sefolosha,111,25.3333333333333,25,0.333333333333336,57,51,6,6,0
21700460,201937,UTA,OKC,Ricky Rubio,107,25.0666666666667,25,0.0666666666666664,32,57,-25,-27,2
21700460,201973,UTA,OKC,Jonas Jerebko,113,25.4333333333333,26,-0.56666666666667,49,55,-6,-4,-2
21700460,202324,UTA,OKC,Derrick Favors,96,22.5833333333333,23,-0.416666666666668,26,63,-37,-35,-2
21700460,202327,UTA,OKC,Ekpe Udoh,83,18.4333333333333,18,0.43333333333333,40,30,10,8,2
21700460,202692,UTA,OKC,Alec Burks,107,24.35,25,-0.649999999999999,43,50,-7,-5,-2
21700460,203489,UTA,OKC,Nate Wolters,32,7.75,8,-0.25,14,14,0,0,0
21700460,203918,UTA,OKC,Rodney Hood,118,27.1333333333333,28,-0.866666666666667,41,70,-29,-31,2
21700460,204060,UTA,OKC,Joe Ingles,94,22.2166666666667,23,-0.783333333333335,26,58,-32,-32,0
21700460,1626220,UTA,OKC,Royce O'Neale,67,14.9166666666667,15,-0.0833333333333322,31,28,3,5,-2
21700460,1628396,UTA,OKC,Tony Bradley,27,6.55,7,-0.45,13,14,-1,-1,0
21700461,1717,DAL,DET,Dirk Nowitzki,110,25.35,26,-0.649999999999999,55,55,0,1,-1
21700461,2734,DAL,DET,Devin Harris,68,16.8166666666667,17,-0.183333333333334,45,28,17,18,-1
21700461,200826,DAL,DET,J.J. Barea,79,18.4333333333333,19,-0.56666666666667,52,37,15,16,-1
21700461,202083,DAL,DET,Wesley Matthews,116,27.1166666666667,27,0.116666666666667,63,42,21,21,0
21700461,203084,DAL,DET,Harrison Barnes,130,31.1833333333333,31,0.183333333333334,74,52,22,22,0
21700461,203939,DAL,DET,Dwight Powell,85,20.35,20,0.350000000000001,49,47,2,0,2
21700461,1626257,DAL,DET,Salah Mejri,62,15.5166666666667,15,0.516666666666668,38,23,15,17,-2
21700461,1627812,DAL,DET,Yogi Ferrell,130,31.25,31,0.25,76,60,16,15,1
21700461,1627858,DAL,DET,Kyle Collinsworth,52,12.7333333333333,13,-0.266666666666666,28,33,-5,-4,-1
21700461,1628372,DAL,DET,Dennis Smith Jr.,93,21.3166666666667,21,0.316666666666666,40,46,-6,-6,0
21700461,1628467,DAL,DET,Maxi Kleber,85,19.0166666666667,19,0.0166666666666657,30,42,-12,-15,3
21700461,201229,DET,DAL,Anthony Tolliver,126,29.6333333333333,30,-0.366666666666667,61,68,-7,-7,0
21700461,202397,DET,DAL,Ish Smith,92,23.0833333333333,23,0.0833333333333357,45,55,-10,-10,0
21700461,202699,DET,DAL,Tobias Harris,122,28.45,28,0.449999999999999,48,62,-14,-16,2
21700461,202704,DET,DAL,Reggie Jackson,93,21.05,21,0.0500000000000007,37,47,-10,-10,0
21700461,203083,DET,DAL,Andre Drummond,92,21.65,22,-0.350000000000001,50,40,10,10,0
21700461,203493,DET,DAL,Reggie Bullock,103,24.1833333333333,24,0.183333333333334,39,55,-16,-16,0
21700461,203961,DET,DAL,Eric Moreland,40,10.4,11,-0.600000000000001,10,32,-22,-22,0
21700461,204038,DET,DAL,Langston Galloway,76,17.3,17,0.300000000000001,38,45,-7,-7,0
21700461,1626169,DET,DAL,Stanley Johnson,114,28.1666666666667,28,0.166666666666664,50,64,-14,-14,0
21700461,1626246,DET,DAL,Boban Marjanovic,66,14.5333333333333,14,0.533333333333333,33,34,-1,1,-2
21700461,1627740,DET,DAL,Henry Ellenson,17,3.68333333333333,4,-0.316666666666666,11,8,3,3,0
21700461,1628379,DET,DAL,Luke Kennard,69,16.95,17,-0.0500000000000007,43,40,3,3,0
21700462,201163,DEN,MIN,Wilson Chandler,174,37.4666666666667,37,0.466666666666669,83,86,-3,-3,0
21700462,203115,DEN,MIN,Will Barton,148,33.6833333333333,34,-0.31666666666667,61,84,-23,-28,5
21700462,203486,DEN,MIN,Mason Plumlee,122,27.7833333333333,29,-1.21666666666667,71,62,9,12,-3
21700462,203999,DEN,MIN,Nikola Jokic,165,36.1333333333333,36,0.133333333333333,80,79,1,-1,2
21700462,1626168,DEN,MIN,Trey Lyles,111,24.2166666666667,24,0.216666666666669,48,61,-13,-18,5
21700462,1627736,DEN,MIN,Malik Beasley,25,5.56666666666667,6,-0.433333333333334,12,12,0,-2,2
21700462,1627750,DEN,MIN,Jamal Murray,169,37.4,37,0.400000000000006,83,84,-1,-1,0
21700462,1628470,DEN,MIN,Torrey Craig,156,36.75,37,-0.25,82,82,0,1,-1
21700462,2037,MIN,DEN,Jamal Crawford,117,27.9333333333333,28,-0.0666666666666664,71,44,27,27,0
21700462,201952,MIN,DEN,Jeff Teague,151,32.4666666666667,32,0.466666666666669,71,73,-2,-2,0
21700462,201959,MIN,DEN,Taj Gibson,145,30.4833333333333,30,0.483333333333334,63,75,-12,-8,-4
21700462,202710,MIN,DEN,Jimmy Butler,157,34.6833333333333,35,-0.316666666666663,77,82,-5,-5,0
21700462,203476,MIN,DEN,Gorgui Dieng,89,20.7,21,-0.300000000000001,47,39,8,13,-5
21700462,203952,MIN,DEN,Andrew Wiggins,166,34.8,35,-0.200000000000003,83,79,4,3,1
21700462,1626145,MIN,DEN,Tyus Jones,63,15.3333333333333,16,-0.666666666666668,39,31,8,10,-2
21700462,1626157,MIN,DEN,Karl-Anthony Towns,162,37.2166666666667,38,-0.783333333333331,87,85,2,0,2
21700462,1627875,MIN,DEN,Marcus Georges-Hunt,20,5.38333333333333,5,0.383333333333333,12,12,0,2,-2
21700463,202323,POR,SAS,Evan Turner,146,32.3166666666667,32,0.316666666666663,58,58,0,0,0
21700463,202329,POR,SAS,Al-Farouq Aminu,163,35.3166666666667,35,0.316666666666663,71,70,1,2,-1
21700463,202334,POR,SAS,Ed Davis,102,22.2,23,-0.800000000000001,45,51,-6,-9,3
21700463,203081,POR,SAS,Damian Lillard,157,34.1833333333333,34,0.183333333333337,66,63,3,3,0
21700463,203086,POR,SAS,Meyers Leonard,16,3.61666666666667,3,0.616666666666667,5,4,1,1,0
21700463,203468,POR,SAS,CJ McCollum,182,38.4,38,0.399999999999999,70,75,-5,-4,-1
21700463,203894,POR,SAS,Shabazz Napier,93,21.2833333333333,21,0.283333333333331,40,46,-6,-7,1
21700463,203994,POR,SAS,Jusuf Nurkic,117,25.7666666666667,25,0.766666666666666,46,41,5,8,-3
21700463,1626192,POR,SAS,Pat Connaughton,62,13.3,13,0.300000000000001,29,27,2,2,0
21700463,1628380,POR,SAS,Zach Collins,62,13.6166666666667,14,-0.383333333333333,25,30,-5,-6,1
21700463,1938,SAS,POR,Manu Ginobili,124,25.9666666666667,26,-0.0333333333333314,61,51,10,9,1
21700463,2200,SAS,POR,Pau Gasol,149,33.4,33,0.399999999999999,63,62,1,1,0
21700463,200746,SAS,POR,LaMarcus Aldridge,163,35.7833333333333,36,-0.216666666666669,63,67,-4,-5,1
21700463,200752,SAS,POR,Rudy Gay,72,15.2666666666667,15,0.266666666666666,35,28,7,4,3
21700463,201980,SAS,POR,Danny Green,106,23.6833333333333,24,-0.316666666666666,37,42,-5,-3,-2
21700463,201988,SAS,POR,Patty Mills,110,23.6,23,0.600000000000001,53,41,12,14,-2
21700463,202722,SAS,POR,Davis Bertans,23,4.65,4,0.65,13,13,0,3,-3
21700463,203530,SAS,POR,Joffrey Lauvergne,32,6.68333333333333,7,-0.316666666666666,13,12,1,2,-1
21700463,203937,SAS,POR,Kyle Anderson,116,24.7166666666667,24,0.716666666666669,55,49,6,4,2
21700463,1627749,SAS,POR,Dejounte Murray,120,27.2333333333333,27,0.233333333333334,47,53,-6,-7,1
21700463,1627854,SAS,POR,Bryn Forbes,85,19.0166666666667,19,0.0166666666666657,25,37,-12,-12,0
21700464,2561,GSW,MEM,David West,87,18.5166666666667,19,-0.483333333333334,45,29,16,16,0
21700464,201142,GSW,MEM,Kevin Durant,144,33.5666666666667,33,0.566666666666663,62,59,3,2,1
21700464,201156,GSW,MEM,Nick Young,119,23.5166666666667,24,-0.483333333333334,47,43,4,9,-5
21700464,201580,GSW,MEM,JaVale McGee,48,11.7666666666667,12,-0.233333333333334,23,19,4,2,2
21700464,201956,GSW,MEM,Omri Casspi,120,25.0333333333333,26,-0.966666666666669,55,41,14,14,0
21700464,202691,GSW,MEM,Klay Thompson,158,36.9166666666667,37,-0.0833333333333357,81,62,19,17,2
21700464,1626172,GSW,MEM,Kevon Looney,62,13.8,13,0.800000000000001,22,30,-8,-3,-5
21700464,1626188,GSW,MEM,Quinn Cook,75,18.3166666666667,19,-0.683333333333334,34,29,5,3,2
21700464,1627745,GSW,MEM,Damian Jones,9,1.6,2,-0.4,2,4,-2,-2,0
21700464,1627775,GSW,MEM,Patrick McCaw,140,29.4833333333333,29,0.483333333333334,62,55,7,10,-3
21700464,1628395,GSW,MEM,Jordan Bell,113,26.4833333333333,26,0.483333333333334,47,49,-2,-3,1
21700464,201188,MEM,GSW,Marc Gasol,157,35.6666666666667,36,-0.333333333333329,63,64,-1,-4,3
21700464,201596,MEM,GSW,Mario Chalmers,129,27.35,27,0.350000000000001,59,49,10,7,3
21700464,201936,MEM,GSW,Tyreke Evans,145,32.2166666666667,33,-0.783333333333331,49,68,-19,-20,1
21700464,203210,MEM,GSW,JaMychal Green,100,24.25,24,0.25,43,52,-9,-11,2
21700464,203463,MEM,GSW,Ben McLemore,111,23.1166666666667,23,0.116666666666667,43,43,0,-3,3
21700464,203516,MEM,GSW,James Ennis III,74,16.1833333333333,16,0.183333333333334,28,36,-8,-6,-2
21700464,1626150,MEM,GSW,Andrew Harrison,104,24.1333333333333,24,0.133333333333333,36,52,-16,-16,0
21700464,1626185,MEM,GSW,Jarell Martin,97,19.85,20,-0.149999999999999,37,38,-1,-4,3
21700464,1626205,MEM,GSW,Vincent Hunter,13,2.41666666666667,2,0.416666666666667,4,6,-2,0,-2
21700464,1627738,MEM,GSW,Deyonta Davis,37,7.78333333333333,8,-0.216666666666667,13,19,-6,-6,0
21700464,1628397,MEM,GSW,Ivan Rabb,13,2.41666666666667,2,0.416666666666667,4,6,-2,0,-2
21700464,1628415,MEM,GSW,Dillon Brooks,82,21.2,21,0.199999999999999,37,41,-4,-2,-2
21700464,1628424,MEM,GSW,Kobi Simmons,13,2.41666666666667,2,0.416666666666667,4,6,-2,0,-2
21700465,101150,LAC,PHX,Lou Williams,135,28.2,28,0.199999999999999,53,60,-7,-3,-4
21700465,201599,LAC,PHX,DeAndre Jordan,145,30.35,31,-0.649999999999999,70,60,10,11,-1
21700465,203085,LAC,PHX,Austin Rivers,132,28.8333333333333,29,-0.166666666666664,67,53,14,11,3
21700465,203186,LAC,PHX,Willie Reed,74,16.1,16,0.100000000000001,34,29,5,1,4
21700465,203710,LAC,PHX,C.J. Williams,138,28.3333333333333,29,-0.666666666666664,71,58,13,12,1
21700465,203966,LAC,PHX,Jamil Wilson,132,28.4,28,0.399999999999999,69,48,21,19,2
21700465,1626149,LAC,PHX,Montrezl Harrell,86,18.2166666666667,18,0.216666666666665,39,41,-2,-2,0
21700465,1626155,LAC,PHX,Sam Dekker,95,19.55,19,0.550000000000001,40,43,-3,-2,-1
21700465,1628393,LAC,PHX,Jawun Evans,72,13.6166666666667,13,0.616666666666667,27,35,-8,-10,2
21700465,1628414,LAC,PHX,Sindarius Thornwell,5,1.31666666666667,1,0.316666666666667,2,4,-2,-1,-1
21700465,1628462,LAC,PHX,Milos Teodosic,126,27,27,0,68,44,24,29,-5
21700465,2199,PHX,LAC,Tyson Chandler,103,22.1,22,0.100000000000001,32,55,-23,-25,2
21700465,201162,PHX,LAC,Jared Dudley,35,8.06666666666667,8,0.0666666666666664,24,15,9,9,0
21700465,203458,PHX,LAC,Alex Len,89,17.7666666666667,18,-0.233333333333334,39,38,1,3,-2
21700465,203477,PHX,LAC,Isaiah Canaan,110,22.3166666666667,22,0.316666666666666,43,59,-16,-14,-2
21700465,203584,PHX,LAC,Troy Daniels,104,21.9,22,-0.100000000000001,43,50,-7,-5,-2
21700465,203933,PHX,LAC,T.J. Warren,153,32.75,33,-0.25,57,66,-9,-10,1
21700465,1627733,PHX,LAC,Dragan Bender,114,22.4,22,0.399999999999999,45,50,-5,-5,0
21700465,1627737,PHX,LAC,Marquese Chriss,114,25.5833333333333,26,-0.416666666666668,50,58,-8,-8,0
21700465,1627755,PHX,LAC,Tyler Ulis,83,17.6,18,-0.399999999999999,28,34,-6,-8,2
21700465,1627863,PHX,LAC,Danuel House Jr.,43,7.96666666666667,8,-0.0333333333333332,27,17,10,11,-1
21700465,1628367,PHX,LAC,Josh Jackson,143,30.1666666666667,30,0.166666666666664,56,67,-11,-13,2
21700465,1628455,PHX,LAC,Mike James,49,11.3,11,0.300000000000001,31,31,0,0,0
21700466,2544,CLE,CHI,LeBron James,166,39.4,39,0.399999999999999,96,91,5,5,0
21700466,2548,CLE,CHI,Dwyane Wade,112,24.1666666666667,24,0.166666666666668,50,50,0,1,-1
21700466,2594,CLE,CHI,Kyle Korver,112,25.2333333333333,25,0.233333333333334,62,54,8,11,-3
21700466,101112,CLE,CHI,Channing Frye,61,15.1166666666667,15,0.116666666666667,38,37,1,2,-1
21700466,101181,CLE,CHI,Jose Calderon,97,23.8,24,-0.199999999999999,65,62,3,4,-1
21700466,201145,CLE,CHI,Jeff Green,110,24.3166666666667,24,0.316666666666666,54,54,0,-4,4
21700466,201567,CLE,CHI,Kevin Love,124,29.5666666666667,29,0.566666666666666,77,73,4,5,-1
21700466,202684,CLE,CHI,Tristan Thompson,101,21.75,22,-0.25,43,44,-1,-3,2
21700466,203109,CLE,CHI,Jae Crowder,122,28.45,29,-0.549999999999997,71,73,-2,-4,2
21700466,1626224,CLE,CHI,Cedi Osman,40,8.03333333333333,8,0.0333333333333332,19,22,-3,-2,-1
21700466,201577,CHI,CLE,Robin Lopez,117,27.75,27,0.75,66,65,1,1,0
21700466,202703,CHI,CLE,Nikola Mirotic,117,25.2166666666667,25,0.216666666666669,61,57,4,6,-2
21700466,203200,CHI,CLE,Justin Holiday,149,34.8666666666667,35,-0.133333333333333,93,83,10,9,1
21700466,1626170,CHI,CLE,Jerian Grant,60,12.95,13,-0.0500000000000007,25,31,-6,-7,1
21700466,1626171,CHI,CLE,Bobby Portis,62,13.2666666666667,14,-0.733333333333334,24,33,-9,-9,0
21700466,1627739,CHI,CLE,Kris Dunn,148,34.9666666666667,35,-0.0333333333333314,87,82,5,4,1
21700466,1627756,CHI,CLE,Denzel Valentine,152,35.9,36,-0.100000000000001,88,82,6,8,-2
21700466,1627835,CHI,CLE,Paul Zipser,45,9.41666666666667,9,0.416666666666666,17,25,-8,-8,0
21700466,1628021,CHI,CLE,David Nwaba,72,15.75,16,-0.25,26,40,-14,-15,1
21700466,1628374,CHI,CLE,Lauri Markkanen,123,29.75,30,-0.25,73,77,-4,-4,0
21700467,101161,PHI,TOR,Amir Johnson,96,20.75,21,-0.25,50,44,6,6,0
21700467,201573,PHI,TOR,Jerryd Bayless,167,33.0666666666667,34,-0.933333333333337,70,76,-6,-7,1
21700467,202344,PHI,TOR,Trevor Booker,78,15.3666666666667,15,0.366666666666667,28,41,-13,-13,0
21700467,203496,PHI,TOR,Robert Covington,192,37.9,38,-0.100000000000001,93,90,3,4,-1
21700467,203967,PHI,TOR,Dario Saric,182,36.5833333333333,37,-0.416666666666671,84,82,2,1,1
21700467,204456,PHI,TOR,T.J. McConnell,103,21.4666666666667,21,0.466666666666665,50,48,2,6,-4
21700467,1626158,PHI,TOR,Richaun Holmes,143,27.1333333333333,27,0.133333333333333,58,68,-10,-11,1
21700467,1627732,PHI,TOR,Ben Simmons,172,33.2833333333333,33,0.283333333333331,75,84,-9,-8,-1
21700467,1627789,PHI,TOR,Timothe Luwawu-Cabarrot,72,14.3666666666667,14,0.366666666666667,32,37,-5,-3,-2
21700467,200768,TOR,PHI,Kyle Lowry,183,35.9666666666667,36,-0.0333333333333314,91,78,13,8,5
21700467,201586,TOR,PHI,Serge Ibaka,177,34.6,34,0.600000000000001,89,74,15,14,1
21700467,201942,TOR,PHI,DeMar DeRozan,203,39.5666666666667,39,0.566666666666663,102,91,11,12,-1
21700467,202685,TOR,PHI,Jonas Valanciunas,81,15.7166666666667,16,-0.283333333333333,35,47,-12,-12,0
21700467,1626153,TOR,PHI,Delon Wright,136,27.6166666666667,28,-0.383333333333333,68,50,18,15,3
21700467,1626181,TOR,PHI,Norman Powell,60,12.3,12,0.300000000000001,22,29,-7,-9,2
21700467,1627751,TOR,PHI,Jakob Poeltl,99,19.9666666666667,20,-0.033333333333335,40,46,-6,-7,1
21700467,1627783,TOR,PHI,Pascal Siakam,90,18.9166666666667,19,-0.0833333333333357,43,38,5,7,-2
21700467,1627832,TOR,PHI,Fred VanVleet,66,13.9166666666667,14,-0.0833333333333339,27,36,-9,-5,-4
21700467,1628384,TOR,PHI,OG Anunoby,110,21.35,21,0.350000000000001,53,51,2,2,0
21700468,201143,BOS,NYK,Al Horford,147,32.55,33,-0.450000000000003,67,68,-1,-1,0
21700468,202681,BOS,NYK,Kyrie Irving,168,36.7833333333333,37,-0.216666666666669,77,81,-4,-6,2
21700468,203382,BOS,NYK,Aron Baynes,99,22.5,22,0.5,43,43,0,-1,1
21700468,203935,BOS,NYK,Marcus Smart,158,34.2833333333333,34,0.283333333333331,69,73,-4,-4,0
21700468,1626179,BOS,NYK,Terry Rozier,125,27.2166666666667,27,0.216666666666669,47,56,-9,-10,1
21700468,1627824,BOS,NYK,Guerschon Yabusele,18,3.86666666666667,4,-0.133333333333334,6,6,0,2,-2
21700468,1627846,BOS,NYK,Abdel Nader,51,11.75,12,-0.25,20,25,-5,-7,2
21700468,1628369,BOS,NYK,Jayson Tatum,156,33.65,34,-0.350000000000001,70,75,-5,-6,1
21700468,1628400,BOS,NYK,Semi Ojeleye,82,19.3,19,0.299999999999997,31,39,-8,-5,-3
21700468,1628443,BOS,NYK,Kadeem Allen,4,0.216666666666667,0,0.216666666666667,2,2,0,1,-1
21700468,1628464,BOS,NYK,Daniel Theis,77,17.05,17,0.0499999999999972,33,42,-9,-7,-2
21700468,101127,NYK,BOS,Jarrett Jack,108,23.4,23,0.399999999999999,47,49,-2,-4,2
21700468,201563,NYK,BOS,Michael Beasley,111,25.0333333333333,25,0.0333333333333314,61,43,18,18,0
21700468,201584,NYK,BOS,Courtney Lee,132,27.6666666666667,28,-0.333333333333336,59,54,5,5,0
21700468,202498,NYK,BOS,Lance Thomas,93,19.8166666666667,20,-0.183333333333334,39,44,-5,-5,0
21700468,202683,NYK,BOS,Enes Kanter,105,22.65,23,-0.350000000000001,43,47,-4,-4,0
21700468,203124,NYK,BOS,Kyle O'Quinn,105,24.6833333333333,24,0.683333333333334,56,46,10,10,0
21700468,203926,NYK,BOS,Doug McDermott,124,28.0166666666667,28,0.0166666666666657,63,49,14,14,0
21700468,204001,NYK,BOS,Kristaps Porzingis,106,22.8,23,-0.199999999999999,41,50,-9,-9,0
21700468,1627758,NYK,BOS,Ron Baker,92,20.6666666666667,21,-0.333333333333336,46,39,7,7,0
21700468,1628373,NYK,BOS,Frank Ntilikina,109,24.4333333333333,25,-0.566666666666666,55,44,11,13,-2
21700469,202328,PHX,MEM,Greg Monroe,122,26.8833333333333,27,-0.116666666666667,56,60,-4,-4,0
21700469,203458,PHX,MEM,Alex Len,90,21.1,21,0.100000000000001,41,35,6,6,0
21700469,203477,PHX,MEM,Isaiah Canaan,111,24.5166666666667,24,0.516666666666666,53,38,15,16,-1
21700469,203584,PHX,MEM,Troy Daniels,99,21.6666666666667,22,-0.333333333333336,44,39,5,7,-2
21700469,203933,PHX,MEM,T.J. Warren,154,33.65,34,-0.350000000000001,68,70,-2,-1,-1
21700469,1627733,PHX,MEM,Dragan Bender,144,32.0833333333333,32,0.0833333333333357,69,52,17,17,0
21700469,1627737,PHX,MEM,Marquese Chriss,68,15.9,16,-0.0999999999999996,28,43,-15,-15,0
21700469,1627755,PHX,MEM,Tyler Ulis,101,23.4666666666667,24,-0.533333333333331,44,57,-13,-14,1
21700469,1627863,PHX,MEM,Danuel House Jr.,58,14.3333333333333,14,0.333333333333332,29,25,4,3,1
21700469,1628367,PHX,MEM,Josh Jackson,113,26.3166666666667,26,0.316666666666666,53,56,-3,-5,2
21700469,201148,MEM,PHX,Brandan Wright,86,19.8833333333333,20,-0.116666666666667,36,31,5,4,1
21700469,201188,MEM,PHX,Marc Gasol,167,38.0166666666667,38,0.0166666666666657,71,71,0,4,-4
21700469,201596,MEM,PHX,Mario Chalmers,37,7.98333333333333,8,-0.0166666666666675,12,32,-20,-19,-1
21700469,201936,MEM,PHX,Tyreke Evans,152,33.7833333333333,34,-0.216666666666669,75,65,10,9,1
21700469,202718,MEM,PHX,Chandler Parsons,78,16.65,17,-0.350000000000001,34,44,-10,-15,5
21700469,203210,MEM,PHX,JaMychal Green,116,26.7,27,-0.299999999999997,57,50,7,8,-1
21700469,203463,MEM,PHX,Ben McLemore,30,6.7,7,-0.300000000000001,9,20,-11,-10,-1
21700469,203516,MEM,PHX,James Ennis III,37,8.45,8,0.449999999999999,17,12,5,3,2
21700469,1626150,MEM,PHX,Andrew Harrison,146,33.4833333333333,34,-0.516666666666666,70,57,13,12,1
21700469,1626185,MEM,PHX,Jarell Martin,20,4.31666666666667,4,0.316666666666666,10,17,-7,-8,1
21700469,1627738,MEM,PHX,Deyonta Davis,32,6.45,6,0.449999999999999,10,25,-15,-16,1
21700469,1628415,MEM,PHX,Dillon Brooks,121,28.6166666666667,29,-0.383333333333333,57,51,6,11,-5
21700469,1628424,MEM,PHX,Kobi Simmons,38,8.88333333333333,9,-0.116666666666667,17,10,7,7,0
21700470,2225,SAS,UTA,Tony Parker,105,25.8333333333333,26,-0.166666666666664,52,59,-7,-5,-2
21700470,200746,SAS,UTA,LaMarcus Aldridge,120,27.75,28,-0.25,56,55,1,-7,8
21700470,200752,SAS,UTA,Rudy Gay,82,19.8,20,-0.199999999999999,32,40,-8,-8,0
21700470,201988,SAS,UTA,Patty Mills,114,26.1333333333333,26,0.133333333333333,38,58,-20,-21,1
21700470,202695,SAS,UTA,Kawhi Leonard,86,20.55,20,0.550000000000001,42,42,0,2,-2
21700470,202722,SAS,UTA,Davis Bertans,69,16.75,17,-0.25,31,40,-9,-7,-2
21700470,203464,SAS,UTA,Brandon Paul,44,10.3333333333333,11,-0.666666666666668,28,22,6,6,0
21700470,203530,SAS,UTA,Joffrey Lauvergne,108,26.7666666666667,26,0.766666666666666,54,57,-3,3,-6
21700470,203937,SAS,UTA,Kyle Anderson,94,22.9,23,-0.100000000000001,34,49,-15,-17,2
21700470,1627749,SAS,UTA,Dejounte Murray,76,17.9166666666667,19,-1.08333333333334,31,29,2,-2,4
21700470,1627854,SAS,UTA,Bryn Forbes,97,23.6,24,-0.399999999999999,47,49,-2,1,-3
21700470,2207,UTA,SAS,Joe Johnson,70,18.3333333333333,18,0.333333333333332,39,34,5,5,0
21700470,200757,UTA,SAS,Thabo Sefolosha,87,22.0333333333333,22,0.0333333333333314,46,46,0,-2,2
21700470,201937,UTA,SAS,Ricky Rubio,155,37.3333333333333,38,-0.666666666666671,78,72,6,6,0
21700470,201973,UTA,SAS,Jonas Jerebko,98,22.4166666666667,22,0.416666666666668,48,44,4,4,0
21700470,202324,UTA,SAS,Derrick Favors,133,31.4333333333333,32,-0.56666666666667,67,59,8,8,0
21700470,202327,UTA,SAS,Ekpe Udoh,66,16.2333333333333,16,0.233333333333334,33,30,3,3,0
21700470,202692,UTA,SAS,Alec Burks,81,19.7666666666667,21,-1.23333333333333,45,33,12,14,-2
21700470,203918,UTA,SAS,Rodney Hood,148,34.5833333333333,35,-0.416666666666671,69,65,4,6,-2
21700470,204060,UTA,SAS,Joe Ingles,157,36.2,36,0.200000000000003,75,62,13,11,2
21700471,101127,NYK,DET,Jarrett Jack,140,28.1666666666667,28,0.166666666666664,59,54,5,3,2
21700471,201149,NYK,DET,Joakim Noah,17,3.13333333333333,3,0.133333333333333,7,5,2,2,0
21700471,201563,NYK,DET,Michael Beasley,63,13.35,13,0.35,20,40,-20,-19,-1
21700471,201584,NYK,DET,Courtney Lee,164,33.2,34,-0.799999999999997,74,62,12,12,0
21700471,202498,NYK,DET,Lance Thomas,171,34.7666666666667,35,-0.233333333333334,79,66,13,13,0
21700471,202683,NYK,DET,Enes Kanter,144,29.7166666666667,29,0.716666666666665,70,54,16,17,-1
21700471,203124,NYK,DET,Kyle O'Quinn,53,11.55,12,-0.449999999999999,18,36,-18,-18,0
21700471,203926,NYK,DET,Doug McDermott,75,16.25,16,0.25,28,45,-17,-17,0
21700471,204001,NYK,DET,Kristaps Porzingis,186,38.0666666666667,38,0.0666666666666629,87,73,14,13,1
21700471,1627758,NYK,DET,Ron Baker,55,11.9666666666667,12,-0.0333333333333332,21,35,-14,-15,1
21700471,1628373,NYK,DET,Frank Ntilikina,92,19.8333333333333,20,-0.166666666666664,42,50,-8,-6,-2
21700471,201229,DET,NYK,Anthony Tolliver,170,35.3666666666667,35,0.36666666666666,67,83,-16,-15,-1
21700471,202397,DET,NYK,Ish Smith,93,19.5833333333333,20,-0.416666666666664,47,39,8,7,1
21700471,202699,DET,NYK,Tobias Harris,201,41.05,41,0.0499999999999972,94,80,14,14,0
21700471,202704,DET,NYK,Reggie Jackson,139,28.4166666666667,28,0.416666666666664,57,62,-5,-4,-1
21700471,203083,DET,NYK,Andre Drummond,128,26.0333333333333,26,0.0333333333333314,54,63,-9,-9,0
21700471,203493,DET,NYK,Reggie Bullock,148,30.0833333333333,30,0.0833333333333322,55,68,-13,-13,0
21700471,203961,DET,NYK,Eric Moreland,101,21.5666666666667,22,-0.433333333333334,48,38,10,10,0
21700471,1626169,DET,NYK,Stanley Johnson,96,19.9833333333333,20,-0.0166666666666657,49,39,10,9,1
21700471,1628379,DET,NYK,Luke Kennard,84,17.9166666666667,18,-0.0833333333333357,49,33,16,16,0
21700472,2749,NOP,ORL,Jameer Nelson,93,19.5666666666667,20,-0.433333333333334,42,39,3,2,1
21700472,200765,NOP,ORL,Rajon Rondo,116,23.2,23,0.200000000000003,53,49,4,4,0
21700472,201950,NOP,ORL,Jrue Holiday,151,29.7833333333333,30,-0.216666666666669,74,61,13,11,2
21700472,201967,NOP,ORL,Dante Cunningham,125,25.7666666666667,26,-0.233333333333334,62,49,13,10,3
21700472,202326,NOP,ORL,DeMarcus Cousins,159,32.9166666666667,33,-0.0833333333333357,75,64,11,12,-1
21700472,202734,NOP,ORL,E'Twaun Moore,103,20.5166666666667,21,-0.483333333333334,46,34,12,12,0
21700472,203076,NOP,ORL,Anthony Davis,158,30.8833333333333,31,-0.116666666666667,79,62,17,17,0
21700472,203121,NOP,ORL,Darius Miller,130,26.2833333333333,27,-0.716666666666669,71,52,19,20,-1
21700472,203546,NOP,ORL,Ian Clark,84,18.2,18,0.199999999999999,41,36,5,6,-1
21700472,1627767,NOP,ORL,Cheick Diallo,26,5.63333333333333,6,-0.366666666666667,6,17,-11,-11,0
21700472,1628429,NOP,ORL,Charles Cooke,25,5.25,5,0.25,6,17,-11,-13,2
21700472,201167,ORL,NOP,Arron Afflalo,63,11.4333333333333,11,0.433333333333334,16,34,-18,-20,2
21700472,201571,ORL,NOP,D.J. Augustin,145,29.2833333333333,30,-0.716666666666669,58,74,-16,-14,-2
21700472,201578,ORL,NOP,Marreese Speights,84,17.0166666666667,18,-0.983333333333334,42,39,3,1,2
21700472,202687,ORL,NOP,Bismack Biyombo,80,16.3166666666667,16,0.31666666666667,34,36,-2,-2,0
21700472,202696,ORL,NOP,Nikola Vucevic,139,27.6833333333333,28,-0.316666666666666,50,75,-25,-26,1
21700472,202714,ORL,NOP,Shelvin Mack,78,16.5,17,-0.5,34,32,2,1,1
21700472,203613,ORL,NOP,Jonathon Simmons,149,30.5833333333333,31,-0.416666666666668,65,76,-11,-8,-3
21700472,203901,ORL,NOP,Elfrid Payton,146,28.6,29,-0.399999999999999,58,69,-11,-9,-2
21700472,203940,ORL,NOP,Adreian Payne,64,13.8666666666667,14,-0.133333333333333,29,31,-2,-2,0
21700472,1626209,ORL,NOP,Mario Hezonja,101,20.3166666666667,20,0.316666666666666,37,41,-4,1,-5
21700472,1628411,ORL,NOP,Wes Iwundu,70,14.8,15,-0.199999999999999,32,25,7,6,1
21700472,1628503,ORL,NOP,Jamel Artis,51,11.6,12,-0.399999999999999,25,23,2,2,0
21700473,201960,BKN,WAS,DeMarre Carroll,108,22.5333333333333,23,-0.466666666666669,59,36,23,22,1
21700473,202389,BKN,WAS,Timofey Mozgov,34,8.48333333333333,8,0.483333333333333,24,18,6,6,0
21700473,203092,BKN,WAS,Tyler Zeller,86,17.6333333333333,18,-0.366666666666667,49,26,23,19,4
21700473,203112,BKN,WAS,Quincy Acy,104,23.7333333333333,24,-0.266666666666666,54,45,9,12,-3
21700473,203459,BKN,WAS,Allen Crabbe,151,32.45,33,-0.549999999999997,79,53,26,26,0
21700473,203915,BKN,WAS,Spencer Dinwiddie,113,22.3833333333333,22,0.383333333333333,64,38,26,26,0
21700473,203917,BKN,WAS,Nik Stauskas,66,15.35,15,0.35,38,33,5,6,-1
21700473,203925,BKN,WAS,Joe Harris,143,31.7833333333333,32,-0.216666666666669,73,56,17,17,0
21700473,1626178,BKN,WAS,Rondae Hollis-Jefferson,118,23.6,24,-0.399999999999999,66,42,24,23,1
21700473,1627747,BKN,WAS,Caris LeVert,110,23.8666666666667,24,-0.133333333333333,50,40,10,10,0
21700473,1628386,BKN,WAS,Jarrett Allen,87,18.1833333333333,18,0.183333333333334,39,33,6,8,-2
21700473,101133,WAS,BKN,Ian Mahinmi,34,8,8,0,14,14,0,0,0
21700473,101162,WAS,BKN,Marcin Gortat,89,18.6,19,-0.399999999999999,31,45,-14,-12,-2
21700473,201160,WAS,BKN,Jason Smith,56,13.2833333333333,13,0.283333333333331,26,31,-5,-5,0
21700473,201975,WAS,BKN,Jodie Meeks,100,22.6333333333333,22,0.633333333333333,41,53,-12,-12,0
21700473,202322,WAS,BKN,John Wall,83,16.3666666666667,16,0.366666666666667,26,47,-21,-21,0
21700473,202693,WAS,BKN,Markieff Morris,134,26.7166666666667,27,-0.283333333333331,44,74,-30,-30,0
21700473,203078,WAS,BKN,Bradley Beal,141,28.5333333333333,29,-0.466666666666669,49,76,-27,-27,0
21700473,203107,WAS,BKN,Tomas Satoransky,94,20.75,21,-0.25,36,43,-7,-9,2
21700473,203118,WAS,BKN,Mike Scott,90,20.1166666666667,20,0.116666666666667,34,49,-15,-15,0
21700473,203490,WAS,BKN,Otto Porter Jr.,107,21.3166666666667,21,0.316666666666666,33,61,-28,-26,-2
21700473,204025,WAS,BKN,Tim Frazier,34,8.48333333333333,8,0.483333333333333,18,24,-6,-6,0
21700473,1626162,WAS,BKN,Kelly Oubre Jr.,130,28.5666666666667,29,-0.433333333333334,54,63,-9,-11,2
21700473,1626191,WAS,BKN,Chris McCullough,28,6.63333333333333,6,0.633333333333333,14,15,-1,-1,0
21700474,1717,DAL,MIA,Dirk Nowitzki,122,32.2,32,0.200000000000003,62,76,-14,-14,0
21700474,2734,DAL,MIA,Devin Harris,29,8.31666666666667,8,0.316666666666666,17,18,-1,-1,0
21700474,200826,DAL,MIA,J.J. Barea,94,25.3166666666667,26,-0.683333333333334,60,53,7,7,0
21700474,202083,DAL,MIA,Wesley Matthews,123,33.75,34,-0.25,72,85,-13,-13,0
21700474,203084,DAL,MIA,Harrison Barnes,116,31.9,32,-0.100000000000001,68,83,-15,-15,0
21700474,203939,DAL,MIA,Dwight Powell,62,16.7666666666667,17,-0.233333333333334,36,34,2,2,0
21700474,1626257,DAL,MIA,Salah Mejri,50,14.6333333333333,15,-0.366666666666667,36,33,3,3,0
21700474,1627812,DAL,MIA,Yogi Ferrell,113,32.6833333333333,33,-0.316666666666663,80,75,5,5,0
21700474,1627858,DAL,MIA,Kyle Collinsworth,33,8.71666666666667,9,-0.283333333333333,21,18,3,3,0
21700474,1628372,DAL,MIA,Dennis Smith Jr.,102,26.6666666666667,27,-0.333333333333336,48,63,-15,-15,0
21700474,1628467,DAL,MIA,Maxi Kleber,31,7.8,8,-0.200000000000001,5,27,-22,-22,0
21700474,2617,MIA,DAL,Udonis Haslem,29,8.33333333333333,8,0.333333333333332,16,16,0,0,0
21700474,201961,MIA,DAL,Wayne Ellington,144,39.6,39,0.600000000000001,92,82,10,10,0
21700474,203079,MIA,DAL,Dion Waiters,34,8.53333333333333,9,-0.466666666666667,26,17,9,9,0
21700474,203482,MIA,DAL,Kelly Olynyk,99,25.9,26,-0.100000000000001,60,59,1,3,-2
21700474,204020,MIA,DAL,Tyler Johnson,142,38.5166666666667,39,-0.483333333333334,95,79,16,16,0
21700474,1626175,MIA,DAL,Jordan Mickey,79,21.5833333333333,22,-0.416666666666668,47,51,-4,-4,0
21700474,1626196,MIA,DAL,Josh Richardson,130,35.7,36,-0.299999999999997,85,70,15,13,2
21700474,1628389,MIA,DAL,Bam Adebayo,134,36.5833333333333,37,-0.416666666666671,97,69,28,28,0
21700474,1628476,MIA,DAL,Derrick Walton Jr.,84,24,24,0,47,62,-15,-15,0
21700475,2403,HOU,LAC,Nene,79,16.6,17,-0.399999999999999,38,39,-1,-1,0
21700475,2772,HOU,LAC,Trevor Ariza,205,42.7333333333333,43,-0.266666666666666,106,109,-3,-3,0
21700475,200782,HOU,LAC,PJ Tucker,158,31.85,32,-0.149999999999999,87,89,-2,-2,0
21700475,201569,HOU,LAC,Eric Gordon,190,39.45,40,-0.549999999999997,94,111,-17,-16,-1
21700475,201583,HOU,LAC,Ryan Anderson,169,34.5,35,-0.5,82,99,-17,-17,0
21700475,201935,HOU,LAC,James Harden,201,41.4166666666667,41,0.416666666666671,103,114,-11,-8,-3
21700475,204028,HOU,LAC,Tarik Black,80,15.7833333333333,16,-0.216666666666667,38,39,-1,-1,0
21700475,1627362,HOU,LAC,Briante Weber,83,16.4166666666667,16,0.416666666666664,42,40,2,-2,4
21700475,101150,LAC,HOU,Lou Williams,191,38.4666666666667,39,-0.533333333333331,107,94,13,12,1
21700475,201599,LAC,HOU,DeAndre Jordan,162,32.9,33,-0.100000000000001,88,83,5,5,0
21700475,203085,LAC,HOU,Austin Rivers,191,39.2833333333333,39,0.283333333333331,103,95,8,7,1
21700475,203186,LAC,HOU,Willie Reed,43,8.06666666666667,8,0.0666666666666664,21,20,1,1,0
21700475,203710,LAC,HOU,C.J. Williams,145,30.5166666666667,31,-0.483333333333334,79,77,2,6,-4
21700475,203966,LAC,HOU,Jamil Wilson,113,23.0166666666667,23,0.0166666666666657,51,57,-6,-8,2
21700475,1626149,LAC,HOU,Montrezl Harrell,53,12.55,13,-0.449999999999999,32,31,1,0,1
21700475,1626155,LAC,HOU,Sam Dekker,133,27.9833333333333,28,-0.0166666666666657,78,72,6,9,-3
21700475,1628393,LAC,HOU,Jawun Evans,133,25.8166666666667,26,-0.183333333333334,81,58,23,20,3
21700475,1628414,LAC,HOU,Sindarius Thornwell,1,0.15,0,0.15,,3,,-2,
21700476,202339,MIL,CHA,Eric Bledsoe,162,35.8,36,-0.200000000000003,93,77,16,16,0
21700476,202732,MIL,CHA,DeAndre Liggins,35,9.1,9,0.0999999999999996,14,18,-4,-6,2
21700476,203089,MIL,CHA,John Henson,89,19.0666666666667,19,0.0666666666666664,44,55,-11,-13,2
21700476,203114,MIL,CHA,Khris Middleton,170,38.2333333333333,38,0.233333333333334,91,84,7,7,0
21700476,203503,MIL,CHA,Tony Snell,95,20.5666666666667,20,0.566666666666666,48,59,-11,-9,-2
21700476,203507,MIL,CHA,Giannis Antetokounmpo,161,36.2333333333333,37,-0.766666666666666,92,72,20,20,0
21700476,203521,MIL,CHA,Matthew Dellavedova,61,14.1833333333333,14,0.183333333333334,22,35,-13,-13,0
21700476,203930,MIL,CHA,Sean Kilpatrick,44,10.7,10,0.699999999999999,23,20,3,5,-2
21700476,1627748,MIL,CHA,Thon Maker,81,18.1333333333333,18,0.133333333333333,42,29,13,13,0
21700476,1627763,MIL,CHA,Malcolm Brogdon,137,30.4833333333333,31,-0.516666666666669,66,59,7,7,0
21700476,1628425,MIL,CHA,Sterling Brown,35,7,7,0,10,12,-2,-2,0
21700476,2730,CHA,MIL,Dwight Howard,22,4.6,5,-0.4,11,13,-2,-2,0
21700476,101107,CHA,MIL,Marvin Williams,142,32.1666666666667,32,0.166666666666664,72,80,-8,-7,-1
21700476,201587,CHA,MIL,Nicolas Batum,145,31.8333333333333,32,-0.166666666666668,74,80,-6,-5,-1
21700476,202689,CHA,MIL,Kemba Walker,145,31.85,32,-0.149999999999999,76,76,0,1,-1
21700476,203077,CHA,MIL,Michael Kidd-Gilchrist,146,31.8,32,-0.200000000000003,71,67,4,3,1
21700476,203087,CHA,MIL,Jeremy Lamb,143,31.9833333333333,32,-0.0166666666666657,63,70,-7,-7,0
21700476,203487,CHA,MIL,Michael Carter-Williams,72,17.1,17,0.100000000000001,36,34,2,1,1
21700476,203948,CHA,MIL,Johnny O'Bryant III,87,18.4333333333333,18,0.43333333333333,39,38,1,0,1
21700476,1626163,CHA,MIL,Frank Kaminsky,131,30.0166666666667,30,0.0166666666666657,58,66,-8,-7,-1
21700476,1628370,CHA,MIL,Malik Monk,37,9.71666666666667,10,-0.283333333333333,20,21,-1,-2,1
21700477,101141,ATL,OKC,Ersan Ilyasova,147,30.9166666666667,31,-0.0833333333333357,80,80,0,-2,2
21700477,201158,ATL,OKC,Marco Belinelli,150,32.15,33,-0.850000000000001,78,80,-2,2,-4
21700477,203101,ATL,OKC,Miles Plumlee,96,19.25,19,0.25,49,44,5,5,0
21700477,203145,ATL,OKC,Kent Bazemore,131,27.0833333333333,27,0.0833333333333357,67,70,-3,-3,0
21700477,1627098,ATL,OKC,Malcolm Delaney,132,27.4833333333333,27,0.483333333333334,70,64,6,8,-2
21700477,1627752,ATL,OKC,Taurean Prince,163,33.4166666666667,34,-0.583333333333329,81,85,-4,-8,4
21700477,1627761,ATL,OKC,DeAndre' Bembry,34,7.63333333333333,7,0.633333333333333,12,18,-6,-6,0
21700477,1627819,ATL,OKC,Isaiah Taylor,82,16.7166666666667,17,-0.283333333333331,43,43,0,-2,2
21700477,1628381,ATL,OKC,John Collins,127,27.0666666666667,27,0.0666666666666664,64,70,-6,-4,-2
21700477,1628463,ATL,OKC,Tyler Cavanaugh,88,18.2833333333333,19,-0.716666666666669,41,46,-5,-5,0
21700477,2546,OKC,ATL,Carmelo Anthony,165,34.85,35,-0.150000000000006,86,88,-2,0,-2
21700477,101109,OKC,ATL,Raymond Felton,60,12.4666666666667,12,0.466666666666665,26,29,-3,-3,0
21700477,201566,OKC,ATL,Russell Westbrook,170,35.5333333333333,36,-0.466666666666669,94,88,6,6,0
21700477,202331,OKC,ATL,Paul George,189,39.7,40,-0.299999999999997,105,94,11,11,0
21700477,202335,OKC,ATL,Patrick Patterson,64,13.55,14,-0.449999999999999,38,27,11,11,0
21700477,203460,OKC,ATL,Andre Roberson,136,28.05,28,0.0499999999999972,68,69,-1,-3,2
21700477,203500,OKC,ATL,Steven Adams,164,33.9666666666667,34,-0.0333333333333314,82,90,-8,-8,0
21700477,203518,OKC,ATL,Alex Abrines,21,3.98333333333333,4,-0.0166666666666666,10,10,0,0,0
21700477,203924,OKC,ATL,Jerami Grant,65,13.15,13,0.15,34,29,5,3,2
21700477,203962,OKC,ATL,Josh Huestis,116,24.75,25,-0.25,57,61,-4,-2,-2
21700478,201163,DEN,POR,Wilson Chandler,178,41.8666666666667,42,-0.133333333333333,85,71,14,14,0
21700478,203115,DEN,POR,Will Barton,113,25.45,26,-0.549999999999997,42,44,-2,-2,0
21700478,203486,DEN,POR,Mason Plumlee,109,24.6833333333333,25,-0.31666666666667,49,49,0,0,0
21700478,203914,DEN,POR,Gary Harris,169,38.1,38,0.100000000000001,88,61,27,27,0
21700478,203999,DEN,POR,Nikola Jokic,161,37.0666666666667,37,0.0666666666666629,85,56,29,29,0
21700478,1626168,DEN,POR,Trey Lyles,143,32.9166666666667,33,-0.0833333333333357,65,59,6,6,0
21700478,1627736,DEN,POR,Malik Beasley,6,1.1,1,0.1,5,6,-1,-1,0
21700478,1627750,DEN,POR,Jamal Murray,119,26.85,27,-0.149999999999999,65,50,15,15,0
21700478,1627823,DEN,POR,Juancho Hernangomez,6,1.1,1,0.1,5,6,-1,-1,0
21700478,1628470,DEN,POR,Torrey Craig,46,10.5333333333333,11,-0.466666666666667,21,23,-2,-2,0
21700478,202323,POR,DEN,Evan Turner,98,21.8,22,-0.199999999999999,36,57,-21,-20,-1
21700478,202329,POR,DEN,Al-Farouq Aminu,114,26.9333333333333,27,-0.06666666666667,34,70,-36,-36,0
21700478,202334,POR,DEN,Ed Davis,99,21.3,21,0.300000000000001,47,35,12,11,1
21700478,203090,POR,DEN,Maurice Harkless,86,19.45,19,0.449999999999999,36,32,4,4,0
21700478,203468,POR,DEN,CJ McCollum,148,33.15,34,-0.850000000000001,53,75,-22,-20,-2
21700478,203894,POR,DEN,Shabazz Napier,163,37.3833333333333,37,0.383333333333333,64,79,-15,-17,2
21700478,203943,POR,DEN,Noah Vonleh,10,2.88333333333333,3,-0.116666666666667,4,4,0,0,0
21700478,203994,POR,DEN,Jusuf Nurkic,101,23.75,24,-0.25,34,63,-29,-28,-1
21700478,1626192,POR,DEN,Pat Connaughton,92,21.5333333333333,22,-0.466666666666669,47,37,10,10,0
21700478,1627774,POR,DEN,Jake Layman,42,9.81666666666667,10,-0.183333333333334,19,24,-5,-5,0
21700478,1628380,POR,DEN,Zach Collins,81,17.6833333333333,18,-0.316666666666666,41,25,16,15,1
21700478,1628403,POR,DEN,Caleb Swanigan,16,3.98333333333333,4,-0.0166666666666666,10,9,1,1,0
21700479,2561,GSW,LAL,David West,87,17.5833333333333,18,-0.416666666666668,41,42,-1,-1,0
21700479,2738,GSW,LAL,Andre Iguodala,101,22.0166666666667,22,0.0166666666666657,44,55,-11,-9,-2
21700479,201142,GSW,LAL,Kevin Durant,185,37.2833333333333,38,-0.716666666666669,93,77,16,15,1
21700479,201156,GSW,LAL,Nick Young,87,18.7333333333333,19,-0.266666666666666,42,43,-1,0,-1
21700479,201956,GSW,LAL,Omri Casspi,88,18.3833333333333,19,-0.616666666666667,36,48,-12,-13,1
21700479,202691,GSW,LAL,Klay Thompson,172,34.0166666666667,34,0.0166666666666657,80,74,6,6,0
21700479,203110,GSW,LAL,Draymond Green,151,29.8833333333333,30,-0.116666666666667,72,66,6,6,0
21700479,1626172,GSW,LAL,Kevon Looney,42,8.98333333333333,8,0.983333333333333,15,21,-6,-5,-1
21700479,1627775,GSW,LAL,Patrick McCaw,142,27.3,28,-0.700000000000003,71,56,15,14,1
21700479,1628395,GSW,LAL,Jordan Bell,125,24.5666666666667,25,-0.433333333333334,71,48,23,22,1
21700479,101106,LAL,GSW,Andrew Bogut,54,11.3666666666667,12,-0.633333333333333,23,23,0,1,-1
21700479,201147,LAL,GSW,Corey Brewer,25,4.88333333333333,5,-0.116666666666667,7,20,-13,-11,-2
21700479,203484,LAL,GSW,Kentavious Caldwell-Pope,169,33.6,34,-0.400000000000006,79,80,-1,-2,1
21700479,203903,LAL,GSW,Jordan Clarkson,75,14.7333333333333,14,0.733333333333334,33,30,3,3,0
21700479,203944,LAL,GSW,Julius Randle,124,23.9833333333333,24,-0.0166666666666657,63,54,9,8,1
21700479,1626204,LAL,GSW,Larry Nance Jr.,58,12.4,12,0.4,20,36,-16,-16,0
21700479,1627742,LAL,GSW,Brandon Ingram,169,34.95,36,-1.05,75,82,-7,-9,2
21700479,1627936,LAL,GSW,Alex Caruso,37,7,7,0,21,14,7,8,-1
21700479,1628366,LAL,GSW,Lonzo Ball,180,36.7833333333333,37,-0.216666666666669,77,90,-13,-13,0
21700479,1628398,LAL,GSW,Kyle Kuzma,206,42.3833333333333,43,-0.616666666666667,96,101,-5,-5,0
21700479,1628404,LAL,GSW,Josh Hart,83,16.6666666666667,16,0.666666666666664,36,35,1,1,0
21700480,101161,PHI,TOR,Amir Johnson,85,17.5333333333333,18,-0.466666666666669,42,37,5,7,-2
21700480,201573,PHI,TOR,Jerryd Bayless,107,23.3166666666667,24,-0.683333333333334,46,47,-1,-9,8
21700480,202344,PHI,TOR,Trevor Booker,75,15.0333333333333,15,0.0333333333333314,21,35,-14,-11,-3
21700480,203496,PHI,TOR,Robert Covington,170,36.8333333333333,37,-0.166666666666671,65,70,-5,-4,-1
21700480,203949,PHI,TOR,James Michael McAdoo,21,3.48333333333333,4,-0.516666666666667,8,8,0,0,0
21700480,203954,PHI,TOR,Joel Embiid,105,23.4166666666667,23,0.416666666666664,31,50,-19,-19,0
21700480,203967,PHI,TOR,Dario Saric,158,32.5833333333333,33,-0.416666666666664,60,68,-8,-9,1
21700480,204456,PHI,TOR,T.J. McConnell,104,19.8666666666667,20,-0.133333333333333,31,48,-17,-17,0
21700480,1626158,PHI,TOR,Richaun Holmes,21,3.48333333333333,4,-0.516666666666667,8,8,0,0,0
21700480,1626643,PHI,TOR,Jacob Pullen,21,3.48333333333333,4,-0.516666666666667,8,8,0,0,0
21700480,1627732,PHI,TOR,Ben Simmons,162,32.6333333333333,33,-0.366666666666667,62,71,-9,-8,-1
21700480,1627789,PHI,TOR,Timothe Luwawu-Cabarrot,131,26.75,27,-0.25,43,60,-17,-10,-7
21700480,200768,TOR,PHI,Kyle Lowry,143,29.8666666666667,30,-0.133333333333333,64,61,3,0,3
21700480,201586,TOR,PHI,Serge Ibaka,117,24.15,25,-0.850000000000001,57,50,7,4,3
21700480,201942,TOR,PHI,DeMar DeRozan,165,34.45,35,-0.549999999999997,78,63,15,16,-1
21700480,202685,TOR,PHI,Jonas Valanciunas,113,23.45,24,-0.550000000000001,49,50,-1,0,-1
21700480,1626153,TOR,PHI,Delon Wright,120,25.1333333333333,25,0.133333333333333,50,35,15,13,2
21700480,1626181,TOR,PHI,Norman Powell,64,12.5166666666667,13,-0.483333333333334,22,22,0,0,0
21700480,1626259,TOR,PHI,Malcolm Miller,16,2.46666666666667,3,-0.533333333333333,6,6,0,0,0
21700480,1627751,TOR,PHI,Jakob Poeltl,119,24.2333333333333,24,0.233333333333334,53,35,18,16,2
21700480,1627783,TOR,PHI,Pascal Siakam,110,22.5666666666667,23,-0.433333333333334,45,33,12,14,-2
21700480,1627832,TOR,PHI,Fred VanVleet,92,18.5333333333333,19,-0.466666666666669,40,24,16,16,0
21700480,1628384,TOR,PHI,OG Anunoby,101,21.05,21,0.0499999999999972,46,46,0,1,-1
21700481,202339,MIL,CHA,Eric Bledsoe,150,32.1666666666667,32,0.166666666666664,76,79,-3,-2,-1
21700481,202732,MIL,CHA,DeAndre Liggins,53,11.8333333333333,12,-0.166666666666666,21,26,-5,-7,2
21700481,203089,MIL,CHA,John Henson,134,28.45,28,0.450000000000003,65,55,10,9,1
21700481,203114,MIL,CHA,Khris Middleton,181,40.1833333333333,40,0.183333333333337,85,94,-9,-10,1
21700481,203503,MIL,CHA,Tony Snell,159,33.6166666666667,34,-0.383333333333333,76,78,-2,-3,1
21700481,203521,MIL,CHA,Matthew Dellavedova,82,18.8,19,-0.200000000000003,47,31,16,18,-2
21700481,203930,MIL,CHA,Sean Kilpatrick,69,15.3166666666667,15,0.316666666666666,38,39,-1,1,-2
21700481,1627748,MIL,CHA,Thon Maker,54,12.9,13,-0.100000000000001,23,34,-11,-11,0
21700481,1627763,MIL,CHA,Malcolm Brogdon,150,32.55,33,-0.450000000000003,67,83,-16,-19,3
21700481,1628391,MIL,CHA,D.J. Wilson,25,6.3,6,0.3,15,15,0,0,0
21700481,1628425,MIL,CHA,Sterling Brown,38,7.88333333333333,8,-0.116666666666667,17,16,1,-1,2
21700481,2730,CHA,MIL,Dwight Howard,152,32.1333333333333,32,0.133333333333333,68,75,-7,-5,-2
21700481,101107,CHA,MIL,Marvin Williams,97,20.5166666666667,21,-0.483333333333334,38,51,-13,-12,-1
21700481,201587,CHA,MIL,Nicolas Batum,168,35.5666666666667,35,0.566666666666663,87,80,7,5,2
21700481,202689,CHA,MIL,Kemba Walker,158,33.2666666666667,33,0.266666666666666,76,76,0,1,-1
21700481,203077,CHA,MIL,Michael Kidd-Gilchrist,113,22.8333333333333,23,-0.166666666666668,48,58,-10,-10,0
21700481,203087,CHA,MIL,Jeremy Lamb,82,18.8833333333333,19,-0.116666666666667,42,38,4,5,-1
21700481,203487,CHA,MIL,Michael Carter-Williams,67,15.0833333333333,15,0.0833333333333322,40,33,7,7,0
21700481,203948,CHA,MIL,Johnny O'Bryant III,33,8.85,9,-0.15,18,16,2,2,0
21700481,1626163,CHA,MIL,Frank Kaminsky,93,22.4666666666667,23,-0.533333333333331,57,42,15,16,-1
21700481,1626203,CHA,MIL,Treveon Graham,126,28.65,28,0.649999999999999,74,57,17,17,0
21700481,1628370,CHA,MIL,Malik Monk,6,1.75,2,-0.25,2,4,-2,-1,-1
21700482,201960,BKN,IND,DeMarre Carroll,154,36.35,36,0.350000000000001,85,85,0,-3,3
21700482,203092,BKN,IND,Tyler Zeller,89,21.35,21,0.350000000000001,46,45,1,2,-1
21700482,203112,BKN,IND,Quincy Acy,52,12.1666666666667,12,0.166666666666668,27,33,-6,-4,-2
21700482,203459,BKN,IND,Allen Crabbe,152,34.8166666666667,35,-0.183333333333337,83,76,7,5,2
21700482,203915,BKN,IND,Spencer Dinwiddie,165,38.7333333333333,39,-0.266666666666666,89,93,-4,-5,1
21700482,203917,BKN,IND,Nik Stauskas,60,12.6,13,-0.399999999999999,25,33,-8,-6,-2
21700482,203925,BKN,IND,Joe Harris,93,19.8333333333333,20,-0.166666666666664,43,40,3,6,-3
21700482,1626178,BKN,IND,Rondae Hollis-Jefferson,163,36.9,37,-0.100000000000001,85,85,0,-2,2
21700482,1627747,BKN,IND,Caris LeVert,162,34.2166666666667,34,0.216666666666669,79,81,-2,-3,1
21700482,1628386,BKN,IND,Jarrett Allen,80,18.0333333333333,18,0.0333333333333314,33,44,-11,-10,-1
21700482,201152,IND,BKN,Thaddeus Young,104,25.65,26,-0.350000000000001,69,53,16,16,0
21700482,201954,IND,BKN,Darren Collison,161,38.75,38,0.75,93,87,6,1,5
21700482,202362,IND,BKN,Lance Stephenson,116,24.0333333333333,24,0.0333333333333314,55,61,-6,-1,-5
21700482,202709,IND,BKN,Cory Joseph,109,21.8333333333333,22,-0.166666666666664,54,54,0,-2,2
21700482,202711,IND,BKN,Bojan Bogdanovic,175,39.7,40,-0.299999999999997,90,83,7,9,-2
21700482,203506,IND,BKN,Victor Oladipo,184,42.4666666666667,42,0.466666666666669,94,87,7,7,0
21700482,1626167,IND,BKN,Myles Turner,164,38.55,38,0.549999999999997,90,92,-2,-1,-1
21700482,1627734,IND,BKN,Domantas Sabonis,133,29.0833333333333,29,0.0833333333333322,62,66,-4,-5,1
21700482,1628388,IND,BKN,TJ Leaf,24,4.93333333333333,5,-0.0666666666666664,8,12,-4,-4,0
21700483,201167,ORL,WAS,Arron Afflalo,55,11.4166666666667,12,-0.583333333333332,33,32,1,4,-3
21700483,201571,ORL,WAS,D.J. Augustin,116,23.8666666666667,24,-0.133333333333333,39,65,-26,-26,0
21700483,201578,ORL,WAS,Marreese Speights,65,12.9666666666667,13,-0.0333333333333332,23,36,-13,-11,-2
21700483,202687,ORL,WAS,Bismack Biyombo,114,24.2,24,0.199999999999999,60,64,-4,-6,2
21700483,202696,ORL,WAS,Nikola Vucevic,23,4.96666666666667,5,-0.0333333333333332,12,15,-3,-3,0
21700483,203613,ORL,WAS,Jonathon Simmons,116,24.7333333333333,25,-0.266666666666666,51,66,-15,-17,2
21700483,203901,ORL,WAS,Elfrid Payton,171,35.5166666666667,36,-0.483333333333334,82,94,-12,-11,-1
21700483,203940,ORL,WAS,Adreian Payne,92,19.5166666666667,20,-0.483333333333334,33,54,-21,-21,0
21700483,1626209,ORL,WAS,Mario Hezonja,173,35.65,36,-0.349999999999994,82,94,-12,-11,-1
21700483,1628411,ORL,WAS,Wes Iwundu,116,24.8666666666667,25,-0.133333333333333,52,69,-17,-21,4
21700483,1628503,ORL,WAS,Jamel Artis,104,21.4666666666667,21,0.466666666666669,48,61,-13,-12,-1
21700483,101133,WAS,ORL,Ian Mahinmi,106,22.0666666666667,22,0.0666666666666664,64,48,16,17,-1
21700483,101162,WAS,ORL,Marcin Gortat,72,15.3166666666667,15,0.316666666666666,37,41,-4,-5,1
21700483,201160,WAS,ORL,Jason Smith,17,3.61666666666667,4,-0.383333333333334,8,3,5,5,0
21700483,201975,WAS,ORL,Jodie Meeks,89,19.0666666666667,19,0.0666666666666664,54,33,21,22,-1
21700483,202322,WAS,ORL,John Wall,147,30.8,31,-0.199999999999999,86,75,11,11,0
21700483,202693,WAS,ORL,Markieff Morris,131,27.1,27,0.100000000000001,73,69,4,4,0
21700483,203078,WAS,ORL,Bradley Beal,148,30.1833333333333,30,0.183333333333334,83,75,8,8,0
21700483,203107,WAS,ORL,Tomas Satoransky,82,17.0333333333333,17,0.0333333333333314,44,28,16,16,0
21700483,203118,WAS,ORL,Mike Scott,81,17.1166666666667,17,0.116666666666667,49,31,18,18,0
21700483,203490,WAS,ORL,Otto Porter Jr.,106,22.3166666666667,22,0.316666666666666,58,49,9,10,-1
21700483,204025,WAS,ORL,Tim Frazier,15,3.18333333333333,3,0.183333333333334,8,3,5,5,0
21700483,1626162,WAS,ORL,Kelly Oubre Jr.,134,27.75,28,-0.25,78,57,21,19,2
21700483,1626191,WAS,ORL,Chris McCullough,17,3.61666666666667,4,-0.383333333333334,8,3,5,5,0
21700484,101141,ATL,DAL,Ersan Ilyasova,151,34.8166666666667,36,-1.18333333333334,86,76,10,8,2
21700484,201158,ATL,DAL,Marco Belinelli,68,15.9,16,-0.100000000000001,29,37,-8,-9,1
21700484,203101,ATL,DAL,Miles Plumlee,92,20.6166666666667,21,-0.383333333333333,53,42,11,12,-1
21700484,203145,ATL,DAL,Kent Bazemore,125,28.2166666666667,29,-0.783333333333335,74,58,16,17,-1
21700484,203471,ATL,DAL,Dennis Schroder,155,35.85,36,-0.149999999999999,90,73,17,18,-1
21700484,1627098,ATL,DAL,Malcolm Delaney,122,28.1333333333333,28,0.133333333333333,63,67,-4,0,-4
21700484,1627752,ATL,DAL,Taurean Prince,123,28.55,29,-0.450000000000003,72,59,13,9,4
21700484,1627819,ATL,DAL,Isaiah Taylor,54,12.1,12,0.0999999999999996,22,34,-12,-13,1
21700484,1628381,ATL,DAL,John Collins,91,20.2166666666667,20,0.216666666666669,39,48,-9,-10,1
21700484,1628463,ATL,DAL,Tyler Cavanaugh,69,15.6,15,0.6,32,41,-9,-7,-2
21700484,1717,DAL,ATL,Dirk Nowitzki,116,26.9,27,-0.100000000000001,59,64,-5,-6,1
21700484,2734,DAL,ATL,Devin Harris,79,17.7,18,-0.299999999999997,47,40,7,5,2
21700484,200826,DAL,ATL,J.J. Barea,125,29.0666666666667,29,0.0666666666666629,71,61,10,12,-2
21700484,202083,DAL,ATL,Wesley Matthews,144,33.0833333333333,33,0.0833333333333286,68,83,-15,-11,-4
21700484,203084,DAL,ATL,Harrison Barnes,147,34.1833333333333,35,-0.816666666666663,70,83,-13,-13,0
21700484,203939,DAL,ATL,Dwight Powell,102,22.5,22,0.5,57,49,8,10,-2
21700484,1626257,DAL,ATL,Salah Mejri,48,10.5333333333333,11,-0.466666666666667,23,26,-3,2,-5
21700484,1627812,DAL,ATL,Yogi Ferrell,103,24.3166666666667,24,0.316666666666666,52,52,0,-3,3
21700484,1628372,DAL,ATL,Dennis Smith Jr.,101,22.4,22,0.399999999999999,51,55,-4,-7,3
21700484,1628467,DAL,ATL,Maxi Kleber,85,19.3166666666667,19,0.316666666666666,37,47,-10,-12,2
21700485,201143,BOS,CHI,Al Horford,125,27.4666666666667,28,-0.533333333333331,74,51,23,19,4
21700485,202681,BOS,CHI,Kyrie Irving,126,27.7166666666667,28,-0.283333333333331,79,50,29,33,-4
21700485,203382,BOS,CHI,Aron Baynes,69,14.25,14,0.25,43,26,17,17,0
21700485,203935,BOS,CHI,Marcus Smart,128,26.9666666666667,27,-0.0333333333333314,57,60,-3,-5,2
21700485,1626179,BOS,CHI,Terry Rozier,134,27.5166666666667,27,0.516666666666666,58,53,5,5,0
21700485,1627759,BOS,CHI,Jaylen Brown,127,27.2833333333333,27,0.283333333333331,78,52,26,28,-2
21700485,1627824,BOS,CHI,Guerschon Yabusele,11,2.36666666666667,3,-0.633333333333333,6,3,3,3,0
21700485,1627846,BOS,CHI,Abdel Nader,66,14.1,15,-0.899999999999999,29,20,9,7,2
21700485,1628369,BOS,CHI,Jayson Tatum,152,32.4666666666667,33,-0.533333333333331,85,62,23,23,0
21700485,1628400,BOS,CHI,Semi Ojeleye,53,11.2666666666667,11,0.266666666666666,24,34,-10,-10,0
21700485,1628443,BOS,CHI,Kadeem Allen,11,2.36666666666667,3,-0.633333333333333,6,3,3,3,0
21700485,1628464,BOS,CHI,Daniel Theis,113,23.9833333333333,24,-0.0166666666666657,46,46,0,2,-2
21700485,201577,CHI,BOS,Robin Lopez,74,16.65,17,-0.350000000000001,31,46,-15,-15,0
21700485,202347,CHI,BOS,Quincy Pondexter,24,5.11666666666667,6,-0.883333333333333,8,10,-2,-2,0
21700485,202703,CHI,BOS,Nikola Mirotic,109,22.5833333333333,23,-0.416666666666664,55,53,2,3,-1
21700485,203200,CHI,BOS,Justin Holiday,120,25.2666666666667,25,0.266666666666666,52,72,-20,-18,-2
21700485,1626170,CHI,BOS,Jerian Grant,111,23.3166666666667,23,0.316666666666666,48,45,3,4,-1
21700485,1626171,CHI,BOS,Bobby Portis,102,21.2833333333333,21,0.283333333333331,43,46,-3,-3,0
21700485,1626245,CHI,BOS,Cristiano Felicio,24,5.11666666666667,6,-0.883333333333333,8,10,-2,-2,0
21700485,1627739,CHI,BOS,Kris Dunn,112,24.2333333333333,25,-0.766666666666666,44,72,-28,-29,1
21700485,1627756,CHI,BOS,Denzel Valentine,112,25.5666666666667,26,-0.433333333333334,42,61,-19,-19,0
21700485,1627835,CHI,BOS,Paul Zipser,82,17,18,-1,35,38,-3,-5,2
21700485,1628021,CHI,BOS,David Nwaba,125,25.7833333333333,26,-0.216666666666669,53,61,-8,-8,0
21700485,1628374,CHI,BOS,Lauri Markkanen,120,25.8333333333333,26,-0.166666666666668,41,71,-30,-31,1
21700486,2749,NOP,MIA,Jameer Nelson,88,20.7833333333333,21,-0.216666666666669,46,39,7,5,2
21700486,200765,NOP,MIA,Rajon Rondo,97,22.95,23,-0.0500000000000007,55,50,5,5,0
21700486,201950,NOP,MIA,Jrue Holiday,134,31.0833333333333,31,0.0833333333333322,75,65,10,9,1
21700486,201967,NOP,MIA,Dante Cunningham,116,26.0833333333333,26,0.0833333333333357,60,43,17,17,0
21700486,202326,NOP,MIA,DeMarcus Cousins,116,28.7333333333333,29,-0.266666666666666,74,53,21,19,2
21700486,202734,NOP,MIA,E'Twaun Moore,116,27.05,27,0.0499999999999972,53,61,-8,-4,-4
21700486,203076,NOP,MIA,Anthony Davis,138,31.6833333333333,32,-0.31666666666667,74,66,8,6,2
21700486,203121,NOP,MIA,Darius Miller,89,20.7166666666667,21,-0.283333333333331,50,33,17,15,2
21700486,203546,NOP,MIA,Ian Clark,93,22.5166666666667,23,-0.483333333333334,51,36,15,16,-1
21700486,1627767,NOP,MIA,Cheick Diallo,19,4.7,5,-0.300000000000001,5,13,-8,-6,-2
21700486,1628429,NOP,MIA,Charles Cooke,14,3.45,3,0.45,2,11,-9,-7,-2
21700486,2617,MIA,NOP,Udonis Haslem,56,13.1833333333333,13,0.183333333333334,26,22,4,4,0
21700486,201609,MIA,NOP,Goran Dragic,124,29.5,30,-0.5,58,74,-16,-14,-2
21700486,201949,MIA,NOP,James Johnson,36,8.06666666666667,8,0.0666666666666664,18,19,-1,-1,0
21700486,201961,MIA,NOP,Wayne Ellington,151,35.1166666666667,35,0.116666666666667,67,82,-15,-15,0
21700486,203482,MIA,NOP,Kelly Olynyk,108,25.15,26,-0.850000000000001,51,60,-9,-14,5
21700486,204020,MIA,NOP,Tyler Johnson,121,27.9,28,-0.100000000000001,49,64,-15,-15,0
21700486,1626175,MIA,NOP,Jordan Mickey,79,19.05,19,0.0500000000000007,38,45,-7,-2,-5
21700486,1626196,MIA,NOP,Josh Richardson,156,36.7666666666667,37,-0.233333333333334,74,82,-8,-6,-2
21700486,1628389,MIA,NOP,Bam Adebayo,129,30.45,30,0.449999999999999,55,72,-17,-17,0
21700486,1628475,MIA,NOP,Matt Williams Jr.,14,3.45,3,0.45,11,2,9,7,2
21700486,1628476,MIA,NOP,Derrick Walton Jr.,46,11.1166666666667,11,0.116666666666667,23,23,0,-2,2
21700487,101150,LAC,MEM,Lou Williams,165,34.75,35,-0.25,80,85,-5,-7,2
21700487,201599,LAC,MEM,DeAndre Jordan,165,36.55,36,0.549999999999997,86,87,-1,1,-2
21700487,203085,LAC,MEM,Austin Rivers,147,33.3833333333333,33,0.383333333333333,80,77,3,1,2
21700487,203186,LAC,MEM,Willie Reed,53,10.4333333333333,11,-0.566666666666666,26,26,0,-2,2
21700487,203710,LAC,MEM,C.J. Williams,142,31.8,32,-0.199999999999999,77,72,5,5,0
21700487,203966,LAC,MEM,Jamil Wilson,87,21.1666666666667,21,0.166666666666668,50,52,-2,-3,1
21700487,1626149,LAC,MEM,Montrezl Harrell,64,12.25,13,-0.75,26,33,-7,-5,-2
21700487,1626155,LAC,MEM,Sam Dekker,90,17.95,18,-0.0499999999999972,36,47,-11,-10,-1
21700487,1628393,LAC,MEM,Jawun Evans,47,9.23333333333333,10,-0.766666666666666,18,26,-8,-6,-2
21700487,1628462,LAC,MEM,Milos Teodosic,150,32.4833333333333,32,0.483333333333334,81,70,11,11,0
21700487,201148,MEM,LAC,Brandan Wright,52,11.4166666666667,11,0.416666666666668,22,17,5,5,0
21700487,201188,MEM,LAC,Marc Gasol,162,35.1166666666667,35,0.116666666666667,86,88,-2,-2,0
21700487,201936,MEM,LAC,Tyreke Evans,175,38.5166666666667,38,0.516666666666666,93,92,1,3,-2
21700487,202718,MEM,LAC,Chandler Parsons,101,24.55,25,-0.449999999999999,67,61,6,1,5
21700487,203516,MEM,LAC,James Ennis III,133,28.1833333333333,28,0.183333333333334,70,58,12,12,0
21700487,1626150,MEM,LAC,Andrew Harrison,142,31.7666666666667,32,-0.233333333333334,71,79,-8,-12,4
21700487,1626185,MEM,LAC,Jarell Martin,88,17.35,17,0.350000000000001,37,32,5,10,-5
21700487,1627738,MEM,LAC,Deyonta Davis,20,4.13333333333333,4,0.133333333333333,12,12,0,0,0
21700487,1628415,MEM,LAC,Dillon Brooks,107,23.2833333333333,24,-0.716666666666669,60,65,-5,-6,1
21700487,1628424,MEM,LAC,Kobi Simmons,130,25.6833333333333,25,0.683333333333334,57,56,1,4,-3
21700488,2546,OKC,UTA,Carmelo Anthony,143,34.6666666666667,35,-0.333333333333329,71,62,9,9,0
21700488,101109,OKC,UTA,Raymond Felton,52,12.15,12,0.15,29,23,6,0,6
21700488,201566,OKC,UTA,Russell Westbrook,163,37.65,38,-0.350000000000001,77,72,5,12,-7
21700488,202331,OKC,UTA,Paul George,158,37.4333333333333,37,0.43333333333333,73,63,10,13,-3
21700488,202335,OKC,UTA,Patrick Patterson,54,11.8166666666667,11,0.816666666666666,29,25,4,3,1
21700488,203460,OKC,UTA,Andre Roberson,106,24.8666666666667,25,-0.133333333333333,52,45,7,11,-4
21700488,203500,OKC,UTA,Steven Adams,135,31.3833333333333,32,-0.616666666666667,60,57,3,6,-3
21700488,203518,OKC,UTA,Alex Abrines,67,16.2333333333333,16,0.233333333333334,37,32,5,2,3
21700488,203924,OKC,UTA,Jerami Grant,74,17.6666666666667,18,-0.333333333333336,44,34,10,10,0
21700488,203962,OKC,UTA,Josh Huestis,63,14.9666666666667,15,-0.033333333333335,38,32,6,4,2
21700488,2207,UTA,OKC,Joe Johnson,97,21.8833333333333,22,-0.116666666666667,46,53,-7,-7,0
21700488,200757,UTA,OKC,Thabo Sefolosha,63,15.55,16,-0.450000000000001,31,25,6,5,1
21700488,201937,UTA,OKC,Ricky Rubio,90,23.0166666666667,23,0.0166666666666657,37,51,-14,-10,-4
21700488,201973,UTA,OKC,Jonas Jerebko,55,12.55,13,-0.449999999999999,18,30,-12,-12,0
21700488,202324,UTA,OKC,Derrick Favors,141,33.8,34,-0.200000000000003,59,70,-11,-11,0
21700488,202327,UTA,OKC,Ekpe Udoh,62,13.9666666666667,14,-0.0333333333333332,30,32,-2,-3,1
21700488,202692,UTA,OKC,Alec Burks,55,12.3333333333333,13,-0.666666666666668,23,27,-4,-2,-2
21700488,203918,UTA,OKC,Rodney Hood,134,30.85,31,-0.149999999999999,60,66,-6,-4,-2
21700488,204060,UTA,OKC,Joe Ingles,140,33.3666666666667,33,0.366666666666667,60,69,-9,-16,7
21700488,1626220,UTA,OKC,Royce O'Neale,21,4.88333333333333,5,-0.116666666666667,13,12,1,2,-1
21700488,1628378,UTA,OKC,Donovan Mitchell,157,36.6333333333333,37,-0.366666666666667,68,75,-7,-12,5
21700489,201163,DEN,GSW,Wilson Chandler,147,32.5166666666667,33,-0.483333333333334,62,49,13,13,0
21700489,203115,DEN,GSW,Will Barton,137,28.7,29,-0.300000000000001,65,50,15,19,-4
21700489,203486,DEN,GSW,Mason Plumlee,116,24.6333333333333,25,-0.366666666666667,41,40,1,-1,2
21700489,203914,DEN,GSW,Gary Harris,163,35.7833333333333,36,-0.216666666666669,69,55,14,12,2
21700489,203999,DEN,GSW,Nikola Jokic,166,36.3333333333333,37,-0.666666666666671,74,62,12,17,-5
21700489,1626168,DEN,GSW,Trey Lyles,136,28.9,29,-0.100000000000001,63,51,12,11,1
21700489,1627736,DEN,GSW,Malik Beasley,48,9.6,9,0.6,22,19,3,3,0
21700489,1627750,DEN,GSW,Jamal Murray,123,25.9666666666667,26,-0.0333333333333314,45,45,0,0,0
21700489,1627823,DEN,GSW,Juancho Hernangomez,6,1.68333333333333,2,-0.316666666666667,4,4,0,-2,2
21700489,1628470,DEN,GSW,Torrey Craig,68,14.05,14,0.0500000000000007,35,30,5,3,2
21700489,2561,GSW,DEN,David West,60,11.65,12,-0.350000000000001,22,29,-7,-9,2
21700489,2738,GSW,DEN,Andre Iguodala,117,23.5166666666667,24,-0.483333333333334,41,48,-7,-7,0
21700489,201142,GSW,DEN,Kevin Durant,162,34.7666666666667,35,-0.233333333333334,56,69,-13,-13,0
21700489,201156,GSW,DEN,Nick Young,83,18.55,19,-0.449999999999999,32,49,-17,-18,1
21700489,201580,GSW,DEN,JaVale McGee,27,6.6,7,-0.4,15,14,1,2,-1
21700489,201956,GSW,DEN,Omri Casspi,98,21.0333333333333,22,-0.966666666666669,42,42,0,-1,1
21700489,202691,GSW,DEN,Klay Thompson,160,34.1666666666667,34,0.166666666666671,52,58,-6,-7,1
21700489,203110,GSW,DEN,Draymond Green,155,33.3666666666667,33,0.366666666666667,54,63,-9,-6,-3
21700489,1626172,GSW,DEN,Kevon Looney,26,5.96666666666667,6,-0.0333333333333332,13,12,1,-1,2
21700489,1626188,GSW,DEN,Quinn Cook,11,3.2,4,-0.8,8,6,2,2,0
21700489,1627775,GSW,DEN,Patrick McCaw,107,23.35,23,0.350000000000001,36,48,-12,-10,-2
21700489,1628395,GSW,DEN,Jordan Bell,104,22,22,0,34,42,-8,-7,-1
21700490,2037,MIN,PHX,Jamal Crawford,100,21.2333333333333,21,0.233333333333334,58,48,10,12,-2
21700490,201952,MIN,PHX,Jeff Teague,157,33.35,34,-0.649999999999999,73,76,-3,-5,2
21700490,201959,MIN,PHX,Taj Gibson,169,34.85,35,-0.149999999999999,82,87,-5,-9,4
21700490,202710,MIN,PHX,Jimmy Butler,173,37.6833333333333,38,-0.31666666666667,86,84,2,2,0
21700490,203476,MIN,PHX,Gorgui Dieng,107,22.5166666666667,23,-0.483333333333334,62,52,10,11,-1
21700490,203952,MIN,PHX,Andrew Wiggins,147,30.6166666666667,31,-0.383333333333333,72,73,-1,-4,3
21700490,1626145,MIN,PHX,Tyus Jones,68,14.3833333333333,14,0.383333333333333,42,30,12,14,-2
21700490,1626157,MIN,PHX,Karl-Anthony Towns,174,38.1,38,0.0999999999999943,86,73,13,14,-1
21700490,1627875,MIN,PHX,Marcus Georges-Hunt,30,5.93333333333333,6,-0.0666666666666664,14,7,7,10,-3
21700490,2199,PHX,MIN,Tyson Chandler,147,31.1166666666667,31,0.116666666666667,68,68,0,-2,2
21700490,203458,PHX,MIN,Alex Len,78,16.6166666666667,17,-0.383333333333333,38,47,-9,-7,-2
21700490,203477,PHX,MIN,Isaiah Canaan,139,29.9833333333333,30,-0.0166666666666657,68,76,-8,-8,0
21700490,203584,PHX,MIN,Troy Daniels,132,28.8,29,-0.199999999999999,68,77,-9,-6,-3
21700490,203933,PHX,MIN,T.J. Warren,178,38.5,39,-0.5,81,83,-2,-2,0
21700490,1627733,PHX,MIN,Dragan Bender,109,22.6833333333333,23,-0.31666666666667,53,64,-11,-8,-3
21700490,1627737,PHX,MIN,Marquese Chriss,116,25.05,25,0.0499999999999972,53,51,2,-1,3
21700490,1627755,PHX,MIN,Tyler Ulis,86,17.75,18,-0.25,38,39,-1,-1,0
21700490,1627863,PHX,MIN,Danuel House Jr.,44,8.5,8,0.5,22,29,-7,-7,0
21700490,1628367,PHX,MIN,Josh Jackson,96,19.6666666666667,19,0.666666666666664,41,41,0,-3,3
21700491,101106,LAL,POR,Andrew Bogut,71,14.8,15,-0.199999999999999,27,22,5,5,0
21700491,201147,LAL,POR,Corey Brewer,52,12.8166666666667,13,-0.183333333333334,21,30,-9,-9,0
21700491,203484,LAL,POR,Kentavious Caldwell-Pope,158,32.8166666666667,33,-0.18333333333333,68,61,7,7,0
21700491,203898,LAL,POR,Tyler Ennis,13,3.03333333333333,3,0.0333333333333332,3,6,-3,-3,0
21700491,203903,LAL,POR,Jordan Clarkson,97,21.1333333333333,21,0.133333333333333,35,48,-13,-13,0
21700491,203944,LAL,POR,Julius Randle,111,23,23,0,40,52,-12,-12,0
21700491,1626204,LAL,POR,Larry Nance Jr.,46,10.2,10,0.199999999999999,25,21,4,4,0
21700491,1627936,LAL,POR,Alex Caruso,56,11.9166666666667,12,-0.0833333333333339,19,29,-10,-11,1
21700491,1628366,LAL,POR,Lonzo Ball,179,36.6666666666667,36,0.666666666666671,74,68,6,8,-2
21700491,1628398,LAL,POR,Kyle Kuzma,176,35.1833333333333,35,0.183333333333337,71,65,6,6,0
21700491,1628404,LAL,POR,Josh Hart,166,34.5833333333333,34,0.583333333333329,71,62,9,8,1
21700491,1628418,LAL,POR,Thomas Bryant,15,3.85,4,-0.15,6,11,-5,-5,0
21700491,202323,POR,LAL,Evan Turner,98,20.5666666666667,21,-0.433333333333334,35,43,-8,-8,0
21700491,202329,POR,LAL,Al-Farouq Aminu,105,22.2,22,0.200000000000003,38,45,-7,-7,0
21700491,202334,POR,LAL,Ed Davis,134,28.1666666666667,28,0.166666666666664,60,51,9,9,0
21700491,203090,POR,LAL,Maurice Harkless,117,25.1333333333333,25,0.133333333333333,54,46,8,8,0
21700491,203468,POR,LAL,CJ McCollum,174,35.8166666666667,36,-0.183333333333337,68,72,-4,-3,-1
21700491,203894,POR,LAL,Shabazz Napier,164,34.7333333333333,35,-0.266666666666666,67,63,4,7,-3
21700491,203994,POR,LAL,Jusuf Nurkic,81,17.2,17,0.199999999999999,30,34,-4,-6,2
21700491,1626192,POR,LAL,Pat Connaughton,125,25.8833333333333,26,-0.116666666666667,60,48,12,10,2
21700491,1628380,POR,LAL,Zach Collins,142,30.3,31,-0.700000000000003,63,58,5,5,0
21700492,2216,SAC,SAS,Zach Randolph,132,30.75,31,-0.25,74,69,5,3,2
21700492,201585,SAC,SAS,Kosta Koufos,79,18.3333333333333,18,0.333333333333336,30,41,-11,-11,0
21700492,201588,SAC,SAS,George Hill,144,33.85,34,-0.150000000000006,78,74,4,3,1
21700492,202066,SAC,SAS,Garrett Temple,133,30.7666666666667,31,-0.233333333333334,72,75,-3,-2,-1
21700492,203992,SAC,SAS,Bogdan Bogdanovic,121,28.1666666666667,29,-0.833333333333336,58,65,-7,-8,1
21700492,1626161,SAC,SAS,Willie Cauley-Stein,135,30.7166666666667,31,-0.283333333333331,63,61,2,1,1
21700492,1627741,SAC,SAS,Buddy Hield,136,31.8333333333333,32,-0.166666666666668,67,74,-7,-9,2
21700492,1627781,SAC,SAS,Malachi Richardson,40,9.46666666666667,9,0.466666666666665,16,23,-7,-6,-1
21700492,1628382,SAC,SAS,Justin Jackson,36,8.53333333333333,9,-0.466666666666667,14,19,-5,-5,0
21700492,1628412,SAC,SAS,Frank Mason,69,16,16,0,23,34,-11,-11,0
21700492,1938,SAS,SAC,Manu Ginobili,95,21.4,21,0.399999999999999,52,48,4,6,-2
21700492,2200,SAS,SAC,Pau Gasol,135,30.6,31,-0.399999999999999,70,68,2,1,1
21700492,2225,SAS,SAC,Tony Parker,97,23.0333333333333,23,0.0333333333333314,53,49,4,4,0
21700492,200746,SAS,SAC,LaMarcus Aldridge,164,38.1333333333333,39,-0.866666666666667,85,81,4,4,0
21700492,200752,SAS,SAC,Rudy Gay,72,16.7,17,-0.300000000000001,43,38,5,6,-1
21700492,201988,SAS,SAC,Patty Mills,94,21.5333333333333,22,-0.466666666666669,55,44,11,12,-1
21700492,202722,SAS,SAC,Davis Bertans,37,9.56666666666667,10,-0.433333333333334,16,11,5,7,-2
21700492,203937,SAS,SAC,Kyle Anderson,112,26.65,27,-0.350000000000001,55,51,4,3,1
21700492,1627749,SAS,SAC,Dejounte Murray,108,24.65,25,-0.350000000000001,54,50,4,5,-1
21700492,1627854,SAS,SAC,Bryn Forbes,111,26.15,26,0.149999999999999,52,55,-3,-3,0
21700493,101127,NYK,PHI,Jarrett Jack,96,21,21,0,44,41,3,3,0
21700493,201563,NYK,PHI,Michael Beasley,118,22.65,23,-0.350000000000001,48,61,-13,-10,-3
21700493,201584,NYK,PHI,Courtney Lee,168,34.95,35,-0.0499999999999972,71,69,2,6,-4
21700493,202498,NYK,PHI,Lance Thomas,109,23.95,24,-0.0500000000000007,50,42,8,10,-2
21700493,202683,NYK,PHI,Enes Kanter,177,35.75,36,-0.25,75,72,3,3,0
21700493,203124,NYK,PHI,Kyle O'Quinn,55,11.5833333333333,11,0.583333333333332,21,31,-10,-10,0
21700493,203926,NYK,PHI,Doug McDermott,74,15.4333333333333,15,0.433333333333334,29,44,-15,-17,2
21700493,204001,NYK,PHI,Kristaps Porzingis,169,34.3333333333333,34,0.333333333333329,71,65,6,3,3
21700493,1627758,NYK,PHI,Ron Baker,66,12.95,13,-0.0500000000000007,27,36,-9,-13,4
21700493,1628373,NYK,PHI,Frank Ntilikina,138,26.9,27,-0.100000000000001,54,64,-10,-10,0
21700493,101161,PHI,NYK,Amir Johnson,60,13.15,14,-0.85,15,31,-16,-18,2
21700493,200755,PHI,NYK,JJ Redick,135,27.1333333333333,27,0.133333333333333,73,49,24,25,-1
21700493,201573,PHI,NYK,Jerryd Bayless,114,23.85,24,-0.149999999999999,49,48,1,2,-1
21700493,202344,PHI,NYK,Trevor Booker,73,14.7,15,-0.300000000000001,43,29,14,11,3
21700493,203496,PHI,NYK,Robert Covington,142,30.4833333333333,30,0.483333333333334,64,66,-2,-4,2
21700493,203954,PHI,NYK,Joel Embiid,174,34.75,34,0.75,90,67,23,25,-2
21700493,203967,PHI,NYK,Dario Saric,161,33.2,33,0.200000000000003,62,69,-7,-4,-3
21700493,204456,PHI,NYK,T.J. McConnell,150,29.4666666666667,29,0.466666666666669,64,64,0,2,-2
21700493,1627732,PHI,NYK,Ben Simmons,161,32.7666666666667,33,-0.233333333333334,65,67,-2,-4,2
21700494,2544,CLE,GSW,LeBron James,186,39.95,40,-0.0499999999999972,85,86,-1,-1,0
21700494,2548,CLE,GSW,Dwyane Wade,135,29.4333333333333,29,0.433333333333334,54,61,-7,-9,2
21700494,2594,CLE,GSW,Kyle Korver,104,21.5166666666667,21,0.516666666666666,40,47,-7,-5,-2
21700494,2747,CLE,GSW,JR Smith,145,30.5166666666667,31,-0.483333333333334,59,62,-3,-5,2
21700494,101181,CLE,GSW,Jose Calderon,77,16.7166666666667,17,-0.283333333333331,33,34,-1,1,-2
21700494,201145,CLE,GSW,Jeff Green,90,19.8833333333333,20,-0.116666666666667,33,39,-6,-6,0
21700494,201567,CLE,GSW,Kevin Love,169,35.8166666666667,36,-0.183333333333337,75,76,-1,-1,0
21700494,202684,CLE,GSW,Tristan Thompson,53,11.4833333333333,12,-0.516666666666666,17,23,-6,-4,-2
21700494,203109,CLE,GSW,Jae Crowder,134,28.4166666666667,29,-0.583333333333336,59,58,1,-1,2
21700494,1626224,CLE,GSW,Cedi Osman,27,5.76666666666667,6,-0.233333333333333,5,9,-4,-4,0
21700494,2561,GSW,CLE,David West,60,13.4166666666667,13,0.416666666666668,28,24,4,4,0
21700494,2733,GSW,CLE,Shaun Livingston,60,13.4166666666667,14,-0.583333333333332,28,24,4,2,2
21700494,2738,GSW,CLE,Andre Iguodala,114,23.9166666666667,24,-0.0833333333333357,56,48,8,12,-4
21700494,201142,GSW,CLE,Kevin Durant,173,37.1,37,0.100000000000001,76,72,4,4,0
21700494,201156,GSW,CLE,Nick Young,53,11.5666666666667,11,0.566666666666666,27,19,8,6,2
21700494,201956,GSW,CLE,Omri Casspi,60,12.0166666666667,12,0.0166666666666657,27,19,8,6,2
21700494,202691,GSW,CLE,Klay Thompson,168,35.5666666666667,36,-0.433333333333337,69,71,-2,2,-4
21700494,203110,GSW,CLE,Draymond Green,190,40.3166666666667,40,0.316666666666663,82,79,3,5,-2
21700494,1626172,GSW,CLE,Kevon Looney,14,2.93333333333333,3,-0.0666666666666664,6,7,-1,-1,0
21700494,1627775,GSW,CLE,Patrick McCaw,108,23.3,24,-0.700000000000003,43,47,-4,-8,4
21700494,1628395,GSW,CLE,Jordan Bell,120,25.95,26,-0.0499999999999972,53,50,3,3,0
21700495,201143,BOS,WAS,Al Horford,157,33.3833333333333,34,-0.616666666666667,65,87,-22,-20,-2
21700495,202681,BOS,WAS,Kyrie Irving,156,34,34,0,69,83,-14,-14,0
21700495,202694,BOS,WAS,Marcus Morris,77,16.1,16,0.100000000000001,39,29,10,9,1
21700495,203382,BOS,WAS,Aron Baynes,43,9.56666666666667,10,-0.433333333333334,14,25,-11,-12,1
21700495,203499,BOS,WAS,Shane Larkin,25,5.4,6,-0.6,14,10,4,4,0
21700495,203935,BOS,WAS,Marcus Smart,140,28.4833333333333,29,-0.516666666666666,61,65,-4,-2,-2
21700495,1626179,BOS,WAS,Terry Rozier,119,26.0833333333333,26,0.0833333333333322,58,52,6,3,3
21700495,1627759,BOS,WAS,Jaylen Brown,145,31.5166666666667,32,-0.483333333333334,66,80,-14,-11,-3
21700495,1628369,BOS,WAS,Jayson Tatum,166,35.5333333333333,36,-0.466666666666669,80,86,-6,-8,2
21700495,1628464,BOS,WAS,Daniel Theis,82,17.85,18,-0.149999999999999,49,38,11,11,0
21700495,101133,WAS,BOS,Ian Mahinmi,27,5.6,6,-0.4,11,9,2,2,0
21700495,101162,WAS,BOS,Marcin Gortat,126,26.85,27,-0.149999999999999,61,55,6,6,0
21700495,201975,WAS,BOS,Jodie Meeks,38,8.21666666666667,8,0.216666666666667,11,23,-12,-12,0
21700495,202322,WAS,BOS,John Wall,179,38.3833333333333,39,-0.616666666666667,95,78,17,15,2
21700495,202693,WAS,BOS,Markieff Morris,130,28.5333333333333,29,-0.466666666666669,76,59,17,17,0
21700495,203078,WAS,BOS,Bradley Beal,184,39.3666666666667,40,-0.633333333333333,100,80,20,20,0
21700495,203107,WAS,BOS,Tomas Satoransky,43,9.2,9,0.199999999999999,16,25,-9,-7,-2
21700495,203118,WAS,BOS,Mike Scott,71,15.2666666666667,15,0.266666666666666,26,43,-17,-17,0
21700495,203490,WAS,BOS,Otto Porter Jr.,162,34.9,36,-1.1,85,71,14,16,-2
21700495,1626162,WAS,BOS,Kelly Oubre Jr.,150,31.6,32,-0.399999999999999,74,72,2,0,2
21700496,2403,HOU,OKC,Nene,71,14.75,14,0.75,29,36,-7,-5,-2
21700496,2772,HOU,OKC,Trevor Ariza,194,42.8666666666667,43,-0.133333333333333,95,97,-2,-2,0
21700496,200782,HOU,OKC,PJ Tucker,133,29.2,29,0.200000000000003,60,68,-8,-10,2
21700496,201569,HOU,OKC,Eric Gordon,173,36.5666666666667,37,-0.433333333333337,85,83,2,1,1
21700496,201583,HOU,OKC,Ryan Anderson,139,29.6166666666667,30,-0.383333333333333,66,68,-2,0,-2
21700496,201935,HOU,OKC,James Harden,174,38.45,39,-0.549999999999997,88,96,-8,-7,-1
21700496,203991,HOU,OKC,Clint Capela,135,29.5166666666667,30,-0.483333333333334,73,76,-3,-3,0
21700496,1627362,HOU,OKC,Briante Weber,81,17.7833333333333,18,-0.216666666666669,39,36,3,1,2
21700496,2546,OKC,HOU,Carmelo Anthony,146,31.1,31,0.100000000000001,83,76,7,5,2
21700496,101109,OKC,HOU,Raymond Felton,68,14.7333333333333,15,-0.266666666666666,24,32,-8,-6,-2
21700496,201566,OKC,HOU,Russell Westbrook,169,36.55,37,-0.450000000000003,95,84,11,11,0
21700496,202331,OKC,HOU,Paul George,193,41.3333333333333,41,0.333333333333329,95,94,1,4,-3
21700496,202335,OKC,HOU,Patrick Patterson,43,9.08333333333333,9,0.0833333333333322,11,16,-5,-4,-1
21700496,203460,OKC,HOU,Andre Roberson,128,27.9166666666667,28,-0.0833333333333322,78,60,18,14,4
21700496,203500,OKC,HOU,Steven Adams,177,38.6666666666667,39,-0.333333333333329,101,91,10,9,1
21700496,203518,OKC,HOU,Alex Abrines,15,2.93333333333333,3,-0.0666666666666664,8,7,1,1,0
21700496,203924,OKC,HOU,Jerami Grant,82,18.8,19,-0.200000000000003,35,37,-2,2,-4
21700496,203962,OKC,HOU,Josh Huestis,79,17.6333333333333,18,-0.366666666666667,30,38,-8,-11,3
21700497,101106,LAL,MIN,Andrew Bogut,69,15.0833333333333,15,0.0833333333333322,25,39,-14,-14,0
21700497,201147,LAL,MIN,Corey Brewer,43,9.2,9,0.199999999999999,16,27,-11,-9,-2
21700497,203484,LAL,MIN,Kentavious Caldwell-Pope,164,35.5166666666667,36,-0.483333333333334,77,85,-8,-6,-2
21700497,203898,LAL,MIN,Tyler Ennis,70,14.6666666666667,15,-0.333333333333334,29,41,-12,-12,0
21700497,203903,LAL,MIN,Jordan Clarkson,163,35.05,35,0.0499999999999972,76,85,-9,-9,0
21700497,203944,LAL,MIN,Julius Randle,87,18.7833333333333,19,-0.216666666666669,42,53,-11,-11,0
21700497,1626204,LAL,MIN,Larry Nance Jr.,99,20.8666666666667,21,-0.133333333333333,51,51,0,0,0
21700497,1627936,LAL,MIN,Alex Caruso,49,10.6,10,0.6,26,31,-5,-7,2
21700497,1628398,LAL,MIN,Kyle Kuzma,191,41.1,41,0.100000000000001,90,99,-9,-9,0
21700497,1628404,LAL,MIN,Josh Hart,180,38.7166666666667,39,-0.283333333333331,88,94,-6,-8,2
21700497,2037,MIN,LAL,Jamal Crawford,91,18.9166666666667,19,-0.0833333333333322,48,38,10,11,-1
21700497,201952,MIN,LAL,Jeff Teague,148,32.6833333333333,33,-0.31666666666667,80,71,9,9,0
21700497,201959,MIN,LAL,Taj Gibson,155,34.1333333333333,34,0.133333333333333,78,75,3,5,-2
21700497,202357,MIN,LAL,Nemanja Bjelica,28,5.78333333333333,6,-0.216666666666667,15,15,0,-2,2
21700497,202710,MIN,LAL,Jimmy Butler,190,40.9833333333333,41,-0.0166666666666657,106,89,17,17,0
21700497,203476,MIN,LAL,Gorgui Dieng,78,16.1666666666667,16,0.166666666666668,45,32,13,13,0
21700497,203952,MIN,LAL,Andrew Wiggins,156,34.3333333333333,34,0.333333333333329,85,75,10,11,-1
21700497,1626145,MIN,LAL,Tyus Jones,75,15.2333333333333,15,0.233333333333333,41,33,8,8,0
21700497,1626157,MIN,LAL,Karl-Anthony Towns,185,39.75,40,-0.25,104,86,18,18,0
21700497,1627875,MIN,LAL,Marcus Georges-Hunt,9,1.6,2,-0.4,3,6,-3,-5,2
21700498,2744,IND,DET,Al Jefferson,25,6.06666666666667,6,0.0666666666666664,11,11,0,0,0
21700498,2863,IND,DET,Damien Wilkins,27,6.6,7,-0.4,13,13,0,-2,2
21700498,201152,IND,DET,Thaddeus Young,90,21.7833333333333,22,-0.216666666666669,29,64,-35,-34,-1
21700498,201954,IND,DET,Darren Collison,74,18.4,18,0.399999999999999,28,57,-29,-29,0
21700498,202362,IND,DET,Lance Stephenson,135,32.25,32,0.25,57,61,-4,-2,-2
21700498,202709,IND,DET,Cory Joseph,117,28.5333333333333,29,-0.466666666666669,48,51,-3,-1,-2
21700498,202711,IND,DET,Bojan Bogdanovic,101,23.7166666666667,24,-0.283333333333331,41,54,-13,-17,4
21700498,203506,IND,DET,Victor Oladipo,110,25.8,26,-0.200000000000003,45,68,-23,-23,0
21700498,1626167,IND,DET,Myles Turner,100,23.6833333333333,23,0.683333333333334,38,58,-20,-19,-1
21700498,1626202,IND,DET,Joe Young,27,6.6,7,-0.4,13,13,0,-2,2
21700498,1627734,IND,DET,Domantas Sabonis,68,17.1,17,0.100000000000001,29,34,-5,-6,1
21700498,1627816,IND,DET,Alex Poythress,96,22.3166666666667,22,0.316666666666666,52,40,12,15,-3
21700498,1628388,IND,DET,TJ Leaf,25,6.06666666666667,6,0.0666666666666664,11,11,0,0,0
21700498,201229,DET,IND,Anthony Tolliver,66,16.3666666666667,17,-0.633333333333333,26,31,-5,-5,0
21700498,202397,DET,IND,Ish Smith,100,24.6,25,-0.399999999999999,46,45,1,1,0
21700498,202699,DET,IND,Tobias Harris,125,29.3666666666667,29,0.366666666666667,77,48,29,29,0
21700498,202704,DET,IND,Reggie Jackson,91,21.1333333333333,21,0.133333333333333,57,34,23,23,0
21700498,202779,DET,IND,Dwight Buycks,8,2.05,2,0.0499999999999998,4,4,0,0,0
21700498,203083,DET,IND,Andre Drummond,135,32.5833333333333,33,-0.416666666666664,81,47,34,35,-1
21700498,203493,DET,IND,Reggie Bullock,125,29.3666666666667,29,0.366666666666667,77,48,29,29,0
21700498,203961,DET,IND,Eric Moreland,51,11.9333333333333,12,-0.0666666666666664,20,29,-9,-11,2
21700498,204038,DET,IND,Langston Galloway,74,18.4166666666667,19,-0.583333333333336,30,35,-5,-5,0
21700498,1626169,DET,IND,Stanley Johnson,152,36.2666666666667,36,0.266666666666666,68,64,4,2,2
21700498,1626246,DET,IND,Boban Marjanovic,13,3.26666666666667,3,0.266666666666667,6,7,-1,0,-1
21700498,1627740,DET,IND,Henry Ellenson,8,2.05,2,0.0499999999999998,4,4,0,0,0
21700498,1628379,DET,IND,Luke Kennard,47,11.5166666666667,12,-0.483333333333334,39,19,20,22,-2
21700499,1717,DAL,TOR,Dirk Nowitzki,128,26.6333333333333,27,-0.366666666666667,53,46,7,5,2
21700499,2734,DAL,TOR,Devin Harris,64,13.8666666666667,14,-0.133333333333333,29,31,-2,-4,2
21700499,200826,DAL,TOR,J.J. Barea,110,22.65,23,-0.350000000000001,50,45,5,5,0
21700499,202083,DAL,TOR,Wesley Matthews,177,35.8833333333333,36,-0.116666666666667,75,69,6,6,0
21700499,203084,DAL,TOR,Harrison Barnes,176,35.4833333333333,36,-0.516666666666666,71,67,4,6,-2
21700499,203939,DAL,TOR,Dwight Powell,87,18.15,18,0.149999999999999,39,33,6,8,-2
21700499,1626257,DAL,TOR,Salah Mejri,78,15.45,15,0.449999999999999,33,40,-7,-9,2
21700499,1627812,DAL,TOR,Yogi Ferrell,99,20.0166666666667,20,0.0166666666666657,40,35,5,5,0
21700499,1628372,DAL,TOR,Dennis Smith Jr.,130,26.4166666666667,27,-0.583333333333336,43,53,-10,-8,-2
21700499,1628467,DAL,TOR,Maxi Kleber,126,24.8666666666667,25,-0.133333333333333,57,46,11,11,0
21700499,101139,TOR,DAL,CJ Miles,55,10.5666666666667,10,0.566666666666666,18,34,-16,-16,0
21700499,200768,TOR,DAL,Kyle Lowry,167,34.2333333333333,34,0.233333333333334,70,55,15,16,-1
21700499,201586,TOR,DAL,Serge Ibaka,153,30.8333333333333,31,-0.166666666666664,62,52,10,9,1
21700499,201942,TOR,DAL,DeMar DeRozan,169,34.4666666666667,35,-0.533333333333331,65,66,-1,-3,2
21700499,202685,TOR,DAL,Jonas Valanciunas,128,25.05,25,0.0500000000000007,51,42,9,7,2
21700499,1626153,TOR,DAL,Delon Wright,77,15.9,16,-0.0999999999999996,26,46,-20,-20,0
21700499,1626181,TOR,DAL,Norman Powell,50,10.9833333333333,11,-0.0166666666666657,24,24,0,2,-2
21700499,1627751,TOR,DAL,Jakob Poeltl,82,17.4333333333333,18,-0.566666666666666,35,48,-13,-9,-4
21700499,1627783,TOR,DAL,Pascal Siakam,97,20.4,20,0.399999999999999,38,48,-10,-13,3
21700499,1627832,TOR,DAL,Fred VanVleet,97,19.9833333333333,20,-0.0166666666666657,31,36,-5,-5,0
21700499,1628384,TOR,DAL,OG Anunoby,100,19.5666666666667,20,-0.433333333333334,45,39,6,7,-1
21700500,201609,MIA,ORL,Goran Dragic,134,29.6,30,-0.399999999999999,59,53,6,6,0
21700500,201961,MIA,ORL,Wayne Ellington,160,33.7666666666667,34,-0.233333333333334,75,66,9,11,-2
21700500,202355,MIA,ORL,Hassan Whiteside,83,17.7166666666667,18,-0.283333333333335,34,29,5,4,1
21700500,203482,MIA,ORL,Kelly Olynyk,154,31.6833333333333,32,-0.316666666666663,74,56,18,20,-2
21700500,204020,MIA,ORL,Tyler Johnson,177,36.5,37,-0.5,92,58,34,32,2
21700500,1626175,MIA,ORL,Jordan Mickey,69,15.2333333333333,16,-0.766666666666668,29,35,-6,-8,2
21700500,1626196,MIA,ORL,Josh Richardson,171,36.2,36,0.200000000000003,82,67,15,15,0
21700500,1628389,MIA,ORL,Bam Adebayo,119,25.4666666666667,25,0.466666666666665,66,43,23,24,-1
21700500,1628475,MIA,ORL,Matt Williams Jr.,8,1.23333333333333,2,-0.766666666666667,5,5,0,0,0
21700500,1628476,MIA,ORL,Derrick Walton Jr.,55,11.1833333333333,11,0.183333333333334,19,33,-14,-14,0
21700500,201167,ORL,MIA,Arron Afflalo,77,16.6,17,-0.399999999999999,35,33,2,1,1
21700500,201571,ORL,MIA,D.J. Augustin,70,16,16,0,32,28,4,6,-2
21700500,201578,ORL,MIA,Marreese Speights,73,16.85,17,-0.150000000000002,35,30,5,7,-2
21700500,202687,ORL,MIA,Bismack Biyombo,145,29.6333333333333,30,-0.366666666666667,49,72,-23,-25,2
21700500,203095,ORL,MIA,Evan Fournier,143,29.9,30,-0.100000000000001,50,69,-19,-18,-1
21700500,203613,ORL,MIA,Jonathon Simmons,153,31.3166666666667,32,-0.683333333333334,54,79,-25,-21,-4
21700500,203901,ORL,MIA,Elfrid Payton,160,32.9833333333333,34,-1.01666666666667,57,81,-24,-24,0
21700500,203920,ORL,MIA,Khem Birch,8,1.23333333333333,2,-0.766666666666667,5,5,0,0,0
21700500,203940,ORL,MIA,Adreian Payne,8,1.23333333333333,2,-0.766666666666667,5,5,0,0,0
21700500,1626209,ORL,MIA,Mario Hezonja,154,32.3,32,0.299999999999997,57,71,-14,-14,0
21700500,1628371,ORL,MIA,Jonathan Isaac,71,15.75,16,-0.25,29,36,-7,-7,0
21700500,1628411,ORL,MIA,Wes Iwundu,68,14.7833333333333,15,-0.216666666666667,37,26,11,5,6
21700501,201577,CHI,MIL,Robin Lopez,117,23.4333333333333,24,-0.56666666666667,46,63,-17,-17,0
21700501,202703,CHI,MIL,Nikola Mirotic,133,27.75,28,-0.25,67,55,12,11,1
21700501,203200,CHI,MIL,Justin Holiday,168,32.2166666666667,33,-0.783333333333331,73,73,0,-1,1
21700501,1626170,CHI,MIL,Jerian Grant,63,14.4833333333333,14,0.483333333333334,40,33,7,11,-4
21700501,1626171,CHI,MIL,Bobby Portis,120,24.3,24,0.299999999999997,68,43,25,26,-1
21700501,1627739,CHI,MIL,Kris Dunn,174,33.25,34,-0.75,74,73,1,-2,3
21700501,1627756,CHI,MIL,Denzel Valentine,136,27.6333333333333,28,-0.366666666666667,65,62,3,3,0
21700501,1627835,CHI,MIL,Paul Zipser,47,11.35,11,0.35,31,25,6,8,-2
21700501,1628021,CHI,MIL,David Nwaba,123,24.2666666666667,25,-0.733333333333334,59,52,7,8,-1
21700501,1628374,CHI,MIL,Lauri Markkanen,104,19.9833333333333,20,-0.0166666666666657,47,51,-4,-2,-2
21700501,202339,MIL,CHI,Eric Bledsoe,148,28.8166666666667,29,-0.183333333333334,68,68,0,-3,3
21700501,202732,MIL,CHI,DeAndre Liggins,78,17.0333333333333,17,0.0333333333333314,34,42,-8,-8,0
21700501,203089,MIL,CHI,John Henson,109,20.7166666666667,21,-0.283333333333331,51,47,4,2,2
21700501,203114,MIL,CHI,Khris Middleton,193,39.1666666666667,39,0.166666666666664,81,98,-17,-11,-6
21700501,203503,MIL,CHI,Tony Snell,172,32.4166666666667,33,-0.583333333333336,73,72,1,2,-1
21700501,203507,MIL,CHI,Giannis Antetokounmpo,191,36.7166666666667,37,-0.283333333333331,86,83,3,2,1
21700501,203521,MIL,CHI,Matthew Dellavedova,78,17.2666666666667,18,-0.733333333333334,37,46,-9,-9,0
21700501,1627748,MIL,CHI,Thon Maker,73,16.85,17,-0.149999999999999,34,43,-9,-9,0
21700501,1627763,MIL,CHI,Malcolm Brogdon,143,29.6833333333333,30,-0.31666666666667,66,71,-5,-11,6
21700502,201960,BKN,SAS,DeMarre Carroll,126,27.0833333333333,27,0.0833333333333322,61,62,-1,-4,3
21700502,203092,BKN,SAS,Tyler Zeller,86,19.0166666666667,19,0.0166666666666657,35,43,-8,-6,-2
21700502,203112,BKN,SAS,Quincy Acy,88,19.6833333333333,20,-0.316666666666666,41,40,1,1,0
21700502,203459,BKN,SAS,Allen Crabbe,143,31.7833333333333,32,-0.216666666666669,70,75,-5,-7,2
21700502,203915,BKN,SAS,Spencer Dinwiddie,126,26.6,26,0.600000000000001,61,67,-6,-4,-2
21700502,203917,BKN,SAS,Nik Stauskas,51,11.2666666666667,12,-0.733333333333334,21,21,0,0,0
21700502,203925,BKN,SAS,Joe Harris,118,25.8,26,-0.200000000000003,40,53,-13,-13,0
21700502,1626178,BKN,SAS,Rondae Hollis-Jefferson,127,27.2,27,0.200000000000003,65,71,-6,-4,-2
21700502,1627747,BKN,SAS,Caris LeVert,130,27.95,28,-0.0500000000000007,54,71,-17,-16,-1
21700502,1628386,BKN,SAS,Jarrett Allen,93,20.8166666666667,21,-0.183333333333334,35,40,-5,-7,2
21700502,1628495,BKN,SAS,Milton Doyle,7,1.38333333333333,2,-0.616666666666667,2,2,0,0,0
21700502,1938,SAS,BKN,Manu Ginobili,105,21.1666666666667,21,0.166666666666664,54,45,9,8,1
21700502,2200,SAS,BKN,Pau Gasol,134,28.7333333333333,29,-0.266666666666666,68,57,11,12,-1
21700502,2225,SAS,BKN,Tony Parker,106,24.5,25,-0.5,49,44,5,7,-2
21700502,200746,SAS,BKN,LaMarcus Aldridge,153,34.4166666666667,34,0.416666666666664,80,72,8,8,0
21700502,200752,SAS,BKN,Rudy Gay,75,15.6333333333333,16,-0.366666666666667,36,28,8,8,0
21700502,201980,SAS,BKN,Danny Green,103,23.1833333333333,23,0.183333333333334,47,51,-4,-6,2
21700502,201988,SAS,BKN,Patty Mills,106,21.8333333333333,22,-0.166666666666668,58,51,7,5,2
21700502,202695,SAS,BKN,Kawhi Leonard,122,26.0833333333333,26,0.0833333333333357,65,48,17,18,-1
21700502,202722,SAS,BKN,Davis Bertans,19,4.46666666666667,5,-0.533333333333333,5,8,-3,-3,0
21700502,203530,SAS,BKN,Joffrey Lauvergne,18,3.86666666666667,4,-0.133333333333333,5,8,-3,-3,0
21700502,203937,SAS,BKN,Kyle Anderson,82,18.0833333333333,18,0.0833333333333357,39,29,10,9,1
21700502,1627749,SAS,BKN,Dejounte Murray,17,3.8,4,-0.2,9,10,-1,-1,0
21700502,1627854,SAS,BKN,Bryn Forbes,55,12.8166666666667,13,-0.183333333333334,30,34,-4,-2,-2
21700503,2210,DEN,UTA,Richard Jefferson,8,1.61666666666667,2,-0.383333333333333,9,2,7,7,0
21700503,201163,DEN,UTA,Wilson Chandler,141,32.9,34,-1.1,70,53,17,16,1
21700503,203115,DEN,UTA,Will Barton,159,36.0666666666667,36,0.0666666666666629,77,60,17,17,0
21700503,203486,DEN,UTA,Mason Plumlee,87,20.2333333333333,20,0.233333333333334,39,39,0,-1,1
21700503,203914,DEN,UTA,Gary Harris,159,36.0666666666667,36,0.0666666666666629,80,63,17,17,0
21700503,203999,DEN,UTA,Nikola Jokic,102,25.2166666666667,26,-0.783333333333331,54,43,11,11,0
21700503,1626144,DEN,UTA,Emmanuel Mudiay,8,1.61666666666667,2,-0.383333333333333,9,2,7,7,0
21700503,1626168,DEN,UTA,Trey Lyles,126,27.95,28,-0.0500000000000007,63,50,13,15,-2
21700503,1627736,DEN,UTA,Malik Beasley,8,1.61666666666667,2,-0.383333333333333,9,2,7,7,0
21700503,1627750,DEN,UTA,Jamal Murray,154,35.15,35,0.150000000000006,78,64,14,13,1
21700503,1628470,DEN,UTA,Torrey Craig,93,21.2333333333333,21,0.233333333333334,47,37,10,11,-1
21700503,2207,UTA,DEN,Joe Johnson,112,24.6,24,0.600000000000001,42,49,-7,-8,1
21700503,201937,UTA,DEN,Ricky Rubio,146,32.15,32,0.149999999999999,53,72,-19,-16,-3
21700503,201973,UTA,DEN,Jonas Jerebko,110,26.1,27,-0.899999999999999,46,62,-16,-15,-1
21700503,202324,UTA,DEN,Derrick Favors,122,28.2833333333333,29,-0.716666666666669,51,63,-12,-15,3
21700503,202327,UTA,DEN,Ekpe Udoh,56,12.5333333333333,12,0.533333333333333,18,33,-15,-11,-4
21700503,202692,UTA,DEN,Alec Burks,56,12.3833333333333,12,0.383333333333333,19,33,-14,-14,0
21700503,203918,UTA,DEN,Rodney Hood,122,28.9333333333333,29,-0.06666666666667,50,64,-14,-19,5
21700503,204060,UTA,DEN,Joe Ingles,125,29.7833333333333,30,-0.216666666666669,53,62,-9,-6,-3
21700503,1626220,UTA,DEN,Royce O'Neale,56,12.2166666666667,12,0.216666666666665,23,28,-5,-5,0
21700503,1628378,UTA,DEN,Donovan Mitchell,137,32.2,33,-0.799999999999997,57,68,-11,-16,5
21700503,1628513,UTA,DEN,Naz Mitrou-Long,3,0.483333333333333,1,-0.516666666666667,3,1,2,5,-3
21700504,2199,PHX,MEM,Tyson Chandler,90,17.8833333333333,18,-0.116666666666667,48,42,6,2,4
21700504,203458,PHX,MEM,Alex Len,129,29.5833333333333,30,-0.416666666666668,50,53,-3,-1,-2
21700504,203477,PHX,MEM,Isaiah Canaan,94,20.4833333333333,21,-0.516666666666666,37,49,-12,-8,-4
21700504,203584,PHX,MEM,Troy Daniels,94,20.1,20,0.100000000000001,42,49,-7,-4,-3
21700504,203933,PHX,MEM,T.J. Warren,142,30.05,30,0.0500000000000007,62,53,9,6,3
21700504,1626164,PHX,MEM,Devin Booker,156,33.9166666666667,34,-0.0833333333333286,73,63,10,10,0
21700504,1627733,PHX,MEM,Dragan Bender,83,18.5,18,0.5,36,47,-11,-9,-2
21700504,1627737,PHX,MEM,Marquese Chriss,140,29.1333333333333,29,0.133333333333333,64,50,14,11,3
21700504,1627755,PHX,MEM,Tyler Ulis,130,27.7833333333333,27,0.783333333333331,62,49,13,11,2
21700504,1628367,PHX,MEM,Josh Jackson,57,12.5666666666667,13,-0.433333333333334,21,30,-9,-8,-1
21700504,201148,MEM,PHX,Brandan Wright,84,18.6666666666667,19,-0.333333333333336,27,39,-12,-12,0
21700504,201188,MEM,PHX,Marc Gasol,180,37.8166666666667,38,-0.183333333333337,70,82,-12,-12,0
21700504,201936,MEM,PHX,Tyreke Evans,166,36.1333333333333,37,-0.866666666666667,80,71,9,11,-2
21700504,203516,MEM,PHX,James Ennis III,113,21.3833333333333,21,0.383333333333333,51,47,4,6,-2
21700504,1626150,MEM,PHX,Andrew Harrison,136,30.8833333333333,31,-0.116666666666667,55,55,0,-8,8
21700504,1626185,MEM,PHX,Jarell Martin,131,27.05,27,0.0499999999999972,63,63,0,-1,1
21700504,1627738,MEM,PHX,Deyonta Davis,37,8.48333333333333,9,-0.516666666666668,24,14,10,10,0
21700504,1628415,MEM,PHX,Dillon Brooks,142,33.0166666666667,33,0.0166666666666657,61,67,-6,-2,-4
21700504,1628424,MEM,PHX,Kobi Simmons,126,26.5666666666667,26,0.566666666666663,54,57,-3,-2,-1
21700505,101150,LAC,SAC,Lou Williams,128,26.9833333333333,27,-0.0166666666666657,75,53,22,22,0
21700505,201599,LAC,SAC,DeAndre Jordan,123,26.3166666666667,26,0.316666666666666,66,56,10,10,0
21700505,203085,LAC,SAC,Austin Rivers,122,25.5666666666667,26,-0.433333333333334,67,54,13,11,2
21700505,203186,LAC,SAC,Willie Reed,22,5.16666666666667,5,0.166666666666666,14,7,7,7,0
21700505,203710,LAC,SAC,C.J. Williams,97,21.6666666666667,22,-0.333333333333332,47,45,2,2,0
21700505,203966,LAC,SAC,Jamil Wilson,88,18.6833333333333,19,-0.316666666666666,42,42,0,0,0
21700505,1626149,LAC,SAC,Montrezl Harrell,99,21.5,22,-0.5,56,39,17,17,0
21700505,1626155,LAC,SAC,Sam Dekker,112,23.9666666666667,24,-0.0333333333333314,66,46,20,20,0
21700505,1628393,LAC,SAC,Jawun Evans,122,26.45,27,-0.550000000000001,65,53,12,12,0
21700505,1628414,LAC,SAC,Sindarius Thornwell,100,22.25,22,0.25,55,41,14,16,-2
21700505,1628462,LAC,SAC,Milos Teodosic,97,20.5333333333333,21,-0.466666666666669,57,39,18,18,0
21700505,2216,SAC,LAC,Zach Randolph,101,21.3,21,0.300000000000001,44,58,-14,-14,0
21700505,201585,SAC,LAC,Kosta Koufos,66,14.6833333333333,15,-0.316666666666666,29,42,-13,-12,-1
21700505,201588,SAC,LAC,George Hill,130,27.25,27,0.25,56,66,-10,-10,0
21700505,202066,SAC,LAC,Garrett Temple,104,21.8,22,-0.200000000000003,48,55,-7,-7,0
21700505,203992,SAC,LAC,Bogdan Bogdanovic,138,29.2166666666667,29,0.216666666666665,56,77,-21,-23,2
21700505,1626161,SAC,LAC,Willie Cauley-Stein,120,25.25,25,0.25,50,58,-8,-9,1
21700505,1627741,SAC,LAC,Buddy Hield,78,17.3666666666667,18,-0.633333333333333,36,40,-4,-4,0
21700505,1627781,SAC,LAC,Malachi Richardson,142,30.7,31,-0.300000000000001,59,82,-23,-21,-2
21700505,1627834,SAC,LAC,Georgios Papagiannis,33,7.73333333333333,8,-0.266666666666668,15,16,-1,-1,0
21700505,1628382,SAC,LAC,Justin Jackson,97,21.85,22,-0.149999999999999,43,58,-15,-15,0
21700505,1628412,SAC,LAC,Frank Mason,101,21.9333333333333,22,-0.0666666666666664,39,58,-19,-19,0
21700506,201143,BOS,CHA,Al Horford,155,35.65,36,-0.350000000000001,78,66,12,15,-3
21700506,202681,BOS,CHA,Kyrie Irving,142,30.7666666666667,31,-0.233333333333334,63,58,5,4,1
21700506,203382,BOS,CHA,Aron Baynes,115,25.1166666666667,26,-0.883333333333333,49,50,-1,-2,1
21700506,203499,BOS,CHA,Shane Larkin,105,23.8166666666667,24,-0.183333333333334,56,45,11,14,-3
21700506,203935,BOS,CHA,Marcus Smart,153,34.5166666666667,35,-0.483333333333334,74,69,5,4,1
21700506,1626179,BOS,CHA,Terry Rozier,117,26.3,26,0.299999999999997,60,51,9,7,2
21700506,1627824,BOS,CHA,Guerschon Yabusele,48,9.75,10,-0.25,18,20,-2,-3,1
21700506,1628369,BOS,CHA,Jayson Tatum,158,35.1166666666667,35,0.116666666666667,68,59,9,10,-1
21700506,1628464,BOS,CHA,Daniel Theis,77,17.05,17,0.0500000000000007,44,37,7,6,1
21700506,2730,CHA,BOS,Dwight Howard,164,35.8666666666667,36,-0.133333333333333,71,76,-5,-3,-2
21700506,101107,CHA,BOS,Marvin Williams,151,33.55,34,-0.450000000000003,67,72,-5,-2,-3
21700506,201587,CHA,BOS,Nicolas Batum,153,33.7833333333333,34,-0.216666666666669,66,72,-6,-5,-1
21700506,202689,CHA,BOS,Kemba Walker,161,35.7166666666667,36,-0.283333333333331,69,74,-5,-4,-1
21700506,203077,CHA,BOS,Michael Kidd-Gilchrist,117,25.4,25,0.399999999999999,52,58,-6,-4,-2
21700506,203087,CHA,BOS,Jeremy Lamb,95,21.8166666666667,22,-0.183333333333334,39,44,-5,-7,2
21700506,203487,CHA,BOS,Michael Carter-Williams,53,11.9,12,-0.100000000000001,22,28,-6,-7,1
21700506,203948,CHA,BOS,Johnny O'Bryant III,35,7.85,8,-0.15,15,20,-5,-7,2
21700506,1626163,CHA,BOS,Frank Kaminsky,78,17.9666666666667,18,-0.0333333333333314,29,36,-7,-10,3
21700506,1626203,CHA,BOS,Treveon Graham,63,14.2333333333333,14,0.233333333333334,25,30,-5,-6,1
21700507,1717,DAL,IND,Dirk Nowitzki,108,26.4,26,0.399999999999999,54,48,6,6,0
21700507,2734,DAL,IND,Devin Harris,92,22.6166666666667,22,0.616666666666667,49,46,3,3,0
21700507,200826,DAL,IND,J.J. Barea,83,20.7833333333333,21,-0.216666666666669,46,40,6,6,0
21700507,202083,DAL,IND,Wesley Matthews,133,32.05,32,0.0499999999999972,63,64,-1,-1,0
21700507,203084,DAL,IND,Harrison Barnes,126,30.5833333333333,31,-0.416666666666664,59,60,-1,-1,0
21700507,203939,DAL,IND,Dwight Powell,97,22.8,23,-0.200000000000003,53,40,13,13,0
21700507,1626257,DAL,IND,Salah Mejri,32,7.4,7,0.4,17,16,1,1,0
21700507,1627812,DAL,IND,Yogi Ferrell,126,30.7333333333333,31,-0.266666666666666,63,61,2,1,1
21700507,1628372,DAL,IND,Dennis Smith Jr.,120,28.7666666666667,29,-0.233333333333334,58,57,1,2,-1
21700507,1628467,DAL,IND,Maxi Kleber,68,17.7833333333333,18,-0.216666666666669,28,38,-10,-10,0
21700507,201152,IND,DAL,Thaddeus Young,144,35.2333333333333,35,0.233333333333334,76,71,5,7,-2
21700507,201954,IND,DAL,Darren Collison,142,34.8833333333333,35,-0.116666666666667,72,70,2,2,0
21700507,202362,IND,DAL,Lance Stephenson,144,35.3833333333333,36,-0.616666666666674,74,75,-1,-1,0
21700507,202709,IND,DAL,Cory Joseph,129,30.2,30,0.199999999999999,56,70,-14,-14,0
21700507,202711,IND,DAL,Bojan Bogdanovic,142,35.2,35,0.200000000000003,65,60,5,3,2
21700507,1626167,IND,DAL,Myles Turner,141,34.1666666666667,35,-0.833333333333336,68,66,2,2,0
21700507,1626202,IND,DAL,Joe Young,55,13.1,13,0.100000000000001,22,28,-6,-6,0
21700507,1627734,IND,DAL,Domantas Sabonis,77,19.1,19,0.100000000000001,37,42,-5,-5,0
21700507,1627816,IND,DAL,Alex Poythress,11,2.65,2,0.65,0,8,-8,-8,0
21700508,101141,ATL,WAS,Ersan Ilyasova,147,29.4333333333333,29,0.433333333333334,70,72,-2,6,-8
21700508,201158,ATL,WAS,Marco Belinelli,101,20.5833333333333,21,-0.416666666666664,52,32,20,22,-2
21700508,203101,ATL,WAS,Miles Plumlee,114,23.65,23,0.649999999999999,52,61,-9,-9,0
21700508,203145,ATL,WAS,Kent Bazemore,121,25.7666666666667,26,-0.233333333333334,55,62,-7,-7,0
21700508,203471,ATL,WAS,Dennis Schroder,163,32.5,32,0.5,81,74,7,10,-3
21700508,1627098,ATL,WAS,Malcolm Delaney,84,18.2666666666667,19,-0.733333333333334,51,28,23,21,2
21700508,1627752,ATL,WAS,Taurean Prince,156,31.6666666666667,32,-0.333333333333336,73,76,-3,-3,0
21700508,1627819,ATL,WAS,Isaiah Taylor,66,15.1166666666667,16,-0.883333333333333,32,25,7,4,3
21700508,1628381,ATL,WAS,John Collins,111,22.9166666666667,24,-1.08333333333333,56,38,18,18,0
21700508,1628463,ATL,WAS,Tyler Cavanaugh,82,18.1833333333333,19,-0.816666666666666,43,27,16,8,8
21700508,101133,WAS,ATL,Ian Mahinmi,80,17.7833333333333,17,0.783333333333331,39,46,-7,-5,-2
21700508,101162,WAS,ATL,Marcin Gortat,102,20.3666666666667,21,-0.633333333333333,39,38,1,-1,2
21700508,201975,WAS,ATL,Jodie Meeks,67,15.75,16,-0.25,35,37,-2,-3,1
21700508,202322,WAS,ATL,John Wall,166,33.3833333333333,34,-0.616666666666667,65,82,-17,-16,-1
21700508,202693,WAS,ATL,Markieff Morris,157,31.3,31,0.299999999999997,64,72,-8,-10,2
21700508,203078,WAS,ATL,Bradley Beal,173,34.5166666666667,35,-0.483333333333334,72,86,-14,-13,-1
21700508,203107,WAS,ATL,Tomas Satoransky,55,12.45,12,0.449999999999999,27,24,3,2,1
21700508,203118,WAS,ATL,Mike Scott,79,17.9666666666667,18,-0.0333333333333314,37,43,-6,-4,-2
21700508,203490,WAS,ATL,Otto Porter Jr.,155,30.7666666666667,31,-0.233333333333334,62,70,-8,-10,2
21700508,1626162,WAS,ATL,Kelly Oubre Jr.,104,22.25,23,-0.75,49,65,-16,-14,-2
21700508,1626191,WAS,ATL,Chris McCullough,7,1.55,2,-0.45,6,2,4,4,0
21700509,201577,CHI,NYK,Robin Lopez,129,29.4666666666667,30,-0.533333333333331,51,61,-10,-7,-3
21700509,202703,CHI,NYK,Nikola Mirotic,117,25.35,25,0.350000000000001,46,43,3,3,0
21700509,203200,CHI,NYK,Justin Holiday,171,37.2333333333333,37,0.233333333333334,73,67,6,6,0
21700509,1626170,CHI,NYK,Jerian Grant,76,16.2833333333333,16,0.283333333333335,41,34,7,6,1
21700509,1626171,CHI,NYK,Bobby Portis,66,13.25,13,0.25,25,25,0,1,-1
21700509,1627739,CHI,NYK,Kris Dunn,144,31.6833333333333,32,-0.31666666666667,51,53,-2,-1,-1
21700509,1627756,CHI,NYK,Denzel Valentine,130,28.9166666666667,29,-0.0833333333333357,60,49,11,13,-2
21700509,1627835,CHI,NYK,Paul Zipser,49,10.7333333333333,11,-0.266666666666666,19,20,-1,-1,0
21700509,1628021,CHI,NYK,David Nwaba,90,19.05,19,0.0500000000000007,32,38,-6,-10,4
21700509,1628374,CHI,NYK,Lauri Markkanen,128,27.8666666666667,28,-0.133333333333333,62,45,17,15,2
21700509,101127,NYK,CHI,Jarrett Jack,94,19.5666666666667,20,-0.433333333333334,38,46,-8,-4,-4
21700509,201563,NYK,CHI,Michael Beasley,73,14.75,15,-0.25,25,30,-5,-5,0
21700509,201584,NYK,CHI,Courtney Lee,159,34.8833333333333,35,-0.11666666666666,59,69,-10,-10,0
21700509,202498,NYK,CHI,Lance Thomas,131,28.5166666666667,28,0.516666666666666,56,58,-2,-4,2
21700509,202683,NYK,CHI,Enes Kanter,98,21.8333333333333,22,-0.166666666666664,40,47,-7,-5,-2
21700509,203124,NYK,CHI,Kyle O'Quinn,76,16.7333333333333,17,-0.266666666666666,36,25,11,9,2
21700509,203926,NYK,CHI,Doug McDermott,166,36.2666666666667,37,-0.733333333333334,59,68,-9,-7,-2
21700509,204001,NYK,CHI,Kristaps Porzingis,179,38.9666666666667,39,-0.0333333333333314,73,73,0,0,0
21700509,1628373,NYK,CHI,Frank Ntilikina,124,28.3166666666667,28,0.316666666666666,49,44,5,1,4
21700510,201163,DEN,MIN,Wilson Chandler,125,29.5833333333333,30,-0.416666666666668,58,72,-14,-11,-3
21700510,201589,DEN,MIN,Darrell Arthur,25,4.95,5,-0.0500000000000007,8,13,-5,-5,0
21700510,203115,DEN,MIN,Will Barton,149,34.05,34,0.0499999999999972,91,80,11,9,2
21700510,203486,DEN,MIN,Mason Plumlee,104,25.0666666666667,25,0.0666666666666664,51,58,-7,-5,-2
21700510,203914,DEN,MIN,Gary Harris,178,41.75,41,0.75,92,100,-8,-5,-3
21700510,203999,DEN,MIN,Nikola Jokic,175,41.1333333333333,41,0.133333333333333,97,100,-3,1,-4
21700510,1626168,DEN,MIN,Trey Lyles,141,31.6833333333333,31,0.68333333333333,88,79,9,7,2
21700510,1627750,DEN,MIN,Jamal Murray,196,45.7333333333333,46,-0.266666666666666,107,107,0,-1,1
21700510,1628470,DEN,MIN,Torrey Craig,52,11.05,11,0.0500000000000007,33,31,2,-5,7
21700510,2037,MIN,DEN,Jamal Crawford,112,26.1,26,0.100000000000001,59,64,-5,-4,-1
21700510,201952,MIN,DEN,Jeff Teague,151,35.2833333333333,36,-0.716666666666669,82,81,1,5,-4
21700510,201959,MIN,DEN,Taj Gibson,171,40.0833333333333,40,0.0833333333333286,97,94,3,3,0
21700510,202357,MIN,DEN,Nemanja Bjelica,47,9.71666666666667,10,-0.283333333333335,23,23,0,0,0
21700510,202710,MIN,DEN,Jimmy Butler,179,42.4833333333333,42,0.483333333333334,105,100,5,5,0
21700510,203476,MIN,DEN,Gorgui Dieng,95,21.5166666666667,21,0.516666666666666,53,62,-9,-11,2
21700510,203952,MIN,DEN,Andrew Wiggins,181,42.3166666666667,42,0.316666666666663,103,97,6,8,-2
21700510,1626145,MIN,DEN,Tyus Jones,66,14.6,15,-0.4,36,44,-8,-1,-7
21700510,1626157,MIN,DEN,Karl-Anthony Towns,131,29.7833333333333,30,-0.216666666666669,72,60,12,11,1
21700510,1627875,MIN,DEN,Marcus Georges-Hunt,12,3.11666666666667,2,1.11666666666667,10,0,10,-1,11
21700511,2749,NOP,BKN,Jameer Nelson,54,12.2333333333333,12,0.233333333333333,25,43,-18,-20,2
21700511,200765,NOP,BKN,Rajon Rondo,144,29.8833333333333,30,-0.116666666666667,94,55,39,28,11
21700511,201600,NOP,BKN,Omer Asik,12,3.25,3,0.25,0,17,-17,-17,0
21700511,201950,NOP,BKN,Jrue Holiday,153,32.55,33,-0.450000000000003,100,52,48,36,12
21700511,201967,NOP,BKN,Dante Cunningham,74,15.3833333333333,15,0.383333333333333,43,44,-1,-3,2
21700511,202326,NOP,BKN,DeMarcus Cousins,152,32.3666666666667,32,0.366666666666667,100,50,50,39,11
21700511,202734,NOP,BKN,E'Twaun Moore,178,38,38,0,105,77,28,20,8
21700511,203076,NOP,BKN,Anthony Davis,152,32.2166666666667,32,0.216666666666669,100,57,43,37,6
21700511,203121,NOP,BKN,Darius Miller,87,18.6833333333333,19,-0.31666666666667,49,42,7,-5,12
21700511,203546,NOP,BKN,Ian Clark,67,14,14,0,34,49,-15,-16,1
21700511,1627767,NOP,BKN,Cheick Diallo,52,10.6833333333333,11,-0.316666666666666,20,44,-24,-24,0
21700511,201960,BKN,NOP,DeMarre Carroll,74,16.6333333333333,17,-0.366666666666667,30,55,-25,-18,-7
21700511,202389,BKN,NOP,Timofey Mozgov,69,12.2333333333333,12,0.233333333333333,37,41,-4,-4,0
21700511,203092,BKN,NOP,Tyler Zeller,57,14.1833333333333,14,0.183333333333334,19,39,-20,-17,-3
21700511,203112,BKN,NOP,Quincy Acy,119,24.3333333333333,24,0.333333333333332,59,71,-12,0,-12
21700511,203459,BKN,NOP,Allen Crabbe,83,18.7166666666667,19,-0.283333333333331,32,63,-31,-24,-7
21700511,203915,BKN,NOP,Spencer Dinwiddie,95,21.7666666666667,22,-0.233333333333334,32,68,-36,-21,-15
21700511,203917,BKN,NOP,Nik Stauskas,119,23.7,24,-0.300000000000001,70,56,14,12,2
21700511,203925,BKN,NOP,Joe Harris,81,17.6666666666667,18,-0.333333333333332,43,40,3,-1,4
21700511,1626178,BKN,NOP,Rondae Hollis-Jefferson,104,23.8166666666667,24,-0.183333333333334,49,65,-16,-1,-15
21700511,1627747,BKN,NOP,Caris LeVert,153,31.5166666666667,32,-0.483333333333334,78,81,-3,3,-6
21700511,1628386,BKN,NOP,Jarrett Allen,93,19.65,19,0.649999999999999,44,47,-3,-5,2
21700511,1628495,BKN,NOP,Milton Doyle,78,15.0333333333333,15,0.0333333333333332,37,44,-7,1,-8
21700512,2546,OKC,TOR,Carmelo Anthony,154,30.95,31,-0.0500000000000007,94,67,27,24,3
21700512,101109,OKC,TOR,Raymond Felton,81,17.6833333333333,18,-0.316666666666666,32,36,-4,-2,-2
21700512,201566,OKC,TOR,Russell Westbrook,178,35.5666666666667,35,0.566666666666663,103,75,28,26,2
21700512,202331,OKC,TOR,Paul George,171,36.3333333333333,37,-0.666666666666671,99,90,9,11,-2
21700512,202335,OKC,TOR,Patrick Patterson,76,16.3166666666667,17,-0.683333333333334,34,44,-10,-6,-4
21700512,203460,OKC,TOR,Andre Roberson,171,34.7333333333333,35,-0.266666666666666,101,70,31,26,5
21700512,203500,OKC,TOR,Steven Adams,108,23.4,23,0.399999999999999,65,40,25,23,2
21700512,203518,OKC,TOR,Alex Abrines,30,6.93333333333333,7,-0.0666666666666664,8,30,-22,-19,-3
21700512,203924,OKC,TOR,Jerami Grant,121,24.7166666666667,25,-0.283333333333331,55,63,-8,-7,-1
21700512,203962,OKC,TOR,Josh Huestis,58,11.9166666666667,12,-0.0833333333333339,29,20,9,9,0
21700512,1626177,OKC,TOR,Dakari Johnson,1,0.183333333333333,0,0.183333333333333,,0,,0,
21700512,1628390,OKC,TOR,Terrance Ferguson,1,0.183333333333333,0,0.183333333333333,,0,,0,
21700512,101139,TOR,OKC,CJ Miles,112,22.7,22,0.699999999999999,66,55,11,9,2
21700512,200768,TOR,OKC,Kyle Lowry,148,29.6666666666667,30,-0.333333333333336,65,94,-29,-27,-2
21700512,201586,TOR,OKC,Serge Ibaka,128,26.2666666666667,27,-0.733333333333334,58,84,-26,-24,-2
21700512,201942,TOR,OKC,DeMar DeRozan,171,35.5833333333333,36,-0.416666666666671,81,101,-20,-18,-2
21700512,202685,TOR,OKC,Jonas Valanciunas,95,20.2,20,0.199999999999999,36,64,-28,-28,0
21700512,203512,TOR,OKC,Lucas Nogueira,17,3.76666666666667,4,-0.233333333333333,8,5,3,3,0
21700512,1626153,TOR,OKC,Delon Wright,73,15.8,16,-0.199999999999999,25,29,-4,-4,0
21700512,1626181,TOR,OKC,Norman Powell,44,9.7,10,-0.300000000000001,14,18,-4,-4,0
21700512,1627751,TOR,OKC,Jakob Poeltl,102,21.0166666666667,21,0.0166666666666657,60,45,15,13,2
21700512,1627783,TOR,OKC,Pascal Siakam,78,16.05,16,0.0500000000000007,43,30,13,11,2
21700512,1627832,TOR,OKC,Fred VanVleet,91,19.0166666666667,18,1.01666666666667,44,39,5,3,2
21700512,1628384,TOR,OKC,OG Anunoby,91,19.15,20,-0.850000000000001,35,56,-21,-19,-2
21700513,2544,CLE,SAC,LeBron James,156,37.6666666666667,38,-0.333333333333329,75,86,-11,-11,0
21700513,2548,CLE,SAC,Dwyane Wade,79,18.3833333333333,19,-0.616666666666667,33,51,-18,-20,2
21700513,2594,CLE,SAC,Kyle Korver,82,20.25,21,-0.75,38,65,-27,-27,0
21700513,2747,CLE,SAC,JR Smith,128,30.0166666666667,30,0.0166666666666657,63,60,3,5,-2
21700513,101112,CLE,SAC,Channing Frye,48,10.0333333333333,10,0.0333333333333332,21,33,-12,-13,1
21700513,101181,CLE,SAC,Jose Calderon,99,22.4333333333333,23,-0.566666666666666,46,35,11,13,-2
21700513,201145,CLE,SAC,Jeff Green,106,25.5666666666667,26,-0.433333333333334,48,64,-16,-15,-1
21700513,201567,CLE,SAC,Kevin Love,120,29.4333333333333,30,-0.56666666666667,61,60,1,2,-1
21700513,202684,CLE,SAC,Tristan Thompson,54,13.2666666666667,13,0.266666666666666,21,30,-9,-9,0
21700513,203109,CLE,SAC,Jae Crowder,131,29.25,29,0.25,66,61,5,2,3
21700513,1626224,CLE,SAC,Cedi Osman,7,2.03333333333333,2,0.0333333333333332,3,0,3,3,0
21700513,1713,SAC,CLE,Vince Carter,120,29.65,30,-0.350000000000001,76,54,22,21,1
21700513,2216,SAC,CLE,Zach Randolph,87,19.4666666666667,20,-0.533333333333331,37,42,-5,-5,0
21700513,201588,SAC,CLE,George Hill,155,37.2666666666667,38,-0.733333333333334,79,72,7,7,0
21700513,202066,SAC,CLE,Garrett Temple,121,28.3666666666667,28,0.366666666666667,52,60,-8,-13,5
21700513,203992,SAC,CLE,Bogdan Bogdanovic,127,30.5,31,-0.5,71,53,18,20,-2
21700513,1626161,SAC,CLE,Willie Cauley-Stein,147,35.65,36,-0.350000000000001,93,64,29,28,1
21700513,1627741,SAC,CLE,Buddy Hield,99,23.35,24,-0.649999999999999,67,44,23,25,-2
21700513,1627781,SAC,CLE,Malachi Richardson,69,15.5333333333333,16,-0.466666666666669,26,37,-11,-10,-1
21700513,1628382,SAC,CLE,Justin Jackson,41,8.81666666666667,9,-0.183333333333334,30,22,8,10,-2
21700513,1628412,SAC,CLE,Frank Mason,44,9.73333333333333,10,-0.266666666666668,14,27,-13,-13,0
21700514,2561,GSW,UTA,David West,54,11.9833333333333,12,-0.0166666666666657,28,23,5,3,2
21700514,2585,GSW,UTA,Zaza Pachulia,62,13.6833333333333,14,-0.316666666666666,37,32,5,5,0
21700514,2733,GSW,UTA,Shaun Livingston,100,20.2,20,0.200000000000003,54,47,7,7,0
21700514,2738,GSW,UTA,Andre Iguodala,102,20.0666666666667,20,0.0666666666666664,54,32,22,22,0
21700514,201142,GSW,UTA,Kevin Durant,149,29.3166666666667,29,0.316666666666666,77,59,18,22,-4
21700514,201156,GSW,UTA,Nick Young,107,21.4833333333333,22,-0.516666666666666,58,47,11,10,1
21700514,201580,GSW,UTA,JaVale McGee,22,4.33333333333333,4,0.333333333333333,14,16,-2,-2,0
21700514,201956,GSW,UTA,Omri Casspi,75,15.1333333333333,15,0.133333333333333,38,32,6,7,-1
21700514,202691,GSW,UTA,Klay Thompson,141,29.8666666666667,30,-0.133333333333333,77,61,16,14,2
21700514,203110,GSW,UTA,Draymond Green,109,24.0333333333333,25,-0.966666666666669,59,49,10,6,4
21700514,1626172,GSW,UTA,Kevon Looney,28,5.78333333333333,6,-0.216666666666667,16,19,-3,-3,0
21700514,1627775,GSW,UTA,Patrick McCaw,111,20.65,20,0.649999999999999,57,42,15,17,-2
21700514,1628395,GSW,UTA,Jordan Bell,120,22.05,22,0.0500000000000007,61,46,15,17,-2
21700514,2207,UTA,GSW,Joe Johnson,69,14.8,15,-0.199999999999999,27,41,-14,-12,-2
21700514,200757,UTA,GSW,Thabo Sefolosha,167,32.9166666666667,33,-0.0833333333333357,74,85,-11,-13,2
21700514,201937,UTA,GSW,Ricky Rubio,116,25.0666666666667,26,-0.933333333333334,51,56,-5,-9,4
21700514,202324,UTA,GSW,Derrick Favors,122,24.9666666666667,26,-1.03333333333333,54,58,-4,-6,2
21700514,202327,UTA,GSW,Ekpe Udoh,114,22.75,23,-0.25,47,68,-21,-19,-2
21700514,202692,UTA,GSW,Alec Burks,95,19.55,20,-0.449999999999999,37,56,-19,-17,-2
21700514,203918,UTA,GSW,Rodney Hood,154,29.5333333333333,29,0.533333333333331,62,82,-20,-22,2
21700514,204060,UTA,GSW,Joe Ingles,124,24.1833333333333,24,0.183333333333334,51,77,-26,-23,-3
21700514,1626220,UTA,GSW,Royce O'Neale,47,10.1666666666667,10,0.166666666666668,29,22,7,7,0
21700514,1628378,UTA,GSW,Donovan Mitchell,172,34.65,35,-0.349999999999994,73,85,-12,-11,-1
21700515,101106,LAL,MEM,Andrew Bogut,50,12.2,13,-0.800000000000001,15,20,-5,-4,-1
21700515,201147,LAL,MEM,Corey Brewer,30,6.31666666666667,7,-0.683333333333334,11,14,-3,-3,0
21700515,203484,LAL,MEM,Kentavious Caldwell-Pope,166,35.9166666666667,36,-0.0833333333333357,74,80,-6,-4,-2
21700515,203898,LAL,MEM,Tyler Ennis,19,4.03333333333333,4,0.0333333333333332,4,10,-6,-6,0
21700515,203903,LAL,MEM,Jordan Clarkson,176,38.0333333333333,38,0.0333333333333314,84,85,-1,-1,0
21700515,203944,LAL,MEM,Julius Randle,50,11.1166666666667,11,0.116666666666667,22,27,-5,-9,4
21700515,1626204,LAL,MEM,Larry Nance Jr.,97,19.4166666666667,19,0.416666666666664,48,49,-1,0,-1
21700515,1627742,LAL,MEM,Brandon Ingram,204,43.9,44,-0.0999999999999943,95,99,-4,-4,0
21700515,1627936,LAL,MEM,Alex Caruso,19,4.08333333333333,4,0.0833333333333339,6,13,-7,-9,2
21700515,1628398,LAL,MEM,Kyle Kuzma,161,34.75,34,0.75,69,78,-9,-7,-2
21700515,1628404,LAL,MEM,Josh Hart,143,29.9,30,-0.100000000000001,67,70,-3,-3,0
21700515,201188,MEM,LAL,Marc Gasol,147,32.65,32,0.649999999999999,69,66,3,1,2
21700515,201596,MEM,LAL,Mario Chalmers,102,21.1166666666667,22,-0.883333333333333,50,43,7,5,2
21700515,201936,MEM,LAL,Tyreke Evans,147,31.2166666666667,32,-0.783333333333335,74,59,15,22,-7
21700515,202718,MEM,LAL,Chandler Parsons,88,18.3166666666667,18,0.316666666666666,44,44,0,2,-2
21700515,203516,MEM,LAL,James Ennis III,74,14.1166666666667,14,0.116666666666667,32,35,-3,-5,2
21700515,1626150,MEM,LAL,Andrew Harrison,125,28.2333333333333,28,0.233333333333334,73,47,26,24,2
21700515,1626185,MEM,LAL,Jarell Martin,147,31.9833333333333,32,-0.0166666666666657,67,64,3,1,2
21700515,1627738,MEM,LAL,Deyonta Davis,72,14.8166666666667,15,-0.183333333333334,38,31,7,9,-2
21700515,1628415,MEM,LAL,Dillon Brooks,133,29.9666666666667,30,-0.0333333333333314,62,58,4,1,3
21700515,1628424,MEM,LAL,Kobi Simmons,80,17.25,17,0.25,36,48,-12,-10,-2
21700516,201167,ORL,DET,Arron Afflalo,63,14.1,14,0.0999999999999996,35,23,12,10,2
21700516,201571,ORL,DET,D.J. Augustin,60,13.0833333333333,13,0.0833333333333322,31,15,16,12,4
21700516,201578,ORL,DET,Marreese Speights,68,15.1833333333333,15,0.183333333333334,39,22,17,14,3
21700516,202687,ORL,DET,Bismack Biyombo,153,32.5,33,-0.5,63,67,-4,-1,-3
21700516,203095,ORL,DET,Evan Fournier,153,32.5,33,-0.5,67,62,5,5,0
21700516,203613,ORL,DET,Jonathon Simmons,172,36.7833333333333,37,-0.216666666666669,78,76,2,4,-2
21700516,203901,ORL,DET,Elfrid Payton,178,38.6666666666667,39,-0.333333333333329,82,79,3,5,-2
21700516,203932,ORL,DET,Aaron Gordon,140,30.1666666666667,30,0.166666666666664,59,59,0,5,-5
21700516,1626209,ORL,DET,Mario Hezonja,81,17.5166666666667,18,-0.483333333333334,43,30,13,8,5
21700516,1628411,ORL,DET,Wes Iwundu,37,7.91666666666667,8,-0.083333333333333,13,12,1,3,-2
21700516,201229,DET,ORL,Anthony Tolliver,109,23.8666666666667,24,-0.133333333333333,36,47,-11,-11,0
21700516,202397,DET,ORL,Ish Smith,151,32.15,32,0.149999999999999,65,61,4,0,4
21700516,202699,DET,ORL,Tobias Harris,166,35.8333333333333,36,-0.166666666666671,75,76,-1,-1,0
21700516,202779,DET,ORL,Dwight Buycks,9,2,2,0,4,2,2,4,-2
21700516,203083,DET,ORL,Andre Drummond,176,37.7,38,-0.299999999999997,77,81,-4,-6,2
21700516,203493,DET,ORL,Reggie Bullock,174,36.6333333333333,37,-0.366666666666667,70,80,-10,-8,-2
21700516,203961,DET,ORL,Eric Moreland,45,9.98333333333333,10,-0.0166666666666657,12,21,-9,-7,-2
21700516,204038,DET,ORL,Langston Galloway,70,15.5333333333333,16,-0.466666666666669,24,41,-17,-13,-4
21700516,1626169,DET,ORL,Stanley Johnson,114,24.35,24,0.350000000000001,51,55,-4,-3,-1
21700516,1627740,DET,ORL,Henry Ellenson,5,1.08333333333333,1,0.0833333333333335,4,0,4,2,2
21700516,1628379,DET,ORL,Luke Kennard,86,19.2833333333333,20,-0.716666666666669,27,46,-19,-22,3
21700517,201143,BOS,HOU,Al Horford,150,33.0666666666667,33,0.0666666666666629,68,73,-5,-5,0
21700517,202681,BOS,HOU,Kyrie Irving,180,37.9,38,-0.100000000000001,86,79,7,7,0
21700517,202694,BOS,HOU,Marcus Morris,87,19.3666666666667,19,0.366666666666667,38,36,2,2,0
21700517,203382,BOS,HOU,Aron Baynes,60,12.8333333333333,13,-0.166666666666668,29,29,0,3,-3
21700517,203499,BOS,HOU,Shane Larkin,63,15.2333333333333,15,0.233333333333334,28,32,-4,-2,-2
21700517,203935,BOS,HOU,Marcus Smart,165,34.55,34,0.549999999999997,70,65,5,3,2
21700517,1626179,BOS,HOU,Terry Rozier,94,20.2166666666667,20,0.216666666666669,41,35,6,5,1
21700517,1627846,BOS,HOU,Abdel Nader,96,20.9666666666667,21,-0.0333333333333314,43,45,-2,-2,0
21700517,1628369,BOS,HOU,Jayson Tatum,178,39.5666666666667,40,-0.433333333333337,88,80,8,6,2
21700517,1628444,BOS,HOU,Jabari Bird,4,1.01666666666667,1,0.0166666666666666,2,5,-3,-3,0
21700517,1628464,BOS,HOU,Daniel Theis,28,5.28333333333333,5,0.283333333333333,2,11,-9,-9,0
21700517,2403,HOU,BOS,Nene,85,19.45,19,0.449999999999999,42,39,3,3,0
21700517,2772,HOU,BOS,Trevor Ariza,173,38.5333333333333,39,-0.466666666666669,80,78,2,2,0
21700517,101123,HOU,BOS,Gerald Green,54,11.2833333333333,11,0.283333333333333,20,25,-5,-6,1
21700517,200782,HOU,BOS,PJ Tucker,120,24.8166666666667,25,-0.183333333333334,51,54,-3,-5,2
21700517,201569,HOU,BOS,Eric Gordon,184,40.1833333333333,40,0.183333333333337,86,88,-2,1,-3
21700517,201583,HOU,BOS,Ryan Anderson,171,39.6166666666667,40,-0.383333333333333,84,83,1,6,-5
21700517,201935,HOU,BOS,James Harden,186,38.8666666666667,39,-0.133333333333333,80,80,0,0,0
21700517,204028,HOU,BOS,Tarik Black,66,12.1166666666667,12,0.116666666666667,19,22,-3,-6,3
21700517,1627362,HOU,BOS,Briante Weber,66,15.1333333333333,15,0.133333333333333,28,26,2,0,2
21700518,1891,MIL,MIN,Jason Terry,38,8.15,8,0.149999999999999,25,17,8,6,2
21700518,202339,MIL,MIN,Eric Bledsoe,146,34.3666666666667,34,0.366666666666667,78,71,7,6,1
21700518,203089,MIL,MIN,John Henson,117,28.0166666666667,28,0.0166666666666657,67,57,10,13,-3
21700518,203114,MIL,MIN,Khris Middleton,167,39.5666666666667,40,-0.433333333333337,83,87,-4,-3,-1
21700518,203503,MIL,MIN,Tony Snell,107,26.1833333333333,26,0.18333333333333,60,62,-2,-2,0
21700518,203507,MIL,MIN,Giannis Antetokounmpo,166,40.3333333333333,40,0.333333333333336,80,70,10,9,1
21700518,203521,MIL,MIN,Matthew Dellavedova,40,10.3166666666667,10,0.316666666666666,16,17,-1,0,-1
21700518,1627748,MIL,MIN,Thon Maker,84,19.9833333333333,20,-0.0166666666666657,35,39,-4,-7,3
21700518,1627763,MIL,MIN,Malcolm Brogdon,108,25.9833333333333,26,-0.0166666666666657,62,44,18,20,-2
21700518,1628425,MIL,MIN,Sterling Brown,32,7.1,7,0.0999999999999996,4,16,-12,-12,0
21700518,2037,MIN,MIL,Jamal Crawford,111,26.3333333333333,26,0.333333333333332,44,67,-23,-22,-1
21700518,201166,MIN,MIL,Aaron Brooks,18,3.71666666666667,4,-0.283333333333333,9,16,-7,-4,-3
21700518,201959,MIN,MIL,Taj Gibson,159,38.4666666666667,39,-0.533333333333331,77,69,8,2,6
21700518,202357,MIN,MIL,Nemanja Bjelica,36,7.58333333333333,8,-0.416666666666667,20,29,-9,-5,-4
21700518,202710,MIN,MIL,Jimmy Butler,175,42.65,43,-0.350000000000001,83,79,4,-2,6
21700518,203476,MIN,MIL,Gorgui Dieng,68,15.1666666666667,15,0.166666666666666,24,38,-14,-11,-3
21700518,203952,MIN,MIL,Andrew Wiggins,140,34.0166666666667,34,0.0166666666666657,68,64,4,7,-3
21700518,1626145,MIN,MIL,Tyus Jones,145,35.1,35,0.100000000000001,74,68,6,4,2
21700518,1626157,MIN,MIL,Karl-Anthony Towns,149,36.2166666666667,36,0.216666666666669,78,78,0,2,-2
21700518,1627875,MIN,MIL,Marcus Georges-Hunt,4,0.75,1,-0.25,3,2,1,-1,2
21700519,101127,NYK,SAS,Jarrett Jack,143,30.9333333333333,31,-0.0666666666666664,68,77,-9,-8,-1
21700519,201563,NYK,SAS,Michael Beasley,152,32.5333333333333,33,-0.466666666666669,74,77,-3,-3,0
21700519,201584,NYK,SAS,Courtney Lee,181,39.5,39,0.5,85,94,-9,-7,-2
21700519,202498,NYK,SAS,Lance Thomas,58,13.15,13,0.15,29,37,-8,-9,1
21700519,202683,NYK,SAS,Enes Kanter,78,17.4666666666667,17,0.466666666666665,35,46,-11,-11,0
21700519,203124,NYK,SAS,Kyle O'Quinn,77,16.3833333333333,17,-0.616666666666667,37,46,-9,-8,-1
21700519,203926,NYK,SAS,Doug McDermott,75,15.7166666666667,16,-0.283333333333333,39,43,-4,-4,0
21700519,204001,NYK,SAS,Kristaps Porzingis,152,33.8,34,-0.200000000000003,70,78,-8,-9,1
21700519,1627758,NYK,SAS,Ron Baker,40,8.45,9,-0.550000000000001,22,25,-3,-5,2
21700519,1628373,NYK,SAS,Frank Ntilikina,149,31.8166666666667,32,-0.183333333333337,76,72,4,4,0
21700519,1938,SAS,NYK,Manu Ginobili,97,20.5166666666667,20,0.516666666666666,38,47,-9,-12,3
21700519,2200,SAS,NYK,Pau Gasol,118,26.1,26,0.100000000000001,64,53,11,11,0
21700519,2225,SAS,NYK,Tony Parker,129,28.9,29,-0.100000000000001,79,68,11,11,0
21700519,200746,SAS,NYK,LaMarcus Aldridge,161,35.75,36,-0.25,95,82,13,9,4
21700519,200752,SAS,NYK,Rudy Gay,80,17.2666666666667,17,0.266666666666666,30,35,-5,-3,-2
21700519,201980,SAS,NYK,Danny Green,93,21.3833333333333,22,-0.616666666666667,63,46,17,15,2
21700519,201988,SAS,NYK,Patty Mills,95,20.4666666666667,20,0.466666666666669,43,41,2,-1,3
21700519,202722,SAS,NYK,Davis Bertans,10,1.36666666666667,1,0.366666666666667,4,4,0,2,-2
21700519,203464,SAS,NYK,Brandon Paul,15,2.45,3,-0.55,6,7,-1,-1,0
21700519,203937,SAS,NYK,Kyle Anderson,128,28.5666666666667,29,-0.433333333333334,86,62,24,26,-2
21700519,1627749,SAS,NYK,Dejounte Murray,46,9.01666666666667,9,0.0166666666666657,22,21,1,3,-2
21700519,1627854,SAS,NYK,Bryn Forbes,133,27.9666666666667,28,-0.0333333333333314,65,69,-4,0,-4
21700520,101161,PHI,POR,Amir Johnson,55,13.3333333333333,13,0.333333333333332,26,28,-2,-4,2
21700520,200755,PHI,POR,JJ Redick,156,32.6333333333333,32,0.633333333333326,80,80,0,3,-3
21700520,201573,PHI,POR,Jerryd Bayless,87,19.7333333333333,20,-0.266666666666666,31,48,-17,-20,3
21700520,202344,PHI,POR,Trevor Booker,59,13.95,14,-0.0500000000000007,24,28,-4,-7,3
21700520,203496,PHI,POR,Robert Covington,105,23.7,24,-0.300000000000001,63,45,18,18,0
21700520,203954,PHI,POR,Joel Embiid,167,34.6666666666667,35,-0.333333333333336,84,86,-2,0,-2
21700520,203967,PHI,POR,Dario Saric,163,34.05,34,0.0499999999999972,86,86,0,3,-3
21700520,204456,PHI,POR,T.J. McConnell,162,34.4166666666667,34,0.416666666666664,71,89,-18,-18,0
21700520,1627732,PHI,POR,Ben Simmons,156,33.5166666666667,34,-0.483333333333334,85,80,5,5,0
21700520,202323,POR,PHI,Evan Turner,98,21.6166666666667,22,-0.383333333333333,43,59,-16,-17,1
21700520,202329,POR,PHI,Al-Farouq Aminu,148,31.15,31,0.149999999999999,77,73,4,3,1
21700520,202334,POR,PHI,Ed Davis,75,16.7166666666667,17,-0.283333333333335,38,37,1,1,0
21700520,203086,POR,PHI,Meyers Leonard,15,2.85,3,-0.15,3,10,-7,-7,0
21700520,203090,POR,PHI,Maurice Harkless,119,25.2333333333333,25,0.233333333333334,66,50,16,16,0
21700520,203468,POR,PHI,CJ McCollum,180,38.55,38,0.549999999999997,93,95,-2,-5,3
21700520,203894,POR,PHI,Shabazz Napier,164,34.5,34,0.5,82,76,6,8,-2
21700520,203994,POR,PHI,Jusuf Nurkic,129,28.0666666666667,28,0.0666666666666664,71,61,10,10,0
21700520,1626192,POR,PHI,Pat Connaughton,108,24.4666666666667,25,-0.533333333333331,60,52,8,10,-2
21700520,1628380,POR,PHI,Zach Collins,74,16.85,17,-0.149999999999999,37,37,0,1,-1
21700521,2772,HOU,WAS,Trevor Ariza,149,31.7666666666667,32,-0.233333333333334,59,73,-14,-12,-2
21700521,101108,HOU,WAS,Chris Paul,116,25.6,26,-0.399999999999999,46,61,-15,-16,1
21700521,101123,HOU,WAS,Gerald Green,132,27.15,27,0.149999999999999,63,81,-18,-20,2
21700521,200782,HOU,WAS,PJ Tucker,73,15.45,15,0.449999999999999,36,43,-7,-10,3
21700521,201569,HOU,WAS,Eric Gordon,124,26.9,27,-0.100000000000001,55,73,-18,-17,-1
21700521,201583,HOU,WAS,Ryan Anderson,143,31.3833333333333,32,-0.616666666666667,68,77,-9,-8,-1
21700521,201628,HOU,WAS,Bobby Brown,33,6.36666666666667,6,0.366666666666667,18,16,2,2,0
21700521,201935,HOU,WAS,James Harden,133,29.3833333333333,29,0.383333333333333,65,66,-1,0,-1
21700521,204028,HOU,WAS,Tarik Black,127,27.75,28,-0.25,60,66,-6,-4,-2
21700521,1627362,HOU,WAS,Briante Weber,33,6.36666666666667,6,0.366666666666667,18,16,2,2,0
21700521,1627753,HOU,WAS,Zhou Qi,62,11.8833333333333,12,-0.116666666666667,27,33,-6,-7,1
21700521,101133,WAS,HOU,Ian Mahinmi,103,21.15,21,0.149999999999999,60,37,23,25,-2
21700521,101162,WAS,HOU,Marcin Gortat,79,18.4166666666667,19,-0.583333333333336,41,37,4,2,2
21700521,201160,WAS,HOU,Jason Smith,15,2.85,3,-0.15,7,15,-8,-8,0
21700521,201975,WAS,HOU,Jodie Meeks,91,18.2,18,0.199999999999999,50,50,0,-1,1
21700521,202322,WAS,HOU,John Wall,143,30.7166666666667,31,-0.283333333333331,77,63,14,13,1
21700521,202693,WAS,HOU,Markieff Morris,117,26.4333333333333,27,-0.566666666666666,58,55,3,1,2
21700521,203078,WAS,HOU,Bradley Beal,144,31.5166666666667,32,-0.483333333333334,73,59,14,13,1
21700521,203107,WAS,HOU,Tomas Satoransky,82,17.2833333333333,17,0.283333333333331,44,40,4,5,-1
21700521,203490,WAS,HOU,Otto Porter Jr.,181,39.4,40,-0.600000000000001,105,75,30,32,-2
21700521,204025,WAS,HOU,Tim Frazier,15,2.85,3,-0.15,7,15,-8,-8,0
21700521,1626162,WAS,HOU,Kelly Oubre Jr.,131,26.7333333333333,26,0.733333333333334,73,51,22,24,-2
21700521,1626191,WAS,HOU,Chris McCullough,24,4.45,4,0.449999999999999,10,18,-8,-8,0
21700522,101141,ATL,TOR,Ersan Ilyasova,149,27.85,28,-0.149999999999999,67,64,3,4,-1
21700522,201158,ATL,TOR,Marco Belinelli,131,27.55,27,0.550000000000001,56,66,-10,-10,0
21700522,203101,ATL,TOR,Miles Plumlee,100,17.9833333333333,19,-1.01666666666667,34,47,-13,-14,1
21700522,203145,ATL,TOR,Kent Bazemore,149,28.4666666666667,29,-0.533333333333331,63,59,4,4,0
21700522,203471,ATL,TOR,Dennis Schroder,178,35.0666666666667,35,0.0666666666666629,71,81,-10,-9,-1
21700522,1627098,ATL,TOR,Malcolm Delaney,92,19.5666666666667,20,-0.433333333333334,32,51,-19,-19,0
21700522,1627752,ATL,TOR,Taurean Prince,179,34.5333333333333,35,-0.466666666666669,75,81,-6,-5,-1
21700522,1627819,ATL,TOR,Isaiah Taylor,62,12.65,13,-0.350000000000001,27,30,-3,-4,1
21700522,1628381,ATL,TOR,John Collins,93,20.75,21,-0.25,38,44,-6,-5,-1
21700522,1628463,ATL,TOR,Tyler Cavanaugh,67,14.1666666666667,14,0.166666666666668,27,32,-5,-7,2
21700522,101139,TOR,ATL,CJ Miles,95,17.7833333333333,18,-0.216666666666669,43,40,3,3,0
21700522,200768,TOR,ATL,Kyle Lowry,153,30.2666666666667,30,0.266666666666666,67,69,-2,-2,0
21700522,201942,TOR,ATL,DeMar DeRozan,171,33.8666666666667,34,-0.133333333333333,81,71,10,10,0
21700522,202685,TOR,ATL,Jonas Valanciunas,111,21.65,22,-0.350000000000001,50,45,5,5,0
21700522,203512,TOR,ATL,Lucas Nogueira,36,6.73333333333333,7,-0.266666666666668,16,19,-3,-3,0
21700522,1626153,TOR,ATL,Delon Wright,140,28.85,29,-0.149999999999999,64,48,16,16,0
21700522,1626181,TOR,ATL,Norman Powell,88,17.4,17,0.399999999999999,37,41,-4,-2,-2
21700522,1627751,TOR,ATL,Jakob Poeltl,93,19.3333333333333,19,0.333333333333336,45,34,11,11,0
21700522,1627783,TOR,ATL,Pascal Siakam,109,23.2,23,0.199999999999999,52,39,13,13,0
21700522,1627832,TOR,ATL,Fred VanVleet,87,17.45,18,-0.549999999999997,44,29,15,15,0
21700522,1628384,TOR,ATL,OG Anunoby,117,22.05,23,-0.950000000000003,56,55,1,-1,2
21700523,2617,MIA,BKN,Udonis Haslem,19,4.51666666666667,5,-0.483333333333333,7,6,1,3,-2
21700523,201609,MIA,BKN,Goran Dragic,110,23.1333333333333,23,0.133333333333333,38,64,-26,-27,1
21700523,201961,MIA,BKN,Wayne Ellington,135,28.1833333333333,28,0.183333333333334,43,68,-25,-28,3
21700523,202355,MIA,BKN,Hassan Whiteside,97,19.8166666666667,20,-0.183333333333334,39,42,-3,-3,0
21700523,203482,MIA,BKN,Kelly Olynyk,109,23.0833333333333,23,0.0833333333333322,40,55,-15,-16,1
21700523,204020,MIA,BKN,Tyler Johnson,156,32.5333333333333,33,-0.466666666666669,57,81,-24,-29,5
21700523,1626175,MIA,BKN,Jordan Mickey,92,19.1,19,0.100000000000001,40,40,0,1,-1
21700523,1626196,MIA,BKN,Josh Richardson,138,28.2,28,0.200000000000003,57,69,-12,-10,-2
21700523,1628389,MIA,BKN,Bam Adebayo,130,27.6833333333333,28,-0.316666666666666,48,67,-19,-21,2
21700523,1628475,MIA,BKN,Matt Williams Jr.,27,5.9,6,-0.0999999999999996,15,6,9,9,0
21700523,1628476,MIA,BKN,Derrick Walton Jr.,122,25.35,26,-0.649999999999999,51,47,4,1,3
21700523,201960,BKN,MIA,DeMarre Carroll,125,25.1166666666667,25,0.116666666666667,63,46,17,19,-2
21700523,202389,BKN,MIA,Timofey Mozgov,30,6.31666666666667,7,-0.683333333333334,8,16,-8,-7,-1
21700523,203092,BKN,MIA,Tyler Zeller,101,20.5666666666667,21,-0.433333333333334,39,45,-6,-6,0
21700523,203112,BKN,MIA,Quincy Acy,94,20.7333333333333,21,-0.266666666666666,49,30,19,20,-1
21700523,203459,BKN,MIA,Allen Crabbe,127,25.75,26,-0.25,57,51,6,7,-1
21700523,203915,BKN,MIA,Spencer Dinwiddie,137,28.7333333333333,29,-0.266666666666666,60,56,4,7,-3
21700523,203917,BKN,MIA,Nik Stauskas,72,15.3166666666667,16,-0.683333333333334,29,28,1,1,0
21700523,203925,BKN,MIA,Joe Harris,137,29.2833333333333,29,0.283333333333331,68,52,16,16,0
21700523,1626178,BKN,MIA,Rondae Hollis-Jefferson,108,22.6,23,-0.399999999999999,59,40,19,21,-2
21700523,1627747,BKN,MIA,Caris LeVert,110,23.2166666666667,23,0.216666666666669,63,38,25,25,0
21700523,1628386,BKN,MIA,Jarrett Allen,94,19.8666666666667,20,-0.133333333333333,50,33,17,17,0
21700524,201577,CHI,IND,Robin Lopez,108,23.8166666666667,24,-0.183333333333334,59,54,5,5,0
21700524,202703,CHI,IND,Nikola Mirotic,128,27.45,28,-0.550000000000001,72,65,7,9,-2
21700524,203200,CHI,IND,Justin Holiday,161,35.8333333333333,36,-0.166666666666671,85,87,-2,-2,0
21700524,1626170,CHI,IND,Jerian Grant,149,32.6333333333333,33,-0.366666666666667,82,77,5,5,0
21700524,1626171,CHI,IND,Bobby Portis,76,15.6166666666667,16,-0.383333333333333,38,28,10,11,-1
21700524,1627756,CHI,IND,Denzel Valentine,123,25.9,26,-0.100000000000001,60,48,12,12,0
21700524,1627835,CHI,IND,Paul Zipser,83,17.1,17,0.100000000000001,46,32,14,12,2
21700524,1628021,CHI,IND,David Nwaba,150,31.75,32,-0.25,86,77,9,9,0
21700524,1628374,CHI,IND,Lauri Markkanen,127,28.15,28,0.149999999999999,67,67,0,-1,1
21700524,201152,IND,CHI,Thaddeus Young,144,31.3666666666667,32,-0.633333333333333,69,73,-4,-4,0
21700524,201954,IND,CHI,Darren Collison,180,39.0833333333333,39,0.0833333333333286,93,93,0,2,-2
21700524,202362,IND,CHI,Lance Stephenson,159,35.0166666666667,35,0.0166666666666657,78,87,-9,-7,-2
21700524,202709,IND,CHI,Cory Joseph,140,30.5166666666667,31,-0.483333333333334,75,82,-7,-9,2
21700524,202711,IND,CHI,Bojan Bogdanovic,156,33.2666666666667,33,0.266666666666666,68,79,-11,-13,2
21700524,1626167,IND,CHI,Myles Turner,112,25.4166666666667,25,0.416666666666664,54,59,-5,-5,0
21700524,1626202,IND,CHI,Joe Young,61,12.3666666666667,12,0.366666666666667,22,38,-16,-16,0
21700524,1627734,IND,CHI,Domantas Sabonis,131,27.35,28,-0.649999999999999,67,76,-9,-9,0
21700524,1627816,IND,CHI,Alex Poythress,22,3.86666666666667,4,-0.133333333333333,9,8,1,1,0
21700525,2749,NOP,DAL,Jameer Nelson,95,21.25,22,-0.75,52,55,-3,-2,-1
21700525,200765,NOP,DAL,Rajon Rondo,94,19.8,20,-0.199999999999999,48,53,-5,-5,0
21700525,201950,NOP,DAL,Jrue Holiday,179,39.3166666666667,39,0.316666666666663,100,98,2,3,-1
21700525,201967,NOP,DAL,Dante Cunningham,50,10.2666666666667,10,0.266666666666666,32,31,1,-1,2
21700525,202326,NOP,DAL,DeMarcus Cousins,194,42.75,44,-1.25,102,114,-12,-12,0
21700525,202734,NOP,DAL,E'Twaun Moore,162,34.3666666666667,35,-0.633333333333333,87,94,-7,-8,1
21700525,203076,NOP,DAL,Anthony Davis,192,41.7166666666667,42,-0.283333333333331,104,111,-7,-3,-4
21700525,203121,NOP,DAL,Darius Miller,67,13.7833333333333,14,-0.216666666666667,35,43,-8,-12,4
21700525,203546,NOP,DAL,Ian Clark,62,14.5,15,-0.5,40,41,-1,0,-1
21700525,1717,DAL,NOP,Dirk Nowitzki,109,23.4666666666667,25,-1.53333333333333,62,47,15,17,-2
21700525,2734,DAL,NOP,Devin Harris,91,20.25,20,0.25,66,54,12,12,0
21700525,200826,DAL,NOP,J.J. Barea,105,23.3833333333333,24,-0.616666666666667,69,57,12,14,-2
21700525,202083,DAL,NOP,Wesley Matthews,137,29.2833333333333,30,-0.716666666666669,74,74,0,0,0
21700525,203084,DAL,NOP,Harrison Barnes,167,36.5,36,0.5,93,94,-1,1,-2
21700525,203939,DAL,NOP,Dwight Powell,65,14.6,15,-0.4,41,32,9,7,2
21700525,1626257,DAL,NOP,Salah Mejri,71,14.6333333333333,15,-0.366666666666667,39,44,-5,-5,0
21700525,1627812,DAL,NOP,Yogi Ferrell,103,23.3333333333333,24,-0.666666666666668,61,64,-3,-3,0
21700525,1628372,DAL,NOP,Dennis Smith Jr.,144,30.95,31,-0.0499999999999972,76,78,-2,-4,2
21700525,1628467,DAL,NOP,Maxi Kleber,103,21.35,21,0.350000000000001,59,56,3,1,2
21700526,1891,MIL,OKC,Jason Terry,42,9.9,10,-0.0999999999999996,19,17,2,-1,3
21700526,202339,MIL,OKC,Eric Bledsoe,107,24.6333333333333,24,0.633333333333333,43,46,-3,-1,-2
21700526,203089,MIL,OKC,John Henson,123,29.2666666666667,29,0.266666666666666,56,52,4,2,2
21700526,203114,MIL,OKC,Khris Middleton,170,39.1,39,0.0999999999999943,75,76,-1,-1,0
21700526,203503,MIL,OKC,Tony Snell,166,36.4833333333333,36,0.483333333333334,78,74,4,5,-1
21700526,203507,MIL,OKC,Giannis Antetokounmpo,179,39.8833333333333,40,-0.11666666666666,78,79,-1,1,-2
21700526,203521,MIL,OKC,Matthew Dellavedova,111,24.9833333333333,25,-0.0166666666666657,54,53,1,1,0
21700526,1627748,MIL,OKC,Thon Maker,70,14.8166666666667,15,-0.183333333333334,37,29,8,8,0
21700526,1627763,MIL,OKC,Malcolm Brogdon,97,20.9333333333333,21,-0.0666666666666664,45,49,-4,-4,0
21700526,2546,OKC,MIL,Carmelo Anthony,154,34.6666666666667,35,-0.333333333333329,70,71,-1,-3,2
21700526,101109,OKC,MIL,Raymond Felton,118,27.1333333333333,27,0.133333333333333,71,50,21,20,1
21700526,201566,OKC,MIL,Russell Westbrook,180,40.0833333333333,40,0.0833333333333357,79,79,0,0,0
21700526,202335,OKC,MIL,Patrick Patterson,59,13.3333333333333,13,0.333333333333332,25,26,-1,1,-2
21700526,203460,OKC,MIL,Andre Roberson,154,34.9666666666667,35,-0.0333333333333314,52,75,-23,-22,-1
21700526,203500,OKC,MIL,Steven Adams,141,32.0166666666667,32,0.0166666666666657,61,69,-8,-8,0
21700526,203518,OKC,MIL,Alex Abrines,49,9.8,10,-0.199999999999999,12,34,-22,-24,2
21700526,203924,OKC,MIL,Jerami Grant,93,20.5166666666667,20,0.516666666666666,42,38,4,5,-1
21700526,203962,OKC,MIL,Josh Huestis,117,27.4833333333333,28,-0.516666666666666,63,43,20,21,-1
21700527,2199,PHX,SAC,Tyson Chandler,130,29.4833333333333,30,-0.516666666666666,70,56,14,12,2
21700527,203458,PHX,SAC,Alex Len,80,18.3,18,0.300000000000001,41,45,-4,-2,-2
21700527,203477,PHX,SAC,Isaiah Canaan,86,19.6,19,0.600000000000001,47,45,2,6,-4
21700527,203584,PHX,SAC,Troy Daniels,94,20.6666666666667,21,-0.333333333333336,55,41,14,15,-1
21700527,203933,PHX,SAC,T.J. Warren,168,38.15,38,0.149999999999999,87,72,15,14,1
21700527,1626164,PHX,SAC,Devin Booker,139,31.5333333333333,32,-0.466666666666669,70,64,6,5,1
21700527,1627733,PHX,SAC,Dragan Bender,86,19.45,20,-0.550000000000001,46,47,-1,3,-4
21700527,1627737,PHX,SAC,Marquese Chriss,124,28.3333333333333,28,0.333333333333336,65,54,11,7,4
21700527,1627755,PHX,SAC,Tyler Ulis,101,23.7666666666667,24,-0.233333333333334,50,52,-2,-6,4
21700527,1628367,PHX,SAC,Josh Jackson,42,9.63333333333333,10,-0.366666666666667,24,29,-5,-4,-1
21700527,2216,SAC,PHX,Zach Randolph,108,24.4666666666667,25,-0.533333333333331,60,62,-2,-3,1
21700527,201585,SAC,PHX,Kosta Koufos,94,22.2333333333333,22,0.233333333333334,39,44,-5,-4,-1
21700527,201588,SAC,PHX,George Hill,133,29.6666666666667,30,-0.333333333333332,64,82,-18,-18,0
21700527,202066,SAC,PHX,Garrett Temple,120,27.3333333333333,28,-0.666666666666664,56,70,-14,-10,-4
21700527,203992,SAC,PHX,Bogdan Bogdanovic,135,30.3666666666667,30,0.366666666666667,64,71,-7,-11,4
21700527,1626161,SAC,PHX,Willie Cauley-Stein,136,30.5666666666667,31,-0.433333333333334,62,68,-6,-4,-2
21700527,1627741,SAC,PHX,Buddy Hield,111,24.8833333333333,25,-0.116666666666667,48,53,-5,-9,4
21700527,1627746,SAC,PHX,Skal Labissiere,68,15.6666666666667,16,-0.333333333333336,39,40,-1,-3,2
21700527,1628412,SAC,PHX,Frank Mason,145,33.7333333333333,34,-0.266666666666666,73,65,8,12,-4
21700528,2561,GSW,CHA,David West,67,15.0166666666667,15,0.0166666666666675,25,34,-9,-9,0
21700528,2585,GSW,CHA,Zaza Pachulia,65,13.75,14,-0.25,30,36,-6,-7,1
21700528,2733,GSW,CHA,Shaun Livingston,108,23.1166666666667,23,0.116666666666667,57,63,-6,-8,2
21700528,2738,GSW,CHA,Andre Iguodala,134,27.55,28,-0.450000000000003,51,52,-1,-3,2
21700528,201142,GSW,CHA,Kevin Durant,168,33.9,34,-0.0999999999999943,73,81,-8,-6,-2
21700528,201156,GSW,CHA,Nick Young,74,14.8666666666667,16,-1.13333333333333,32,27,5,5,0
21700528,202691,GSW,CHA,Klay Thompson,172,36.1833333333333,36,0.183333333333337,74,84,-10,-6,-4
21700528,203110,GSW,CHA,Draymond Green,160,34.0333333333333,34,0.0333333333333314,73,80,-7,-9,2
21700528,1626172,GSW,CHA,Kevon Looney,7,1.26666666666667,1,0.266666666666667,6,2,4,2,2
21700528,1627775,GSW,CHA,Patrick McCaw,96,19.4166666666667,20,-0.583333333333336,34,53,-19,-19,0
21700528,1628395,GSW,CHA,Jordan Bell,104,19.65,20,-0.350000000000001,45,43,2,5,-3
21700528,2730,CHA,GSW,Dwight Howard,188,40,40,0,92,83,9,9,0
21700528,101107,CHA,GSW,Marvin Williams,108,22.5333333333333,23,-0.466666666666669,53,49,4,4,0
21700528,201587,CHA,GSW,Nicolas Batum,152,31.2,32,-0.800000000000001,77,72,5,5,0
21700528,202689,CHA,GSW,Kemba Walker,169,35.1666666666667,35,0.166666666666671,85,74,11,11,0
21700528,203077,CHA,GSW,Michael Kidd-Gilchrist,123,25.7,26,-0.299999999999997,60,62,-2,0,-2
21700528,203087,CHA,GSW,Jeremy Lamb,108,22.05,22,0.0500000000000007,51,38,13,11,2
21700528,203487,CHA,GSW,Michael Carter-Williams,62,12.5833333333333,13,-0.416666666666668,26,26,0,0,0
21700528,203948,CHA,GSW,Johnny O'Bryant III,43,7.75,8,-0.25,19,17,2,2,0
21700528,1626163,CHA,GSW,Frank Kaminsky,123,25.2166666666667,25,0.216666666666669,58,51,7,7,0
21700528,1626203,CHA,GSW,Treveon Graham,79,16.55,16,0.549999999999997,34,28,6,6,0
21700529,101150,LAC,LAL,Lou Williams,145,30.6,31,-0.399999999999999,78,70,8,10,-2
21700529,201599,LAC,LAL,DeAndre Jordan,154,31.7666666666667,32,-0.233333333333334,83,67,16,14,2
21700529,201933,LAC,LAL,Blake Griffin,153,32.1666666666667,32,0.166666666666664,79,68,11,11,0
21700529,202325,LAC,LAL,Wesley Johnson,46,9.81666666666667,10,-0.183333333333334,26,23,3,3,0
21700529,203085,LAC,LAL,Austin Rivers,132,26.35,27,-0.649999999999999,65,59,6,8,-2
21700529,203710,LAC,LAL,C.J. Williams,119,23.6833333333333,24,-0.31666666666667,59,47,12,10,2
21700529,1626149,LAC,LAL,Montrezl Harrell,79,16.2333333333333,16,0.233333333333334,38,39,-1,1,-2
21700529,1626155,LAC,LAL,Sam Dekker,90,18.4666666666667,18,0.466666666666665,48,46,2,4,-2
21700529,1628393,LAC,LAL,Jawun Evans,78,16.0166666666667,16,0.0166666666666657,43,37,6,4,2
21700529,1628414,LAC,LAL,Sindarius Thornwell,7,1.75,1,0.75,2,4,-2,-4,2
21700529,1628462,LAC,LAL,Milos Teodosic,162,33.15,33,0.149999999999999,84,70,14,14,0
21700529,101106,LAL,LAC,Andrew Bogut,25,5.06666666666667,5,0.0666666666666664,8,12,-4,-4,0
21700529,201147,LAL,LAC,Corey Brewer,78,15.25,15,0.25,36,38,-2,-2,0
21700529,203484,LAL,LAC,Kentavious Caldwell-Pope,161,33.5333333333333,34,-0.466666666666669,74,86,-12,-14,2
21700529,203903,LAL,LAC,Jordan Clarkson,169,35.1,35,0.0999999999999943,82,81,1,1,0
21700529,203944,LAL,LAC,Julius Randle,139,28.25,29,-0.75,57,71,-14,-16,2
21700529,1626204,LAL,LAC,Larry Nance Jr.,89,18.1833333333333,18,0.18333333333333,46,48,-2,-2,0
21700529,1627742,LAL,LAC,Brandon Ingram,179,36.35,37,-0.650000000000006,78,94,-16,-18,2
21700529,1627826,LAL,LAC,Ivica Zubac,5,1.56666666666667,1,0.566666666666667,3,2,1,3,-2
21700529,1627936,LAL,LAC,Alex Caruso,30,6.43333333333333,6,0.433333333333334,17,19,-2,-2,0
21700529,1628398,LAL,LAC,Kyle Kuzma,178,36.5,37,-0.5,81,90,-9,-9,0
21700529,1628404,LAL,LAC,Josh Hart,107,22.2,22,0.199999999999999,45,62,-17,-15,-2
21700529,1628418,LAL,LAC,Thomas Bryant,5,1.56666666666667,1,0.566666666666667,3,2,1,3,-2
21700530,1938,SAS,DET,Manu Ginobili,80,18.5833333333333,19,-0.416666666666668,33,36,-3,-1,-2
21700530,2200,SAS,DET,Pau Gasol,89,21.45,22,-0.549999999999997,32,46,-14,-14,0
21700530,2225,SAS,DET,Tony Parker,85,20.3166666666667,20,0.316666666666666,24,46,-22,-22,0
21700530,200746,SAS,DET,LaMarcus Aldridge,143,33.4666666666667,33,0.466666666666669,52,63,-11,-11,0
21700530,201980,SAS,DET,Danny Green,79,18.5333333333333,19,-0.466666666666669,24,42,-18,-20,2
21700530,201988,SAS,DET,Patty Mills,75,17.4666666666667,18,-0.533333333333331,25,37,-12,-6,-6
21700530,202695,SAS,DET,Kawhi Leonard,117,27.6333333333333,28,-0.366666666666667,39,60,-21,-21,0
21700530,202722,SAS,DET,Davis Bertans,24,4.33333333333333,5,-0.666666666666666,6,9,-3,-1,-2
21700530,203464,SAS,DET,Brandon Paul,47,10.6166666666667,11,-0.383333333333333,22,15,7,7,0
21700530,203530,SAS,DET,Joffrey Lauvergne,43,9.28333333333333,9,0.283333333333333,17,16,1,1,0
21700530,203937,SAS,DET,Kyle Anderson,83,19.75,20,-0.25,42,30,12,8,4
21700530,1627749,SAS,DET,Dejounte Murray,59,12.9666666666667,13,-0.0333333333333332,32,19,13,11,2
21700530,1627854,SAS,DET,Bryn Forbes,106,24.2666666666667,25,-0.733333333333334,47,46,1,-1,2
21700530,201229,DET,SAS,Anthony Tolliver,116,26.5833333333333,27,-0.416666666666668,47,44,3,1,2
21700530,202397,DET,SAS,Ish Smith,133,30.35,30,0.350000000000001,62,53,9,12,-3
21700530,202699,DET,SAS,Tobias Harris,150,35,35,0,73,55,18,20,-2
21700530,202779,DET,SAS,Dwight Buycks,73,17.3833333333333,18,-0.616666666666667,31,26,5,2,3
21700530,203083,DET,SAS,Andre Drummond,163,38.05,38,0.0499999999999972,76,60,16,16,0
21700530,203493,DET,SAS,Reggie Bullock,144,34.3166666666667,34,0.316666666666663,68,56,12,11,1
21700530,203961,DET,SAS,Eric Moreland,18,4.41666666666667,4,0.416666666666667,11,8,3,3,0
21700530,204038,DET,SAS,Langston Galloway,72,15.9333333333333,16,-0.0666666666666664,27,31,-4,-5,1
21700530,1626242,DET,SAS,Luis Montero,9,1.23333333333333,1,0.233333333333333,1,4,-3,-4,1
21700530,1626246,DET,SAS,Boban Marjanovic,19,4.4,4,0.4,6,7,-1,-1,0
21700530,1627740,DET,SAS,Henry Ellenson,6,0.866666666666667,1,-0.133333333333333,0,4,-4,-4,0
21700530,1628379,DET,SAS,Luke Kennard,127,30.1333333333333,30,0.133333333333333,63,47,16,19,-3
21700531,201609,MIA,ORL,Goran Dragic,161,38.5,38,0.5,92,86,6,9,-3
21700531,201961,MIA,ORL,Wayne Ellington,135,31.75,32,-0.25,78,71,7,6,1
21700531,202355,MIA,ORL,Hassan Whiteside,127,28.6333333333333,29,-0.366666666666667,75,67,8,5,3
21700531,203482,MIA,ORL,Kelly Olynyk,135,30.4666666666667,30,0.466666666666669,77,76,1,2,-1
21700531,204020,MIA,ORL,Tyler Johnson,168,38.6333333333333,39,-0.366666666666667,95,88,7,7,0
21700531,1626175,MIA,ORL,Jordan Mickey,53,13.2166666666667,13,0.216666666666667,32,33,-1,3,-4
21700531,1626196,MIA,ORL,Josh Richardson,176,40.35,41,-0.650000000000006,97,92,5,5,0
21700531,1628389,MIA,ORL,Bam Adebayo,65,15.5666666666667,16,-0.433333333333334,28,33,-5,-7,2
21700531,1628476,MIA,ORL,Derrick Walton Jr.,15,2.88333333333333,3,-0.116666666666667,11,9,2,0,2
21700531,201167,ORL,MIA,Arron Afflalo,57,14.6666666666667,15,-0.333333333333334,30,33,-3,-5,2
21700531,201571,ORL,MIA,D.J. Augustin,53,13.1833333333333,13,0.183333333333334,31,33,-2,-2,0
21700531,201578,ORL,MIA,Marreese Speights,61,15.5,15,0.5,32,38,-6,-8,2
21700531,202687,ORL,MIA,Bismack Biyombo,146,32.5,33,-0.5,79,79,0,2,-2
21700531,203095,ORL,MIA,Evan Fournier,162,36.75,37,-0.25,87,88,-1,1,-2
21700531,203613,ORL,MIA,Jonathon Simmons,156,34.8833333333333,35,-0.116666666666667,84,86,-2,0,-2
21700531,203901,ORL,MIA,Elfrid Payton,175,39.6833333333333,40,-0.316666666666663,88,95,-7,-7,0
21700531,203932,ORL,MIA,Aaron Gordon,157,35.8333333333333,36,-0.166666666666671,83,88,-5,-3,-2
21700531,1626209,ORL,MIA,Mario Hezonja,50,12.1666666666667,12,0.166666666666668,28,29,-1,-3,2
21700531,1628411,ORL,MIA,Wes Iwundu,18,4.83333333333333,5,-0.166666666666667,13,16,-3,-5,2
21700532,2749,NOP,NYK,Jameer Nelson,36,7.61666666666667,8,-0.383333333333334,11,20,-9,-9,0
21700532,200765,NOP,NYK,Rajon Rondo,157,33.8833333333333,34,-0.116666666666667,80,73,7,9,-2
21700532,201950,NOP,NYK,Jrue Holiday,152,33.0833333333333,34,-0.916666666666664,79,68,11,9,2
21700532,201967,NOP,NYK,Dante Cunningham,67,14.3333333333333,14,0.333333333333332,26,30,-4,-6,2
21700532,202326,NOP,NYK,DeMarcus Cousins,187,39.9833333333333,40,-0.0166666666666657,86,89,-3,-3,0
21700532,202734,NOP,NYK,E'Twaun Moore,143,30.1333333333333,30,0.133333333333333,71,69,2,4,-2
21700532,203076,NOP,NYK,Anthony Davis,172,36.45,36,0.450000000000003,82,85,-3,-3,0
21700532,203121,NOP,NYK,Darius Miller,152,32.8666666666667,32,0.866666666666667,61,68,-7,-7,0
21700532,203546,NOP,NYK,Ian Clark,54,11.4833333333333,12,-0.516666666666666,19,23,-4,-4,0
21700532,101127,NYK,NOP,Jarrett Jack,108,23.7833333333333,24,-0.216666666666669,56,57,-1,-1,0
21700532,201149,NYK,NOP,Joakim Noah,54,12.55,13,-0.450000000000001,26,25,1,1,0
21700532,201196,NYK,NOP,Ramon Sessions,12,2.51666666666667,3,-0.483333333333333,6,8,-2,-5,3
21700532,201563,NYK,NOP,Michael Beasley,93,20.2166666666667,20,0.216666666666669,46,47,-1,-2,1
21700532,201584,NYK,NOP,Courtney Lee,166,35.7833333333333,36,-0.216666666666669,82,77,5,4,1
21700532,202498,NYK,NOP,Lance Thomas,85,17.5833333333333,18,-0.416666666666664,39,42,-3,-2,-1
21700532,202683,NYK,NOP,Enes Kanter,94,19.9333333333333,20,-0.0666666666666664,43,45,-2,-2,0
21700532,203124,NYK,NOP,Kyle O'Quinn,76,15.4833333333333,15,0.483333333333334,36,33,3,3,0
21700532,203926,NYK,NOP,Doug McDermott,102,22.1166666666667,22,0.116666666666667,42,40,2,4,-2
21700532,204001,NYK,NOP,Kristaps Porzingis,150,31.65,32,-0.350000000000001,75,68,7,7,0
21700532,1627758,NYK,NOP,Ron Baker,44,8.9,9,-0.100000000000001,19,19,0,-1,1
21700532,1628373,NYK,NOP,Frank Ntilikina,136,29.3166666666667,29,0.316666666666666,55,54,1,4,-3
21700533,101141,ATL,POR,Ersan Ilyasova,140,28.7666666666667,29,-0.233333333333334,63,57,6,4,2
21700533,201158,ATL,POR,Marco Belinelli,96,20.7,21,-0.300000000000001,46,34,12,14,-2
21700533,203101,ATL,POR,Miles Plumlee,94,19.45,19,0.450000000000003,40,35,5,4,1
21700533,203145,ATL,POR,Kent Bazemore,123,25.75,26,-0.25,58,51,7,3,4
21700533,203471,ATL,POR,Dennis Schroder,163,33.6333333333333,33,0.633333333333333,78,63,15,13,2
21700533,1627098,ATL,POR,Malcolm Delaney,73,16.1333333333333,17,-0.866666666666667,34,32,2,3,-1
21700533,1627752,ATL,POR,Taurean Prince,151,31.2,31,0.200000000000003,70,57,13,12,1
21700533,1627819,ATL,POR,Isaiah Taylor,62,13.95,15,-1.05,26,26,0,2,-2
21700533,1628381,ATL,POR,John Collins,115,24.4833333333333,25,-0.516666666666666,52,48,4,6,-2
21700533,1628416,ATL,POR,Tyler Dorsey,7,1.38333333333333,2,-0.616666666666667,0,4,-4,-2,-2
21700533,1628463,ATL,POR,Tyler Cavanaugh,101,22.4666666666667,23,-0.533333333333331,53,38,15,16,-1
21700533,202323,POR,ATL,Evan Turner,152,30.75,30,0.75,58,75,-17,-17,0
21700533,202329,POR,ATL,Al-Farouq Aminu,153,31.15,31,0.149999999999999,60,79,-19,-19,0
21700533,202334,POR,ATL,Ed Davis,89,20.2833333333333,20,0.283333333333331,34,45,-11,-11,0
21700533,203090,POR,ATL,Maurice Harkless,77,17.3333333333333,18,-0.666666666666668,30,33,-3,-3,0
21700533,203468,POR,ATL,CJ McCollum,170,34.8666666666667,35,-0.13333333333334,62,87,-25,-25,0
21700533,203894,POR,ATL,Shabazz Napier,165,35.35,36,-0.649999999999999,67,74,-7,-5,-2
21700533,203943,POR,ATL,Noah Vonleh,13,3.13333333333333,4,-0.866666666666667,6,3,3,3,0
21700533,203994,POR,ATL,Jusuf Nurkic,123,24.1666666666667,24,0.166666666666664,49,56,-7,-7,0
21700533,1626192,POR,ATL,Pat Connaughton,98,21.3166666666667,22,-0.683333333333334,44,40,4,2,2
21700533,1627774,POR,ATL,Jake Layman,13,3.13333333333333,4,-0.866666666666667,6,3,3,3,0
21700533,1628380,POR,ATL,Zach Collins,72,16.4333333333333,17,-0.566666666666666,29,25,4,4,0
21700534,2544,CLE,UTA,LeBron James,171,37.55,37,0.549999999999997,80,85,-5,-5,0
21700534,2548,CLE,UTA,Dwyane Wade,113,24.9166666666667,25,-0.0833333333333357,59,53,6,6,0
21700534,2594,CLE,UTA,Kyle Korver,82,18.4333333333333,18,0.433333333333334,40,41,-1,2,-3
21700534,2747,CLE,UTA,JR Smith,151,32.9333333333333,33,-0.0666666666666629,68,75,-7,-6,-1
21700534,101181,CLE,UTA,Jose Calderon,82,18.5666666666667,19,-0.433333333333334,35,41,-6,-6,0
21700534,201145,CLE,UTA,Jeff Green,122,26.75,27,-0.25,64,53,11,7,4
21700534,201567,CLE,UTA,Kevin Love,137,29.8333333333333,29,0.833333333333336,56,68,-12,-10,-2
21700534,202684,CLE,UTA,Tristan Thompson,86,19.5333333333333,20,-0.466666666666669,45,38,7,5,2
21700534,203109,CLE,UTA,Jae Crowder,95,21.2166666666667,21,0.216666666666669,37,49,-12,-10,-2
21700534,1626224,CLE,UTA,Cedi Osman,46,10.2666666666667,10,0.266666666666666,21,17,4,2,2
21700534,2207,UTA,CLE,Joe Johnson,72,16.45,17,-0.550000000000001,34,38,-4,-4,0
21700534,200757,UTA,CLE,Thabo Sefolosha,145,31.55,31,0.549999999999997,70,63,7,7,0
21700534,201937,UTA,CLE,Ricky Rubio,138,31.55,32,-0.450000000000003,75,60,15,13,2
21700534,201973,UTA,CLE,Jonas Jerebko,14,3.38333333333333,3,0.383333333333333,8,9,-1,0,-1
21700534,202324,UTA,CLE,Derrick Favors,139,30.5666666666667,30,0.566666666666666,70,53,17,17,0
21700534,202327,UTA,CLE,Ekpe Udoh,65,14.4,14,0.4,26,40,-14,-14,0
21700534,202692,UTA,CLE,Alec Burks,30,6.15,6,0.15,11,16,-5,-5,0
21700534,203918,UTA,CLE,Rodney Hood,126,27.3666666666667,27,0.366666666666667,53,68,-15,-11,-4
21700534,204060,UTA,CLE,Joe Ingles,147,32.35,33,-0.649999999999999,74,64,10,6,4
21700534,1626220,UTA,CLE,Royce O'Neale,33,7.98333333333333,8,-0.0166666666666675,15,19,-4,0,-4
21700534,1628378,UTA,CLE,Donovan Mitchell,176,38.25,39,-0.75,84,75,9,6,3
21700535,2561,GSW,MEM,David West,65,13.4833333333333,13,0.483333333333334,31,29,2,1,1
21700535,2585,GSW,MEM,Zaza Pachulia,107,23.8833333333333,24,-0.116666666666667,84,66,18,18,0
21700535,2733,GSW,MEM,Shaun Livingston,74,15.1166666666667,15,0.116666666666667,36,34,2,3,-1
21700535,2738,GSW,MEM,Andre Iguodala,90,18.7333333333333,19,-0.266666666666666,49,46,3,2,1
21700535,201142,GSW,MEM,Kevin Durant,159,35.4333333333333,35,0.433333333333337,113,95,18,18,0
21700535,201156,GSW,MEM,Nick Young,63,12,12,0,36,36,0,-3,3
21700535,201580,GSW,MEM,JaVale McGee,52,10.3166666666667,11,-0.683333333333334,26,32,-6,-6,0
21700535,201939,GSW,MEM,Stephen Curry,114,25.5166666666667,26,-0.483333333333334,89,65,24,24,0
21700535,201956,GSW,MEM,Omri Casspi,94,18.7333333333333,19,-0.266666666666666,51,49,2,1,1
21700535,202691,GSW,MEM,Klay Thompson,154,34.4166666666667,34,0.416666666666664,102,92,10,12,-2
21700535,203110,GSW,MEM,Draymond Green,47,10.0833333333333,10,0.0833333333333322,33,32,1,1,0
21700535,1627775,GSW,MEM,Patrick McCaw,15,2.28333333333333,3,-0.716666666666667,4,9,-5,-5,0
21700535,1628395,GSW,MEM,Jordan Bell,86,18.4166666666667,19,-0.583333333333336,51,50,1,-1,2
21700535,201148,MEM,GSW,Brandan Wright,37,7.66666666666667,8,-0.333333333333334,19,26,-7,-5,-2
21700535,201188,MEM,GSW,Marc Gasol,127,28.35,28,0.350000000000001,72,91,-19,-19,0
21700535,201596,MEM,GSW,Mario Chalmers,73,14.5666666666667,15,-0.433333333333334,34,40,-6,-5,-1
21700535,201936,MEM,GSW,Tyreke Evans,136,30.8333333333333,31,-0.166666666666668,84,97,-13,-13,0
21700535,203210,MEM,GSW,JaMychal Green,87,19.3666666666667,20,-0.633333333333333,50,60,-10,-14,4
21700535,203516,MEM,GSW,James Ennis III,121,25.3,26,-0.700000000000003,72,71,1,2,-1
21700535,1626150,MEM,GSW,Andrew Harrison,72,15.0333333333333,15,0.0333333333333314,40,53,-13,-15,2
21700535,1626185,MEM,GSW,Jarell Martin,115,23.5666666666667,24,-0.433333333333334,69,68,1,4,-3
21700535,1627738,MEM,GSW,Deyonta Davis,82,16.4166666666667,17,-0.583333333333336,44,37,7,8,-1
21700535,1628397,MEM,GSW,Ivan Rabb,15,2.28333333333333,3,-0.716666666666667,9,4,5,5,0
21700535,1628415,MEM,GSW,Dillon Brooks,114,24.4833333333333,24,0.483333333333334,64,80,-16,-16,0
21700535,1628424,MEM,GSW,Kobi Simmons,141,30.55,31,-0.449999999999999,78,78,0,3,-3
21700536,201163,DEN,PHI,Wilson Chandler,156,33.35,33,0.350000000000001,78,69,9,1,8
21700536,203115,DEN,PHI,Will Barton,154,31.3333333333333,31,0.333333333333332,63,78,-15,-15,0
21700536,203486,DEN,PHI,Mason Plumlee,109,22.7833333333333,23,-0.216666666666669,45,57,-12,-10,-2
21700536,203914,DEN,PHI,Gary Harris,194,39.4833333333333,39,0.483333333333334,81,93,-12,-13,1
21700536,203999,DEN,PHI,Nikola Jokic,174,36.3,37,-0.700000000000003,80,69,11,14,-3
21700536,1626168,DEN,PHI,Trey Lyles,153,31.1,31,0.100000000000001,66,70,-4,-1,-3
21700536,1627750,DEN,PHI,Jamal Murray,194,40.0833333333333,40,0.0833333333333286,85,84,1,5,-4
21700536,1628470,DEN,PHI,Torrey Craig,31,5.56666666666667,6,-0.433333333333334,12,15,-3,-6,3
21700536,101161,PHI,DEN,Amir Johnson,107,21.7666666666667,23,-1.23333333333333,46,44,2,2,0
21700536,200755,PHI,DEN,JJ Redick,130,26.0666666666667,26,0.0666666666666664,50,57,-7,-6,-1
21700536,201573,PHI,DEN,Jerryd Bayless,100,19.8666666666667,20,-0.133333333333333,54,29,25,22,3
21700536,202344,PHI,DEN,Trevor Booker,73,14.6,14,0.6,37,30,7,10,-3
21700536,203496,PHI,DEN,Robert Covington,166,34.95,35,-0.0499999999999972,78,71,7,5,2
21700536,203967,PHI,DEN,Dario Saric,168,35.0333333333333,35,0.0333333333333314,70,80,-10,-8,-2
21700536,204456,PHI,DEN,T.J. McConnell,117,25.4833333333333,25,0.483333333333334,61,57,4,2,2
21700536,1626158,PHI,DEN,Richaun Holmes,89,18.8333333333333,19,-0.166666666666668,49,40,9,8,1
21700536,1627732,PHI,DEN,Ben Simmons,160,31.9333333333333,32,-0.0666666666666664,62,72,-10,-11,1
21700536,1627789,PHI,DEN,Timothe Luwawu-Cabarrot,55,11.4666666666667,11,0.466666666666667,28,30,-2,1,-3
21700537,201577,CHI,WAS,Robin Lopez,99,20.7166666666667,21,-0.283333333333335,52,52,0,4,-4
21700537,202703,CHI,WAS,Nikola Mirotic,136,28.05,28,0.0499999999999972,60,65,-5,-5,0
21700537,203200,CHI,WAS,Justin Holiday,169,34.1166666666667,34,0.116666666666667,84,83,1,0,1
21700537,1626170,CHI,WAS,Jerian Grant,80,16.6166666666667,16,0.616666666666667,35,44,-9,-10,1
21700537,1626171,CHI,WAS,Bobby Portis,87,18.4333333333333,18,0.433333333333334,40,41,-1,-2,1
21700537,1627739,CHI,WAS,Kris Dunn,151,31.2833333333333,32,-0.716666666666669,75,70,5,6,-1
21700537,1627756,CHI,WAS,Denzel Valentine,109,21.7166666666667,23,-1.28333333333333,52,53,-1,-3,2
21700537,1627835,CHI,WAS,Paul Zipser,61,13.7833333333333,14,-0.216666666666667,26,30,-4,-4,0
21700537,1628021,CHI,WAS,David Nwaba,121,26.0166666666667,25,1.01666666666667,58,59,-1,-1,0
21700537,1628374,CHI,WAS,Lauri Markkanen,142,28.7666666666667,29,-0.233333333333334,68,73,-5,-5,0
21700537,101133,WAS,CHI,Ian Mahinmi,37,7.43333333333333,7,0.433333333333334,21,26,-5,-5,0
21700537,101162,WAS,CHI,Marcin Gortat,114,24.6166666666667,25,-0.383333333333333,56,55,1,1,0
21700537,201975,WAS,CHI,Jodie Meeks,18,3.11666666666667,3,0.116666666666667,9,15,-6,-4,-2
21700537,202322,WAS,CHI,John Wall,191,40.4166666666667,41,-0.583333333333336,95,83,12,10,2
21700537,202693,WAS,CHI,Markieff Morris,111,23.9333333333333,24,-0.0666666666666664,54,56,-2,-2,0
21700537,203078,WAS,CHI,Bradley Beal,213,44.7833333333333,45,-0.216666666666669,105,95,10,8,2
21700537,203107,WAS,CHI,Tomas Satoransky,57,11.1833333333333,11,0.183333333333334,26,31,-5,-3,-2
21700537,203118,WAS,CHI,Mike Scott,136,27.0333333333333,27,0.0333333333333314,67,62,5,5,0
21700537,203490,WAS,CHI,Otto Porter Jr.,175,36.2833333333333,37,-0.716666666666669,84,75,9,9,0
21700537,1626162,WAS,CHI,Kelly Oubre Jr.,103,20.7,20,0.699999999999999,53,52,1,1,0
21700538,2037,MIN,IND,Jamal Crawford,82,19.1,20,-0.899999999999999,25,37,-12,-10,-2
21700538,201166,MIN,IND,Aaron Brooks,97,21.4666666666667,21,0.466666666666669,35,49,-14,-13,-1
21700538,201959,MIN,IND,Taj Gibson,140,30.6166666666667,31,-0.383333333333333,82,48,34,32,2
21700538,202332,MIN,IND,Cole Aldrich,19,3.15,3,0.15,6,15,-9,-7,-2
21700538,202357,MIN,IND,Nemanja Bjelica,81,17.3833333333333,17,0.383333333333333,25,42,-17,-15,-2
21700538,202710,MIN,IND,Jimmy Butler,125,27,27,0,74,43,31,31,0
21700538,203476,MIN,IND,Gorgui Dieng,79,18.1333333333333,18,0.133333333333333,29,32,-3,-7,4
21700538,203498,MIN,IND,Shabazz Muhammad,24,3.93333333333333,4,-0.0666666666666669,8,15,-7,-7,0
21700538,203952,MIN,IND,Andrew Wiggins,141,31,31,0,82,48,34,32,2
21700538,1626145,MIN,IND,Tyus Jones,123,26.15,27,-0.850000000000001,72,41,31,30,1
21700538,1626157,MIN,IND,Karl-Anthony Towns,169,37.75,38,-0.25,89,65,24,26,-2
21700538,1627875,MIN,IND,Marcus Georges-Hunt,25,4.31666666666667,4,0.316666666666666,8,15,-7,-7,0
21700538,2744,IND,MIN,Al Jefferson,77,17.8,18,-0.200000000000003,36,25,11,11,0
21700538,2863,IND,MIN,Damien Wilkins,128,27.3833333333333,27,0.383333333333333,62,46,16,16,0
21700538,201152,IND,MIN,Thaddeus Young,100,21.6833333333333,22,-0.316666666666666,32,65,-33,-33,0
21700538,201954,IND,MIN,Darren Collison,93,20.4,20,0.399999999999999,32,59,-27,-27,0
21700538,202362,IND,MIN,Lance Stephenson,104,22.0666666666667,22,0.0666666666666664,32,68,-36,-35,-1
21700538,202709,IND,MIN,Cory Joseph,113,25.5,26,-0.5,45,45,0,2,-2
21700538,202711,IND,MIN,Bojan Bogdanovic,94,21.25,21,0.25,30,57,-27,-28,1
21700538,1626167,IND,MIN,Myles Turner,86,18.75,19,-0.25,33,44,-11,-13,2
21700538,1626202,IND,MIN,Joe Young,112,24.25,24,0.25,54,40,14,14,0
21700538,1627734,IND,MIN,Domantas Sabonis,128,29.2833333333333,29,0.283333333333331,49,62,-13,-11,-2
21700538,1627816,IND,MIN,Alex Poythress,22,3.76666666666667,4,-0.233333333333333,15,8,7,5,2
21700538,1628387,IND,MIN,Ike Anigbogu,24,3.93333333333333,4,-0.0666666666666669,15,8,7,7,0
21700538,1628388,IND,MIN,TJ Leaf,24,3.93333333333333,4,-0.0666666666666669,15,8,7,7,0
21700539,201143,BOS,BKN,Al Horford,143,30.4666666666667,30,0.466666666666669,64,63,1,4,-3
21700539,202681,BOS,BKN,Kyrie Irving,161,34.1333333333333,34,0.133333333333333,78,71,7,7,0
21700539,202694,BOS,BKN,Marcus Morris,76,16.8333333333333,17,-0.166666666666664,44,32,12,12,0
21700539,203382,BOS,BKN,Aron Baynes,102,22.6333333333333,23,-0.366666666666667,53,39,14,12,2
21700539,203499,BOS,BKN,Shane Larkin,25,5.68333333333333,6,-0.316666666666666,9,18,-9,-9,0
21700539,203935,BOS,BKN,Marcus Smart,137,28.9166666666667,29,-0.0833333333333357,63,69,-6,-5,-1
21700539,1626179,BOS,BKN,Terry Rozier,115,23.5833333333333,24,-0.416666666666668,56,61,-5,-6,1
21700539,1627759,BOS,BKN,Jaylen Brown,159,34.0833333333333,35,-0.916666666666671,73,72,1,0,1
21700539,1628369,BOS,BKN,Jayson Tatum,157,33.3833333333333,33,0.383333333333333,69,72,-3,-3,0
21700539,1628464,BOS,BKN,Daniel Theis,50,10.2833333333333,10,0.283333333333333,31,28,3,3,0
21700539,201960,BKN,BOS,DeMarre Carroll,136,29.5,30,-0.5,59,64,-5,-12,7
21700539,203092,BKN,BOS,Tyler Zeller,70,15.1833333333333,15,0.183333333333334,22,36,-14,-10,-4
21700539,203112,BKN,BOS,Quincy Acy,116,24.3833333333333,24,0.383333333333333,68,55,13,17,-4
21700539,203459,BKN,BOS,Allen Crabbe,157,33.9333333333333,34,-0.06666666666667,70,73,-3,2,-5
21700539,203915,BKN,BOS,Spencer Dinwiddie,139,29.4666666666667,29,0.466666666666665,64,66,-2,-5,3
21700539,203917,BKN,BOS,Nik Stauskas,37,7.96666666666667,8,-0.0333333333333332,22,17,5,5,0
21700539,203925,BKN,BOS,Joe Harris,99,20.8666666666667,21,-0.133333333333333,50,46,4,-1,5
21700539,1626178,BKN,BOS,Rondae Hollis-Jefferson,153,32.7833333333333,33,-0.216666666666669,66,77,-11,-11,0
21700539,1627747,BKN,BOS,Caris LeVert,143,29.85,30,-0.149999999999999,71,64,7,10,-3
21700539,1628386,BKN,BOS,Jarrett Allen,75,16.0666666666667,16,0.0666666666666664,33,42,-9,-10,1
21700540,2403,HOU,LAL,Nene,30,5.9,6,-0.0999999999999996,20,17,3,7,-4
21700540,2772,HOU,LAL,Trevor Ariza,211,44.4666666666667,45,-0.533333333333331,115,113,2,3,-1
21700540,101108,HOU,LAL,Chris Paul,205,42.3166666666667,42,0.316666666666663,103,106,-3,4,-7
21700540,101123,HOU,LAL,Gerald Green,108,22.0833333333333,22,0.0833333333333322,58,52,6,6,0
21700540,200782,HOU,LAL,PJ Tucker,110,22.35,22,0.350000000000001,56,46,10,6,4
21700540,201569,HOU,LAL,Eric Gordon,207,43.3166666666667,43,0.316666666666663,113,98,15,14,1
21700540,201583,HOU,LAL,Ryan Anderson,101,20.65,21,-0.350000000000001,45,64,-19,-18,-1
21700540,201935,HOU,LAL,James Harden,186,40.25,41,-0.75,107,99,8,4,4
21700540,203991,HOU,LAL,Clint Capela,151,32.1666666666667,32,0.166666666666671,82,85,-3,-9,6
21700540,204028,HOU,LAL,Tarik Black,81,16.25,16,0.25,41,30,11,13,-2
21700540,101106,LAL,HOU,Andrew Bogut,44,8.18333333333333,8,0.183333333333334,19,14,5,1,4
21700540,201147,LAL,HOU,Corey Brewer,152,31.3,31,0.299999999999997,70,81,-11,-10,-1
21700540,203898,LAL,HOU,Tyler Ennis,211,45.4333333333333,45,0.433333333333337,115,112,3,-3,6
21700540,203903,LAL,HOU,Jordan Clarkson,103,20.95,21,-0.0500000000000007,41,58,-17,-11,-6
21700540,203944,LAL,HOU,Julius Randle,153,33.3833333333333,33,0.383333333333333,91,84,7,8,-1
21700540,1626204,LAL,HOU,Larry Nance Jr.,90,17.7,18,-0.300000000000001,38,45,-7,-10,3
21700540,1627742,LAL,HOU,Brandon Ingram,213,44.5666666666667,44,0.566666666666663,112,122,-10,-6,-4
21700540,1627936,LAL,HOU,Alex Caruso,48,9,9,0,23,21,2,2,0
21700540,1628398,LAL,HOU,Kyle Kuzma,204,42.4166666666667,43,-0.583333333333336,106,117,-11,-7,-4
21700540,1628404,LAL,HOU,Josh Hart,172,36.8166666666667,37,-0.183333333333337,95,86,9,6,3
21700541,1717,DAL,OKC,Dirk Nowitzki,105,23.8833333333333,23,0.883333333333333,48,51,-3,-2,-1
21700541,2734,DAL,OKC,Devin Harris,73,15.9833333333333,16,-0.0166666666666657,37,36,1,2,-1
21700541,200826,DAL,OKC,J.J. Barea,105,24.4166666666667,25,-0.583333333333336,56,51,5,9,-4
21700541,202083,DAL,OKC,Wesley Matthews,163,35.6666666666667,36,-0.333333333333329,91,86,5,3,2
21700541,203084,DAL,OKC,Harrison Barnes,156,33.3666666666667,34,-0.633333333333333,91,83,8,8,0
21700541,203939,DAL,OKC,Dwight Powell,70,15.4333333333333,15,0.433333333333334,28,35,-7,-7,0
21700541,1626257,DAL,OKC,Salah Mejri,99,21.9833333333333,22,-0.0166666666666657,62,54,8,12,-4
21700541,1627812,DAL,OKC,Yogi Ferrell,116,26.1333333333333,26,0.133333333333333,57,57,0,-8,8
21700541,1628372,DAL,OKC,Dennis Smith Jr.,130,27.8666666666667,28,-0.133333333333333,71,71,0,0,0
21700541,1628467,DAL,OKC,Maxi Kleber,73,15.1,15,0.100000000000001,39,41,-2,-2,0
21700541,2546,OKC,DAL,Carmelo Anthony,150,31.9,32,-0.100000000000001,81,89,-8,-8,0
21700541,101109,OKC,DAL,Raymond Felton,97,22.25,23,-0.75,47,55,-8,-8,0
21700541,201566,OKC,DAL,Russell Westbrook,172,37,37,0,94,93,1,0,1
21700541,202331,OKC,DAL,Paul George,158,34.2833333333333,35,-0.716666666666669,80,82,-2,-2,0
21700541,202335,OKC,DAL,Patrick Patterson,59,13.5833333333333,13,0.583333333333332,25,23,2,1,1
21700541,203500,OKC,DAL,Steven Adams,142,30.5333333333333,31,-0.466666666666669,78,78,0,-1,1
21700541,203518,OKC,DAL,Alex Abrines,63,14.55,15,-0.449999999999999,33,36,-3,-2,-1
21700541,203924,OKC,DAL,Jerami Grant,95,22.4666666666667,22,0.466666666666669,49,46,3,5,-2
21700541,203962,OKC,DAL,Josh Huestis,94,19.2333333333333,19,0.233333333333334,50,52,-2,-2,0
21700541,1628390,OKC,DAL,Terrance Ferguson,60,14.0333333333333,14,0.0333333333333332,28,26,2,2,0
21700542,101150,LAC,CHA,Lou Williams,176,37.0333333333333,37,0.0333333333333314,89,84,5,5,0
21700542,201599,LAC,CHA,DeAndre Jordan,165,35.9166666666667,36,-0.0833333333333286,88,65,23,23,0
21700542,201933,LAC,CHA,Blake Griffin,151,32.9,33,-0.100000000000001,74,58,16,19,-3
21700542,202325,LAC,CHA,Wesley Johnson,120,25.6166666666667,26,-0.383333333333333,54,46,8,5,3
21700542,203710,LAC,CHA,C.J. Williams,157,33.45,34,-0.549999999999997,82,58,24,24,0
21700542,1626149,LAC,CHA,Montrezl Harrell,61,11.8666666666667,12,-0.133333333333333,18,33,-15,-15,0
21700542,1626155,LAC,CHA,Sam Dekker,82,16.15,16,0.149999999999999,35,47,-12,-14,2
21700542,1628393,LAC,CHA,Jawun Evans,69,13.8666666666667,14,-0.133333333333333,36,33,3,2,1
21700542,1628414,LAC,CHA,Sindarius Thornwell,23,4.78333333333333,5,-0.216666666666667,2,12,-10,-11,1
21700542,1628462,LAC,CHA,Milos Teodosic,126,27.3333333333333,28,-0.666666666666664,52,54,-2,2,-4
21700542,2730,CHA,LAC,Dwight Howard,157,34.0333333333333,34,0.0333333333333314,61,78,-17,-18,1
21700542,101107,CHA,LAC,Marvin Williams,79,16.55,17,-0.449999999999999,26,32,-6,-3,-3
21700542,201587,CHA,LAC,Nicolas Batum,129,28.3166666666667,29,-0.683333333333334,46,60,-14,-14,0
21700542,202689,CHA,LAC,Kemba Walker,153,33.4333333333333,33,0.433333333333337,57,80,-23,-21,-2
21700542,203077,CHA,LAC,Michael Kidd-Gilchrist,97,21.15,21,0.149999999999999,39,45,-6,-1,-5
21700542,203087,CHA,LAC,Jeremy Lamb,117,24,24,0,55,54,1,-2,3
21700542,203487,CHA,LAC,Michael Carter-Williams,83,16.6166666666667,17,-0.383333333333333,47,33,14,12,2
21700542,203948,CHA,LAC,Johnny O'Bryant III,69,13.75,14,-0.25,37,28,9,10,-1
21700542,1626163,CHA,LAC,Frank Kaminsky,142,30.3833333333333,31,-0.616666666666667,72,72,0,-3,3
21700542,1626203,CHA,LAC,Treveon Graham,104,20.6833333333333,21,-0.316666666666666,50,48,2,0,2
21700543,1713,SAC,MEM,Vince Carter,74,15.5,15,0.5,25,41,-16,-14,-2
21700543,2216,SAC,MEM,Zach Randolph,86,18.6666666666667,18,0.666666666666664,30,43,-13,-13,0
21700543,201585,SAC,MEM,Kosta Koufos,47,9.96666666666667,10,-0.0333333333333332,9,25,-16,-16,0
21700543,201588,SAC,MEM,George Hill,108,23.6833333333333,24,-0.31666666666667,35,53,-18,-18,0
21700543,202066,SAC,MEM,Garrett Temple,106,21.7,22,-0.300000000000001,32,51,-19,-21,2
21700543,203992,SAC,MEM,Bogdan Bogdanovic,123,27.1,28,-0.899999999999999,48,66,-18,-16,-2
21700543,1626161,SAC,MEM,Willie Cauley-Stein,132,28.8,29,-0.199999999999999,58,72,-14,-12,-2
21700543,1627741,SAC,MEM,Buddy Hield,139,30.95,31,-0.0499999999999972,71,70,1,5,-4
21700543,1627746,SAC,MEM,Skal Labissiere,93,20.0166666666667,20,0.0166666666666657,47,51,-4,-4,0
21700543,1627781,SAC,MEM,Malachi Richardson,90,19.05,19,0.0500000000000007,46,40,6,6,0
21700543,1627834,SAC,MEM,Georgios Papagiannis,44,9.23333333333333,9,0.233333333333334,27,17,10,10,0
21700543,1628382,SAC,MEM,Justin Jackson,50,10.4,11,-0.600000000000001,29,20,9,9,0
21700543,1628412,SAC,MEM,Frank Mason,23,4.93333333333333,5,-0.0666666666666664,13,21,-8,-6,-2
21700543,201148,MEM,SAC,Brandan Wright,24,5.26666666666667,5,0.266666666666667,12,14,-2,-2,0
21700543,201188,MEM,SAC,Marc Gasol,110,24.3,24,0.299999999999997,57,39,18,20,-2
21700543,201596,MEM,SAC,Mario Chalmers,63,13.45,13,0.449999999999999,37,25,12,10,2
21700543,201936,MEM,SAC,Tyreke Evans,119,25.45,26,-0.550000000000001,62,39,23,23,0
21700543,203210,MEM,SAC,JaMychal Green,94,19.2166666666667,19,0.216666666666669,45,28,17,16,1
21700543,203463,MEM,SAC,Ben McLemore,56,12.0166666666667,12,0.0166666666666657,24,33,-9,-9,0
21700543,203516,MEM,SAC,James Ennis III,78,17.2166666666667,17,0.216666666666669,58,23,35,33,2
21700543,1626150,MEM,SAC,Andrew Harrison,87,18.5833333333333,19,-0.416666666666668,35,32,3,0,3
21700543,1626185,MEM,SAC,Jarell Martin,105,23.5166666666667,24,-0.483333333333334,57,52,5,4,1
21700543,1627738,MEM,SAC,Deyonta Davis,113,23.7,24,-0.300000000000001,57,55,2,-2,4
21700543,1627782,MEM,SAC,Wayne Selden,83,16.8666666666667,17,-0.133333333333333,49,40,9,9,0
21700543,1628415,MEM,SAC,Dillon Brooks,89,18.7666666666667,19,-0.233333333333334,32,38,-6,-6,0
21700543,1628424,MEM,SAC,Kobi Simmons,94,21.65,21,0.649999999999999,45,52,-7,-6,-1
21700544,101161,PHI,PHX,Amir Johnson,87,15.7833333333333,16,-0.216666666666667,30,47,-17,-19,2
21700544,200755,PHI,PHX,JJ Redick,139,28.3,29,-0.700000000000003,82,62,20,23,-3
21700544,201573,PHI,PHX,Jerryd Bayless,134,25.9,25,0.899999999999999,63,76,-13,-10,-3
21700544,202344,PHI,PHX,Trevor Booker,68,15.05,15,0.0500000000000007,35,36,-1,1,-2
21700544,203496,PHI,PHX,Robert Covington,118,23.25,24,-0.75,62,45,17,11,6
21700544,203954,PHI,PHX,Joel Embiid,151,31.35,31,0.350000000000001,91,63,28,32,-4
21700544,203967,PHI,PHX,Dario Saric,154,29.8833333333333,30,-0.116666666666667,81,63,18,14,4
21700544,204456,PHI,PHX,T.J. McConnell,140,27.1833333333333,27,0.18333333333333,62,67,-5,-2,-3
21700544,1627732,PHI,PHX,Ben Simmons,170,32.2,32,0.200000000000003,85,74,11,9,2
21700544,1627789,PHI,PHX,Timothe Luwawu-Cabarrot,49,10.6,11,-0.4,24,17,7,6,1
21700544,2199,PHX,PHI,Tyson Chandler,159,31.1,31,0.100000000000001,63,79,-16,-13,-3
21700544,201162,PHX,PHI,Jared Dudley,35,6.45,6,0.449999999999999,14,10,4,4,0
21700544,203458,PHX,PHI,Alex Len,83,16.8,17,-0.199999999999999,47,44,3,0,3
21700544,203477,PHX,PHI,Isaiah Canaan,78,17.3333333333333,18,-0.666666666666668,39,48,-9,-8,-1
21700544,203584,PHX,PHI,Troy Daniels,95,20.55,21,-0.450000000000003,38,59,-21,-22,1
21700544,203933,PHX,PHI,T.J. Warren,170,32.3833333333333,32,0.383333333333333,76,83,-7,-5,-2
21700544,1626164,PHX,PHI,Devin Booker,200,39.2833333333333,39,0.283333333333331,93,95,-2,-1,-1
21700544,1627733,PHX,PHI,Dragan Bender,105,22.0666666666667,22,0.0666666666666664,44,66,-22,-18,-4
21700544,1627737,PHX,PHI,Marquese Chriss,102,19.3833333333333,20,-0.616666666666667,52,47,5,1,4
21700544,1627755,PHX,PHI,Tyler Ulis,124,22.4,22,0.399999999999999,57,52,5,4,1
21700544,1628367,PHX,PHI,Josh Jackson,59,11.75,12,-0.25,27,32,-5,-7,2
21700545,201960,BKN,ORL,DeMarre Carroll,143,29.2833333333333,29,0.283333333333331,59,50,9,7,2
21700545,203092,BKN,ORL,Tyler Zeller,60,12.55,13,-0.449999999999999,21,21,0,0,0
21700545,203112,BKN,ORL,Quincy Acy,74,17.3333333333333,17,0.333333333333336,34,37,-3,-1,-2
21700545,203459,BKN,ORL,Allen Crabbe,135,28.2,28,0.199999999999999,53,46,7,5,2
21700545,203915,BKN,ORL,Spencer Dinwiddie,145,29.8166666666667,30,-0.183333333333334,64,53,11,10,1
21700545,203917,BKN,ORL,Nik Stauskas,55,11.5833333333333,12,-0.416666666666668,25,30,-5,-3,-2
21700545,203925,BKN,ORL,Joe Harris,124,25.5333333333333,26,-0.466666666666669,50,57,-7,-3,-4
21700545,1626178,BKN,ORL,Rondae Hollis-Jefferson,192,38.5666666666667,38,0.566666666666663,80,75,5,3,2
21700545,1627747,BKN,ORL,Caris LeVert,137,27.1833333333333,27,0.18333333333333,58,57,1,2,-1
21700545,1628386,BKN,ORL,Jarrett Allen,100,19.8666666666667,20,-0.133333333333333,46,49,-3,-5,2
21700545,201167,ORL,BKN,Arron Afflalo,40,7.98333333333333,8,-0.0166666666666666,23,17,6,5,1
21700545,201571,ORL,BKN,D.J. Augustin,67,15.6166666666667,16,-0.383333333333335,28,29,-1,-3,2
21700545,201578,ORL,BKN,Marreese Speights,75,15.5666666666667,16,-0.433333333333334,38,29,9,6,3
21700545,202687,ORL,BKN,Bismack Biyombo,141,28.8833333333333,29,-0.116666666666667,55,60,-5,-4,-1
21700545,203095,ORL,BKN,Evan Fournier,163,32.65,33,-0.350000000000001,70,63,7,1,6
21700545,203613,ORL,BKN,Jonathon Simmons,149,30.35,30,0.350000000000001,54,66,-12,-10,-2
21700545,203901,ORL,BKN,Elfrid Payton,166,32.3666666666667,32,0.366666666666667,67,69,-2,0,-2
21700545,203932,ORL,BKN,Aaron Gordon,202,40.9,41,-0.0999999999999943,81,86,-5,-5,0
21700545,1626209,ORL,BKN,Mario Hezonja,78,16.9,17,-0.100000000000001,27,34,-7,-4,-3
21700545,1628411,ORL,BKN,Wes Iwundu,84,18.7,19,-0.300000000000001,32,37,-5,-1,-4
21700546,1891,MIL,TOR,Jason Terry,20,5.31666666666667,5,0.316666666666666,13,11,2,3,-1
21700546,202339,MIL,TOR,Eric Bledsoe,165,34.3333333333333,35,-0.666666666666664,77,88,-11,-9,-2
21700546,203089,MIL,TOR,John Henson,124,25.6,26,-0.399999999999999,55,65,-10,-9,-1
21700546,203114,MIL,TOR,Khris Middleton,202,43.25,43,0.25,94,100,-6,-8,2
21700546,203503,MIL,TOR,Tony Snell,91,17.7666666666667,18,-0.233333333333334,36,51,-15,-15,0
21700546,203507,MIL,TOR,Giannis Antetokounmpo,198,41.7,42,-0.299999999999997,103,112,-9,-6,-3
21700546,203521,MIL,TOR,Matthew Dellavedova,128,28.9,29,-0.100000000000001,76,71,5,5,0
21700546,203930,MIL,TOR,Sean Kilpatrick,46,10.15,10,0.149999999999999,30,25,5,4,1
21700546,1627748,MIL,TOR,Thon Maker,79,18.3666666666667,18,0.366666666666667,48,41,7,6,1
21700546,1627763,MIL,TOR,Malcolm Brogdon,177,39.6166666666667,39,0.61666666666666,103,91,12,9,3
21700546,101139,TOR,MIL,CJ Miles,73,17.1333333333333,17,0.133333333333333,35,44,-9,-12,3
21700546,200768,TOR,MIL,Kyle Lowry,194,41,41,0,105,95,10,11,-1
21700546,201586,TOR,MIL,Serge Ibaka,181,37.5,38,-0.5,98,88,10,8,2
21700546,201942,TOR,MIL,DeMar DeRozan,207,43.5833333333333,43,0.583333333333329,118,107,11,9,2
21700546,202685,TOR,MIL,Jonas Valanciunas,79,16.0333333333333,16,0.0333333333333314,37,32,5,7,-2
21700546,1626153,TOR,MIL,Delon Wright,87,19.2833333333333,19,0.283333333333331,47,49,-2,2,-4
21700546,1627751,TOR,MIL,Jakob Poeltl,73,17.1666666666667,17,0.166666666666668,37,46,-9,-7,-2
21700546,1627783,TOR,MIL,Pascal Siakam,71,16.65,16,0.649999999999999,35,41,-6,-8,2
21700546,1627832,TOR,MIL,Fred VanVleet,97,21.8666666666667,22,-0.133333333333333,49,55,-6,-6,0
21700546,1628384,TOR,MIL,OG Anunoby,168,34.7833333333333,35,-0.216666666666669,94,78,16,16,0
21700547,201577,CHI,POR,Robin Lopez,170,35.3666666666667,36,-0.633333333333333,76,88,-12,-10,-2
21700547,202703,CHI,POR,Nikola Mirotic,92,18.7333333333333,19,-0.266666666666666,46,37,9,10,-1
21700547,203200,CHI,POR,Justin Holiday,192,40.1833333333333,41,-0.816666666666663,92,101,-9,-12,3
21700547,1626170,CHI,POR,Jerian Grant,86,17.6833333333333,18,-0.316666666666666,43,37,6,4,2
21700547,1626171,CHI,POR,Bobby Portis,86,17.6666666666667,17,0.666666666666664,44,38,6,6,0
21700547,1627739,CHI,POR,Kris Dunn,169,35.2666666666667,35,0.266666666666666,77,87,-10,-8,-2
21700547,1627756,CHI,POR,Denzel Valentine,164,34.6833333333333,34,0.68333333333333,78,79,-1,-2,1
21700547,1627835,CHI,POR,Paul Zipser,63,12.7666666666667,12,0.766666666666666,28,23,5,8,-3
21700547,1628021,CHI,POR,David Nwaba,90,18.1833333333333,19,-0.816666666666666,42,43,-1,-2,1
21700547,1628374,CHI,POR,Lauri Markkanen,163,34.2166666666667,34,0.216666666666669,74,87,-13,-14,1
21700547,202323,POR,CHI,Evan Turner,178,37.2,38,-0.799999999999997,93,82,11,14,-3
21700547,202329,POR,CHI,Al-Farouq Aminu,198,40.8166666666667,41,-0.183333333333337,100,86,14,13,1
21700547,202334,POR,CHI,Ed Davis,72,15.1166666666667,15,0.116666666666665,30,39,-9,-5,-4
21700547,203090,POR,CHI,Maurice Harkless,69,13.85,14,-0.15,23,31,-8,-11,3
21700547,203468,POR,CHI,CJ McCollum,213,44.3833333333333,45,-0.616666666666667,113,99,14,17,-3
21700547,203894,POR,CHI,Shabazz Napier,197,41.4833333333333,41,0.483333333333334,92,95,-3,-8,5
21700547,203994,POR,CHI,Jusuf Nurkic,183,37.8333333333333,38,-0.166666666666664,94,81,13,9,4
21700547,1626192,POR,CHI,Pat Connaughton,108,21.9333333333333,22,-0.06666666666667,51,53,-2,0,-2
21700547,1628380,POR,CHI,Zach Collins,57,12.1333333333333,12,0.133333333333333,24,34,-10,-9,-1
21700548,101106,LAL,MIN,Andrew Bogut,40,8.4,8,0.4,18,15,3,2,1
21700548,201147,LAL,MIN,Corey Brewer,113,22.2,22,0.199999999999999,47,54,-7,-6,-1
21700548,203505,LAL,MIN,Vander Blue,81,17.1166666666667,17,0.116666666666667,37,32,5,6,-1
21700548,203898,LAL,MIN,Tyler Ennis,115,22.55,23,-0.450000000000003,46,60,-14,-16,2
21700548,203903,LAL,MIN,Jordan Clarkson,111,23.85,24,-0.149999999999999,49,51,-2,-4,2
21700548,203944,LAL,MIN,Julius Randle,144,28.25,28,0.25,60,75,-15,-15,0
21700548,1626204,LAL,MIN,Larry Nance Jr.,86,19.55,20,-0.450000000000003,36,38,-2,-3,1
21700548,1627742,LAL,MIN,Brandon Ingram,145,28.6333333333333,29,-0.366666666666667,58,77,-19,-20,1
21700548,1627826,LAL,MIN,Ivica Zubac,49,11.8,12,-0.199999999999999,20,23,-3,-3,0
21700548,1627936,LAL,MIN,Alex Caruso,78,17.6,18,-0.399999999999999,36,32,4,2,2
21700548,1628398,LAL,MIN,Kyle Kuzma,91,18.5,18,0.5,37,55,-18,-16,-2
21700548,1628404,LAL,MIN,Josh Hart,97,20.55,21,-0.450000000000003,36,53,-17,-17,0
21700548,2037,MIN,LAL,Jamal Crawford,91,19.6333333333333,20,-0.366666666666667,37,43,-6,-2,-4
21700548,201166,MIN,LAL,Aaron Brooks,68,14.5666666666667,14,0.566666666666666,23,28,-5,-4,-1
21700548,201959,MIN,LAL,Taj Gibson,164,33.6166666666667,33,0.616666666666667,89,70,19,22,-3
21700548,202332,MIN,LAL,Cole Aldrich,10,2.31666666666667,2,0.316666666666666,4,4,0,-1,1
21700548,202357,MIN,LAL,Nemanja Bjelica,66,14.1833333333333,15,-0.816666666666666,24,26,-2,-4,2
21700548,202710,MIN,LAL,Jimmy Butler,180,36.8666666666667,37,-0.133333333333333,89,75,14,16,-2
21700548,203476,MIN,LAL,Gorgui Dieng,112,21.8333333333333,22,-0.166666666666668,50,45,5,6,-1
21700548,203952,MIN,LAL,Andrew Wiggins,171,35.25,35,0.25,91,72,19,18,1
21700548,1626145,MIN,LAL,Tyus Jones,123,26.8833333333333,27,-0.116666666666667,69,46,23,23,0
21700548,1626157,MIN,LAL,Karl-Anthony Towns,123,26.6666666666667,27,-0.333333333333336,68,51,17,17,0
21700548,1627875,MIN,LAL,Marcus Georges-Hunt,42,7.18333333333333,7,0.183333333333334,21,20,1,-1,2
21700549,2544,CLE,POR,LeBron James,157,34.0333333333333,34,0.0333333333333314,86,84,2,0,2
21700549,2548,CLE,POR,Dwyane Wade,93,17.8,18,-0.199999999999999,56,38,18,20,-2
21700549,2594,CLE,POR,Kyle Korver,103,20.5666666666667,21,-0.433333333333334,59,46,13,12,1
21700549,2747,CLE,POR,JR Smith,111,24.75,25,-0.25,61,62,-1,-2,1
21700549,101112,CLE,POR,Channing Frye,20,4.6,5,-0.4,11,13,-2,-2,0
21700549,101181,CLE,POR,Jose Calderon,89,20.5833333333333,21,-0.416666666666668,53,50,3,3,0
21700549,201145,CLE,POR,Jeff Green,126,25.1,25,0.100000000000001,72,50,22,24,-2
21700549,201567,CLE,POR,Kevin Love,115,25.6666666666667,26,-0.333333333333336,64,64,0,0,0
21700549,202684,CLE,POR,Tristan Thompson,92,17.5,17,0.5,52,33,19,19,0
21700549,202738,CLE,POR,Isaiah Thomas,98,19.0166666666667,19,0.0166666666666657,52,37,15,17,-2
21700549,203109,CLE,POR,Jae Crowder,106,23.6166666666667,24,-0.383333333333333,57,60,-3,-5,2
21700549,1626224,CLE,POR,Cedi Osman,25,5.6,6,-0.4,12,13,-1,-1,0
21700549,202323,POR,CLE,Evan Turner,154,32.85,33,-0.149999999999999,85,76,9,10,-1
21700549,202329,POR,CLE,Al-Farouq Aminu,152,32.3,32,0.299999999999997,74,88,-14,-16,2
21700549,202334,POR,CLE,Ed Davis,71,13.6666666666667,14,-0.333333333333334,32,40,-8,-7,-1
21700549,203081,POR,CLE,Damian Lillard,153,32.9333333333333,33,-0.0666666666666629,79,87,-8,-9,1
21700549,203090,POR,CLE,Maurice Harkless,78,15.4666666666667,16,-0.533333333333333,31,51,-20,-20,0
21700549,203468,POR,CLE,CJ McCollum,176,36.5,36,0.5,80,99,-19,-20,1
21700549,203894,POR,CLE,Shabazz Napier,70,13.85,14,-0.15,28,38,-10,-10,0
21700549,203943,POR,CLE,Noah Vonleh,25,5.6,6,-0.4,13,12,1,1,0
21700549,203994,POR,CLE,Jusuf Nurkic,131,28.5,29,-0.5,65,75,-10,-11,1
21700549,1626192,POR,CLE,Pat Connaughton,75,15.9666666666667,16,-0.033333333333335,37,45,-8,-5,-3
21700549,1627774,POR,CLE,Jake Layman,25,5.6,6,-0.4,13,12,1,1,0
21700549,1628380,POR,CLE,Zach Collins,25,5.6,6,-0.4,13,12,1,1,0
21700550,101127,NYK,SAS,Jarrett Jack,146,32.0666666666667,33,-0.933333333333337,60,68,-8,-4,-4
21700550,201149,NYK,SAS,Joakim Noah,9,1.95,2,-0.05,0,8,-8,-7,-1
21700550,201196,NYK,SAS,Ramon Sessions,39,8.56666666666667,9,-0.433333333333334,16,11,5,5,0
21700550,201563,NYK,SAS,Michael Beasley,122,26.5333333333333,26,0.533333333333331,52,53,-1,-2,1
21700550,201584,NYK,SAS,Courtney Lee,169,36.1333333333333,36,0.133333333333333,69,80,-11,-11,0
21700550,202498,NYK,SAS,Lance Thomas,104,23.1333333333333,23,0.133333333333333,45,47,-2,-4,2
21700550,202683,NYK,SAS,Enes Kanter,80,17.0833333333333,17,0.0833333333333357,34,40,-6,-8,2
21700550,203124,NYK,SAS,Kyle O'Quinn,65,14.65,14,0.649999999999999,31,24,7,7,0
21700550,203926,NYK,SAS,Doug McDermott,97,20.9,21,-0.100000000000001,39,52,-13,-9,-4
21700550,204001,NYK,SAS,Kristaps Porzingis,163,35.7666666666667,36,-0.233333333333334,63,79,-16,-12,-4
21700550,1626195,NYK,SAS,Willy Hernangomez,18,3.98333333333333,4,-0.0166666666666666,8,2,6,6,0
21700550,1628373,NYK,SAS,Frank Ntilikina,77,15.9166666666667,16,-0.0833333333333339,33,34,-1,-7,6
21700550,1628422,NYK,SAS,Damyean Dotson,11,2.48333333333333,3,-0.516666666666667,5,2,3,1,2
21700550,1938,SAS,NYK,Manu Ginobili,108,23.7833333333333,24,-0.216666666666669,49,44,5,4,1
21700550,2200,SAS,NYK,Pau Gasol,120,26.3833333333333,27,-0.616666666666667,45,56,-11,-7,-4
21700550,2225,SAS,NYK,Tony Parker,112,24.15,24,0.149999999999999,49,48,1,3,-2
21700550,200746,SAS,NYK,LaMarcus Aldridge,168,36.9333333333333,37,-0.0666666666666629,81,65,16,14,2
21700550,201980,SAS,NYK,Danny Green,63,14.0333333333333,14,0.0333333333333332,31,28,3,3,0
21700550,201988,SAS,NYK,Patty Mills,102,22.5833333333333,22,0.583333333333332,46,35,11,10,1
21700550,202695,SAS,NYK,Kawhi Leonard,140,30.4,31,-0.600000000000001,64,62,2,4,-2
21700550,202722,SAS,NYK,Davis Bertans,83,17.4166666666667,18,-0.583333333333336,38,34,4,3,1
21700550,203464,SAS,NYK,Brandon Paul,3,0.15,0,0.15,2,2,0,2,-2
21700550,203937,SAS,NYK,Kyle Anderson,131,28.25,28,0.25,61,53,8,5,3
21700550,1627749,SAS,NYK,Dejounte Murray,61,13.5833333333333,14,-0.416666666666666,30,22,8,6,2
21700550,1627854,SAS,NYK,Bryn Forbes,9,1.5,2,-0.5,4,6,-2,-2,0
21700551,101141,ATL,PHX,Ersan Ilyasova,156,33.5,34,-0.5,75,80,-5,-7,2
21700551,201158,ATL,PHX,Marco Belinelli,96,20.7166666666667,21,-0.283333333333331,40,44,-4,-6,2
21700551,203101,ATL,PHX,Miles Plumlee,124,27.1,27,0.100000000000001,67,61,6,8,-2
21700551,203145,ATL,PHX,Kent Bazemore,142,29.3666666666667,29,0.366666666666667,69,69,0,0,0
21700551,203471,ATL,PHX,Dennis Schroder,166,35,35,0,77,82,-5,-5,0
21700551,1627098,ATL,PHX,Malcolm Delaney,64,13.2833333333333,14,-0.716666666666667,24,25,-1,-1,0
21700551,1627752,ATL,PHX,Taurean Prince,161,33.25,33,0.25,75,75,0,2,-2
21700551,1627819,ATL,PHX,Isaiah Taylor,63,13,13,0,26,22,4,4,0
21700551,1628381,ATL,PHX,John Collins,100,20.2833333333333,20,0.283333333333331,34,38,-4,-6,2
21700551,1628463,ATL,PHX,Tyler Cavanaugh,73,14.5,14,0.5,28,24,4,6,-2
21700551,2199,PHX,ATL,Tyson Chandler,118,25.5166666666667,25,0.516666666666666,64,56,8,8,0
21700551,203458,PHX,ATL,Alex Len,106,21.8666666666667,22,-0.133333333333333,35,45,-10,-10,0
21700551,203477,PHX,ATL,Isaiah Canaan,93,20.15,20,0.149999999999999,38,50,-12,-12,0
21700551,203584,PHX,ATL,Troy Daniels,97,20.6333333333333,21,-0.366666666666667,47,40,7,7,0
21700551,203933,PHX,ATL,T.J. Warren,181,38.0666666666667,38,0.0666666666666629,85,85,0,-2,2
21700551,1626164,PHX,ATL,Devin Booker,207,42.15,42,0.149999999999999,95,87,8,10,-2
21700551,1627733,PHX,ATL,Dragan Bender,62,14.2666666666667,14,0.266666666666666,26,32,-6,-4,-2
21700551,1627737,PHX,ATL,Marquese Chriss,167,33.7333333333333,34,-0.266666666666666,78,71,7,5,2
21700551,1627755,PHX,ATL,Tyler Ulis,114,23.6166666666667,24,-0.383333333333333,52,49,3,3,0
21700552,2216,SAC,CHA,Zach Randolph,114,25.2166666666667,25,0.216666666666669,57,69,-12,-12,0
21700552,201585,SAC,CHA,Kosta Koufos,53,12.8,13,-0.199999999999999,36,34,2,2,0
21700552,201588,SAC,CHA,George Hill,120,27.7833333333333,28,-0.216666666666669,72,75,-3,-1,-2
21700552,202066,SAC,CHA,Garrett Temple,95,21.8833333333333,22,-0.116666666666667,50,58,-8,-10,2
21700552,203992,SAC,CHA,Bogdan Bogdanovic,104,23.7833333333333,24,-0.216666666666669,55,66,-11,-11,0
21700552,1626161,SAC,CHA,Willie Cauley-Stein,100,22.9,23,-0.100000000000001,52,64,-12,-12,0
21700552,1627741,SAC,CHA,Buddy Hield,111,24.9666666666667,25,-0.0333333333333314,55,74,-19,-19,0
21700552,1627746,SAC,CHA,Skal Labissiere,132,27.95,28,-0.0499999999999972,62,79,-17,-17,0
21700552,1627781,SAC,CHA,Malachi Richardson,33,6.08333333333333,6,0.0833333333333339,14,14,0,0,0
21700552,1627834,SAC,CHA,Georgios Papagiannis,35,6.6,7,-0.4,15,16,-1,-1,0
21700552,1628368,SAC,CHA,De'Aaron Fox,155,32.6166666666667,33,-0.383333333333333,73,92,-19,-19,0
21700552,1628382,SAC,CHA,Justin Jackson,33,6.08333333333333,6,0.0833333333333339,14,14,0,0,0
21700552,2730,CHA,SAC,Dwight Howard,129,28.9833333333333,29,-0.0166666666666657,83,66,17,17,0
21700552,101107,CHA,SAC,Marvin Williams,85,19.0166666666667,19,0.0166666666666657,55,45,10,10,0
21700552,201587,CHA,SAC,Nicolas Batum,136,30.35,31,-0.649999999999999,89,67,22,22,0
21700552,202689,CHA,SAC,Kemba Walker,138,29.6,30,-0.399999999999999,90,63,27,29,-2
21700552,202933,CHA,SAC,Julyan Stone,8,1.81666666666667,2,-0.183333333333333,5,5,0,2,-2
21700552,203077,CHA,SAC,Michael Kidd-Gilchrist,94,20.6666666666667,21,-0.333333333333336,59,47,12,13,-1
21700552,203087,CHA,SAC,Jeremy Lamb,103,23.25,23,0.25,63,53,10,9,1
21700552,203487,CHA,SAC,Michael Carter-Williams,71,16.3166666666667,16,0.316666666666666,36,43,-7,-11,4
21700552,203948,CHA,SAC,Johnny O'Bryant III,88,18.75,19,-0.25,48,45,3,3,0
21700552,1626163,CHA,SAC,Frank Kaminsky,112,24.9,25,-0.100000000000001,67,55,12,12,0
21700552,1626203,CHA,SAC,Treveon Graham,72,15.9666666666667,16,-0.033333333333335,39,41,-2,-2,0
21700552,1628370,CHA,SAC,Malik Monk,29,5.23333333333333,5,0.233333333333333,12,14,-2,-2,0
21700552,1628407,CHA,SAC,Dwayne Bacon,20,3.81666666666667,4,-0.183333333333334,9,11,-2,-2,0
21700553,101150,LAC,MEM,Lou Williams,168,35.6666666666667,36,-0.333333333333329,89,80,9,12,-3
21700553,201599,LAC,MEM,DeAndre Jordan,158,33.5666666666667,34,-0.433333333333337,75,83,-8,-9,1
21700553,201933,LAC,MEM,Blake Griffin,167,35.6333333333333,36,-0.366666666666667,80,85,-5,-4,-1
21700553,202325,LAC,MEM,Wesley Johnson,71,15.65,16,-0.35,26,39,-13,-17,4
21700553,203186,LAC,MEM,Willie Reed,49,11.9166666666667,12,-0.0833333333333339,32,16,16,17,-1
21700553,203710,LAC,MEM,C.J. Williams,135,29.2166666666667,29,0.216666666666669,78,66,12,11,1
21700553,1626149,LAC,MEM,Montrezl Harrell,24,5.35,5,0.35,13,14,-1,-3,2
21700553,1626155,LAC,MEM,Sam Dekker,54,12.6833333333333,13,-0.316666666666666,35,22,13,14,-1
21700553,1628393,LAC,MEM,Jawun Evans,59,13.5833333333333,14,-0.416666666666666,34,25,9,7,2
21700553,1628414,LAC,MEM,Sindarius Thornwell,50,12.2666666666667,12,0.266666666666666,27,15,12,11,1
21700553,1628462,LAC,MEM,Milos Teodosic,155,33.9666666666667,34,-0.0333333333333314,76,80,-4,1,-5
21700553,201148,MEM,LAC,Brandan Wright,38,8.56666666666667,8,0.566666666666666,15,27,-12,-10,-2
21700553,201188,MEM,LAC,Marc Gasol,162,35.9333333333333,36,-0.0666666666666629,85,73,12,14,-2
21700553,201596,MEM,LAC,Mario Chalmers,117,25.2833333333333,25,0.283333333333331,61,54,7,4,3
21700553,201936,MEM,LAC,Tyreke Evans,167,36.95,37,-0.0499999999999972,79,88,-9,-12,3
21700553,203210,MEM,LAC,JaMychal Green,97,21.9166666666667,22,-0.0833333333333357,52,44,8,5,3
21700553,203516,MEM,LAC,James Ennis III,128,28.1666666666667,28,0.166666666666664,64,71,-7,-5,-2
21700553,1626150,MEM,LAC,Andrew Harrison,84,19.75,20,-0.25,40,35,5,5,0
21700553,1626185,MEM,LAC,Jarell Martin,91,19.6,20,-0.399999999999999,42,48,-6,-6,0
21700553,1627738,MEM,LAC,Deyonta Davis,48,9.78333333333333,9,0.783333333333333,16,34,-18,-19,1
21700553,1627782,MEM,LAC,Wayne Selden,67,13.6,14,-0.4,32,34,-2,0,-2
21700553,1628415,MEM,LAC,Dillon Brooks,78,17.35,18,-0.649999999999999,35,44,-9,-10,1
21700553,1628424,MEM,LAC,Kobi Simmons,13,2.6,3,-0.4,4,13,-9,-6,-3
21700554,2403,HOU,ORL,Nene,63,13.5833333333333,14,-0.416666666666668,29,32,-3,-5,2
21700554,2772,HOU,ORL,Trevor Ariza,167,33,33,0,81,58,23,22,1
21700554,101108,HOU,ORL,Chris Paul,159,31.3666666666667,32,-0.633333333333333,78,55,23,23,0
21700554,101123,HOU,ORL,Gerald Green,129,27.5666666666667,28,-0.433333333333334,71,65,6,9,-3
21700554,200782,HOU,ORL,PJ Tucker,117,25.2,25,0.199999999999999,58,66,-8,-6,-2
21700554,201569,HOU,ORL,Eric Gordon,150,30.3833333333333,30,0.383333333333333,68,57,11,9,2
21700554,201583,HOU,ORL,Ryan Anderson,147,29.75,30,-0.25,74,52,22,20,2
21700554,201628,HOU,ORL,Bobby Brown,6,1.23333333333333,1,0.233333333333333,3,6,-3,-3,0
21700554,203991,HOU,ORL,Clint Capela,120,23.2833333333333,23,0.283333333333331,57,33,24,26,-2
21700554,204028,HOU,ORL,Tarik Black,37,8,8,0,23,23,0,0,0
21700554,1627362,HOU,ORL,Briante Weber,75,16.6333333333333,16,0.633333333333333,38,43,-5,-5,0
21700554,201167,ORL,HOU,Arron Afflalo,79,18.3166666666667,18,0.316666666666666,44,41,3,2,1
21700554,201571,ORL,HOU,D.J. Augustin,41,9.45,9,0.449999999999999,18,23,-5,-5,0
21700554,201578,ORL,HOU,Marreese Speights,75,16.0666666666667,16,0.0666666666666664,36,39,-3,-6,3
21700554,202687,ORL,HOU,Bismack Biyombo,91,17.3333333333333,18,-0.666666666666668,21,39,-18,-16,-2
21700554,202714,ORL,HOU,Shelvin Mack,77,16.3666666666667,16,0.366666666666667,46,37,9,10,-1
21700554,203095,ORL,HOU,Evan Fournier,154,29.6666666666667,30,-0.333333333333336,54,74,-20,-20,0
21700554,203613,ORL,HOU,Jonathon Simmons,76,14.8833333333333,15,-0.116666666666667,28,35,-7,-6,-1
21700554,203901,ORL,HOU,Elfrid Payton,116,22.1833333333333,22,0.183333333333334,34,56,-22,-23,1
21700554,203920,ORL,HOU,Khem Birch,36,7.45,7,0.45,22,24,-2,-4,2
21700554,203932,ORL,HOU,Aaron Gordon,168,32.8666666666667,33,-0.133333333333333,65,81,-16,-14,-2
21700554,1626209,ORL,HOU,Mario Hezonja,135,28.3166666666667,28,0.316666666666666,59,67,-8,-4,-4
21700554,1628411,ORL,HOU,Wes Iwundu,122,27.1,27,0.100000000000001,63,64,-1,-4,3
21700555,101161,PHI,SAS,Amir Johnson,61,12.4333333333333,12,0.433333333333334,25,31,-6,-10,4
21700555,200755,PHI,SAS,JJ Redick,154,32.2166666666667,32,0.216666666666669,79,66,13,11,2
21700555,201573,PHI,SAS,Jerryd Bayless,111,23.7,24,-0.300000000000001,42,54,-12,-7,-5
21700555,202344,PHI,SAS,Trevor Booker,38,7.68333333333333,8,-0.316666666666666,15,19,-4,-5,1
21700555,203496,PHI,SAS,Robert Covington,161,33.0666666666667,33,0.06666666666667,79,78,1,-2,3
21700555,203954,PHI,SAS,Joel Embiid,168,35.4,35,0.400000000000006,87,75,12,16,-4
21700555,203967,PHI,SAS,Dario Saric,137,28.5166666666667,29,-0.483333333333334,77,57,20,19,1
21700555,204456,PHI,SAS,T.J. McConnell,105,22.05,22,0.0500000000000007,50,49,1,-2,3
21700555,1626158,PHI,SAS,Richaun Holmes,27,6.31666666666667,6,0.316666666666666,11,12,-1,2,-3
21700555,1627732,PHI,SAS,Ben Simmons,165,33.75,34,-0.25,80,80,0,2,-2
21700555,1627789,PHI,SAS,Timothe Luwawu-Cabarrot,23,4.61666666666667,5,-0.383333333333333,15,9,6,6,0
21700555,2200,SAS,PHI,Pau Gasol,57,12.5833333333333,13,-0.416666666666668,21,33,-12,-12,0
21700555,200746,SAS,PHI,LaMarcus Aldridge,175,36.15,36,0.149999999999999,80,87,-7,-8,1
21700555,201988,SAS,PHI,Patty Mills,149,29.3,29,0.299999999999997,75,72,3,6,-3
21700555,202722,SAS,PHI,Davis Bertans,154,30.8666666666667,31,-0.133333333333333,79,72,7,7,0
21700555,203464,SAS,PHI,Brandon Paul,76,16.5,16,0.5,38,38,0,-4,4
21700555,203530,SAS,PHI,Joffrey Lauvergne,55,11.8,12,-0.199999999999999,26,25,1,2,-1
21700555,203937,SAS,PHI,Kyle Anderson,172,35.8833333333333,36,-0.116666666666667,74,79,-5,-1,-4
21700555,1626199,SAS,PHI,Darrun Hilliard,23,4.63333333333333,5,-0.366666666666667,9,18,-9,-13,4
21700555,1627749,SAS,PHI,Dejounte Murray,60,13.5666666666667,14,-0.433333333333334,17,32,-15,-20,5
21700555,1627854,SAS,PHI,Bryn Forbes,196,40.85,41,-0.149999999999999,95,92,3,7,-4
21700555,1628401,SAS,PHI,Derrick White,33,7.61666666666667,8,-0.383333333333333,16,12,4,6,-2
21700556,101127,NYK,WAS,Jarrett Jack,133,27.7833333333333,28,-0.216666666666669,65,83,-18,-17,-1
21700556,201563,NYK,WAS,Michael Beasley,123,25.7666666666667,25,0.766666666666666,64,62,2,2,0
21700556,201584,NYK,WAS,Courtney Lee,131,27.4666666666667,28,-0.533333333333331,64,83,-19,-16,-3
21700556,202498,NYK,WAS,Lance Thomas,62,14.0166666666667,14,0.0166666666666657,24,42,-18,-18,0
21700556,202683,NYK,WAS,Enes Kanter,82,17.75,18,-0.25,36,55,-19,-20,1
21700556,203124,NYK,WAS,Kyle O'Quinn,114,23.6,24,-0.399999999999999,49,51,-2,-1,-1
21700556,203926,NYK,WAS,Doug McDermott,115,25,25,0,57,52,5,2,3
21700556,204001,NYK,WAS,Kristaps Porzingis,169,35.4,36,-0.599999999999994,79,98,-19,-16,-3
21700556,1626195,NYK,WAS,Willy Hernangomez,4,1.21666666666667,2,-0.783333333333333,0,3,-3,-3,0
21700556,1627758,NYK,WAS,Ron Baker,88,18.9,19,-0.100000000000001,39,35,4,1,3
21700556,1628373,NYK,WAS,Frank Ntilikina,90,19.8,20,-0.199999999999999,38,38,0,-1,1
21700556,1628422,NYK,WAS,Damyean Dotson,4,1.21666666666667,2,-0.783333333333333,0,3,-3,-3,0
21700556,101133,WAS,NYK,Ian Mahinmi,86,18.3333333333333,19,-0.666666666666664,41,49,-8,-6,-2
21700556,101162,WAS,NYK,Marcin Gortat,137,29.25,29,0.25,80,54,26,24,2
21700556,201975,WAS,NYK,Jodie Meeks,52,11.65,12,-0.35,25,31,-6,-7,1
21700556,202322,WAS,NYK,John Wall,161,34.4833333333333,34,0.483333333333334,94,67,27,27,0
21700556,202693,WAS,NYK,Markieff Morris,153,32.7166666666667,33,-0.283333333333331,92,65,27,28,-1
21700556,203078,WAS,NYK,Bradley Beal,171,35.9333333333333,36,-0.0666666666666629,96,72,24,25,-1
21700556,203107,WAS,NYK,Tomas Satoransky,62,13.1,14,-0.9,27,36,-9,-9,0
21700556,203118,WAS,NYK,Mike Scott,70,14.8666666666667,15,-0.133333333333333,29,38,-9,-10,1
21700556,203490,WAS,NYK,Otto Porter Jr.,156,33.9833333333333,34,-0.0166666666666657,88,69,19,20,-1
21700556,1626162,WAS,NYK,Kelly Oubre Jr.,67,13.6,14,-0.4,33,34,-1,-2,1
21700557,2037,MIN,BKN,Jamal Crawford,78,18.65,19,-0.350000000000001,33,40,-7,-5,-2
21700557,201166,MIN,BKN,Aaron Brooks,19,4.38333333333333,4,0.383333333333333,4,8,-4,-4,0
21700557,201959,MIN,BKN,Taj Gibson,145,33.75,33,0.75,66,67,-1,1,-2
21700557,202357,MIN,BKN,Nemanja Bjelica,51,12.5666666666667,13,-0.433333333333334,25,28,-3,-5,2
21700557,202710,MIN,BKN,Jimmy Butler,163,38.5833333333333,39,-0.416666666666671,80,78,2,2,0
21700557,203476,MIN,BKN,Gorgui Dieng,66,16.6,17,-0.399999999999999,35,34,1,-1,2
21700557,203952,MIN,BKN,Andrew Wiggins,153,36.6333333333333,37,-0.366666666666667,79,76,3,3,0
21700557,1626145,MIN,BKN,Tyus Jones,159,37.1166666666667,37,0.116666666666667,79,72,7,9,-2
21700557,1626157,MIN,BKN,Karl-Anthony Towns,171,40.35,40,0.349999999999994,78,83,-5,-3,-2
21700557,1627875,MIN,BKN,Marcus Georges-Hunt,5,1.28333333333333,1,0.283333333333333,6,4,2,-2,4
21700557,201960,BKN,MIN,DeMarre Carroll,134,31.3166666666667,31,0.316666666666666,65,64,1,3,-2
21700557,203092,BKN,MIN,Tyler Zeller,55,12.8166666666667,13,-0.183333333333334,26,23,3,3,0
21700557,203112,BKN,MIN,Quincy Acy,115,27.8833333333333,28,-0.116666666666667,54,57,-3,-5,2
21700557,203459,BKN,MIN,Allen Crabbe,130,30.5,31,-0.5,64,60,4,0,4
21700557,203915,BKN,MIN,Spencer Dinwiddie,153,36.6666666666667,36,0.666666666666664,75,78,-3,1,-4
21700557,203917,BKN,MIN,Nik Stauskas,82,19.1,19,0.100000000000001,34,39,-5,-5,0
21700557,203925,BKN,MIN,Joe Harris,111,27.4,28,-0.600000000000001,58,56,2,4,-2
21700557,1626143,BKN,MIN,Jahlil Okafor,44,10.6166666666667,11,-0.383333333333333,21,20,1,-1,2
21700557,1626178,BKN,MIN,Rondae Hollis-Jefferson,115,27.1,27,0.100000000000001,60,50,10,10,0
21700557,1628386,BKN,MIN,Jarrett Allen,71,16.5166666666667,17,-0.483333333333334,33,38,-5,-5,0
21700558,201609,MIA,DET,Goran Dragic,158,36.2666666666667,37,-0.733333333333334,93,79,14,12,2
21700558,201949,MIA,DET,James Johnson,108,24.15,24,0.149999999999999,58,43,15,14,1
21700558,201961,MIA,DET,Wayne Ellington,150,33.9833333333333,34,-0.0166666666666657,87,71,16,17,-1
21700558,202355,MIA,DET,Hassan Whiteside,70,16.6333333333333,17,-0.366666666666667,38,41,-3,-2,-1
21700558,203482,MIA,DET,Kelly Olynyk,154,35.7833333333333,36,-0.216666666666669,84,79,5,3,2
21700558,204020,MIA,DET,Tyler Johnson,140,32.8166666666667,33,-0.183333333333337,74,69,5,4,1
21700558,1626175,MIA,DET,Jordan Mickey,23,5.75,6,-0.25,16,13,3,3,0
21700558,1626196,MIA,DET,Josh Richardson,163,37.9,38,-0.100000000000001,80,89,-9,-9,0
21700558,1628389,MIA,DET,Bam Adebayo,47,9.98333333333333,10,-0.0166666666666657,17,24,-7,-5,-2
21700558,1628476,MIA,DET,Derrick Walton Jr.,27,5.48333333333333,6,-0.516666666666667,8,12,-4,-2,-2
21700558,201229,DET,MIA,Anthony Tolliver,86,20.3666666666667,20,0.366666666666667,43,54,-11,-10,-1
21700558,202340,DET,MIA,Avery Bradley,160,37.45,38,-0.549999999999997,76,97,-21,-21,0
21700558,202397,DET,MIA,Ish Smith,131,30.4,31,-0.600000000000001,62,73,-11,-8,-3
21700558,202699,DET,MIA,Tobias Harris,157,35.6166666666667,36,-0.383333333333333,78,78,0,0,0
21700558,202779,DET,MIA,Dwight Buycks,77,17.35,17,0.350000000000001,42,38,4,1,3
21700558,203493,DET,MIA,Reggie Bullock,152,34.35,35,-0.649999999999999,78,75,3,3,0
21700558,203961,DET,MIA,Eric Moreland,80,18.1833333333333,18,0.18333333333333,36,40,-4,-3,-1
21700558,1626246,DET,MIA,Boban Marjanovic,93,21.3333333333333,22,-0.666666666666664,51,50,1,-1,2
21700558,1628379,DET,MIA,Luke Kennard,104,23.7,24,-0.300000000000001,54,50,4,4,0
21700559,201143,BOS,CLE,Al Horford,135,28.8833333333333,29,-0.116666666666667,64,56,8,6,2
21700559,202681,BOS,CLE,Kyrie Irving,132,27.8666666666667,28,-0.133333333333333,65,44,21,18,3
21700559,202694,BOS,CLE,Marcus Morris,120,24.3833333333333,25,-0.616666666666667,54,36,18,16,2
21700559,203382,BOS,CLE,Aron Baynes,82,16.2666666666667,17,-0.733333333333334,36,25,11,14,-3
21700559,203499,BOS,CLE,Shane Larkin,13,2.43333333333333,3,-0.566666666666666,2,7,-5,-6,1
21700559,203935,BOS,CLE,Marcus Smart,131,27.0833333333333,27,0.0833333333333357,60,50,10,6,4
21700559,1626179,BOS,CLE,Terry Rozier,96,19.85,20,-0.149999999999999,45,42,3,8,-5
21700559,1627759,BOS,CLE,Jaylen Brown,146,29.7,29,0.700000000000003,63,51,12,12,0
21700559,1627824,BOS,CLE,Guerschon Yabusele,13,2.43333333333333,3,-0.566666666666666,2,7,-5,-6,1
21700559,1627846,BOS,CLE,Abdel Nader,13,2.43333333333333,3,-0.566666666666666,2,7,-5,-6,1
21700559,1628369,BOS,CLE,Jayson Tatum,145,29.9,30,-0.100000000000001,71,56,15,21,-6
21700559,1628400,BOS,CLE,Semi Ojeleye,110,22.4833333333333,23,-0.516666666666666,38,41,-3,-3,0
21700559,1628464,BOS,CLE,Daniel Theis,14,4.2,5,-0.8,8,18,-10,-10,0
21700559,2544,CLE,BOS,LeBron James,155,32.6666666666667,33,-0.333333333333336,65,71,-6,-6,0
21700559,2548,CLE,BOS,Dwyane Wade,106,23.05,23,0.0499999999999972,44,49,-5,-7,2
21700559,2594,CLE,BOS,Kyle Korver,126,26.25,26,0.25,52,56,-4,-6,2
21700559,2747,CLE,BOS,JR Smith,102,20.3833333333333,21,-0.616666666666667,35,52,-17,-15,-2
21700559,101112,CLE,BOS,Channing Frye,24,5.13333333333333,6,-0.866666666666667,11,4,7,7,0
21700559,101181,CLE,BOS,Jose Calderon,92,18.15,19,-0.850000000000001,30,41,-11,-11,0
21700559,201145,CLE,BOS,Jeff Green,131,26.9666666666667,27,-0.033333333333335,47,53,-6,-6,0
21700559,201567,CLE,BOS,Kevin Love,88,20.2,21,-0.800000000000001,42,49,-7,-5,-2
21700559,202684,CLE,BOS,Tristan Thompson,147,29.3166666666667,29,0.316666666666666,57,61,-4,-6,2
21700559,203109,CLE,BOS,Jae Crowder,134,27.35,28,-0.649999999999999,43,60,-17,-15,-2
21700559,1626224,CLE,BOS,Cedi Osman,45,8.45,9,-0.550000000000001,14,14,0,0,0
21700560,201577,CHI,TOR,Robin Lopez,117,23.6166666666667,24,-0.383333333333333,54,58,-4,-2,-2
21700560,202703,CHI,TOR,Nikola Mirotic,119,25.5,26,-0.5,63,70,-7,-11,4
21700560,203200,CHI,TOR,Justin Holiday,194,38.5166666666667,39,-0.483333333333334,105,100,5,5,0
21700560,1626170,CHI,TOR,Jerian Grant,92,18.95,19,-0.0500000000000007,43,49,-6,-6,0
21700560,1626171,CHI,TOR,Bobby Portis,62,14.35,14,0.35,30,36,-6,-6,0
21700560,1627739,CHI,TOR,Kris Dunn,139,28.9,29,-0.100000000000001,72,75,-3,-3,0
21700560,1627756,CHI,TOR,Denzel Valentine,155,31.0833333333333,31,0.0833333333333322,83,76,7,9,-2
21700560,1627835,CHI,TOR,Paul Zipser,41,10,10,0,13,24,-11,-11,0
21700560,1628021,CHI,TOR,David Nwaba,76,16.7666666666667,17,-0.233333333333334,32,48,-16,-18,2
21700560,1628374,CHI,TOR,Lauri Markkanen,160,31.5666666666667,32,-0.43333333333333,80,84,-4,-2,-2
21700560,101139,TOR,CHI,CJ Miles,79,17.3,18,-0.699999999999999,49,31,18,19,-1
21700560,200768,TOR,CHI,Kyle Lowry,160,31.9166666666667,32,-0.0833333333333357,80,86,-6,-9,3
21700560,201586,TOR,CHI,Serge Ibaka,138,27.15,27,0.149999999999999,68,73,-5,0,-5
21700560,201942,TOR,CHI,DeMar DeRozan,171,33.7333333333333,34,-0.266666666666666,86,92,-6,-5,-1
21700560,202685,TOR,CHI,Jonas Valanciunas,88,17.6666666666667,18,-0.333333333333336,35,47,-12,-8,-4
21700560,203512,TOR,CHI,Lucas Nogueira,5,0.9,1,-0.0999999999999999,0,6,-6,-6,0
21700560,1626153,TOR,CHI,Delon Wright,141,29.3,30,-0.699999999999999,90,64,26,28,-2
21700560,1626181,TOR,CHI,Norman Powell,15,2.81666666666667,3,-0.183333333333334,4,14,-10,-12,2
21700560,1627751,TOR,CHI,Jakob Poeltl,122,25.7833333333333,25,0.783333333333331,79,51,28,26,2
21700560,1627783,TOR,CHI,Pascal Siakam,83,19.5166666666667,19,0.516666666666666,51,37,14,10,4
21700560,1627832,TOR,CHI,Fred VanVleet,77,17.2666666666667,17,0.266666666666666,49,31,18,16,2
21700560,1628384,TOR,CHI,OG Anunoby,76,15.9,16,-0.0999999999999996,29,43,-14,-14,0
21700561,202339,MIL,IND,Eric Bledsoe,126,28.1833333333333,28,0.183333333333334,70,53,17,15,2
21700561,202732,MIL,IND,DeAndre Liggins,101,22.0833333333333,23,-0.916666666666664,56,56,0,4,-4
21700561,203089,MIL,IND,John Henson,117,25.9833333333333,26,-0.0166666666666657,69,50,19,19,0
21700561,203114,MIL,IND,Khris Middleton,127,29.1333333333333,30,-0.866666666666667,73,55,18,20,-2
21700561,203503,MIL,IND,Tony Snell,114,25.8166666666667,26,-0.183333333333334,68,52,16,16,0
21700561,203507,MIL,IND,Giannis Antetokounmpo,138,29.3666666666667,29,0.366666666666667,76,60,16,15,1
21700561,203521,MIL,IND,Matthew Dellavedova,81,17.05,17,0.0500000000000007,42,40,2,4,-2
21700561,203930,MIL,IND,Sean Kilpatrick,18,4.21666666666667,4,0.216666666666667,9,9,0,-2,2
21700561,1627748,MIL,IND,Thon Maker,100,21.75,22,-0.25,53,51,2,2,0
21700561,1627763,MIL,IND,Malcolm Brogdon,147,31.5166666666667,32,-0.483333333333334,87,70,17,14,3
21700561,1628425,MIL,IND,Sterling Brown,16,3.56666666666667,4,-0.433333333333334,7,9,-2,-2,0
21700561,2863,IND,MIL,Damien Wilkins,19,4.43333333333333,5,-0.566666666666666,11,9,2,2,0
21700561,201152,IND,MIL,Thaddeus Young,129,28.1333333333333,28,0.133333333333333,58,76,-18,-22,4
21700561,201954,IND,MIL,Darren Collison,120,26.5,26,0.5,47,68,-21,-17,-4
21700561,202362,IND,MIL,Lance Stephenson,157,34.8666666666667,35,-0.13333333333334,72,93,-21,-20,-1
21700561,202709,IND,MIL,Cory Joseph,148,32.3666666666667,32,0.366666666666667,73,79,-6,-6,0
21700561,202711,IND,MIL,Bojan Bogdanovic,130,28.3666666666667,29,-0.633333333333333,62,70,-8,-10,2
21700561,1626167,IND,MIL,Myles Turner,107,23.8333333333333,24,-0.166666666666664,47,64,-17,-17,0
21700561,1626202,IND,MIL,Joe Young,82,17.7666666666667,18,-0.233333333333334,40,47,-7,-8,1
21700561,1627734,IND,MIL,Domantas Sabonis,151,32.8833333333333,33,-0.116666666666667,71,82,-11,-9,-2
21700561,1627816,IND,MIL,Alex Poythress,26,5.95,6,-0.0500000000000007,15,15,0,0,0
21700561,1628388,IND,MIL,TJ Leaf,16,3.56666666666667,4,-0.433333333333334,9,7,2,2,0
21700562,1717,DAL,GSW,Dirk Nowitzki,119,25.1333333333333,25,0.133333333333333,64,64,0,-1,1
21700562,2734,DAL,GSW,Devin Harris,101,19.3166666666667,19,0.316666666666666,42,62,-20,-18,-2
21700562,200826,DAL,GSW,J.J. Barea,120,25.7666666666667,26,-0.233333333333334,70,71,-1,-1,0
21700562,202083,DAL,GSW,Wesley Matthews,177,37.3333333333333,38,-0.666666666666671,96,94,2,0,2
21700562,203084,DAL,GSW,Harrison Barnes,164,33.6833333333333,34,-0.31666666666667,88,87,1,2,-1
21700562,203939,DAL,GSW,Dwight Powell,138,28.0333333333333,28,0.0333333333333314,80,75,5,4,1
21700562,1626257,DAL,GSW,Salah Mejri,19,4.18333333333333,4,0.183333333333334,4,12,-8,-7,-1
21700562,1627812,DAL,GSW,Yogi Ferrell,105,21.65,21,0.649999999999999,61,52,9,11,-2
21700562,1628372,DAL,GSW,Dennis Smith Jr.,140,29.1833333333333,29,0.183333333333334,74,78,-4,-4,0
21700562,1628467,DAL,GSW,Maxi Kleber,72,15.7166666666667,16,-0.283333333333335,31,30,1,-1,2
21700562,2561,GSW,DAL,David West,65,14.7666666666667,15,-0.233333333333334,40,39,1,1,0
21700562,2585,GSW,DAL,Zaza Pachulia,55,11.6166666666667,12,-0.383333333333333,22,25,-3,-4,1
21700562,2733,GSW,DAL,Shaun Livingston,58,12.75,13,-0.25,33,34,-1,-1,0
21700562,201142,GSW,DAL,Kevin Durant,185,38.2166666666667,38,0.216666666666669,101,98,3,5,-2
21700562,201156,GSW,DAL,Nick Young,57,12.0166666666667,12,0.0166666666666657,29,31,-2,-3,1
21700562,201939,GSW,DAL,Stephen Curry,164,34.4333333333333,34,0.433333333333337,92,86,6,7,-1
21700562,202691,GSW,DAL,Klay Thompson,172,36.15,36,0.150000000000006,90,89,1,1,0
21700562,203110,GSW,DAL,Draymond Green,183,37.75,38,-0.25,86,97,-11,-10,-1
21700562,1627775,GSW,DAL,Patrick McCaw,118,22.1666666666667,22,0.166666666666664,72,62,10,9,1
21700562,1628395,GSW,DAL,Jordan Bell,98,20.1333333333333,20,0.133333333333333,60,49,11,10,1
21700563,2210,DEN,PHX,Richard Jefferson,11,1.95,2,-0.0499999999999998,9,4,5,5,0
21700563,201163,DEN,PHX,Wilson Chandler,163,34.3166666666667,35,-0.683333333333337,94,81,13,13,0
21700563,202702,DEN,PHX,Kenneth Faried,35,6.75,7,-0.25,18,17,1,1,0
21700563,203115,DEN,PHX,Will Barton,104,20.3166666666667,20,0.316666666666666,57,42,15,16,-1
21700563,203486,DEN,PHX,Mason Plumlee,108,22.95,24,-1.05,65,53,12,13,-1
21700563,203914,DEN,PHX,Gary Harris,155,32.0166666666667,32,0.0166666666666657,93,67,26,23,3
21700563,203999,DEN,PHX,Nikola Jokic,182,36.8166666666667,36,0.816666666666663,106,82,24,24,0
21700563,1626144,DEN,PHX,Emmanuel Mudiay,11,1.95,2,-0.0499999999999998,9,4,5,5,0
21700563,1626168,DEN,PHX,Trey Lyles,134,27.4,27,0.399999999999999,70,66,4,3,1
21700563,1627736,DEN,PHX,Malik Beasley,80,15.9166666666667,16,-0.0833333333333322,41,44,-3,0,-3
21700563,1627750,DEN,PHX,Jamal Murray,120,25.6666666666667,26,-0.333333333333336,68,65,3,2,1
21700563,1628470,DEN,PHX,Torrey Craig,72,13.6166666666667,13,0.616666666666667,40,30,10,10,0
21700563,202328,PHX,DEN,Greg Monroe,163,34.3666666666667,35,-0.633333333333333,83,86,-3,-3,0
21700563,203458,PHX,DEN,Alex Len,45,8.95,9,-0.0500000000000007,17,29,-12,-14,2
21700563,203477,PHX,DEN,Isaiah Canaan,110,24.8833333333333,25,-0.116666666666667,64,65,-1,-5,4
21700563,203584,PHX,DEN,Troy Daniels,71,13.5666666666667,14,-0.433333333333334,27,48,-21,-21,0
21700563,203933,PHX,DEN,T.J. Warren,156,32.2,33,-0.799999999999997,72,94,-22,-14,-8
21700563,1626164,PHX,DEN,Devin Booker,158,29.8166666666667,30,-0.183333333333334,64,84,-20,-20,0
21700563,1627733,PHX,DEN,Dragan Bender,109,22.0333333333333,22,0.0333333333333314,52,60,-8,-9,1
21700563,1627737,PHX,DEN,Marquese Chriss,153,30.5166666666667,31,-0.483333333333334,70,93,-23,-20,-3
21700563,1627755,PHX,DEN,Tyler Ulis,80,15.0333333333333,15,0.0333333333333314,30,41,-11,-9,-2
21700563,1627863,PHX,DEN,Danuel House Jr.,17,3.18333333333333,3,0.183333333333334,6,11,-5,-5,0
21700563,1628367,PHX,DEN,Josh Jackson,113,25.1166666666667,25,0.116666666666667,70,59,11,5,6
21700564,2749,NOP,UTA,Jameer Nelson,85,19.3,19,0.300000000000001,45,30,15,17,-2
21700564,200765,NOP,UTA,Rajon Rondo,74,14.9833333333333,15,-0.0166666666666657,27,30,-3,-3,0
21700564,201950,NOP,UTA,Jrue Holiday,177,37.05,37,0.0499999999999972,83,82,1,2,-1
21700564,201967,NOP,UTA,Dante Cunningham,104,24.1,24,0.100000000000001,52,47,5,4,1
21700564,202326,NOP,UTA,DeMarcus Cousins,151,31.1,31,0.0999999999999979,67,66,1,0,1
21700564,202734,NOP,UTA,E'Twaun Moore,156,32.6833333333333,33,-0.316666666666663,73,75,-2,-4,2
21700564,203076,NOP,UTA,Anthony Davis,191,40.8,41,-0.200000000000003,97,83,14,16,-2
21700564,203121,NOP,UTA,Darius Miller,155,34.0166666666667,34,0.0166666666666657,81,72,9,9,0
21700564,203546,NOP,UTA,Ian Clark,22,5.96666666666667,6,-0.0333333333333332,15,5,10,9,1
21700564,2207,UTA,NOP,Joe Johnson,137,29.2333333333333,29,0.233333333333334,68,64,4,7,-3
21700564,201937,UTA,NOP,Ricky Rubio,111,25.05,24,1.05,46,62,-16,-20,4
21700564,201973,UTA,NOP,Jonas Jerebko,86,18.7666666666667,19,-0.233333333333334,30,44,-14,-17,3
21700564,202324,UTA,NOP,Derrick Favors,165,34.8833333333333,35,-0.116666666666667,78,78,0,2,-2
21700564,202327,UTA,NOP,Ekpe Udoh,58,13.1166666666667,13,0.116666666666667,20,30,-10,-12,2
21700564,202692,UTA,NOP,Alec Burks,71,15.9333333333333,16,-0.0666666666666664,26,36,-10,-13,3
21700564,203918,UTA,NOP,Rodney Hood,152,32.5833333333333,33,-0.416666666666671,68,72,-4,-1,-3
21700564,204060,UTA,NOP,Joe Ingles,154,32.4833333333333,33,-0.516666666666666,72,72,0,3,-3
21700564,1628378,UTA,NOP,Donovan Mitchell,181,37.95,38,-0.0499999999999972,82,82,0,1,-1
21700565,201147,LAL,OKC,Corey Brewer,87,18.5,19,-0.5,42,55,-13,-13,0
21700565,201572,LAL,OKC,Brook Lopez,73,16.8166666666667,16,0.816666666666666,32,46,-14,-16,2
21700565,203484,LAL,OKC,Kentavious Caldwell-Pope,131,28.4,29,-0.600000000000001,54,72,-18,-18,0
21700565,203898,LAL,OKC,Tyler Ennis,96,20.8833333333333,21,-0.116666666666667,41,52,-11,-10,-1
21700565,203903,LAL,OKC,Jordan Clarkson,96,21.1333333333333,21,0.133333333333333,43,62,-19,-20,1
21700565,203944,LAL,OKC,Julius Randle,96,20.6166666666667,21,-0.383333333333333,42,50,-8,-8,0
21700565,1626204,LAL,OKC,Larry Nance Jr.,106,22.4333333333333,22,0.433333333333334,49,64,-15,-15,0
21700565,1627742,LAL,OKC,Brandon Ingram,137,29.4333333333333,30,-0.566666666666666,54,78,-24,-24,0
21700565,1627826,LAL,OKC,Ivica Zubac,32,5.91666666666667,6,-0.083333333333333,12,19,-7,-7,0
21700565,1627936,LAL,OKC,Alex Caruso,44,8.2,8,0.199999999999999,20,31,-11,-9,-2
21700565,1628398,LAL,OKC,Kyle Kuzma,129,27.8,28,-0.199999999999999,49,75,-26,-26,0
21700565,1628404,LAL,OKC,Josh Hart,93,19.5333333333333,19,0.533333333333331,42,61,-19,-19,0
21700565,2546,OKC,LAL,Carmelo Anthony,126,26.7833333333333,27,-0.216666666666669,70,49,21,21,0
21700565,2555,OKC,LAL,Nick Collison,26,4.96666666666667,5,-0.0333333333333332,17,7,10,11,-1
21700565,101109,OKC,LAL,Raymond Felton,71,16.2,16,0.200000000000003,38,34,4,7,-3
21700565,201566,OKC,LAL,Russell Westbrook,132,27.8166666666667,28,-0.183333333333337,77,51,26,26,0
21700565,202331,OKC,LAL,Paul George,127,27.1166666666667,27,0.116666666666667,73,57,16,14,2
21700565,202335,OKC,LAL,Patrick Patterson,69,15.1666666666667,15,0.166666666666666,41,40,1,0,1
21700565,202713,OKC,LAL,Kyle Singler,26,4.96666666666667,5,-0.0333333333333332,17,7,10,11,-1
21700565,203500,OKC,LAL,Steven Adams,119,25.9,26,-0.100000000000001,73,52,21,20,1
21700565,203924,OKC,LAL,Jerami Grant,82,18.0833333333333,18,0.0833333333333357,48,37,11,11,0
21700565,203962,OKC,LAL,Josh Huestis,138,30.0333333333333,30,0.0333333333333314,87,55,32,30,2
21700565,1626177,OKC,LAL,Dakari Johnson,26,4.96666666666667,5,-0.0333333333333332,17,7,10,11,-1
21700565,1627772,OKC,LAL,Daniel Hamilton,26,4.96666666666667,5,-0.0333333333333332,17,7,10,11,-1
21700565,1628390,OKC,LAL,Terrance Ferguson,152,32.7,33,-0.299999999999997,90,77,13,12,1
21700566,2561,GSW,HOU,David West,50,11.6666666666667,12,-0.333333333333334,28,21,7,9,-2
21700566,2585,GSW,HOU,Zaza Pachulia,68,14.4333333333333,14,0.433333333333334,33,31,2,2,0
21700566,2733,GSW,HOU,Shaun Livingston,54,12.45,13,-0.550000000000001,31,19,12,13,-1
21700566,2738,GSW,HOU,Andre Iguodala,142,30.4833333333333,31,-0.516666666666666,71,71,0,1,-1
21700566,201156,GSW,HOU,Nick Young,90,19.45,19,0.449999999999999,58,53,5,7,-2
21700566,201939,GSW,HOU,Stephen Curry,175,36.85,37,-0.149999999999999,96,93,3,3,0
21700566,202691,GSW,HOU,Klay Thompson,171,37.5,38,-0.5,95,81,14,16,-2
21700566,203110,GSW,HOU,Draymond Green,179,38.0666666666667,38,0.0666666666666629,106,89,17,18,-1
21700566,1626172,GSW,HOU,Kevon Looney,69,14.75,15,-0.25,38,36,2,2,0
21700566,1627775,GSW,HOU,Patrick McCaw,84,17.8833333333333,18,-0.116666666666667,47,54,-7,-6,-1
21700566,1628395,GSW,HOU,Jordan Bell,28,6.13333333333333,6,0.133333333333333,17,22,-5,-5,0
21700566,2772,HOU,GSW,Trevor Ariza,159,35.4166666666667,35,0.416666666666664,77,86,-9,-9,0
21700566,101108,HOU,GSW,Chris Paul,163,36.2166666666667,36,0.216666666666669,82,82,0,0,0
21700566,101123,HOU,GSW,Gerald Green,157,33.9833333333333,34,-0.0166666666666657,84,91,-7,-5,-2
21700566,200782,HOU,GSW,PJ Tucker,106,22.0833333333333,22,0.0833333333333357,65,64,1,1,0
21700566,201569,HOU,GSW,Eric Gordon,181,37.75,38,-0.25,91,98,-7,-9,2
21700566,201583,HOU,GSW,Ryan Anderson,111,25.0666666666667,25,0.0666666666666664,48,59,-11,-12,1
21700566,203991,HOU,GSW,Clint Capela,122,27.2333333333333,28,-0.766666666666666,58,71,-13,-12,-1
21700566,204028,HOU,GSW,Tarik Black,52,10.2,10,0.199999999999999,33,27,6,6,0
21700566,1627362,HOU,GSW,Briante Weber,59,11.7166666666667,12,-0.283333333333333,32,42,-10,-10,0
21700567,101150,LAC,OKC,Lou Williams,169,31.5333333333333,32,-0.466666666666669,78,82,-4,-4,0
21700567,201599,LAC,OKC,DeAndre Jordan,191,37.5833333333333,38,-0.416666666666664,97,101,-4,-4,0
21700567,201933,LAC,OKC,Blake Griffin,165,32.65,33,-0.350000000000001,79,93,-14,-12,-2
21700567,202325,LAC,OKC,Wesley Johnson,148,29.2833333333333,30,-0.716666666666669,69,78,-9,-9,0
21700567,203710,LAC,OKC,C.J. Williams,160,33.1666666666667,33,0.166666666666664,81,100,-19,-21,2
21700567,1626149,LAC,OKC,Montrezl Harrell,53,10.7666666666667,11,-0.233333333333334,22,24,-2,-2,0
21700567,1626155,LAC,OKC,Sam Dekker,102,19.5666666666667,19,0.566666666666666,49,42,7,7,0
21700567,1628393,LAC,OKC,Jawun Evans,117,23.35,23,0.350000000000001,59,66,-7,-10,3
21700567,1628414,LAC,OKC,Sindarius Thornwell,61,11.2333333333333,12,-0.766666666666668,31,21,10,11,-1
21700567,1628462,LAC,OKC,Milos Teodosic,44,9.28333333333333,9,0.283333333333333,20,28,-8,-6,-2
21700567,2546,OKC,LAC,Carmelo Anthony,156,30.9666666666667,31,-0.033333333333335,93,79,14,12,2
21700567,101109,OKC,LAC,Raymond Felton,108,20.9666666666667,21,-0.0333333333333314,52,53,-1,4,-5
21700567,201566,OKC,LAC,Russell Westbrook,194,37.8333333333333,38,-0.166666666666671,103,97,6,6,0
21700567,202331,OKC,LAC,Paul George,169,34.55,35,-0.450000000000003,95,85,10,12,-2
21700567,202335,OKC,LAC,Patrick Patterson,70,14,14,0,30,30,0,2,-2
21700567,203500,OKC,LAC,Steven Adams,173,34.1833333333333,35,-0.816666666666663,95,84,11,11,0
21700567,203924,OKC,LAC,Jerami Grant,103,20.2166666666667,20,0.216666666666669,45,50,-5,-2,-3
21700567,203962,OKC,LAC,Josh Huestis,78,14.6666666666667,15,-0.333333333333332,39,36,3,6,-3
21700567,1628390,OKC,LAC,Terrance Ferguson,159,31.0333333333333,31,0.0333333333333314,83,71,12,9,3
21700568,201609,MIA,NYK,Goran Dragic,174,39.6,40,-0.400000000000006,84,77,7,9,-2
21700568,201949,MIA,NYK,James Johnson,138,33.1333333333333,33,0.133333333333333,63,60,3,4,-1
21700568,201961,MIA,NYK,Wayne Ellington,154,36.5666666666667,36,0.566666666666663,69,68,1,3,-2
21700568,202355,MIA,NYK,Hassan Whiteside,106,23.1333333333333,23,0.133333333333333,51,49,2,2,0
21700568,203482,MIA,NYK,Kelly Olynyk,153,34.8,35,-0.200000000000003,76,68,8,7,1
21700568,204020,MIA,NYK,Tyler Johnson,143,32.8666666666667,33,-0.133333333333333,64,67,-3,-7,4
21700568,1626196,MIA,NYK,Josh Richardson,178,40.3166666666667,40,0.316666666666663,83,80,3,3,0
21700568,1627884,MIA,NYK,Derrick Jones Jr.,41,9.6,9,0.6,21,17,4,4,0
21700568,1628389,MIA,NYK,Bam Adebayo,63,14.9,15,-0.0999999999999996,24,29,-5,-5,0
21700568,101127,NYK,MIA,Jarrett Jack,147,33.3833333333333,34,-0.616666666666667,64,75,-11,-11,0
21700568,201563,NYK,MIA,Michael Beasley,102,23.55,23,0.549999999999997,45,44,1,5,-4
21700568,201584,NYK,MIA,Courtney Lee,175,40.0333333333333,40,0.0333333333333314,77,87,-10,-8,-2
21700568,202498,NYK,MIA,Lance Thomas,123,27.7833333333333,28,-0.216666666666669,55,61,-6,-12,6
21700568,202683,NYK,MIA,Enes Kanter,112,24.5833333333333,25,-0.416666666666664,52,54,-2,-2,0
21700568,203124,NYK,MIA,Kyle O'Quinn,70,16.6833333333333,17,-0.316666666666666,31,26,5,6,-1
21700568,203926,NYK,MIA,Doug McDermott,102,24.55,24,0.549999999999997,46,43,3,3,0
21700568,204001,NYK,MIA,Kristaps Porzingis,163,37.0833333333333,37,0.0833333333333286,74,84,-10,-11,1
21700568,1627758,NYK,MIA,Ron Baker,51,11.65,12,-0.35,24,15,9,7,2
21700568,1628373,NYK,MIA,Frank Ntilikina,105,25.6166666666667,25,0.616666666666667,47,46,1,3,-2
21700569,101161,PHI,DET,Amir Johnson,71,15.9666666666667,16,-0.033333333333335,33,24,9,8,1
21700569,200755,PHI,DET,JJ Redick,107,24.5333333333333,24,0.533333333333331,73,39,34,34,0
21700569,201573,PHI,DET,Jerryd Bayless,68,14.6666666666667,15,-0.333333333333334,37,26,11,9,2
21700569,202344,PHI,DET,Trevor Booker,33,8.08333333333333,8,0.0833333333333339,15,13,2,2,0
21700569,203496,PHI,DET,Robert Covington,110,24.1,24,0.100000000000001,65,44,21,22,-1
21700569,203949,PHI,DET,James Michael McAdoo,28,7.51666666666667,7,0.516666666666668,15,13,2,2,0
21700569,203954,PHI,DET,Joel Embiid,111,24.3666666666667,25,-0.633333333333333,66,41,25,26,-1
21700569,203967,PHI,DET,Dario Saric,96,20.6833333333333,21,-0.31666666666667,55,31,24,24,0
21700569,204456,PHI,DET,T.J. McConnell,126,29.5333333333333,30,-0.466666666666669,70,48,22,21,1
21700569,1626147,PHI,DET,Justin Anderson,32,8.11666666666667,8,0.116666666666667,9,8,1,1,0
21700569,1626158,PHI,DET,Richaun Holmes,85,20.35,20,0.350000000000001,37,33,4,6,-2
21700569,1627732,PHI,DET,Ben Simmons,106,22.7666666666667,23,-0.233333333333334,58,42,16,16,0
21700569,1627789,PHI,DET,Timothe Luwawu-Cabarrot,77,18.5666666666667,18,0.566666666666666,37,28,9,9,0
21700569,201229,DET,PHI,Anthony Tolliver,60,12.4833333333333,12,0.483333333333334,22,30,-8,-9,1
21700569,202340,DET,PHI,Avery Bradley,98,21.3833333333333,22,-0.616666666666667,40,56,-16,-15,-1
21700569,202397,DET,PHI,Ish Smith,118,26.0666666666667,26,0.0666666666666664,47,69,-22,-23,1
21700569,202699,DET,PHI,Tobias Harris,113,25.6333333333333,26,-0.366666666666667,44,67,-23,-22,-1
21700569,202779,DET,PHI,Dwight Buycks,92,21.7833333333333,22,-0.216666666666669,31,45,-14,-13,-1
21700569,203083,DET,PHI,Andre Drummond,128,28.3166666666667,29,-0.683333333333334,49,78,-29,-30,1
21700569,203493,DET,PHI,Reggie Bullock,103,23.5166666666667,24,-0.483333333333334,39,67,-28,-27,-1
21700569,203961,DET,PHI,Eric Moreland,47,11.85,12,-0.15,17,17,0,0,0
21700569,204038,DET,PHI,Langston Galloway,95,22.5166666666667,22,0.516666666666666,36,48,-12,-13,1
21700569,1626242,DET,PHI,Luis Montero,24,6.33333333333333,6,0.333333333333333,11,12,-1,-1,0
21700569,1626246,DET,PHI,Boban Marjanovic,35,7.68333333333333,7,0.683333333333334,12,19,-7,-6,-1
21700569,1627740,DET,PHI,Henry Ellenson,47,11.85,12,-0.15,17,17,0,0,0
21700569,1628379,DET,PHI,Luke Kennard,90,19.8333333333333,20,-0.166666666666664,25,45,-20,-21,1
21700570,201143,BOS,MIN,Al Horford,137,31.25,31,0.25,53,57,-4,-3,-1
21700570,202681,BOS,MIN,Kyrie Irving,165,36.7333333333333,37,-0.266666666666666,68,68,0,2,-2
21700570,203382,BOS,MIN,Aron Baynes,114,25.75,27,-1.25,52,44,8,7,1
21700570,203935,BOS,MIN,Marcus Smart,134,29.2,29,0.199999999999999,68,51,17,17,0
21700570,1626179,BOS,MIN,Terry Rozier,103,21.8666666666667,22,-0.133333333333333,51,37,14,14,0
21700570,1627759,BOS,MIN,Jaylen Brown,145,32.7,33,-0.299999999999997,57,55,2,3,-1
21700570,1627824,BOS,MIN,Guerschon Yabusele,17,3.81666666666667,4,-0.183333333333333,8,6,2,2,0
21700570,1628369,BOS,MIN,Jayson Tatum,135,29.85,31,-1.15,44,54,-10,-11,1
21700570,1628400,BOS,MIN,Semi Ojeleye,16,3.13333333333333,3,0.133333333333334,4,5,-1,-1,0
21700570,1628464,BOS,MIN,Daniel Theis,114,24.7833333333333,25,-0.216666666666669,50,43,7,5,2
21700570,2037,MIN,BOS,Jamal Crawford,89,18.5833333333333,19,-0.416666666666664,31,44,-13,-11,-2
21700570,201166,MIN,BOS,Aaron Brooks,67,15.3,15,0.300000000000001,32,31,1,2,-1
21700570,201959,MIN,BOS,Taj Gibson,152,34.15,34,0.150000000000006,60,60,0,2,-2
21700570,202357,MIN,BOS,Nemanja Bjelica,51,10.7166666666667,11,-0.283333333333333,18,20,-2,-2,0
21700570,202710,MIN,BOS,Jimmy Butler,149,34.5333333333333,35,-0.466666666666669,62,62,0,-2,2
21700570,203476,MIN,BOS,Gorgui Dieng,82,17.4166666666667,18,-0.583333333333336,30,44,-14,-16,2
21700570,203952,MIN,BOS,Andrew Wiggins,163,36.1333333333333,36,0.133333333333333,64,64,0,2,-2
21700570,1626145,MIN,BOS,Tyus Jones,137,29.6,30,-0.399999999999999,47,54,-7,-8,1
21700570,1626157,MIN,BOS,Karl-Anthony Towns,187,42.0833333333333,42,0.0833333333333286,74,74,0,0,0
21700570,1627875,MIN,BOS,Marcus Georges-Hunt,3,0.566666666666667,0,0.566666666666667,2,2,0,-2,2
21700571,1891,MIL,TOR,Jason Terry,20,5.06666666666667,5,0.0666666666666664,13,14,-1,-2,1
21700571,202339,MIL,TOR,Eric Bledsoe,133,28.3666666666667,28,0.366666666666667,51,83,-32,-32,0
21700571,202732,MIL,TOR,DeAndre Liggins,57,12.0666666666667,12,0.0666666666666664,31,25,6,7,-1
21700571,203089,MIL,TOR,John Henson,78,16.9,17,-0.100000000000001,31,45,-14,-15,1
21700571,203114,MIL,TOR,Khris Middleton,138,30.6,30,0.600000000000001,60,90,-30,-29,-1
21700571,203503,MIL,TOR,Tony Snell,112,23.1,23,0.100000000000001,46,55,-9,-9,0
21700571,203507,MIL,TOR,Giannis Antetokounmpo,150,33.5333333333333,34,-0.466666666666669,77,91,-14,-16,2
21700571,203521,MIL,TOR,Matthew Dellavedova,90,21.1,21,0.100000000000001,57,69,-12,-13,1
21700571,203930,MIL,TOR,Sean Kilpatrick,26,5.9,6,-0.0999999999999996,24,13,11,11,0
21700571,1627748,MIL,TOR,Thon Maker,121,25.6833333333333,26,-0.316666666666666,66,70,-4,-2,-2
21700571,1627763,MIL,TOR,Malcolm Brogdon,137,29.3333333333333,30,-0.666666666666668,75,79,-4,-4,0
21700571,1628425,MIL,TOR,Sterling Brown,33,6.6,7,-0.4,19,11,8,9,-1
21700571,101139,TOR,MIL,CJ Miles,77,16.5,17,-0.5,49,45,4,2,2
21700571,200768,TOR,MIL,Kyle Lowry,119,27.0166666666667,27,0.0166666666666657,74,55,19,20,-1
21700571,201586,TOR,MIL,Serge Ibaka,134,29.2333333333333,29,0.233333333333334,86,51,35,35,0
21700571,201942,TOR,MIL,DeMar DeRozan,137,29.5,29,0.5,86,52,34,34,0
21700571,202685,TOR,MIL,Jonas Valanciunas,82,17.7,17,0.699999999999999,59,33,26,26,0
21700571,203512,TOR,MIL,Lucas Nogueira,78,17.1,18,-0.899999999999999,36,44,-8,-8,0
21700571,1626153,TOR,MIL,Delon Wright,94,19.8166666666667,20,-0.183333333333334,62,53,9,6,3
21700571,1626181,TOR,MIL,Norman Powell,28,5.63333333333333,6,-0.366666666666667,8,15,-7,-7,0
21700571,1627751,TOR,MIL,Jakob Poeltl,38,8.51666666666667,9,-0.483333333333334,22,25,-3,-3,0
21700571,1627783,TOR,MIL,Pascal Siakam,87,18.15,19,-0.850000000000001,43,54,-11,-11,0
21700571,1627832,TOR,MIL,Fred VanVleet,82,18.15,19,-0.850000000000001,43,58,-15,-15,0
21700571,1628384,TOR,MIL,OG Anunoby,139,30.9333333333333,31,-0.06666666666667,77,65,12,16,-4
21700572,201577,CHI,DAL,Robin Lopez,92,21.2333333333333,22,-0.766666666666666,48,51,-3,-3,0
21700572,202703,CHI,DAL,Nikola Mirotic,115,22.7666666666667,23,-0.233333333333334,67,73,-6,-2,-4
21700572,203200,CHI,DAL,Justin Holiday,179,37.3666666666667,37,0.366666666666667,101,100,1,-1,2
21700572,1626170,CHI,DAL,Jerian Grant,73,15.8,16,-0.199999999999999,36,31,5,5,0
21700572,1626171,CHI,DAL,Bobby Portis,94,20.1166666666667,20,0.116666666666667,52,44,8,8,0
21700572,1627739,CHI,DAL,Kris Dunn,156,32.2,32,0.200000000000003,91,93,-2,-2,0
21700572,1627756,CHI,DAL,Denzel Valentine,102,22.2833333333333,23,-0.716666666666669,50,57,-7,3,-10
21700572,1627835,CHI,DAL,Paul Zipser,67,14.1166666666667,14,0.116666666666667,32,29,3,5,-2
21700572,1628021,CHI,DAL,David Nwaba,110,22.2333333333333,22,0.233333333333334,71,62,9,-1,10
21700572,1628374,CHI,DAL,Lauri Markkanen,157,31.8833333333333,32,-0.116666666666667,87,80,7,3,4
21700572,1717,DAL,CHI,Dirk Nowitzki,106,23.65,23,0.649999999999999,56,65,-9,-6,-3
21700572,2734,DAL,CHI,Devin Harris,72,16.8166666666667,16,0.816666666666666,43,43,0,-3,3
21700572,200826,DAL,CHI,J.J. Barea,100,22.8833333333333,22,0.883333333333333,52,61,-9,-6,-3
21700572,202083,DAL,CHI,Wesley Matthews,173,35.55,36,-0.450000000000003,99,95,4,5,-1
21700572,203084,DAL,CHI,Harrison Barnes,167,34.4333333333333,35,-0.566666666666663,96,95,1,0,1
21700572,203939,DAL,CHI,Dwight Powell,125,27.35,27,0.350000000000001,65,70,-5,-9,4
21700572,1626257,DAL,CHI,Salah Mejri,43,9.65,10,-0.35,17,13,4,4,0
21700572,1627812,DAL,CHI,Yogi Ferrell,109,20.9,21,-0.100000000000001,62,58,4,-1,5
21700572,1628372,DAL,CHI,Dennis Smith Jr.,138,26.2666666666667,26,0.266666666666666,68,76,-8,-4,-4
21700572,1628467,DAL,CHI,Maxi Kleber,112,22.5,23,-0.5,62,59,3,5,-2
21700573,2199,PHX,SAS,Tyson Chandler,120,25.6833333333333,26,-0.316666666666666,43,55,-12,-12,0
21700573,203458,PHX,SAS,Alex Len,70,14.6333333333333,15,-0.366666666666667,32,40,-8,-10,2
21700573,203584,PHX,SAS,Troy Daniels,147,30.7166666666667,31,-0.283333333333335,58,63,-5,-5,0
21700573,1626164,PHX,SAS,Devin Booker,166,35.1166666666667,35,0.116666666666667,63,82,-19,-16,-3
21700573,1627733,PHX,SAS,Dragan Bender,114,23.1666666666667,23,0.166666666666668,48,47,1,-1,2
21700573,1627737,PHX,SAS,Marquese Chriss,154,31.65,32,-0.350000000000001,55,64,-9,-5,-4
21700573,1627755,PHX,SAS,Tyler Ulis,163,34.0333333333333,35,-0.966666666666669,62,68,-6,-10,4
21700573,1627863,PHX,SAS,Danuel House Jr.,106,21.0666666666667,21,0.0666666666666664,46,46,0,1,-1
21700573,1628367,PHX,SAS,Josh Jackson,105,21.7666666666667,22,-0.233333333333334,38,50,-12,-12,0
21700573,1938,SAS,PHX,Manu Ginobili,95,19.4166666666667,19,0.416666666666664,40,44,-4,-2,-2
21700573,2200,SAS,PHX,Pau Gasol,121,24.6333333333333,25,-0.366666666666667,65,52,13,15,-2
21700573,2225,SAS,PHX,Tony Parker,129,27.5333333333333,27,0.533333333333331,63,49,14,14,0
21700573,201988,SAS,PHX,Patty Mills,85,17.5666666666667,18,-0.433333333333334,37,37,0,0,0
21700573,202695,SAS,PHX,Kawhi Leonard,134,28.8,29,-0.199999999999999,58,53,5,5,0
21700573,202722,SAS,PHX,Davis Bertans,125,26.8166666666667,27,-0.183333333333334,48,43,5,5,0
21700573,203464,SAS,PHX,Brandon Paul,50,9.38333333333333,10,-0.616666666666667,17,18,-1,1,-2
21700573,203530,SAS,PHX,Joffrey Lauvergne,72,15.1,15,0.0999999999999996,28,26,2,0,2
21700573,203937,SAS,PHX,Kyle Anderson,129,26.3666666666667,26,0.366666666666667,68,55,13,11,2
21700573,1627749,SAS,PHX,Dejounte Murray,45,8.03333333333333,8,0.0333333333333332,19,19,0,0,0
21700573,1627854,SAS,PHX,Bryn Forbes,145,31.7166666666667,32,-0.283333333333335,69,46,23,21,2
21700573,1628401,SAS,PHX,Derrick White,15,2.46666666666667,3,-0.533333333333333,3,3,0,0,0
21700574,201163,DEN,UTA,Wilson Chandler,146,32.7,33,-0.299999999999997,69,63,6,5,1
21700574,203115,DEN,UTA,Will Barton,147,33.3166666666667,33,0.316666666666663,63,65,-2,-1,-1
21700574,203486,DEN,UTA,Mason Plumlee,80,17.2666666666667,17,0.266666666666666,38,35,3,3,0
21700574,203914,DEN,UTA,Gary Harris,166,36.3833333333333,37,-0.616666666666667,73,68,5,7,-2
21700574,203999,DEN,UTA,Nikola Jokic,148,31.9,32,-0.100000000000001,69,63,6,6,0
21700574,1626168,DEN,UTA,Trey Lyles,123,28.0166666666667,28,0.0166666666666657,58,47,11,11,0
21700574,1627736,DEN,UTA,Malik Beasley,72,16.95,17,-0.0500000000000007,33,34,-1,-3,2
21700574,1627750,DEN,UTA,Jamal Murray,146,32.2833333333333,33,-0.716666666666669,69,59,10,10,0
21700574,1628470,DEN,UTA,Torrey Craig,47,10.2666666666667,10,0.266666666666666,23,21,2,2,0
21700574,2207,UTA,DEN,Joe Johnson,106,24.2333333333333,24,0.233333333333334,38,55,-17,-17,0
21700574,200757,UTA,DEN,Thabo Sefolosha,97,21.4,21,0.399999999999999,41,45,-4,-4,0
21700574,201937,UTA,DEN,Ricky Rubio,100,22.6666666666667,23,-0.333333333333336,37,62,-25,-25,0
21700574,202324,UTA,DEN,Derrick Favors,156,33.7,34,-0.299999999999997,70,67,3,3,0
21700574,202327,UTA,DEN,Ekpe Udoh,51,12,12,0,20,28,-8,-8,0
21700574,202692,UTA,DEN,Alec Burks,86,19.5833333333333,20,-0.416666666666668,38,38,0,0,0
21700574,203918,UTA,DEN,Rodney Hood,136,30.75,31,-0.25,61,56,5,5,0
21700574,204060,UTA,DEN,Joe Ingles,143,31.4166666666667,32,-0.583333333333332,65,55,10,11,-1
21700574,1626220,UTA,DEN,Royce O'Neale,35,7.8,8,-0.2,14,19,-5,-6,1
21700574,1628378,UTA,DEN,Donovan Mitchell,165,35.5333333333333,36,-0.466666666666669,71,70,1,1,0
21700575,201148,MEM,WAS,Brandan Wright,71,14.9166666666667,15,-0.0833333333333322,27,20,7,6,1
21700575,201188,MEM,WAS,Marc Gasol,157,32.9833333333333,33,-0.0166666666666657,70,70,0,0,0
21700575,201596,MEM,WAS,Mario Chalmers,137,28.15,28,0.149999999999999,58,71,-13,-14,1
21700575,201936,MEM,WAS,Tyreke Evans,151,31.3166666666667,32,-0.683333333333337,70,54,16,16,0
21700575,203210,MEM,WAS,JaMychal Green,114,24.3,25,-0.699999999999999,58,49,9,9,0
21700575,203463,MEM,WAS,Ben McLemore,46,9.5,10,-0.5,15,8,7,6,1
21700575,203516,MEM,WAS,James Ennis III,167,34.1833333333333,34,0.183333333333337,71,72,-1,-2,1
21700575,1626185,MEM,WAS,Jarell Martin,105,20.5833333333333,20,0.583333333333336,38,50,-12,-13,1
21700575,1627738,MEM,WAS,Deyonta Davis,17,3.21666666666667,3,0.216666666666667,7,13,-6,-6,0
21700575,1627782,MEM,WAS,Wayne Selden,73,15.7,16,-0.300000000000001,36,32,4,4,0
21700575,1628415,MEM,WAS,Dillon Brooks,81,17.0666666666667,17,0.0666666666666664,34,39,-5,-5,0
21700575,1628424,MEM,WAS,Kobi Simmons,41,8.08333333333333,8,0.0833333333333322,16,27,-11,-11,0
21700575,101133,WAS,MEM,Ian Mahinmi,85,17.1833333333333,17,0.183333333333334,32,32,0,1,-1
21700575,101162,WAS,MEM,Marcin Gortat,125,26.6166666666667,27,-0.383333333333333,57,53,4,2,2
21700575,201975,WAS,MEM,Jodie Meeks,45,8.83333333333333,9,-0.166666666666668,12,18,-6,-7,1
21700575,202322,WAS,MEM,John Wall,169,36.05,36,0.0499999999999972,80,77,3,2,1
21700575,202693,WAS,MEM,Markieff Morris,153,32.4833333333333,32,0.483333333333334,71,75,-4,-2,-2
21700575,203078,WAS,MEM,Bradley Beal,183,37.9,38,-0.0999999999999943,86,77,9,11,-2
21700575,203107,WAS,MEM,Tomas Satoransky,99,19.8166666666667,20,-0.183333333333334,32,43,-11,-9,-2
21700575,203118,WAS,MEM,Mike Scott,87,17.3666666666667,18,-0.633333333333333,33,34,-1,2,-3
21700575,203490,WAS,MEM,Otto Porter Jr.,131,27.3833333333333,27,0.383333333333333,67,55,12,12,0
21700575,1626162,WAS,MEM,Kelly Oubre Jr.,83,16.3666666666667,16,0.366666666666667,35,36,-1,-2,1
21700576,101141,ATL,POR,Ersan Ilyasova,119,27.0166666666667,27,0.0166666666666657,52,61,-9,-9,0
21700576,201158,ATL,POR,Marco Belinelli,87,18.2333333333333,18,0.233333333333334,25,50,-25,-25,0
21700576,202337,ATL,POR,Luke Babbitt,37,7.86666666666667,8,-0.133333333333333,17,15,2,2,0
21700576,203101,ATL,POR,Miles Plumlee,88,20.7666666666667,21,-0.233333333333334,43,50,-7,-7,0
21700576,203145,ATL,POR,Kent Bazemore,107,24.7333333333333,24,0.733333333333334,42,60,-18,-21,3
21700576,203471,ATL,POR,Dennis Schroder,100,22.7333333333333,23,-0.266666666666666,38,54,-16,-18,2
21700576,203488,ATL,POR,Mike Muscala,37,7.86666666666667,8,-0.133333333333333,17,15,2,2,0
21700576,1627098,ATL,POR,Malcolm Delaney,82,17.5333333333333,18,-0.466666666666669,37,45,-8,-5,-3
21700576,1627752,ATL,POR,Taurean Prince,108,24.9833333333333,25,-0.0166666666666657,51,54,-3,-3,0
21700576,1627819,ATL,POR,Isaiah Taylor,102,21.9833333333333,22,-0.0166666666666657,44,50,-6,-4,-2
21700576,1628381,ATL,POR,John Collins,105,22.05,22,0.0500000000000007,34,51,-17,-17,0
21700576,1628416,ATL,POR,Tyler Dorsey,47,10.1833333333333,11,-0.816666666666666,21,19,2,2,0
21700576,1628463,ATL,POR,Tyler Cavanaugh,56,12.05,12,0.0500000000000007,24,26,-2,-2,0
21700576,202323,POR,ATL,Evan Turner,101,23.45,23,0.450000000000003,53,43,10,10,0
21700576,202329,POR,ATL,Al-Farouq Aminu,122,27.1,28,-0.899999999999999,63,43,20,17,3
21700576,202334,POR,ATL,Ed Davis,84,17.8833333333333,18,-0.116666666666667,47,36,11,11,0
21700576,203081,POR,ATL,Damian Lillard,127,28.75,29,-0.25,65,48,17,16,1
21700576,203468,POR,ATL,CJ McCollum,143,31.4666666666667,32,-0.533333333333335,82,56,26,25,1
21700576,203894,POR,ATL,Shabazz Napier,103,23.4666666666667,23,0.466666666666669,51,51,0,4,-4
21700576,203943,POR,ATL,Noah Vonleh,34,7.3,7,0.300000000000001,13,14,-1,-1,0
21700576,203994,POR,ATL,Jusuf Nurkic,97,22.4166666666667,23,-0.583333333333336,50,39,11,11,0
21700576,1626192,POR,ATL,Pat Connaughton,107,22.8833333333333,23,-0.116666666666667,54,46,8,8,0
21700576,1627774,POR,ATL,Jake Layman,33,6.76666666666667,7,-0.233333333333333,10,14,-4,-2,-2
21700576,1628380,POR,ATL,Zach Collins,124,26.5166666666667,27,-0.483333333333334,62,55,7,6,1
21700577,201147,LAL,CHA,Corey Brewer,57,11.95,12,-0.0500000000000007,18,15,3,3,0
21700577,201572,LAL,CHA,Brook Lopez,103,19.3333333333333,19,0.333333333333336,53,59,-6,-6,0
21700577,203484,LAL,CHA,Kentavious Caldwell-Pope,103,20.25,20,0.25,54,57,-3,-1,-2
21700577,203898,LAL,CHA,Tyler Ennis,44,8.91666666666667,9,-0.0833333333333339,16,5,11,11,0
21700577,203903,LAL,CHA,Jordan Clarkson,95,19.3333333333333,19,0.333333333333336,30,44,-14,-14,0
21700577,203944,LAL,CHA,Julius Randle,143,27.0333333333333,28,-0.966666666666669,66,68,-2,-2,0
21700577,1626204,LAL,CHA,Larry Nance Jr.,85,17.85,18,-0.149999999999999,21,38,-17,-17,0
21700577,1627742,LAL,CHA,Brandon Ingram,186,36.1833333333333,36,0.183333333333337,77,82,-5,-5,0
21700577,1627826,LAL,CHA,Ivica Zubac,14,3.05,3,0.0499999999999998,7,2,5,5,0
21700577,1628366,LAL,CHA,Lonzo Ball,136,27.05,27,0.0500000000000007,55,79,-24,-24,0
21700577,1628398,LAL,CHA,Kyle Kuzma,126,25.7666666666667,26,-0.233333333333334,35,44,-9,-9,0
21700577,1628404,LAL,CHA,Josh Hart,118,22.95,23,-0.0500000000000007,38,47,-9,-11,2
21700577,2730,CHA,LAL,Dwight Howard,142,27.65,28,-0.350000000000001,77,65,12,12,0
21700577,101107,CHA,LAL,Marvin Williams,92,17.4,18,-0.600000000000001,51,46,5,4,1
21700577,201587,CHA,LAL,Nicolas Batum,144,28.0666666666667,28,0.0666666666666664,80,65,15,15,0
21700577,202689,CHA,LAL,Kemba Walker,151,29.8,30,-0.200000000000003,81,70,11,12,-1
21700577,202933,CHA,LAL,Julyan Stone,14,3.05,3,0.0499999999999998,2,7,-5,-5,0
21700577,203077,CHA,LAL,Michael Kidd-Gilchrist,113,21.5666666666667,22,-0.433333333333334,63,56,7,8,-1
21700577,203087,CHA,LAL,Jeremy Lamb,124,25.4,26,-0.600000000000001,46,34,12,12,0
21700577,203487,CHA,LAL,Michael Carter-Williams,77,15.0833333333333,15,0.0833333333333339,25,17,8,7,1
21700577,203948,CHA,LAL,Johnny O'Bryant III,86,16.8,17,-0.199999999999999,28,26,2,1,1
21700577,1626163,CHA,LAL,Frank Kaminsky,141,28.8833333333333,28,0.883333333333333,55,41,14,15,-1
21700577,1626203,CHA,LAL,Treveon Graham,98,19.8666666666667,20,-0.133333333333333,28,29,-1,-1,0
21700577,1628370,CHA,LAL,Malik Monk,14,3.05,3,0.0499999999999998,2,7,-5,-5,0
21700577,1628407,CHA,LAL,Dwayne Bacon,14,3.05,3,0.0499999999999998,2,7,-5,-5,0
21700578,2561,GSW,LAC,David West,43,7.58333333333333,8,-0.416666666666666,18,19,-1,-2,1
21700578,2585,GSW,LAC,Zaza Pachulia,66,13.4,14,-0.6,34,21,13,11,2
21700578,2733,GSW,LAC,Shaun Livingston,54,9.6,10,-0.4,19,21,-2,-3,1
21700578,2738,GSW,LAC,Andre Iguodala,124,22.7833333333333,23,-0.216666666666669,65,48,17,20,-3
21700578,201156,GSW,LAC,Nick Young,110,19.95,20,-0.0499999999999972,42,46,-4,-5,1
21700578,201580,GSW,LAC,JaVale McGee,80,13.35,13,0.35,40,36,4,6,-2
21700578,201939,GSW,LAC,Stephen Curry,163,29.8333333333333,30,-0.166666666666668,89,61,28,28,0
21700578,201956,GSW,LAC,Omri Casspi,76,15.1166666666667,16,-0.883333333333333,29,41,-12,-13,1
21700578,202691,GSW,LAC,Klay Thompson,137,25.6,26,-0.399999999999999,78,54,24,22,2
21700578,203110,GSW,LAC,Draymond Green,165,28.75,29,-0.25,89,58,31,29,2
21700578,1626172,GSW,LAC,Kevon Looney,71,14.6,15,-0.399999999999999,26,32,-6,-4,-2
21700578,1627775,GSW,LAC,Patrick McCaw,122,22.2,22,0.199999999999999,43,51,-8,-6,-2
21700578,1628395,GSW,LAC,Jordan Bell,84,16.2333333333333,16,0.233333333333334,33,37,-4,-3,-1
21700578,101150,LAC,GSW,Lou Williams,142,24.1333333333333,24,0.133333333333333,58,77,-19,-20,1
21700578,201599,LAC,GSW,DeAndre Jordan,137,24.5333333333333,25,-0.466666666666669,50,76,-26,-24,-2
21700578,201933,LAC,GSW,Blake Griffin,51,9.81666666666667,10,-0.183333333333334,21,29,-8,-8,0
21700578,202325,LAC,GSW,Wesley Johnson,54,10.1666666666667,10,0.166666666666668,25,21,4,2,2
21700578,203186,LAC,GSW,Willie Reed,113,22.1666666666667,22,0.166666666666664,52,42,10,8,2
21700578,203710,LAC,GSW,C.J. Williams,119,22.1,22,0.100000000000001,40,62,-22,-17,-5
21700578,1626149,LAC,GSW,Montrezl Harrell,178,31.9333333333333,32,-0.06666666666667,70,80,-10,-10,0
21700578,1626155,LAC,GSW,Sam Dekker,149,27.9833333333333,28,-0.0166666666666657,57,59,-2,0,-2
21700578,1627820,LAC,GSW,Tyrone Wallace,169,31.4833333333333,31,0.483333333333334,74,80,-6,-4,-2
21700578,1628393,LAC,GSW,Jawun Evans,142,27.35,28,-0.649999999999999,53,58,-5,-11,6
21700578,1628414,LAC,GSW,Sindarius Thornwell,41,7.33333333333333,7,0.333333333333334,25,21,4,4,0
21700579,202681,BOS,BKN,Kyrie Irving,182,37.8666666666667,38,-0.133333333333333,74,69,5,7,-2
21700579,202694,BOS,BKN,Marcus Morris,123,26.2,26,0.200000000000003,46,53,-7,-7,0
21700579,203382,BOS,BKN,Aron Baynes,91,20.1333333333333,20,0.133333333333333,41,43,-2,-2,0
21700579,203499,BOS,BKN,Shane Larkin,68,14.5166666666667,15,-0.483333333333334,33,24,9,3,6
21700579,203935,BOS,BKN,Marcus Smart,143,29.9833333333333,29,0.983333333333334,42,51,-9,-5,-4
21700579,1626179,BOS,BKN,Terry Rozier,87,18.2833333333333,18,0.283333333333331,31,33,-2,-4,2
21700579,1627759,BOS,BKN,Jaylen Brown,167,35.1,35,0.100000000000001,60,61,-1,1,-2
21700579,1628369,BOS,BKN,Jayson Tatum,152,32.1666666666667,32,0.166666666666664,62,52,10,10,0
21700579,1628400,BOS,BKN,Semi Ojeleye,34,6.91666666666667,7,-0.0833333333333339,14,12,2,2,0
21700579,1628464,BOS,BKN,Daniel Theis,93,18.8333333333333,19,-0.166666666666664,32,27,5,5,0
21700579,201960,BKN,BOS,DeMarre Carroll,145,30.5666666666667,31,-0.433333333333334,58,61,-3,-5,2
21700579,203092,BKN,BOS,Tyler Zeller,72,15.75,16,-0.25,30,31,-1,-1,0
21700579,203112,BKN,BOS,Quincy Acy,97,19.9666666666667,20,-0.033333333333335,33,28,5,7,-2
21700579,203459,BKN,BOS,Allen Crabbe,150,32.1166666666667,32,0.116666666666667,53,61,-8,-4,-4
21700579,203915,BKN,BOS,Spencer Dinwiddie,174,36.4833333333333,37,-0.516666666666666,69,70,-1,-1,0
21700579,203917,BKN,BOS,Nik Stauskas,77,15.8166666666667,16,-0.183333333333334,25,24,1,2,-1
21700579,203925,BKN,BOS,Joe Harris,157,32.2166666666667,32,0.216666666666669,53,53,0,-1,1
21700579,1626143,BKN,BOS,Jahlil Okafor,58,12.4,13,-0.600000000000001,26,27,-1,-3,2
21700579,1626178,BKN,BOS,Rondae Hollis-Jefferson,131,28.0333333333333,28,0.0333333333333314,52,59,-7,-9,2
21700579,1628386,BKN,BOS,Jarrett Allen,52,10.5833333333333,11,-0.416666666666668,16,12,4,4,0
21700579,1628495,BKN,BOS,Milton Doyle,27,6.06666666666667,6,0.0666666666666664,10,9,1,1,0
21700580,2772,HOU,DET,Trevor Ariza,151,34.5333333333333,35,-0.466666666666669,73,77,-4,-5,1
21700580,101108,HOU,DET,Chris Paul,153,35.3166666666667,35,0.316666666666663,74,79,-5,0,-5
21700580,101123,HOU,DET,Gerald Green,123,28.4333333333333,29,-0.566666666666666,55,64,-9,-9,0
21700580,200782,HOU,DET,PJ Tucker,109,24.85,25,-0.149999999999999,68,52,16,18,-2
21700580,201569,HOU,DET,Eric Gordon,158,34.7833333333333,34,0.783333333333331,76,78,-2,-6,4
21700580,201583,HOU,DET,Ryan Anderson,98,22.9166666666667,23,-0.0833333333333322,33,55,-22,-24,2
21700580,203991,HOU,DET,Clint Capela,118,27.6,28,-0.399999999999999,44,63,-19,-15,-4
21700580,204028,HOU,DET,Tarik Black,92,20.3,20,0.300000000000001,57,44,13,8,5
21700580,1627362,HOU,DET,Briante Weber,48,10.7666666666667,11,-0.233333333333334,25,23,2,-2,4
21700580,201229,DET,HOU,Anthony Tolliver,72,14.8333333333333,15,-0.166666666666668,32,24,8,8,0
21700580,202340,DET,HOU,Avery Bradley,172,38.5,39,-0.5,85,76,9,5,4
21700580,202397,DET,HOU,Ish Smith,113,25.3166666666667,26,-0.683333333333334,59,56,3,2,1
21700580,202699,DET,HOU,Tobias Harris,141,33.2,33,0.200000000000003,75,77,-2,0,-2
21700580,202779,DET,HOU,Dwight Buycks,97,22.5833333333333,22,0.583333333333336,48,45,3,5,-2
21700580,203493,DET,HOU,Reggie Bullock,144,33.2666666666667,33,0.266666666666666,77,80,-3,-1,-2
21700580,203961,DET,HOU,Eric Moreland,153,36.15,36,0.150000000000006,81,79,2,-2,4
21700580,1626246,DET,HOU,Boban Marjanovic,55,11.6333333333333,12,-0.366666666666667,26,22,4,8,-4
21700580,1628379,DET,HOU,Luke Kennard,103,24.0166666666667,24,0.0166666666666657,52,46,6,10,-4
21700581,201577,CHI,IND,Robin Lopez,96,20.3166666666667,20,0.316666666666666,40,62,-22,-23,1
21700581,202347,CHI,IND,Quincy Pondexter,37,9.05,9,0.0500000000000007,19,22,-3,-3,0
21700581,202703,CHI,IND,Nikola Mirotic,101,23.1666666666667,23,0.166666666666664,36,56,-20,-20,0
21700581,203200,CHI,IND,Justin Holiday,127,26.6333333333333,27,-0.366666666666667,53,77,-24,-22,-2
21700581,1626170,CHI,IND,Jerian Grant,82,18.9833333333333,20,-1.01666666666667,28,39,-11,-11,0
21700581,1626171,CHI,IND,Bobby Portis,93,21.4,22,-0.600000000000001,35,46,-11,-11,0
21700581,1627739,CHI,IND,Kris Dunn,134,28.5333333333333,28,0.533333333333331,57,86,-29,-28,-1
21700581,1627756,CHI,IND,Denzel Valentine,128,27.0166666666667,27,0.0166666666666657,51,78,-27,-25,-2
21700581,1627835,CHI,IND,Paul Zipser,89,20.8833333333333,21,-0.116666666666667,32,48,-16,-17,1
21700581,1628021,CHI,IND,David Nwaba,78,17.2166666666667,17,0.216666666666669,26,38,-12,-11,-1
21700581,1628374,CHI,IND,Lauri Markkanen,115,24.3833333333333,25,-0.616666666666667,48,73,-25,-24,-1
21700581,2863,IND,CHI,Damien Wilkins,103,22,22,0,63,46,17,15,2
21700581,201152,IND,CHI,Thaddeus Young,110,23.3333333333333,24,-0.666666666666668,72,48,24,24,0
21700581,201954,IND,CHI,Darren Collison,125,26.8333333333333,27,-0.166666666666664,79,57,22,19,3
21700581,202362,IND,CHI,Lance Stephenson,108,24.1833333333333,24,0.183333333333334,51,40,11,10,1
21700581,202709,IND,CHI,Cory Joseph,113,25.5166666666667,26,-0.483333333333334,62,39,23,24,-1
21700581,203506,IND,CHI,Victor Oladipo,108,23.3333333333333,24,-0.666666666666664,74,45,29,29,0
21700581,1626167,IND,CHI,Myles Turner,93,19.9166666666667,20,-0.0833333333333357,59,38,21,17,4
21700581,1626202,IND,CHI,Joe Young,91,20.6833333333333,21,-0.316666666666666,46,28,18,20,-2
21700581,1627734,IND,CHI,Domantas Sabonis,122,27.35,27,0.350000000000001,66,46,20,21,-1
21700581,1627816,IND,CHI,Alex Poythress,23,4.81666666666667,5,-0.183333333333334,9,8,1,1,0
21700581,1628388,IND,CHI,TJ Leaf,84,19.6166666666667,20,-0.383333333333333,44,30,14,15,-1
21700582,2544,CLE,ORL,LeBron James,202,37.2666666666667,37,0.266666666666666,107,92,15,15,0
21700582,2548,CLE,ORL,Dwyane Wade,141,25.05,25,0.0499999999999972,63,71,-8,-9,1
21700582,2594,CLE,ORL,Kyle Korver,100,19.7666666666667,20,-0.233333333333334,42,62,-20,-20,0
21700582,2747,CLE,ORL,JR Smith,156,29,29,0,91,74,17,18,-1
21700582,201145,CLE,ORL,Jeff Green,122,21.9,22,-0.100000000000001,45,72,-27,-27,0
21700582,201567,CLE,ORL,Kevin Love,147,27.4333333333333,28,-0.56666666666667,78,72,6,12,-6
21700582,202684,CLE,ORL,Tristan Thompson,113,20.5666666666667,20,0.566666666666666,53,55,-2,-8,6
21700582,202738,CLE,ORL,Isaiah Thomas,112,21.4,21,0.399999999999999,51,54,-3,-3,0
21700582,203109,CLE,ORL,Jae Crowder,130,24.3666666666667,24,0.366666666666667,81,52,29,29,0
21700582,1626224,CLE,ORL,Cedi Osman,77,13.25,13,0.25,44,31,13,13,0
21700582,201167,ORL,CLE,Arron Afflalo,51,10.4333333333333,10,0.433333333333334,31,24,7,5,2
21700582,201571,ORL,CLE,D.J. Augustin,145,25.2666666666667,25,0.266666666666666,68,75,-7,-3,-4
21700582,201578,ORL,CLE,Marreese Speights,77,13.3166666666667,13,0.316666666666666,39,34,5,7,-2
21700582,202687,ORL,CLE,Bismack Biyombo,145,27.6166666666667,28,-0.383333333333333,66,85,-19,-19,0
21700582,202714,ORL,CLE,Shelvin Mack,34,7.1,7,0.100000000000001,20,16,4,4,0
21700582,203095,ORL,CLE,Evan Fournier,213,37.9833333333333,38,-0.0166666666666657,98,109,-11,-11,0
21700582,203901,ORL,CLE,Elfrid Payton,144,26.9833333333333,27,-0.0166666666666657,70,67,3,1,2
21700582,203932,ORL,CLE,Aaron Gordon,172,31.3166666666667,32,-0.68333333333333,82,76,6,2,4
21700582,1626209,ORL,CLE,Mario Hezonja,202,38.5166666666667,39,-0.483333333333334,103,103,0,8,-8
21700582,1628411,ORL,CLE,Wes Iwundu,117,21.4666666666667,22,-0.533333333333335,58,66,-8,-14,6
21700583,202339,MIL,WAS,Eric Bledsoe,152,32.9833333333333,33,-0.0166666666666657,72,68,4,-1,5
21700583,203089,MIL,WAS,John Henson,154,33.2333333333333,34,-0.766666666666666,79,73,6,7,-1
21700583,203114,MIL,WAS,Khris Middleton,190,41.8833333333333,42,-0.116666666666667,94,96,-2,3,-5
21700583,203503,MIL,WAS,Tony Snell,152,32.0666666666667,32,0.0666666666666629,80,66,14,15,-1
21700583,203507,MIL,WAS,Giannis Antetokounmpo,188,40.4,41,-0.599999999999994,97,84,13,14,-1
21700583,203521,MIL,WAS,Matthew Dellavedova,75,15.6,15,0.600000000000001,39,35,4,8,-4
21700583,1627748,MIL,WAS,Thon Maker,47,10.5333333333333,11,-0.466666666666667,22,28,-6,-4,-2
21700583,1627763,MIL,WAS,Malcolm Brogdon,147,31.9666666666667,32,-0.033333333333335,62,65,-3,-7,4
21700583,101133,WAS,MIL,Ian Mahinmi,67,13.9166666666667,14,-0.0833333333333322,27,33,-6,-4,-2
21700583,101162,WAS,MIL,Marcin Gortat,152,33.2,33,0.200000000000003,76,74,2,-1,3
21700583,201975,WAS,MIL,Jodie Meeks,68,14.3,15,-0.699999999999999,27,33,-6,-6,0
21700583,202322,WAS,MIL,John Wall,190,41.4666666666667,42,-0.533333333333331,96,94,2,1,1
21700583,202693,WAS,MIL,Markieff Morris,144,31.8833333333333,32,-0.116666666666667,66,68,-2,3,-5
21700583,203078,WAS,MIL,Bradley Beal,194,41.4166666666667,42,-0.583333333333336,83,93,-10,-9,-1
21700583,203107,WAS,MIL,Tomas Satoransky,69,14.75,15,-0.25,35,37,-2,-8,6
21700583,203118,WAS,MIL,Mike Scott,79,16.4666666666667,16,0.466666666666669,37,43,-6,-12,6
21700583,1626162,WAS,MIL,Kelly Oubre Jr.,142,31.2666666666667,31,0.266666666666666,68,70,-2,1,-3
21700584,2749,NOP,MIN,Jameer Nelson,83,18.1666666666667,18,0.166666666666664,45,44,1,3,-2
21700584,200765,NOP,MIN,Rajon Rondo,103,21.3833333333333,22,-0.616666666666667,37,64,-27,-27,0
21700584,201950,NOP,MIN,Jrue Holiday,149,32.45,33,-0.549999999999997,56,78,-22,-24,2
21700584,201967,NOP,MIN,Dante Cunningham,116,24.75,25,-0.25,57,64,-7,-5,-2
21700584,202326,NOP,MIN,DeMarcus Cousins,178,38.4666666666667,39,-0.533333333333331,80,92,-12,-14,2
21700584,202734,NOP,MIN,E'Twaun Moore,128,28.2833333333333,29,-0.716666666666669,52,66,-14,-16,2
21700584,203076,NOP,MIN,Anthony Davis,163,35.6833333333333,36,-0.31666666666667,62,86,-24,-26,2
21700584,203121,NOP,MIN,Darius Miller,113,25.35,26,-0.649999999999999,62,53,9,9,0
21700584,203546,NOP,MIN,Ian Clark,45,9.75,10,-0.25,28,23,5,7,-2
21700584,1627767,NOP,MIN,Cheick Diallo,17,3.55,4,-0.45,11,10,1,3,-2
21700584,2037,MIN,NOP,Jamal Crawford,87,19.2833333333333,20,-0.716666666666669,44,51,-7,-6,-1
21700584,201166,MIN,NOP,Aaron Brooks,69,14.9833333333333,15,-0.0166666666666657,42,40,2,4,-2
21700584,201959,MIN,NOP,Taj Gibson,159,34.15,34,0.149999999999999,86,67,19,21,-2
21700584,202332,MIN,NOP,Cole Aldrich,7,1.41666666666667,2,-0.583333333333334,4,6,-2,-2,0
21700584,202357,MIN,NOP,Nemanja Bjelica,52,11.4166666666667,12,-0.583333333333334,30,28,2,2,0
21700584,202710,MIN,NOP,Jimmy Butler,149,32.3333333333333,32,0.333333333333329,79,56,23,25,-2
21700584,203476,MIN,NOP,Gorgui Dieng,96,21.15,21,0.149999999999999,48,48,0,-7,7
21700584,203952,MIN,NOP,Andrew Wiggins,161,34.6,35,-0.400000000000006,87,66,21,21,0
21700584,1626145,MIN,NOP,Tyus Jones,150,32.5833333333333,33,-0.416666666666671,74,58,16,14,2
21700584,1626157,MIN,NOP,Karl-Anthony Towns,158,34.5,35,-0.5,82,64,18,21,-3
21700584,1627875,MIN,NOP,Marcus Georges-Hunt,7,1.41666666666667,2,-0.583333333333334,4,6,-2,-3,1
21700585,201163,DEN,SAC,Wilson Chandler,131,27.6166666666667,27,0.616666666666667,43,59,-16,-16,0
21700585,203115,DEN,SAC,Will Barton,139,30.1,30,0.100000000000001,70,69,1,1,0
21700585,203486,DEN,SAC,Mason Plumlee,83,16.9333333333333,17,-0.0666666666666664,35,38,-3,-1,-2
21700585,203914,DEN,SAC,Gary Harris,178,36.0166666666667,36,0.0166666666666657,72,82,-10,-12,2
21700585,203999,DEN,SAC,Nikola Jokic,166,33.85,34,-0.150000000000006,69,82,-13,-13,0
21700585,1626168,DEN,SAC,Trey Lyles,145,31.3166666666667,31,0.316666666666666,73,66,7,5,2
21700585,1627736,DEN,SAC,Malik Beasley,78,17.6333333333333,17,0.633333333333333,35,32,3,5,-2
21700585,1627750,DEN,SAC,Jamal Murray,172,36.2,37,-0.799999999999997,74,79,-5,-7,2
21700585,1628470,DEN,SAC,Torrey Craig,48,9.83333333333333,10,-0.166666666666668,19,23,-4,-2,-2
21700585,1713,SAC,DEN,Vince Carter,144,31.4,31,0.399999999999999,61,69,-8,-10,2
21700585,201585,SAC,DEN,Kosta Koufos,107,23.6166666666667,23,0.616666666666667,51,51,0,0,0
21700585,202066,SAC,DEN,Garrett Temple,102,22.2666666666667,22,0.266666666666666,31,50,-19,-21,2
21700585,203992,SAC,DEN,Bogdan Bogdanovic,149,32.6,33,-0.400000000000006,73,69,4,4,0
21700585,1626161,SAC,DEN,Willie Cauley-Stein,124,24.9333333333333,25,-0.0666666666666664,60,49,11,11,0
21700585,1627741,SAC,DEN,Buddy Hield,167,34.5333333333333,35,-0.466666666666669,79,65,14,14,0
21700585,1627746,SAC,DEN,Skal Labissiere,79,15.6,16,-0.4,40,27,13,15,-2
21700585,1627781,SAC,DEN,Malachi Richardson,97,19.3333333333333,19,0.333333333333336,46,38,8,8,0
21700585,1628368,SAC,DEN,De'Aaron Fox,171,35.2166666666667,35,0.216666666666669,89,72,17,19,-2
21700586,201609,MIA,UTA,Goran Dragic,151,33.55,34,-0.450000000000003,77,69,8,8,0
21700586,201949,MIA,UTA,James Johnson,112,26.4,27,-0.600000000000001,55,52,3,2,1
21700586,201961,MIA,UTA,Wayne Ellington,131,31.5666666666667,31,0.566666666666666,60,65,-5,-2,-3
21700586,202355,MIA,UTA,Hassan Whiteside,115,25.5833333333333,26,-0.416666666666664,51,55,-4,-5,1
21700586,203482,MIA,UTA,Kelly Olynyk,140,32.3333333333333,32,0.333333333333329,70,72,-2,-1,-1
21700586,204020,MIA,UTA,Tyler Johnson,154,34.25,34,0.25,78,71,7,9,-2
21700586,1626196,MIA,UTA,Josh Richardson,162,37.0833333333333,37,0.0833333333333357,88,80,8,4,4
21700586,1627884,MIA,UTA,Derrick Jones Jr.,49,11.85,12,-0.15,20,28,-8,-8,0
21700586,1628389,MIA,UTA,Bam Adebayo,31,7.3,7,0.3,16,18,-2,-2,0
21700586,2207,UTA,MIA,Joe Johnson,81,19.5666666666667,19,0.566666666666666,37,33,4,4,0
21700586,200757,UTA,MIA,Thabo Sefolosha,128,28.4166666666667,29,-0.583333333333332,65,70,-5,-5,0
21700586,201937,UTA,MIA,Ricky Rubio,128,29.5333333333333,30,-0.466666666666669,65,68,-3,0,-3
21700586,202324,UTA,MIA,Derrick Favors,145,32.3833333333333,32,0.383333333333333,71,76,-5,-7,2
21700586,202327,UTA,MIA,Ekpe Udoh,64,15.6,16,-0.4,31,27,4,6,-2
21700586,202692,UTA,MIA,Alec Burks,60,15.7166666666667,16,-0.283333333333335,31,32,-1,0,-1
21700586,203918,UTA,MIA,Rodney Hood,126,30.15,30,0.149999999999999,59,63,-4,-7,3
21700586,204060,UTA,MIA,Joe Ingles,149,32.3166666666667,32,0.316666666666663,69,69,0,-1,1
21700586,1628378,UTA,MIA,Donovan Mitchell,164,36.2333333333333,36,0.233333333333334,82,77,5,5,0
21700587,1717,DAL,NYK,Dirk Nowitzki,107,22.3833333333333,23,-0.616666666666667,38,55,-17,-17,0
21700587,2734,DAL,NYK,Devin Harris,108,22.5333333333333,23,-0.466666666666669,51,40,11,12,-1
21700587,200826,DAL,NYK,J.J. Barea,121,25.4833333333333,26,-0.516666666666666,52,53,-1,0,-1
21700587,202083,DAL,NYK,Wesley Matthews,159,34.0333333333333,34,0.0333333333333314,72,80,-8,-6,-2
21700587,203084,DAL,NYK,Harrison Barnes,167,35.8833333333333,36,-0.116666666666667,74,74,0,0,0
21700587,203939,DAL,NYK,Dwight Powell,68,14.4833333333333,14,0.483333333333334,26,30,-4,-4,0
21700587,1626257,DAL,NYK,Salah Mejri,102,22.1833333333333,22,0.18333333333333,56,39,17,17,0
21700587,1627812,DAL,NYK,Yogi Ferrell,87,19.1833333333333,19,0.183333333333334,36,36,0,-4,4
21700587,1628372,DAL,NYK,Dennis Smith Jr.,114,24.6666666666667,25,-0.333333333333336,45,56,-11,-10,-1
21700587,1628467,DAL,NYK,Maxi Kleber,87,19.0833333333333,19,0.0833333333333357,30,37,-7,-8,1
21700587,101127,NYK,DAL,Jarrett Jack,125,25.2166666666667,25,0.216666666666669,57,54,3,6,-3
21700587,201584,NYK,DAL,Courtney Lee,163,34.6166666666667,35,-0.383333333333333,75,75,0,-2,2
21700587,202498,NYK,DAL,Lance Thomas,121,25.5,25,0.5,55,57,-2,1,-3
21700587,202683,NYK,DAL,Enes Kanter,121,25.2166666666667,25,0.216666666666669,56,48,8,8,0
21700587,203124,NYK,DAL,Kyle O'Quinn,103,22.7666666666667,23,-0.233333333333334,44,48,-4,-4,0
21700587,203926,NYK,DAL,Doug McDermott,104,23.4833333333333,24,-0.516666666666666,47,42,5,-1,6
21700587,204001,NYK,DAL,Kristaps Porzingis,182,38.25,38,0.25,83,75,8,10,-2
21700587,1626195,NYK,DAL,Willy Hernangomez,28,6.43333333333333,6,0.433333333333334,15,15,0,-2,2
21700587,1627758,NYK,DAL,Ron Baker,61,13.3666666666667,13,0.366666666666667,25,21,4,6,-2
21700587,1628373,NYK,DAL,Frank Ntilikina,112,25.0666666666667,25,0.0666666666666664,43,45,-2,-2,0
21700588,2199,PHX,OKC,Tyson Chandler,135,30.15,30,0.149999999999999,62,69,-7,-11,4
21700588,201162,PHX,OKC,Jared Dudley,20,5.58333333333333,6,-0.416666666666667,17,7,10,10,0
21700588,203458,PHX,OKC,Alex Len,38,7.61666666666667,8,-0.383333333333333,23,9,14,14,0
21700588,203584,PHX,OKC,Troy Daniels,100,22.8833333333333,23,-0.116666666666667,61,37,24,25,-1
21700588,203933,PHX,OKC,T.J. Warren,143,30.6,31,-0.399999999999999,71,80,-9,-9,0
21700588,1626164,PHX,OKC,Devin Booker,141,30.0833333333333,31,-0.916666666666668,70,71,-1,-1,0
21700588,1627733,PHX,OKC,Dragan Bender,170,38.75,39,-0.25,92,76,16,19,-3
21700588,1627737,PHX,OKC,Marquese Chriss,53,10.35,10,0.35,23,33,-10,-10,0
21700588,1627755,PHX,OKC,Tyler Ulis,137,31.7166666666667,32,-0.283333333333331,69,70,-1,-1,0
21700588,1628367,PHX,OKC,Josh Jackson,138,30.5166666666667,31,-0.483333333333334,82,48,34,34,0
21700588,2546,OKC,PHX,Carmelo Anthony,154,31.8166666666667,32,-0.183333333333334,74,78,-4,-4,0
21700588,101109,OKC,PHX,Raymond Felton,92,21.3166666666667,21,0.316666666666666,40,50,-10,-8,-2
21700588,201566,OKC,PHX,Russell Westbrook,161,33.6,34,-0.399999999999999,75,88,-13,-10,-3
21700588,202331,OKC,PHX,Paul George,156,34.4666666666667,34,0.466666666666669,74,82,-8,-7,-1
21700588,202335,OKC,PHX,Patrick Patterson,69,17.3166666666667,17,0.316666666666666,33,40,-7,-8,1
21700588,202713,OKC,PHX,Kyle Singler,7,2.4,3,-0.6,4,2,2,2,0
21700588,203500,OKC,PHX,Steven Adams,152,31.8666666666667,32,-0.133333333333333,69,80,-11,-7,-4
21700588,203518,OKC,PHX,Alex Abrines,7,2.4,3,-0.6,4,2,2,2,0
21700588,203924,OKC,PHX,Jerami Grant,69,16.1833333333333,16,0.183333333333334,27,37,-10,-13,3
21700588,203962,OKC,PHX,Josh Huestis,115,27.2166666666667,27,0.216666666666669,56,66,-10,-12,2
21700588,1626177,OKC,PHX,Dakari Johnson,7,2.4,3,-0.6,4,2,2,2,0
21700588,1628390,OKC,PHX,Terrance Ferguson,86,17.2666666666667,18,-0.733333333333334,40,43,-3,-7,4
21700589,202323,POR,SAS,Evan Turner,111,24.0666666666667,24,0.0666666666666664,45,55,-10,-8,-2
21700589,202329,POR,SAS,Al-Farouq Aminu,149,31.8,32,-0.199999999999999,67,75,-8,-8,0
21700589,202334,POR,SAS,Ed Davis,75,17.0833333333333,17,0.0833333333333322,44,36,8,8,0
21700589,203090,POR,SAS,Maurice Harkless,109,23.9,24,-0.100000000000001,66,55,11,9,2
21700589,203468,POR,SAS,CJ McCollum,176,38.25,38,0.25,81,86,-5,-7,2
21700589,203894,POR,SAS,Shabazz Napier,156,33.3166666666667,33,0.316666666666663,76,78,-2,2,-4
21700589,203994,POR,SAS,Jusuf Nurkic,144,30.7333333333333,31,-0.266666666666666,67,74,-7,-7,0
21700589,1626192,POR,SAS,Pat Connaughton,109,24.5166666666667,25,-0.483333333333334,65,56,9,7,2
21700589,1628380,POR,SAS,Zach Collins,71,16.1666666666667,16,0.166666666666664,44,35,9,9,0
21700589,1938,SAS,POR,Manu Ginobili,123,27.7166666666667,27,0.716666666666669,67,70,-3,-3,0
21700589,2200,SAS,POR,Pau Gasol,131,27.65,28,-0.350000000000001,61,60,1,4,-3
21700589,200746,SAS,POR,LaMarcus Aldridge,162,35.0833333333333,35,0.0833333333333286,82,72,10,10,0
21700589,201988,SAS,POR,Patty Mills,124,27.7333333333333,28,-0.266666666666666,67,70,-3,-5,2
21700589,202722,SAS,POR,Davis Bertans,123,27.95,28,-0.0500000000000007,65,68,-3,-7,4
21700589,203464,SAS,POR,Brandon Paul,31,6.08333333333333,6,0.083333333333333,17,20,-3,-6,3
21700589,203530,SAS,POR,Joffrey Lauvergne,23,5.11666666666667,5,0.116666666666667,12,20,-8,-7,-1
21700589,203937,SAS,POR,Kyle Anderson,163,35.55,36,-0.450000000000003,75,72,3,6,-3
21700589,1627749,SAS,POR,Dejounte Murray,97,20.3666666666667,21,-0.633333333333333,43,43,0,2,-2
21700589,1627854,SAS,POR,Bryn Forbes,123,26.5833333333333,27,-0.416666666666664,61,60,1,1,0
21700590,101141,ATL,LAL,Ersan Ilyasova,140,28.3166666666667,28,0.316666666666666,62,69,-7,-7,0
21700590,201158,ATL,LAL,Marco Belinelli,82,16.9333333333333,17,-0.0666666666666664,33,52,-19,-17,-2
21700590,202337,ATL,LAL,Luke Babbitt,27,4.66666666666667,5,-0.333333333333334,15,14,1,1,0
21700590,203101,ATL,LAL,Miles Plumlee,127,24.4666666666667,25,-0.533333333333331,58,61,-3,-3,0
21700590,203145,ATL,LAL,Kent Bazemore,130,25.5333333333333,26,-0.466666666666669,65,66,-1,0,-1
21700590,203471,ATL,LAL,Dennis Schroder,164,32.55,33,-0.450000000000003,80,80,0,0,0
21700590,203488,ATL,LAL,Mike Muscala,32,5.66666666666667,6,-0.333333333333334,21,17,4,4,0
21700590,1627098,ATL,LAL,Malcolm Delaney,106,21.95,21,0.949999999999999,39,63,-24,-24,0
21700590,1627752,ATL,LAL,Taurean Prince,126,24.7166666666667,25,-0.283333333333331,64,63,1,-2,3
21700590,1627819,ATL,LAL,Isaiah Taylor,46,7.98333333333333,8,-0.0166666666666675,19,28,-9,-9,0
21700590,1628381,ATL,LAL,John Collins,104,20.6,21,-0.399999999999999,46,66,-20,-20,0
21700590,1628416,ATL,LAL,Tyler Dorsey,48,8.96666666666667,9,-0.033333333333335,24,30,-6,-6,0
21700590,1628463,ATL,LAL,Tyler Cavanaugh,83,16.4833333333333,16,0.483333333333334,39,51,-12,-12,0
21700590,201147,LAL,ATL,Corey Brewer,18,2.98333333333333,3,-0.0166666666666666,8,10,-2,0,-2
21700590,201572,LAL,ATL,Brook Lopez,100,19.15,19,0.149999999999999,52,48,4,6,-2
21700590,203484,LAL,ATL,Kentavious Caldwell-Pope,120,23.2333333333333,23,0.233333333333334,61,59,2,0,2
21700590,203898,LAL,ATL,Tyler Ennis,96,18.75,18,0.75,54,48,6,8,-2
21700590,203903,LAL,ATL,Jordan Clarkson,118,23.6833333333333,24,-0.316666666666666,68,50,18,18,0
21700590,203944,LAL,ATL,Julius Randle,123,23.1833333333333,23,0.183333333333334,59,60,-1,-1,0
21700590,1626204,LAL,ATL,Larry Nance Jr.,115,23.7333333333333,24,-0.266666666666666,70,49,21,19,2
21700590,1627742,LAL,ATL,Brandon Ingram,154,29.7333333333333,30,-0.266666666666666,75,75,0,0,0
21700590,1627826,LAL,ATL,Ivica Zubac,5,0.85,1,-0.15,3,4,-1,1,-2
21700590,1628366,LAL,ATL,Lonzo Ball,147,29.0166666666667,30,-0.983333333333334,78,65,13,11,2
21700590,1628398,LAL,ATL,Kyle Kuzma,116,23.9666666666667,24,-0.0333333333333314,66,51,15,15,0
21700590,1628404,LAL,ATL,Josh Hart,98,19.7,20,-0.300000000000001,63,42,21,17,4
21700590,1628418,LAL,ATL,Thomas Bryant,5,0.85,1,-0.15,3,4,-1,1,-2
21700591,1891,MIL,IND,Jason Terry,21,4.58333333333333,5,-0.416666666666666,6,20,-14,-14,0
21700591,202339,MIL,IND,Eric Bledsoe,132,28.1166666666667,28,0.116666666666667,55,62,-7,-7,0
21700591,203089,MIL,IND,John Henson,110,24.4,24,0.399999999999999,52,53,-1,1,-2
21700591,203114,MIL,IND,Khris Middleton,148,31.6833333333333,32,-0.316666666666666,59,70,-11,-9,-2
21700591,203503,MIL,IND,Tony Snell,130,28.9833333333333,29,-0.0166666666666657,57,66,-9,-7,-2
21700591,203507,MIL,IND,Giannis Antetokounmpo,146,32.1666666666667,32,0.166666666666664,61,80,-19,-19,0
21700591,203521,MIL,IND,Matthew Dellavedova,61,13.3166666666667,14,-0.683333333333334,16,38,-22,-24,2
21700591,203930,MIL,IND,Sean Kilpatrick,33,8.11666666666667,8,0.116666666666667,25,15,10,12,-2
21700591,1627748,MIL,IND,Thon Maker,80,18.3,18,0.299999999999997,37,45,-8,-10,2
21700591,1627763,MIL,IND,Malcolm Brogdon,165,37.4,38,-0.599999999999994,81,75,6,2,4
21700591,1628425,MIL,IND,Sterling Brown,49,11.7666666666667,12,-0.233333333333334,31,21,10,10,0
21700591,201152,IND,MIL,Thaddeus Young,145,30.9333333333333,31,-0.06666666666667,72,56,16,10,6
21700591,201954,IND,MIL,Darren Collison,130,27.65,28,-0.350000000000001,64,58,6,6,0
21700591,202362,IND,MIL,Lance Stephenson,92,21.5833333333333,22,-0.416666666666668,49,40,9,9,0
21700591,202709,IND,MIL,Cory Joseph,126,28.2833333333333,28,0.283333333333331,62,57,5,9,-4
21700591,202711,IND,MIL,Bojan Bogdanovic,100,21.8833333333333,22,-0.116666666666667,53,43,10,8,2
21700591,203506,IND,MIL,Victor Oladipo,150,32.3666666666667,33,-0.633333333333333,77,66,11,9,2
21700591,1626167,IND,MIL,Myles Turner,107,23.7833333333333,24,-0.216666666666669,55,52,3,1,2
21700591,1626202,IND,MIL,Joe Young,54,13,13,0,26,26,0,2,-2
21700591,1627734,IND,MIL,Domantas Sabonis,108,23.9833333333333,24,-0.0166666666666657,54,44,10,12,-2
21700591,1628388,IND,MIL,TJ Leaf,63,15.3666666666667,16,-0.633333333333333,33,38,-5,-1,-4
21700592,203092,BKN,TOR,Tyler Zeller,53,10.8166666666667,11,-0.183333333333334,17,32,-15,-15,0
21700592,203112,BKN,TOR,Quincy Acy,169,34.25,34,0.25,71,71,0,0,0
21700592,203459,BKN,TOR,Allen Crabbe,173,33.8166666666667,34,-0.183333333333337,83,75,8,8,0
21700592,203915,BKN,TOR,Spencer Dinwiddie,213,41.7666666666667,42,-0.233333333333334,95,91,4,4,0
21700592,203925,BKN,TOR,Joe Harris,180,36.9666666666667,37,-0.0333333333333314,77,86,-9,-7,-2
21700592,1626143,BKN,TOR,Jahlil Okafor,38,9.35,10,-0.65,11,16,-5,-4,-1
21700592,1626178,BKN,TOR,Rondae Hollis-Jefferson,184,36.3333333333333,36,0.333333333333329,87,83,4,4,0
21700592,1627747,BKN,TOR,Caris LeVert,129,27.0166666666667,27,0.0166666666666657,43,50,-7,-9,2
21700592,1628386,BKN,TOR,Jarrett Allen,97,18.2666666666667,18,0.266666666666666,46,33,13,12,1
21700592,1628495,BKN,TOR,Milton Doyle,79,16.4166666666667,17,-0.583333333333336,35,33,2,2,0
21700592,101139,TOR,BKN,CJ Miles,82,16.6166666666667,17,-0.383333333333333,31,28,3,4,-1
21700592,200768,TOR,BKN,Kyle Lowry,193,38.05,38,0.0499999999999972,84,90,-6,-4,-2
21700592,201586,TOR,BKN,Serge Ibaka,198,38.85,39,-0.149999999999999,92,86,6,9,-3
21700592,201942,TOR,BKN,DeMar DeRozan,218,42.85,42,0.850000000000001,98,99,-1,1,-2
21700592,202685,TOR,BKN,Jonas Valanciunas,133,26.5166666666667,26,0.516666666666666,64,68,-4,-2,-2
21700592,203512,TOR,BKN,Lucas Nogueira,52,10.4166666666667,10,0.416666666666666,25,17,8,6,2
21700592,1626153,TOR,BKN,Delon Wright,143,28.9333333333333,29,-0.0666666666666664,58,56,2,-1,3
21700592,1626181,TOR,BKN,Norman Powell,14,2.26666666666667,2,0.266666666666667,4,7,-3,-1,-2
21700592,1627751,TOR,BKN,Jakob Poeltl,43,9.31666666666667,10,-0.683333333333334,13,15,-2,-2,0
21700592,1627783,TOR,BKN,Pascal Siakam,71,16.8,17,-0.199999999999999,23,26,-3,-6,3
21700592,1627832,TOR,BKN,Fred VanVleet,91,18.6166666666667,19,-0.383333333333333,41,42,-1,-3,2
21700592,1628384,TOR,BKN,OG Anunoby,77,15.7666666666667,16,-0.233333333333334,37,31,6,4,2
21700593,201577,CHI,HOU,Robin Lopez,65,14.3333333333333,15,-0.666666666666668,27,38,-11,-14,3
21700593,203200,CHI,HOU,Justin Holiday,186,39.9666666666667,40,-0.0333333333333314,90,96,-6,-4,-2
21700593,1626170,CHI,HOU,Jerian Grant,83,17.7666666666667,18,-0.233333333333334,37,30,7,7,0
21700593,1626171,CHI,HOU,Bobby Portis,159,33.5333333333333,33,0.533333333333331,80,78,2,5,-3
21700593,1626245,CHI,HOU,Cristiano Felicio,32,6.76666666666667,7,-0.233333333333334,15,18,-3,-4,1
21700593,1627739,CHI,HOU,Kris Dunn,141,30.1,30,0.100000000000001,70,86,-16,-16,0
21700593,1627756,CHI,HOU,Denzel Valentine,164,36,36,0,86,91,-5,-4,-1
21700593,1627835,CHI,HOU,Paul Zipser,47,9.46666666666667,9,0.466666666666667,18,19,-1,-3,2
21700593,1628021,CHI,HOU,David Nwaba,86,17.0666666666667,17,0.0666666666666664,34,38,-4,-4,0
21700593,1628374,CHI,HOU,Lauri Markkanen,157,34.3333333333333,34,0.333333333333336,78,86,-8,-8,0
21700593,2772,HOU,CHI,Trevor Ariza,188,41.1833333333333,41,0.183333333333337,99,94,5,5,0
21700593,101108,HOU,CHI,Chris Paul,168,35.25,36,-0.75,79,80,-1,0,-1
21700593,101123,HOU,CHI,Gerald Green,127,26.8833333333333,26,0.883333333333333,72,54,18,18,0
21700593,200782,HOU,CHI,PJ Tucker,120,25.55,25,0.549999999999997,63,56,7,9,-2
21700593,201569,HOU,CHI,Eric Gordon,177,37.5333333333333,38,-0.466666666666669,96,84,12,11,1
21700593,201583,HOU,CHI,Ryan Anderson,124,25.9333333333333,26,-0.0666666666666664,63,60,3,1,2
21700593,203991,HOU,CHI,Clint Capela,156,33.4166666666667,34,-0.583333333333336,88,79,9,9,0
21700593,204028,HOU,CHI,Tarik Black,48,10.8333333333333,11,-0.166666666666668,18,19,-1,-1,0
21700593,1627362,HOU,CHI,Briante Weber,12,2.75,3,-0.25,2,9,-7,-7,0
21700594,2544,CLE,MIN,LeBron James,128,26.6833333333333,27,-0.31666666666667,42,79,-37,-39,2
21700594,2548,CLE,MIN,Dwyane Wade,123,24.2,24,0.199999999999999,56,72,-16,-14,-2
21700594,2594,CLE,MIN,Kyle Korver,105,22.6,23,-0.399999999999999,61,52,9,9,0
21700594,2747,CLE,MIN,JR Smith,120,25.3166666666667,25,0.316666666666666,38,75,-37,-37,0
21700594,101112,CLE,MIN,Channing Frye,25,6.35,6,0.35,16,10,6,6,0
21700594,101181,CLE,MIN,Jose Calderon,34,8.6,9,-0.4,21,14,7,7,0
21700594,201145,CLE,MIN,Jeff Green,125,26.8333333333333,27,-0.166666666666668,74,67,7,7,0
21700594,201567,CLE,MIN,Kevin Love,97,20.4833333333333,21,-0.516666666666666,26,57,-31,-30,-1
21700594,202684,CLE,MIN,Tristan Thompson,112,22.75,23,-0.25,61,67,-6,-7,1
21700594,202738,CLE,MIN,Isaiah Thomas,86,18.5666666666667,19,-0.433333333333334,31,49,-18,-18,0
21700594,203109,CLE,MIN,Jae Crowder,100,21.0833333333333,21,0.0833333333333357,25,60,-35,-35,0
21700594,1626224,CLE,MIN,Cedi Osman,70,16.1166666666667,16,0.116666666666667,44,33,11,11,0
21700594,2037,MIN,CLE,Jamal Crawford,87,18.95,19,-0.0499999999999972,48,52,-4,-6,2
21700594,201166,MIN,CLE,Aaron Brooks,76,17.0333333333333,17,0.0333333333333314,40,45,-5,-7,2
21700594,201959,MIN,CLE,Taj Gibson,151,31.25,31,0.25,89,54,35,35,0
21700594,202357,MIN,CLE,Nemanja Bjelica,76,17.0333333333333,17,0.0333333333333314,40,45,-5,-7,2
21700594,202710,MIN,CLE,Jimmy Butler,132,27.4833333333333,27,0.483333333333334,79,42,37,39,-2
21700594,203476,MIN,CLE,Gorgui Dieng,122,25.8166666666667,26,-0.183333333333334,65,69,-4,-3,-1
21700594,203498,MIN,CLE,Shabazz Muhammad,17,4.05,4,0.0499999999999998,8,14,-6,-6,0
21700594,203952,MIN,CLE,Andrew Wiggins,149,30.8833333333333,31,-0.116666666666667,87,54,33,35,-2
21700594,1626145,MIN,CLE,Tyus Jones,138,28.3166666666667,28,0.316666666666666,79,45,34,36,-2
21700594,1626157,MIN,CLE,Karl-Anthony Towns,143,30.1666666666667,30,0.166666666666664,86,54,32,31,1
21700594,1627875,MIN,CLE,Marcus Georges-Hunt,34,8.6,9,-0.4,14,21,-7,-7,0
21700595,2749,NOP,DET,Jameer Nelson,38,7.53333333333333,7,0.533333333333333,14,26,-12,-14,2
21700595,200765,NOP,DET,Rajon Rondo,156,31.95,32,-0.0499999999999972,79,70,9,11,-2
21700595,201950,NOP,DET,Jrue Holiday,206,43.5,44,-0.5,107,92,15,15,0
21700595,201967,NOP,DET,Dante Cunningham,128,27.7666666666667,28,-0.233333333333334,52,72,-20,-20,0
21700595,202326,NOP,DET,DeMarcus Cousins,191,39.8666666666667,40,-0.133333333333333,94,82,12,12,0
21700595,202734,NOP,DET,E'Twaun Moore,171,34.6166666666667,35,-0.383333333333333,83,74,9,7,2
21700595,203076,NOP,DET,Anthony Davis,130,26.8666666666667,27,-0.133333333333333,78,59,19,19,0
21700595,203121,NOP,DET,Darius Miller,70,16.4333333333333,16,0.433333333333334,33,46,-13,-13,0
21700595,203546,NOP,DET,Ian Clark,40,9.96666666666667,10,-0.0333333333333332,20,19,1,3,-2
21700595,1627767,NOP,DET,Cheick Diallo,5,1.5,2,-0.5,0,5,-5,-5,0
21700595,201229,DET,NOP,Anthony Tolliver,125,26.7,26,0.699999999999999,58,66,-8,-10,2
21700595,202340,DET,NOP,Avery Bradley,170,35.55,35,0.549999999999997,74,85,-11,-11,0
21700595,202397,DET,NOP,Ish Smith,163,33.0666666666667,34,-0.933333333333337,71,79,-8,-6,-2
21700595,202699,DET,NOP,Tobias Harris,178,37.8666666666667,38,-0.13333333333334,91,96,-5,-3,-2
21700595,202779,DET,NOP,Dwight Buycks,64,14.9333333333333,14,0.933333333333334,38,33,5,3,2
21700595,203083,DET,NOP,Andre Drummond,186,38.5833333333333,39,-0.416666666666671,90,101,-11,-11,0
21700595,203493,DET,NOP,Reggie Bullock,150,31.35,32,-0.650000000000002,81,66,15,14,1
21700595,203961,DET,NOP,Eric Moreland,42,9.51666666666667,9,0.516666666666666,19,12,7,8,-1
21700595,1628379,DET,NOP,Luke Kennard,57,12.4333333333333,12,0.433333333333334,23,22,1,1,0
21700596,1713,SAC,SAS,Vince Carter,47,10.5833333333333,11,-0.416666666666666,22,21,1,1,0
21700596,2216,SAC,SAS,Zach Randolph,122,24.7166666666667,25,-0.283333333333331,50,56,-6,-6,0
21700596,201585,SAC,SAS,Kosta Koufos,79,19.2,19,0.199999999999999,43,39,4,4,0
21700596,202066,SAC,SAS,Garrett Temple,134,29.85,30,-0.149999999999999,59,75,-16,-15,-1
21700596,203992,SAC,SAS,Bogdan Bogdanovic,153,33.5166666666667,33,0.516666666666666,72,78,-6,-7,1
21700596,1626161,SAC,SAS,Willie Cauley-Stein,145,30.05,30,0.0500000000000007,61,72,-11,-11,0
21700596,1627741,SAC,SAS,Buddy Hield,124,27.8833333333333,28,-0.116666666666667,64,55,9,9,0
21700596,1627746,SAC,SAS,Skal Labissiere,90,21.6,22,-0.399999999999999,46,47,-1,-1,0
21700596,1627781,SAC,SAS,Malachi Richardson,52,11.5333333333333,12,-0.466666666666667,22,18,4,4,0
21700596,1628368,SAC,SAS,De'Aaron Fox,144,29.9833333333333,30,-0.0166666666666657,61,74,-13,-13,0
21700596,2200,SAS,SAC,Pau Gasol,113,24.1666666666667,24,0.166666666666664,52,48,4,5,-1
21700596,2225,SAS,SAC,Tony Parker,99,22.8,23,-0.200000000000003,40,45,-5,-5,0
21700596,200746,SAS,SAC,LaMarcus Aldridge,160,35.8333333333333,36,-0.166666666666671,76,77,-1,-2,1
21700596,201988,SAS,SAC,Patty Mills,129,27.1833333333333,27,0.183333333333334,73,58,15,15,0
21700596,202722,SAS,SAC,Davis Bertans,146,31.3333333333333,31,0.333333333333332,75,65,10,12,-2
21700596,203464,SAS,SAC,Brandon Paul,56,11.6166666666667,12,-0.383333333333333,26,29,-3,-2,-1
21700596,203937,SAS,SAC,Kyle Anderson,123,27.8833333333333,28,-0.116666666666667,60,52,8,8,0
21700596,1627749,SAS,SAC,Dejounte Murray,88,18.1833333333333,18,0.18333333333333,42,44,-2,-2,0
21700596,1627854,SAS,SAC,Bryn Forbes,129,29.2333333333333,30,-0.766666666666666,68,59,9,8,1
21700596,1627856,SAS,SAC,Matt Costello,17,4.23333333333333,4,0.233333333333333,11,10,1,-1,2
21700596,1628401,SAS,SAC,Derrick White,30,6.45,6,0.449999999999999,12,13,-1,-1,0
21700597,201163,DEN,GSW,Wilson Chandler,185,38.5,38,0.5,100,106,-6,-3,-3
21700597,203115,DEN,GSW,Will Barton,85,18.4166666666667,19,-0.583333333333332,40,52,-12,-13,1
21700597,203486,DEN,GSW,Mason Plumlee,121,27.15,27,0.149999999999999,64,75,-11,-12,1
21700597,203914,DEN,GSW,Gary Harris,169,34.6666666666667,35,-0.333333333333329,85,90,-5,-4,-1
21700597,203999,DEN,GSW,Nikola Jokic,169,35.7,36,-0.299999999999997,86,84,2,2,0
21700597,1626168,DEN,GSW,Trey Lyles,129,26.0833333333333,26,0.0833333333333357,61,66,-5,-4,-1
21700597,1627736,DEN,GSW,Malik Beasley,17,3.18333333333333,3,0.183333333333334,7,8,-1,-1,0
21700597,1627750,DEN,GSW,Jamal Murray,194,41.6,42,-0.399999999999999,97,101,-4,-6,2
21700597,1628470,DEN,GSW,Torrey Craig,61,13.2,13,0.199999999999999,30,38,-8,-9,1
21700597,2561,GSW,DEN,David West,69,15.95,16,-0.0500000000000007,40,37,3,4,-1
21700597,2585,GSW,DEN,Zaza Pachulia,63,12.95,13,-0.0500000000000007,33,30,3,3,0
21700597,2733,GSW,DEN,Shaun Livingston,59,13.8,14,-0.199999999999999,35,31,4,4,0
21700597,2738,GSW,DEN,Andre Iguodala,140,29.4666666666667,30,-0.533333333333331,72,72,0,0,0
21700597,201156,GSW,DEN,Nick Young,73,15.3666666666667,15,0.366666666666667,46,38,8,6,2
21700597,201939,GSW,DEN,Stephen Curry,171,34.95,35,-0.0499999999999972,90,86,4,3,1
21700597,201956,GSW,DEN,Omri Casspi,69,14.45,14,0.449999999999999,40,40,0,2,-2
21700597,202691,GSW,DEN,Klay Thompson,164,34.6333333333333,35,-0.366666666666667,87,80,7,10,-3
21700597,203110,GSW,DEN,Draymond Green,169,35.1666666666667,35,0.166666666666671,90,87,3,0,3
21700597,1627775,GSW,DEN,Patrick McCaw,66,13.45,13,0.449999999999999,37,31,6,6,0
21700597,1628395,GSW,DEN,Jordan Bell,87,18.3166666666667,19,-0.683333333333334,50,38,12,12,0
21700598,101141,ATL,LAC,Ersan Ilyasova,156,29.4,30,-0.600000000000001,66,75,-9,-11,2
21700598,201158,ATL,LAC,Marco Belinelli,93,19.1666666666667,19,0.166666666666664,43,34,9,9,0
21700598,203101,ATL,LAC,Miles Plumlee,72,14.05,14,0.0500000000000007,29,32,-3,-6,3
21700598,203145,ATL,LAC,Kent Bazemore,151,28.7833333333333,29,-0.216666666666669,64,74,-10,-10,0
21700598,203471,ATL,LAC,Dennis Schroder,134,27.2666666666667,27,0.266666666666666,56,69,-13,-13,0
21700598,203473,ATL,LAC,Dewayne Dedmon,101,20.55,20,0.549999999999997,46,50,-4,-1,-3
21700598,203488,ATL,LAC,Mike Muscala,60,10.6166666666667,11,-0.383333333333333,28,23,5,7,-2
21700598,1627098,ATL,LAC,Malcolm Delaney,139,26.7333333333333,26,0.733333333333334,65,51,14,14,0
21700598,1627752,ATL,LAC,Taurean Prince,186,35.5333333333333,36,-0.466666666666669,84,86,-2,-2,0
21700598,1628381,ATL,LAC,John Collins,35,8.11666666666667,8,0.116666666666667,13,18,-5,-5,0
21700598,1628416,ATL,LAC,Tyler Dorsey,29,6.36666666666667,6,0.366666666666667,9,10,-1,-1,0
21700598,1628463,ATL,LAC,Tyler Cavanaugh,64,13.1666666666667,13,0.166666666666668,32,18,14,14,0
21700598,101150,LAC,ATL,Lou Williams,209,40.1333333333333,41,-0.866666666666667,95,95,0,4,-4
21700598,201599,LAC,ATL,DeAndre Jordan,171,33.6333333333333,34,-0.366666666666667,87,73,14,12,2
21700598,202325,LAC,ATL,Wesley Johnson,166,32.0333333333333,32,0.0333333333333314,81,71,10,8,2
21700598,203710,LAC,ATL,C.J. Williams,186,37.0333333333333,37,0.0333333333333314,88,85,3,1,2
21700598,1626149,LAC,ATL,Montrezl Harrell,73,14.3166666666667,14,0.316666666666666,21,34,-13,-11,-2
21700598,1626155,LAC,ATL,Sam Dekker,78,15.9166666666667,16,-0.0833333333333339,27,36,-9,-7,-2
21700598,1627820,LAC,ATL,Tyrone Wallace,95,19.25,19,0.25,35,40,-5,-7,2
21700598,1628393,LAC,ATL,Jawun Evans,204,39.6166666666667,39,0.616666666666667,97,88,9,7,2
21700598,1628414,LAC,ATL,Sindarius Thornwell,38,7.81666666666667,8,-0.183333333333334,9,13,-4,-2,-2
21700599,201609,MIA,TOR,Goran Dragic,180,39.05,39,0.0499999999999972,72,75,-3,-3,0
21700599,201949,MIA,TOR,James Johnson,70,14.0166666666667,14,0.0166666666666657,35,25,10,9,1
21700599,201961,MIA,TOR,Wayne Ellington,167,35.6,35,0.600000000000001,70,63,7,7,0
21700599,202355,MIA,TOR,Hassan Whiteside,139,29.8833333333333,30,-0.116666666666667,52,56,-4,-6,2
21700599,203482,MIA,TOR,Kelly Olynyk,100,22.15,22,0.149999999999999,35,45,-10,-7,-3
21700599,1626196,MIA,TOR,Josh Richardson,180,38.3833333333333,38,0.383333333333333,68,70,-2,-2,0
21700599,1627884,MIA,TOR,Derrick Jones Jr.,133,28.45,28,0.449999999999999,55,55,0,-2,2
21700599,1628389,MIA,TOR,Bam Adebayo,151,32.4666666666667,33,-0.533333333333331,63,56,7,9,-2
21700599,101139,TOR,MIA,CJ Miles,85,18.3833333333333,19,-0.616666666666667,26,33,-7,-7,0
21700599,201586,TOR,MIA,Serge Ibaka,103,21.65,22,-0.350000000000001,40,42,-2,0,-2
21700599,201942,TOR,MIA,DeMar DeRozan,165,35.1666666666667,35,0.166666666666671,70,69,1,3,-2
21700599,202685,TOR,MIA,Jonas Valanciunas,94,21.1333333333333,21,0.133333333333333,37,36,1,1,0
21700599,203485,TOR,MIA,Lorenzo Brown,26,5.61666666666667,6,-0.383333333333333,9,8,1,1,0
21700599,203512,TOR,MIA,Lucas Nogueira,74,15.4166666666667,15,0.416666666666666,27,25,2,2,0
21700599,1626153,TOR,MIA,Delon Wright,138,29.5666666666667,29,0.56666666666667,56,59,-3,-3,0
21700599,1626181,TOR,MIA,Norman Powell,114,23.5833333333333,24,-0.416666666666668,49,43,6,2,4
21700599,1627751,TOR,MIA,Jakob Poeltl,38,8.53333333333333,9,-0.466666666666667,19,25,-6,-6,0
21700599,1627783,TOR,MIA,Pascal Siakam,71,15.2166666666667,15,0.216666666666667,33,29,4,2,2
21700599,1627832,TOR,MIA,Fred VanVleet,88,19.15,19,0.149999999999999,33,33,0,0,0
21700599,1628384,TOR,MIA,OG Anunoby,124,26.5833333333333,26,0.583333333333336,46,48,-2,0,-2
21700600,202323,POR,OKC,Evan Turner,105,21.7666666666667,22,-0.233333333333334,55,43,12,12,0
21700600,202329,POR,OKC,Al-Farouq Aminu,145,30.45,31,-0.549999999999997,78,66,12,13,-1
21700600,202334,POR,OKC,Ed Davis,101,22.3166666666667,23,-0.683333333333334,56,52,4,4,0
21700600,203090,POR,OKC,Maurice Harkless,79,18.3,18,0.300000000000001,42,43,-1,-3,2
21700600,203468,POR,OKC,CJ McCollum,155,32.5833333333333,33,-0.416666666666664,81,70,11,14,-3
21700600,203894,POR,OKC,Shabazz Napier,156,33.8333333333333,34,-0.166666666666671,85,71,14,11,3
21700600,203943,POR,OKC,Noah Vonleh,11,2.33333333333333,2,0.333333333333333,3,8,-5,-6,1
21700600,203994,POR,OKC,Jusuf Nurkic,111,23.1833333333333,23,0.183333333333334,58,46,12,13,-1
21700600,1626192,POR,OKC,Pat Connaughton,138,29.8333333333333,30,-0.166666666666668,70,71,-1,2,-3
21700600,1627774,POR,OKC,Jake Layman,11,2.33333333333333,2,0.333333333333333,3,8,-5,-6,1
21700600,1628380,POR,OKC,Zach Collins,103,22.2333333333333,22,0.233333333333334,54,52,2,1,1
21700600,2546,OKC,POR,Carmelo Anthony,158,33.8333333333333,34,-0.166666666666671,77,79,-2,-6,4
21700600,101109,OKC,POR,Raymond Felton,80,18.4,18,0.399999999999999,40,41,-1,-1,0
21700600,201566,OKC,POR,Russell Westbrook,164,34.75,35,-0.25,75,88,-13,-13,0
21700600,202331,OKC,POR,Paul George,150,33.0166666666667,33,0.0166666666666657,68,83,-15,-15,0
21700600,202335,OKC,POR,Patrick Patterson,52,10.7,11,-0.300000000000001,21,27,-6,-5,-1
21700600,202713,OKC,POR,Kyle Singler,13,2.81666666666667,3,-0.183333333333334,11,6,5,5,0
21700600,203500,OKC,POR,Steven Adams,147,31.95,32,-0.0499999999999972,65,79,-14,-13,-1
21700600,203518,OKC,POR,Alex Abrines,58,12.1166666666667,12,0.116666666666667,30,31,-1,1,-2
21700600,203924,OKC,POR,Jerami Grant,76,16.3666666666667,17,-0.633333333333333,38,43,-5,-3,-2
21700600,203962,OKC,POR,Josh Huestis,75,15.1,15,0.100000000000001,41,34,7,5,2
21700600,1628390,OKC,POR,Terrance Ferguson,142,30.1166666666667,30,0.116666666666667,64,74,-10,-10,0
21700601,1717,DAL,ORL,Dirk Nowitzki,100,24,24,0,55,56,-1,0,-1
21700601,2734,DAL,ORL,Devin Harris,55,13.35,14,-0.65,23,38,-15,-13,-2
21700601,200826,DAL,ORL,J.J. Barea,111,24.9166666666667,25,-0.0833333333333357,57,67,-10,-10,0
21700601,201177,DAL,ORL,Josh McRoberts,10,2.58333333333333,3,-0.416666666666667,0,3,-3,-3,0
21700601,202083,DAL,ORL,Wesley Matthews,145,33.3666666666667,33,0.366666666666667,87,58,29,27,2
21700601,203084,DAL,ORL,Harrison Barnes,156,36.1166666666667,36,0.116666666666667,93,66,27,27,0
21700601,203939,DAL,ORL,Dwight Powell,94,22.85,23,-0.149999999999999,48,53,-5,-5,0
21700601,1626257,DAL,ORL,Salah Mejri,47,10.05,10,0.0500000000000007,32,20,12,11,1
21700601,1627812,DAL,ORL,Yogi Ferrell,142,33.1666666666667,33,0.166666666666671,88,58,30,29,1
21700601,1627858,DAL,ORL,Kyle Collinsworth,4,1.1,1,0.1,4,3,1,1,0
21700601,1628372,DAL,ORL,Dennis Smith Jr.,136,33.2166666666667,34,-0.783333333333331,77,62,15,16,-1
21700601,1628467,DAL,ORL,Maxi Kleber,20,4.36666666666667,5,-0.633333333333333,6,11,-5,-5,0
21700601,201167,ORL,DAL,Arron Afflalo,65,16.2666666666667,16,0.266666666666666,42,29,13,13,0
21700601,201571,ORL,DAL,D.J. Augustin,99,23.4,23,0.399999999999999,54,45,9,10,-1
21700601,201578,ORL,DAL,Marreese Speights,91,21.45,21,0.449999999999999,54,40,14,15,-1
21700601,202687,ORL,DAL,Bismack Biyombo,94,21.65,22,-0.350000000000001,37,60,-23,-24,1
21700601,202714,ORL,DAL,Shelvin Mack,4,1.1,1,0.1,3,4,-1,-1,0
21700601,203095,ORL,DAL,Evan Fournier,149,35.3833333333333,35,0.383333333333333,66,91,-25,-24,-1
21700601,203613,ORL,DAL,Jonathon Simmons,83,20.2166666666667,20,0.216666666666669,31,59,-28,-28,0
21700601,203901,ORL,DAL,Elfrid Payton,101,23.3166666666667,23,0.316666666666666,42,65,-23,-24,1
21700601,203920,ORL,DAL,Khem Birch,4,1.1,1,0.1,3,4,-1,-1,0
21700601,203932,ORL,DAL,Aaron Gordon,144,32.9,33,-0.100000000000001,71,72,-1,0,-1
21700601,1626209,ORL,DAL,Mario Hezonja,114,26.35,27,-0.649999999999999,51,73,-22,-23,1
21700601,1628411,ORL,DAL,Wes Iwundu,72,15.95,17,-1.05,41,28,13,12,1
21700602,201147,LAL,SAC,Corey Brewer,32,5.78333333333333,6,-0.216666666666667,7,21,-14,-14,0
21700602,201572,LAL,SAC,Brook Lopez,113,22.0666666666667,22,0.0666666666666664,61,45,16,15,1
21700602,203484,LAL,SAC,Kentavious Caldwell-Pope,157,32.5333333333333,33,-0.466666666666669,79,53,26,27,-1
21700602,203898,LAL,SAC,Tyler Ennis,50,9.56666666666667,9,0.566666666666666,10,31,-21,-22,1
21700602,203903,LAL,SAC,Jordan Clarkson,71,14.3166666666667,14,0.316666666666666,19,30,-11,-11,0
21700602,203944,LAL,SAC,Julius Randle,144,29.6166666666667,30,-0.383333333333333,75,40,35,33,2
21700602,1626204,LAL,SAC,Larry Nance Jr.,95,19.5333333333333,19,0.533333333333331,31,39,-8,-7,-1
21700602,1627742,LAL,SAC,Brandon Ingram,119,23.4666666666667,24,-0.533333333333331,49,30,19,19,0
21700602,1628366,LAL,SAC,Lonzo Ball,178,36.2,37,-0.799999999999997,86,53,33,33,0
21700602,1628398,LAL,SAC,Kyle Kuzma,118,23.9833333333333,24,-0.0166666666666657,31,48,-17,-15,-2
21700602,1628404,LAL,SAC,Josh Hart,98,20.9333333333333,21,-0.0666666666666664,47,40,7,7,0
21700602,1713,SAC,LAL,Vince Carter,114,22.25,22,0.25,49,50,-1,-1,0
21700602,2216,SAC,LAL,Zach Randolph,109,22.0333333333333,22,0.0333333333333314,48,61,-13,-15,2
21700602,201585,SAC,LAL,Kosta Koufos,108,21.3166666666667,21,0.316666666666666,36,28,8,8,0
21700602,202066,SAC,LAL,Garrett Temple,150,30.0333333333333,30,0.0333333333333314,59,49,10,10,0
21700602,203992,SAC,LAL,Bogdan Bogdanovic,152,31.6166666666667,32,-0.383333333333333,53,45,8,8,0
21700602,1626161,SAC,LAL,Willie Cauley-Stein,133,27.7666666666667,28,-0.233333333333334,50,73,-23,-23,0
21700602,1627741,SAC,LAL,Buddy Hield,108,22.05,23,-0.950000000000003,38,52,-14,-14,0
21700602,1627746,SAC,LAL,Skal Labissiere,120,24.0833333333333,24,0.0833333333333357,38,36,2,4,-2
21700602,1627781,SAC,LAL,Malachi Richardson,24,4.98333333333333,5,-0.0166666666666666,6,22,-16,-16,0
21700602,1628368,SAC,LAL,De'Aaron Fox,157,31.8666666666667,32,-0.133333333333333,53,79,-26,-26,0
21700603,1717,DAL,CHA,Dirk Nowitzki,93,21.75,22,-0.25,44,52,-8,-3,-5
21700603,2734,DAL,CHA,Devin Harris,90,19.5666666666667,20,-0.433333333333334,43,45,-2,-2,0
21700603,200826,DAL,CHA,J.J. Barea,94,20.1666666666667,21,-0.833333333333336,47,48,-1,1,-2
21700603,202083,DAL,CHA,Wesley Matthews,167,36.6166666666667,37,-0.383333333333333,88,81,7,8,-1
21700603,203084,DAL,CHA,Harrison Barnes,162,35.2666666666667,35,0.266666666666666,85,80,5,6,-1
21700603,203939,DAL,CHA,Dwight Powell,55,12.0666666666667,12,0.0666666666666664,28,32,-4,-2,-2
21700603,1626257,DAL,CHA,Salah Mejri,58,13.75,14,-0.25,42,23,19,19,0
21700603,1627812,DAL,CHA,Yogi Ferrell,161,36.25,36,0.25,89,84,5,6,-1
21700603,1628372,DAL,CHA,Dennis Smith Jr.,147,31.5666666666667,31,0.566666666666663,77,75,2,1,1
21700603,1628467,DAL,CHA,Maxi Kleber,68,13,12,1,27,35,-8,-14,6
21700603,2730,CHA,DAL,Dwight Howard,164,35.3833333333333,35,0.383333333333333,81,86,-5,-6,1
21700603,101107,CHA,DAL,Marvin Williams,135,29.05,29,0.0499999999999972,72,66,6,3,3
21700603,201587,CHA,DAL,Nicolas Batum,150,31.9166666666667,32,-0.0833333333333322,76,78,-2,-5,3
21700603,202689,CHA,DAL,Kemba Walker,171,37.0166666666667,37,0.0166666666666657,85,86,-1,0,-1
21700603,203077,CHA,DAL,Michael Kidd-Gilchrist,121,26.05,26,0.0500000000000007,63,59,4,0,4
21700603,203087,CHA,DAL,Jeremy Lamb,98,21.95,22,-0.0500000000000007,48,55,-7,-4,-3
21700603,203487,CHA,DAL,Michael Carter-Williams,48,10.9833333333333,11,-0.0166666666666657,26,28,-2,-4,2
21700603,203948,CHA,DAL,Johnny O'Bryant III,10,2.01666666666667,2,0.0166666666666666,4,7,-3,-3,0
21700603,1626163,CHA,DAL,Frank Kaminsky,77,17.75,18,-0.25,37,44,-7,-5,-2
21700603,1626203,CHA,DAL,Treveon Graham,74,16.4833333333333,17,-0.516666666666666,36,36,0,0,0
21700603,1628370,CHA,DAL,Malik Monk,47,11.4,12,-0.600000000000001,27,25,2,4,-2
21700604,201609,MIA,IND,Goran Dragic,150,30.8,31,-0.200000000000003,74,67,7,7,0
21700604,201961,MIA,IND,Wayne Ellington,159,32.9833333333333,33,-0.0166666666666657,79,69,10,12,-2
21700604,202355,MIA,IND,Hassan Whiteside,138,28.45,28,0.449999999999999,67,54,13,14,-1
21700604,203482,MIA,IND,Kelly Olynyk,125,26.9666666666667,27,-0.0333333333333314,68,65,3,5,-2
21700604,204020,MIA,IND,Tyler Johnson,150,31.0666666666667,31,0.0666666666666664,77,69,8,9,-1
21700604,1626196,MIA,IND,Josh Richardson,180,38.3166666666667,38,0.316666666666663,94,85,9,7,2
21700604,1627884,MIA,IND,Derrick Jones Jr.,94,20.65,21,-0.350000000000001,45,46,-1,-5,4
21700604,1628389,MIA,IND,Bam Adebayo,144,30.7666666666667,31,-0.233333333333334,66,75,-9,-9,0
21700604,2744,IND,MIA,Al Jefferson,77,17.2833333333333,17,0.283333333333331,42,47,-5,-5,0
21700604,201152,IND,MIA,Thaddeus Young,139,29.05,29,0.0499999999999972,61,69,-8,-9,1
21700604,201954,IND,MIA,Darren Collison,129,27.3,27,0.300000000000001,59,62,-3,-3,0
21700604,202362,IND,MIA,Lance Stephenson,117,24.8833333333333,25,-0.116666666666667,58,63,-5,-7,2
21700604,202709,IND,MIA,Cory Joseph,129,26.85,27,-0.149999999999999,62,72,-10,-8,-2
21700604,202711,IND,MIA,Bojan Bogdanovic,155,32.4833333333333,32,0.483333333333334,68,72,-4,-5,1
21700604,203506,IND,MIA,Victor Oladipo,177,37.25,38,-0.75,81,88,-7,-8,1
21700604,1626202,IND,MIA,Joe Young,26,5.35,5,0.35,16,10,6,7,-1
21700604,1627734,IND,MIA,Domantas Sabonis,151,30.7166666666667,31,-0.283333333333331,64,67,-3,-3,0
21700604,1628388,IND,MIA,TJ Leaf,40,8.83333333333333,8,0.833333333333332,19,20,-1,1,-2
21700605,2207,UTA,WAS,Joe Johnson,161,33.75,33,0.75,83,74,9,8,1
21700605,200757,UTA,WAS,Thabo Sefolosha,37,8.51666666666667,9,-0.483333333333334,11,20,-9,-8,-1
21700605,201937,UTA,WAS,Ricky Rubio,190,41.4333333333333,41,0.433333333333337,91,88,3,2,1
21700605,201973,UTA,WAS,Jonas Jerebko,94,20.1666666666667,20,0.166666666666664,45,35,10,10,0
21700605,202327,UTA,WAS,Ekpe Udoh,154,33.5,34,-0.5,75,79,-4,-4,0
21700605,202692,UTA,WAS,Alec Burks,20,4.8,5,-0.2,8,9,-1,-1,0
21700605,203918,UTA,WAS,Rodney Hood,70,15.5333333333333,15,0.533333333333333,31,26,5,5,0
21700605,204060,UTA,WAS,Joe Ingles,180,38.2166666666667,38,0.216666666666669,88,88,0,1,-1
21700605,1626220,UTA,WAS,Royce O'Neale,68,13.1833333333333,14,-0.816666666666666,33,23,10,10,0
21700605,1628378,UTA,WAS,Donovan Mitchell,141,30.7333333333333,31,-0.266666666666666,70,78,-8,-8,0
21700605,101133,WAS,UTA,Ian Mahinmi,12,2.51666666666667,3,-0.483333333333333,3,8,-5,-5,0
21700605,101162,WAS,UTA,Marcin Gortat,125,27.6,27,0.600000000000001,72,64,8,5,3
21700605,201160,WAS,UTA,Jason Smith,26,4.3,4,0.300000000000001,5,14,-9,-9,0
21700605,201975,WAS,UTA,Jodie Meeks,76,16.75,17,-0.25,28,39,-11,-9,-2
21700605,202322,WAS,UTA,John Wall,200,42.3,42,0.299999999999997,93,96,-3,-3,0
21700605,202693,WAS,UTA,Markieff Morris,121,27.0166666666667,27,0.0166666666666657,62,56,6,5,1
21700605,203078,WAS,UTA,Bradley Beal,182,39.5166666666667,40,-0.483333333333334,92,80,12,12,0
21700605,203107,WAS,UTA,Tomas Satoransky,23,5.66666666666667,6,-0.333333333333334,11,11,0,0,0
21700605,203118,WAS,UTA,Mike Scott,61,12.7666666666667,13,-0.233333333333334,21,30,-9,-7,-2
21700605,203490,WAS,UTA,Otto Porter Jr.,170,36.9666666666667,37,-0.0333333333333314,87,76,11,11,0
21700605,1626162,WAS,UTA,Kelly Oubre Jr.,119,24.4333333333333,25,-0.566666666666666,46,61,-15,-15,0
21700606,202389,BKN,DET,Timofey Mozgov,32,8.01666666666667,8,0.0166666666666657,16,10,6,6,0
21700606,203092,BKN,DET,Tyler Zeller,58,13.0333333333333,13,0.0333333333333332,23,30,-7,-6,-1
21700606,203112,BKN,DET,Quincy Acy,72,15.8666666666667,16,-0.133333333333333,19,47,-28,-28,0
21700606,203459,BKN,DET,Allen Crabbe,117,25.8833333333333,26,-0.116666666666667,52,66,-14,-14,0
21700606,203915,BKN,DET,Spencer Dinwiddie,121,26.0166666666667,26,0.0166666666666657,47,63,-16,-15,-1
21700606,203917,BKN,DET,Nik Stauskas,88,19.7833333333333,20,-0.216666666666669,34,46,-12,-13,1
21700606,203925,BKN,DET,Joe Harris,113,25.9833333333333,25,0.983333333333334,40,54,-14,-13,-1
21700606,1626143,BKN,DET,Jahlil Okafor,73,16.9833333333333,17,-0.0166666666666657,22,36,-14,-14,0
21700606,1626178,BKN,DET,Rondae Hollis-Jefferson,126,27.55,28,-0.450000000000003,54,68,-14,-14,0
21700606,1627747,BKN,DET,Caris LeVert,120,26.4333333333333,27,-0.56666666666667,42,70,-28,-29,1
21700606,1628386,BKN,DET,Jarrett Allen,65,13.9166666666667,15,-1.08333333333333,26,37,-11,-12,1
21700606,1628495,BKN,DET,Milton Doyle,80,18.95,19,-0.0500000000000007,25,43,-18,-18,0
21700606,201229,DET,BKN,Anthony Tolliver,78,17.25,17,0.25,38,22,16,16,0
21700606,202340,DET,BKN,Avery Bradley,117,25.2166666666667,25,0.216666666666669,62,44,18,17,1
21700606,202397,DET,BKN,Ish Smith,110,24.5,24,0.5,62,52,10,10,0
21700606,202699,DET,BKN,Tobias Harris,116,25.8166666666667,26,-0.183333333333334,69,52,17,17,0
21700606,202779,DET,BKN,Dwight Buycks,103,23.1833333333333,24,-0.816666666666666,52,28,24,24,0
21700606,203083,DET,BKN,Andre Drummond,143,30.4,31,-0.600000000000001,72,56,16,16,0
21700606,203493,DET,BKN,Reggie Bullock,123,27.3666666666667,28,-0.633333333333333,74,54,20,22,-2
21700606,203961,DET,BKN,Eric Moreland,38,9.26666666666667,9,0.266666666666666,32,8,24,24,0
21700606,204038,DET,BKN,Langston Galloway,19,4.61666666666667,5,-0.383333333333333,7,6,1,1,0
21700606,1626169,DET,BKN,Stanley Johnson,90,20.3166666666667,20,0.316666666666666,40,26,14,12,2
21700606,1626246,DET,BKN,Boban Marjanovic,32,8.01666666666667,8,0.0166666666666657,10,16,-6,-6,0
21700606,1627740,DET,BKN,Henry Ellenson,19,4.61666666666667,5,-0.383333333333333,7,6,1,1,0
21700606,1628379,DET,BKN,Luke Kennard,77,17.85,18,-0.149999999999999,45,30,15,16,-1
21700607,201577,CHI,NYK,Robin Lopez,174,40.4166666666667,40,0.416666666666671,88,79,9,9,0
21700607,203200,CHI,NYK,Justin Holiday,199,45.35,45,0.349999999999994,98,95,3,3,0
21700607,1626170,CHI,NYK,Jerian Grant,50,11.9333333333333,12,-0.0666666666666664,24,22,2,0,2
21700607,1626171,CHI,NYK,Bobby Portis,86,19.4333333333333,19,0.43333333333333,34,43,-9,-7,-2
21700607,1626245,CHI,NYK,Cristiano Felicio,43,10,10,0,22,19,3,1,2
21700607,1627739,CHI,NYK,Kris Dunn,202,46.0166666666667,46,0.0166666666666657,98,97,1,3,-2
21700607,1627756,CHI,NYK,Denzel Valentine,152,33.45,34,-0.549999999999997,83,68,15,19,-4
21700607,1627835,CHI,NYK,Paul Zipser,19,4.8,5,-0.2,7,12,-5,-7,2
21700607,1628021,CHI,NYK,David Nwaba,138,32.4166666666667,32,0.416666666666664,58,63,-5,-9,4
21700607,1628374,CHI,NYK,Lauri Markkanen,202,46.0166666666667,46,0.0166666666666657,98,97,1,3,-2
21700607,101127,NYK,CHI,Jarrett Jack,174,40.0666666666667,40,0.0666666666666629,80,85,-5,-5,0
21700607,201563,NYK,CHI,Michael Beasley,167,39.35,39,0.349999999999994,74,74,0,0,0
21700607,201584,NYK,CHI,Courtney Lee,196,45.0833333333333,45,0.0833333333333286,91,98,-7,-7,0
21700607,202498,NYK,CHI,Lance Thomas,58,13.3,13,0.300000000000001,31,33,-2,-6,4
21700607,202683,NYK,CHI,Enes Kanter,142,32.1666666666667,32,0.166666666666664,70,79,-9,-8,-1
21700607,203124,NYK,CHI,Kyle O'Quinn,109,25.6833333333333,26,-0.31666666666667,47,43,4,7,-3
21700607,203926,NYK,CHI,Doug McDermott,91,19.65,20,-0.350000000000001,46,43,3,5,-2
21700607,204001,NYK,CHI,Kristaps Porzingis,192,43.75,44,-0.25,89,94,-5,-3,-2
21700607,1627758,NYK,CHI,Ron Baker,57,12.8833333333333,13,-0.116666666666667,28,24,4,4,0
21700607,1628373,NYK,CHI,Frank Ntilikina,79,17.9,18,-0.100000000000001,39,37,2,-2,4
21700608,2772,HOU,POR,Trevor Ariza,198,39.1666666666667,39,0.166666666666664,97,97,0,-1,1
21700608,101108,HOU,POR,Chris Paul,164,32.2,33,-0.799999999999997,82,74,8,4,4
21700608,101123,HOU,POR,Gerald Green,163,32.2,32,0.200000000000003,73,68,5,9,-4
21700608,200782,HOU,POR,PJ Tucker,153,29.6833333333333,29,0.683333333333334,78,72,6,9,-3
21700608,201569,HOU,POR,Eric Gordon,165,33.2666666666667,33,0.266666666666666,91,87,4,5,-1
21700608,201583,HOU,POR,Ryan Anderson,176,34.9,35,-0.100000000000001,86,79,7,8,-1
21700608,203991,HOU,POR,Clint Capela,116,23.45,24,-0.550000000000001,62,51,11,8,3
21700608,204028,HOU,POR,Tarik Black,80,14.4666666666667,15,-0.533333333333333,36,32,4,3,1
21700608,202323,POR,HOU,Evan Turner,162,31.7,32,-0.299999999999997,78,85,-7,-4,-3
21700608,202329,POR,HOU,Al-Farouq Aminu,165,32.45,33,-0.549999999999997,85,88,-3,-2,-1
21700608,202334,POR,HOU,Ed Davis,136,25.85,26,-0.149999999999999,59,62,-3,-2,-1
21700608,203081,POR,HOU,Damian Lillard,158,31.6,32,-0.399999999999999,83,88,-5,-4,-1
21700608,203090,POR,HOU,Maurice Harkless,41,8.06666666666667,8,0.0666666666666664,11,14,-3,-4,1
21700608,203468,POR,HOU,CJ McCollum,185,36.8333333333333,37,-0.166666666666664,92,97,-5,-3,-2
21700608,203894,POR,HOU,Shabazz Napier,123,22.6666666666667,23,-0.333333333333336,50,53,-3,-6,3
21700608,203994,POR,HOU,Jusuf Nurkic,99,20.9333333333333,21,-0.0666666666666664,47,51,-4,-5,1
21700608,1626192,POR,HOU,Pat Connaughton,75,15.2166666666667,15,0.216666666666667,27,32,-5,-8,3
21700608,1628380,POR,HOU,Zach Collins,71,14.0166666666667,14,0.0166666666666657,28,35,-7,-7,0
21700609,2749,NOP,MEM,Jameer Nelson,32,6.91666666666667,7,-0.0833333333333339,8,17,-9,-11,2
21700609,200765,NOP,MEM,Rajon Rondo,142,30.7666666666667,31,-0.233333333333334,71,67,4,7,-3
21700609,201600,NOP,MEM,Omer Asik,31,6.43333333333333,6,0.433333333333334,4,14,-10,-9,-1
21700609,201950,NOP,MEM,Jrue Holiday,176,37.6833333333333,38,-0.316666666666663,89,85,4,6,-2
21700609,201967,NOP,MEM,Dante Cunningham,86,17.8166666666667,18,-0.183333333333334,29,40,-11,-12,1
21700609,202326,NOP,MEM,DeMarcus Cousins,181,40.1333333333333,40,0.133333333333333,90,85,5,4,1
21700609,202732,NOP,MEM,DeAndre Liggins,53,11.5166666666667,11,0.516666666666666,14,27,-13,-18,5
21700609,202734,NOP,MEM,E'Twaun Moore,162,34.5166666666667,35,-0.483333333333334,82,76,6,10,-4
21700609,203121,NOP,MEM,Darius Miller,121,27.15,27,0.149999999999999,60,56,4,4,0
21700609,203546,NOP,MEM,Ian Clark,89,20.4166666666667,20,0.416666666666668,33,39,-6,-6,0
21700609,1627767,NOP,MEM,Cheick Diallo,32,6.65,7,-0.35,30,19,11,10,1
21700609,201148,MEM,NOP,Brandan Wright,50,10.6166666666667,10,0.616666666666667,24,19,5,7,-2
21700609,201188,MEM,NOP,Marc Gasol,157,34.8333333333333,35,-0.166666666666671,73,69,4,2,2
21700609,201596,MEM,NOP,Mario Chalmers,108,24.5166666666667,25,-0.483333333333334,54,51,3,1,2
21700609,201936,MEM,NOP,Tyreke Evans,159,32.75,33,-0.25,83,62,21,23,-2
21700609,203210,MEM,NOP,JaMychal Green,153,33.8333333333333,34,-0.166666666666671,76,74,2,0,2
21700609,203516,MEM,NOP,James Ennis III,118,26.15,26,0.149999999999999,54,66,-12,-14,2
21700609,1626150,MEM,NOP,Andrew Harrison,138,29.85,30,-0.149999999999999,63,68,-5,-6,1
21700609,1626185,MEM,NOP,Jarell Martin,65,13.95,14,-0.0500000000000007,27,25,2,1,1
21700609,1627738,MEM,NOP,Deyonta Davis,12,2.43333333333333,3,-0.566666666666666,6,14,-8,-6,-2
21700609,1627782,MEM,NOP,Wayne Selden,35,8.43333333333333,8,0.433333333333334,10,20,-10,-6,-4
21700609,1628415,MEM,NOP,Dillon Brooks,110,22.6333333333333,23,-0.366666666666667,55,42,13,13,0
21700610,202339,MIL,ORL,Eric Bledsoe,128,27.3666666666667,27,0.366666666666667,77,57,20,19,1
21700610,203089,MIL,ORL,John Henson,138,29.8833333333333,30,-0.116666666666667,75,53,22,22,0
21700610,203114,MIL,ORL,Khris Middleton,167,36,36,0,96,79,17,16,1
21700610,203503,MIL,ORL,Tony Snell,77,16.1,17,-0.900000000000002,35,48,-13,-13,0
21700610,203507,MIL,ORL,Giannis Antetokounmpo,153,33.1833333333333,34,-0.81666666666667,81,57,24,22,2
21700610,203521,MIL,ORL,Matthew Dellavedova,66,15.0166666666667,15,0.0166666666666657,20,26,-6,-6,0
21700610,203930,MIL,ORL,Sean Kilpatrick,13,2.7,3,-0.3,2,12,-10,-10,0
21700610,1627748,MIL,ORL,Thon Maker,83,17.7166666666667,18,-0.283333333333331,35,50,-15,-15,0
21700610,1627763,MIL,ORL,Malcolm Brogdon,172,36.7166666666667,37,-0.283333333333331,92,75,17,20,-3
21700610,1628391,MIL,ORL,D.J. Wilson,13,2.7,3,-0.3,2,12,-10,-10,0
21700610,1628425,MIL,ORL,Sterling Brown,95,20.6166666666667,21,-0.383333333333333,35,46,-11,-10,-1
21700610,201167,ORL,MIL,Arron Afflalo,51,10.7833333333333,11,-0.216666666666667,28,18,10,9,1
21700610,201571,ORL,MIL,D.J. Augustin,81,18.0333333333333,18,0.0333333333333314,28,39,-11,-12,1
21700610,201578,ORL,MIL,Marreese Speights,100,22.3333333333333,23,-0.666666666666668,40,41,-1,1,-2
21700610,202687,ORL,MIL,Bismack Biyombo,121,25.2666666666667,25,0.266666666666666,63,69,-6,-8,2
21700610,202714,ORL,MIL,Shelvin Mack,67,14.3666666666667,15,-0.633333333333333,38,28,10,10,0
21700610,203095,ORL,MIL,Evan Fournier,120,26.65,27,-0.350000000000001,60,64,-4,-3,-1
21700610,203613,ORL,MIL,Jonathon Simmons,103,21.2,21,0.199999999999999,45,60,-15,-14,-1
21700610,203901,ORL,MIL,Elfrid Payton,103,21.2,21,0.199999999999999,45,60,-15,-14,-1
21700610,203932,ORL,MIL,Aaron Gordon,139,29.55,30,-0.449999999999999,58,81,-23,-23,0
21700610,1626209,ORL,MIL,Mario Hezonja,140,30.3333333333333,31,-0.666666666666664,71,60,11,10,1
21700610,1628411,ORL,MIL,Wes Iwundu,80,18.2833333333333,18,0.283333333333331,39,30,9,9,0
21700611,2037,MIN,OKC,Jamal Crawford,82,18.0833333333333,18,0.0833333333333322,31,31,0,-1,1
21700611,201166,MIN,OKC,Aaron Brooks,5,1.1,2,-0.9,2,2,0,0,0
21700611,201952,MIN,OKC,Jeff Teague,122,25.6333333333333,26,-0.366666666666667,64,50,14,14,0
21700611,201959,MIN,OKC,Taj Gibson,132,28.3166666666667,28,0.316666666666666,69,54,15,18,-3
21700611,202332,MIN,OKC,Cole Aldrich,5,1.1,2,-0.9,2,2,0,0,0
21700611,202357,MIN,OKC,Nemanja Bjelica,37,7.81666666666667,9,-1.18333333333333,9,12,-3,-3,0
21700611,202710,MIN,OKC,Jimmy Butler,168,35.9833333333333,36,-0.0166666666666657,85,71,14,13,1
21700611,203476,MIN,OKC,Gorgui Dieng,72,16.6666666666667,16,0.666666666666664,24,28,-4,-2,-2
21700611,203498,MIN,OKC,Shabazz Muhammad,5,1.1,2,-0.9,2,2,0,0,0
21700611,203952,MIN,OKC,Andrew Wiggins,196,42.5333333333333,42,0.533333333333331,97,84,13,14,-1
21700611,1626145,MIN,OKC,Tyus Jones,84,18.7833333333333,19,-0.216666666666669,34,31,3,5,-2
21700611,1626157,MIN,OKC,Karl-Anthony Towns,143,29.7333333333333,30,-0.266666666666666,77,58,19,18,1
21700611,1627875,MIN,OKC,Marcus Georges-Hunt,49,10.65,11,-0.35,19,15,4,4,0
21700611,2546,OKC,MIN,Carmelo Anthony,148,30.95,31,-0.0499999999999972,59,75,-16,-17,1
21700611,101109,OKC,MIN,Raymond Felton,88,18.5,18,0.5,32,39,-7,-8,1
21700611,201566,OKC,MIN,Russell Westbrook,164,35.3166666666667,35,0.316666666666663,71,83,-12,-13,1
21700611,202331,OKC,MIN,Paul George,176,37.4,38,-0.599999999999994,62,86,-24,-25,1
21700611,202335,OKC,MIN,Patrick Patterson,61,13.3833333333333,13,0.383333333333333,22,20,2,0,2
21700611,202713,OKC,MIN,Kyle Singler,7,1.4,2,-0.6,2,2,0,0,0
21700611,203500,OKC,MIN,Steven Adams,154,33.3,34,-0.700000000000003,66,83,-17,-16,-1
21700611,203518,OKC,MIN,Alex Abrines,15,3.78333333333333,4,-0.216666666666667,6,6,0,0,0
21700611,203924,OKC,MIN,Jerami Grant,92,19.5166666666667,19,0.516666666666666,43,36,7,8,-1
21700611,203962,OKC,MIN,Josh Huestis,83,19.5333333333333,19,0.533333333333331,40,33,7,8,-1
21700611,1626177,OKC,MIN,Dakari Johnson,7,1.4,2,-0.6,2,2,0,0,0
21700611,1628390,OKC,MIN,Terrance Ferguson,105,23.0166666666667,23,0.0166666666666657,35,50,-15,-17,2
21700612,101141,ATL,DEN,Ersan Ilyasova,132,29.0333333333333,30,-0.966666666666669,62,65,-3,-1,-2
21700612,201158,ATL,DEN,Marco Belinelli,83,17.0833333333333,17,0.0833333333333357,38,37,1,-3,4
21700612,203101,ATL,DEN,Miles Plumlee,78,16.1333333333333,16,0.133333333333333,37,35,2,2,0
21700612,203145,ATL,DEN,Kent Bazemore,133,27.3333333333333,28,-0.666666666666664,57,58,-1,-2,1
21700612,203471,ATL,DEN,Dennis Schroder,156,32.4333333333333,32,0.43333333333333,76,72,4,4,0
21700612,203473,ATL,DEN,Dewayne Dedmon,84,18.25,18,0.25,49,32,17,16,1
21700612,203488,ATL,DEN,Mike Muscala,75,15.1833333333333,15,0.183333333333334,35,26,9,8,1
21700612,1627098,ATL,DEN,Malcolm Delaney,93,20.3166666666667,20,0.316666666666666,49,31,18,16,2
21700612,1627752,ATL,DEN,Taurean Prince,169,35.15,35,0.149999999999999,88,76,12,13,-1
21700612,1627819,ATL,DEN,Isaiah Taylor,2,0.266666666666667,0,0.266666666666667,,0,,1,
21700612,1628381,ATL,DEN,John Collins,87,16.9333333333333,17,-0.0666666666666664,37,32,5,1,4
21700612,1628416,ATL,DEN,Tyler Dorsey,46,10.45,11,-0.550000000000001,22,11,11,11,0
21700612,1628463,ATL,DEN,Tyler Cavanaugh,2,0.266666666666667,0,0.266666666666667,,0,,1,
21700612,2210,DEN,ATL,Richard Jefferson,2,0.266666666666667,0,0.266666666666667,0,,,-1,
21700612,201163,DEN,ATL,Wilson Chandler,123,26.6333333333333,27,-0.366666666666667,53,55,-2,-2,0
21700612,202702,DEN,ATL,Kenneth Faried,31,7,7,0,14,14,0,2,-2
21700612,203115,DEN,ATL,Will Barton,162,34.2333333333333,34,0.233333333333334,62,80,-18,-16,-2
21700612,203486,DEN,ATL,Mason Plumlee,108,22.2333333333333,23,-0.766666666666666,52,55,-3,-1,-2
21700612,203914,DEN,ATL,Gary Harris,178,37.3833333333333,37,0.383333333333333,78,88,-10,-6,-4
21700612,203999,DEN,ATL,Nikola Jokic,152,31.25,32,-0.75,64,77,-13,-14,1
21700612,1626168,DEN,ATL,Trey Lyles,138,29.5,29,0.5,53,68,-15,-14,-1
21700612,1627736,DEN,ATL,Malik Beasley,12,2.73333333333333,3,-0.266666666666667,2,4,-2,-2,0
21700612,1627750,DEN,ATL,Jamal Murray,182,38.1333333333333,39,-0.866666666666667,81,87,-6,-6,0
21700612,1628470,DEN,ATL,Torrey Craig,52,9.46666666666667,9,0.466666666666667,16,22,-6,-6,0
21700613,2561,GSW,LAC,David West,50,11.3666666666667,11,0.366666666666667,13,23,-10,-12,2
21700613,2585,GSW,LAC,Zaza Pachulia,83,15.85,16,-0.150000000000002,38,48,-10,-10,0
21700613,2733,GSW,LAC,Shaun Livingston,130,24.9666666666667,25,-0.0333333333333314,68,69,-1,-1,0
21700613,2738,GSW,LAC,Andre Iguodala,128,28.45,29,-0.549999999999997,53,72,-19,-17,-2
21700613,201142,GSW,LAC,Kevin Durant,159,31.25,31,0.25,81,85,-4,-4,0
21700613,201156,GSW,LAC,Nick Young,127,25.0833333333333,25,0.0833333333333322,52,65,-13,-13,0
21700613,201580,GSW,LAC,JaVale McGee,31,5.96666666666667,6,-0.0333333333333332,16,17,-1,-1,0
21700613,201956,GSW,LAC,Omri Casspi,117,24.0333333333333,24,0.0333333333333314,59,62,-3,-3,0
21700613,203110,GSW,LAC,Draymond Green,146,29.45,29,0.449999999999999,63,77,-14,-16,2
21700613,1626172,GSW,LAC,Kevon Looney,19,3.9,4,-0.1,5,11,-6,-4,-2
21700613,1627775,GSW,LAC,Patrick McCaw,114,24.1833333333333,25,-0.816666666666666,44,62,-18,-20,2
21700613,1628395,GSW,LAC,Jordan Bell,66,13.9166666666667,14,-0.0833333333333339,38,34,4,6,-2
21700613,101150,LAC,GSW,Lou Williams,179,34.8833333333333,35,-0.116666666666667,98,90,8,8,0
21700613,201599,LAC,GSW,DeAndre Jordan,187,36.4166666666667,37,-0.583333333333329,101,94,7,7,0
21700613,202325,LAC,GSW,Wesley Johnson,85,15.1666666666667,15,0.166666666666666,38,50,-12,-12,0
21700613,203186,LAC,GSW,Willie Reed,47,11.2666666666667,11,0.266666666666666,24,12,12,12,0
21700613,203710,LAC,GSW,C.J. Williams,106,19.6833333333333,20,-0.31666666666667,50,57,-7,-7,0
21700613,1626149,LAC,GSW,Montrezl Harrell,117,25.4166666666667,26,-0.583333333333332,63,41,22,24,-2
21700613,1626155,LAC,GSW,Sam Dekker,91,20.6166666666667,21,-0.383333333333333,54,31,23,21,2
21700613,1627820,LAC,GSW,Tyrone Wallace,162,34.1833333333333,34,0.18333333333333,86,68,18,20,-2
21700613,1628393,LAC,GSW,Jawun Evans,175,35.9,36,-0.0999999999999943,101,82,19,17,2
21700613,1628414,LAC,GSW,Sindarius Thornwell,21,4.88333333333333,5,-0.116666666666667,10,5,5,5,0
21700614,201143,BOS,PHI,Al Horford,163,34.9,35,-0.0999999999999943,95,65,30,32,-2
21700614,202681,BOS,PHI,Kyrie Irving,154,31.3333333333333,31,0.333333333333336,80,57,23,22,1
21700614,202694,BOS,PHI,Marcus Morris,117,24.05,24,0.0500000000000007,54,54,0,1,-1
21700614,203382,BOS,PHI,Aron Baynes,66,14.55,15,-0.449999999999999,35,40,-5,-4,-1
21700614,203499,BOS,PHI,Shane Larkin,47,9.46666666666667,9,0.466666666666667,17,22,-5,-5,0
21700614,203935,BOS,PHI,Marcus Smart,111,22.7666666666667,23,-0.233333333333334,53,48,5,5,0
21700614,1626179,BOS,PHI,Terry Rozier,101,21.55,21,0.550000000000001,46,52,-6,-3,-3
21700614,1627759,BOS,PHI,Jaylen Brown,151,31.6166666666667,32,-0.383333333333333,89,56,33,34,-1
21700614,1627824,BOS,PHI,Guerschon Yabusele,8,1.58333333333333,2,-0.416666666666667,0,7,-7,-7,0
21700614,1627846,BOS,PHI,Abdel Nader,8,1.58333333333333,2,-0.416666666666667,0,7,-7,-7,0
21700614,1628369,BOS,PHI,Jayson Tatum,116,24.2666666666667,24,0.266666666666666,54,62,-8,-8,0
21700614,1628400,BOS,PHI,Semi Ojeleye,8,1.58333333333333,2,-0.416666666666667,0,7,-7,-7,0
21700614,1628464,BOS,PHI,Daniel Theis,100,19.4166666666667,20,-0.583333333333336,42,38,4,2,2
21700614,200755,PHI,BOS,JJ Redick,148,30.3666666666667,30,0.366666666666667,71,76,-5,-6,1
21700614,201573,PHI,BOS,Jerryd Bayless,79,17.25,17,0.25,30,41,-11,-11,0
21700614,202344,PHI,BOS,Trevor Booker,48,10.1666666666667,10,0.166666666666666,22,21,1,1,0
21700614,203496,PHI,BOS,Robert Covington,150,30.3666666666667,30,0.366666666666667,55,79,-24,-25,1
21700614,203954,PHI,BOS,Joel Embiid,149,30.4166666666667,31,-0.583333333333336,70,76,-6,-7,1
21700614,203967,PHI,BOS,Dario Saric,160,33.3333333333333,34,-0.666666666666671,73,82,-9,-10,1
21700614,204456,PHI,BOS,T.J. McConnell,124,26.0666666666667,26,0.0666666666666664,57,57,0,0,0
21700614,1626147,PHI,BOS,Justin Anderson,16,3.63333333333333,4,-0.366666666666667,12,4,8,8,0
21700614,1626158,PHI,BOS,Richaun Holmes,81,17.3166666666667,17,0.316666666666666,33,37,-4,-4,0
21700614,1627732,PHI,BOS,Ben Simmons,140,28.3166666666667,29,-0.683333333333334,55,71,-16,-17,1
21700614,1627789,PHI,BOS,Timothe Luwawu-Cabarrot,55,11.4333333333333,12,-0.566666666666666,37,21,16,16,0
21700615,2544,CLE,TOR,LeBron James,162,32.2833333333333,32,0.283333333333331,63,86,-23,-22,-1
21700615,2548,CLE,TOR,Dwyane Wade,85,17.7,18,-0.299999999999997,37,56,-19,-19,0
21700615,2594,CLE,TOR,Kyle Korver,91,18.4666666666667,19,-0.533333333333331,44,61,-17,-17,0
21700615,2747,CLE,TOR,JR Smith,135,27.0166666666667,27,0.0166666666666657,52,67,-15,-14,-1
21700615,101112,CLE,TOR,Channing Frye,51,9.98333333333333,10,-0.0166666666666657,27,32,-5,-5,0
21700615,101181,CLE,TOR,Jose Calderon,31,6.26666666666667,7,-0.733333333333333,19,18,1,1,0
21700615,201145,CLE,TOR,Jeff Green,110,22.05,22,0.0499999999999972,46,68,-22,-22,0
21700615,201567,CLE,TOR,Kevin Love,114,22.9666666666667,23,-0.0333333333333314,46,57,-11,-10,-1
21700615,202684,CLE,TOR,Tristan Thompson,116,22.8833333333333,23,-0.116666666666667,45,61,-16,-18,2
21700615,202738,CLE,TOR,Isaiah Thomas,127,24.8,25,-0.199999999999999,44,65,-21,-20,-1
21700615,203109,CLE,TOR,Jae Crowder,90,18.5166666666667,19,-0.483333333333334,34,54,-20,-17,-3
21700615,1626224,CLE,TOR,Cedi Osman,73,15.4,16,-0.6,33,40,-7,-7,0
21700615,101139,TOR,CLE,CJ Miles,97,18.8166666666667,19,-0.183333333333337,47,39,8,8,0
21700615,201942,TOR,CLE,DeMar DeRozan,146,29,29,0,77,61,16,15,1
21700615,202685,TOR,CLE,Jonas Valanciunas,91,18.6833333333333,19,-0.316666666666666,47,38,9,7,2
21700615,203485,TOR,CLE,Lorenzo Brown,91,18.6666666666667,19,-0.333333333333336,56,37,19,19,0
21700615,203512,TOR,CLE,Lucas Nogueira,20,3.81666666666667,4,-0.183333333333334,10,12,-2,-2,0
21700615,1626153,TOR,CLE,Delon Wright,94,18.1166666666667,18,0.116666666666667,44,38,6,5,1
21700615,1626181,TOR,CLE,Norman Powell,130,26.6833333333333,27,-0.31666666666667,80,57,23,23,0
21700615,1626259,TOR,CLE,Malcolm Miller,28,5.76666666666667,6,-0.233333333333333,18,17,1,1,0
21700615,1627751,TOR,CLE,Jakob Poeltl,126,25.1666666666667,26,-0.833333333333336,76,48,28,29,-1
21700615,1627783,TOR,CLE,Pascal Siakam,112,23.0333333333333,24,-0.966666666666669,73,48,25,24,1
21700615,1627832,TOR,CLE,Fred VanVleet,115,23.7833333333333,24,-0.216666666666669,71,43,28,28,0
21700615,1628384,TOR,CLE,OG Anunoby,135,26.8,27,-0.199999999999999,66,52,14,13,1
21700616,101150,LAC,SAC,Lou Williams,168,34.2333333333333,35,-0.766666666666666,82,82,0,0,0
21700616,201599,LAC,SAC,DeAndre Jordan,46,10.8666666666667,11,-0.133333333333333,27,15,12,13,-1
21700616,201933,LAC,SAC,Blake Griffin,160,32.8666666666667,33,-0.133333333333333,75,78,-3,-3,0
21700616,202325,LAC,SAC,Wesley Johnson,122,24.65,25,-0.350000000000001,65,54,11,12,-1
21700616,203186,LAC,SAC,Willie Reed,49,9.91666666666667,10,-0.0833333333333339,24,29,-5,-5,0
21700616,1626149,LAC,SAC,Montrezl Harrell,138,27.1833333333333,27,0.183333333333334,70,71,-1,-2,1
21700616,1626155,LAC,SAC,Sam Dekker,73,15.1,15,0.0999999999999979,46,37,9,9,0
21700616,1627820,LAC,SAC,Tyrone Wallace,176,37.05,37,0.0499999999999972,95,94,1,0,1
21700616,1628393,LAC,SAC,Jawun Evans,109,22.7666666666667,22,0.766666666666666,58,42,16,14,2
21700616,1628462,LAC,SAC,Milos Teodosic,124,25.2,26,-0.799999999999997,63,73,-10,-8,-2
21700616,2216,SAC,LAC,Zach Randolph,126,26.3833333333333,27,-0.616666666666667,58,67,-9,-9,0
21700616,201585,SAC,LAC,Kosta Koufos,118,25.3333333333333,25,0.333333333333336,56,60,-4,-4,0
21700616,201588,SAC,LAC,George Hill,161,34.6333333333333,35,-0.366666666666667,84,77,7,7,0
21700616,202066,SAC,LAC,Garrett Temple,78,16.85,17,-0.149999999999999,33,41,-8,-8,0
21700616,203992,SAC,LAC,Bogdan Bogdanovic,156,31.1333333333333,31,0.133333333333333,82,80,2,2,0
21700616,1626161,SAC,LAC,Willie Cauley-Stein,115,22.7333333333333,23,-0.266666666666666,59,61,-2,-2,0
21700616,1627741,SAC,LAC,Buddy Hield,161,31.7,32,-0.300000000000001,80,85,-5,-4,-1
21700616,1627746,SAC,LAC,Skal Labissiere,104,21.35,21,0.350000000000001,57,52,5,5,0
21700616,1628368,SAC,LAC,De'Aaron Fox,146,29.7166666666667,29,0.716666666666669,66,82,-16,-17,1
21700617,201572,LAL,SAS,Brook Lopez,76,17.8666666666667,18,-0.133333333333333,25,39,-14,-14,0
21700617,203484,LAL,SAS,Kentavious Caldwell-Pope,138,31.9833333333333,32,-0.0166666666666657,56,57,-1,-3,2
21700617,203898,LAL,SAS,Tyler Ennis,55,12.1666666666667,12,0.166666666666668,20,25,-5,-5,0
21700617,203903,LAL,SAS,Jordan Clarkson,69,14.3833333333333,14,0.383333333333333,32,23,9,11,-2
21700617,203944,LAL,SAS,Julius Randle,73,16.8,18,-1.2,23,37,-14,-17,3
21700617,1626204,LAL,SAS,Larry Nance Jr.,141,30.9166666666667,30,0.916666666666668,70,44,26,29,-3
21700617,1627742,LAL,SAS,Brandon Ingram,161,36.6,37,-0.399999999999999,69,60,9,9,0
21700617,1628366,LAL,SAS,Lonzo Ball,159,35.55,36,-0.450000000000003,73,56,17,17,0
21700617,1628398,LAL,SAS,Kyle Kuzma,138,29.85,30,-0.149999999999999,68,42,26,26,0
21700617,1628404,LAL,SAS,Josh Hart,60,12.4666666666667,13,-0.533333333333333,29,22,7,7,0
21700617,1938,SAS,LAL,Manu Ginobili,101,21.0333333333333,22,-0.966666666666669,30,50,-20,-20,0
21700617,2200,SAS,LAL,Pau Gasol,160,36.55,37,-0.450000000000003,56,74,-18,-18,0
21700617,200746,SAS,LAL,LaMarcus Aldridge,156,35.3333333333333,35,0.333333333333336,66,62,4,4,0
21700617,201988,SAS,LAL,Patty Mills,93,19.7166666666667,20,-0.283333333333331,32,45,-13,-13,0
21700617,202722,SAS,LAL,Davis Bertans,81,16.5833333333333,17,-0.416666666666664,22,38,-16,-16,0
21700617,203464,SAS,LAL,Brandon Paul,39,7.61666666666667,8,-0.383333333333334,12,11,1,1,0
21700617,203937,SAS,LAL,Kyle Anderson,124,28.8,29,-0.199999999999999,50,53,-3,-3,0
21700617,1627749,SAS,LAL,Dejounte Murray,112,26.2,26,0.199999999999999,49,41,8,8,0
21700617,1627854,SAS,LAL,Bryn Forbes,164,37.1,37,0.100000000000001,62,75,-13,-13,0
21700617,1627856,SAS,LAL,Matt Costello,11,2.33333333333333,3,-0.666666666666667,6,3,3,3,0
21700617,1628401,SAS,LAL,Derrick White,29,7.31666666666667,7,0.316666666666666,20,13,7,7,0
21700618,2207,UTA,CHA,Joe Johnson,116,25.3833333333333,26,-0.616666666666667,45,46,-1,-6,5
21700618,200757,UTA,CHA,Thabo Sefolosha,73,16.7,17,-0.300000000000001,35,39,-4,-2,-2
21700618,201937,UTA,CHA,Ricky Rubio,119,28.3666666666667,28,0.366666666666667,55,53,2,-2,4
21700618,201973,UTA,CHA,Jonas Jerebko,21,5,5,0,8,11,-3,-1,-2
21700618,202324,UTA,CHA,Derrick Favors,133,28.7166666666667,29,-0.283333333333335,51,67,-16,-19,3
21700618,202327,UTA,CHA,Ekpe Udoh,81,18.9,19,-0.100000000000001,37,33,4,8,-4
21700618,203918,UTA,CHA,Rodney Hood,118,25.8,26,-0.199999999999999,51,43,8,7,1
21700618,204060,UTA,CHA,Joe Ingles,156,34.1166666666667,35,-0.883333333333333,59,80,-21,-21,0
21700618,1626220,UTA,CHA,Royce O'Neale,79,18.5333333333333,19,-0.466666666666669,34,35,-1,-1,0
21700618,1628378,UTA,CHA,Donovan Mitchell,169,36.15,37,-0.850000000000001,65,83,-18,-18,0
21700618,2730,CHA,UTA,Dwight Howard,155,32.4666666666667,33,-0.533333333333331,70,59,11,14,-3
21700618,101107,CHA,UTA,Marvin Williams,120,26.1166666666667,27,-0.883333333333333,56,44,12,13,-1
21700618,201587,CHA,UTA,Nicolas Batum,166,35.9,36,-0.100000000000001,78,69,9,12,-3
21700618,202689,CHA,UTA,Kemba Walker,172,36.6166666666667,37,-0.38333333333334,84,66,18,17,1
21700618,203077,CHA,UTA,Michael Kidd-Gilchrist,124,26.1166666666667,27,-0.883333333333333,60,45,15,14,1
21700618,203087,CHA,UTA,Jeremy Lamb,89,21.4166666666667,22,-0.583333333333336,38,43,-5,-3,-2
21700618,203487,CHA,UTA,Michael Carter-Williams,51,13.05,13,0.0500000000000007,21,24,-3,-3,0
21700618,203948,CHA,UTA,Johnny O'Bryant III,26,7.18333333333333,7,0.183333333333334,10,16,-6,-6,0
21700618,1626163,CHA,UTA,Frank Kaminsky,115,26.7666666666667,27,-0.233333333333334,53,52,1,-1,2
21700618,1626203,CHA,UTA,Treveon Graham,47,12.0333333333333,12,0.0333333333333314,20,22,-2,-2,0
21700619,2544,CLE,IND,LeBron James,178,40.1,40,0.100000000000001,79,85,-6,-6,0
21700619,2594,CLE,IND,Kyle Korver,85,18.1,18,0.100000000000001,36,43,-7,-5,-2
21700619,2747,CLE,IND,JR Smith,134,30.8833333333333,31,-0.116666666666667,63,59,4,4,0
21700619,101181,CLE,IND,Jose Calderon,145,33.1833333333333,33,0.183333333333337,68,60,8,8,0
21700619,201145,CLE,IND,Jeff Green,96,19.7,20,-0.300000000000001,37,44,-7,-9,2
21700619,201567,CLE,IND,Kevin Love,157,35.9666666666667,36,-0.0333333333333314,76,67,9,9,0
21700619,202684,CLE,IND,Tristan Thompson,91,20.95,21,-0.0500000000000007,37,43,-6,-6,0
21700619,203109,CLE,IND,Jae Crowder,106,23.9166666666667,24,-0.0833333333333322,47,45,2,2,0
21700619,1626224,CLE,IND,Cedi Osman,83,17.2,17,0.200000000000003,32,39,-7,-7,0
21700619,2744,IND,CLE,Al Jefferson,72,15.4166666666667,15,0.416666666666666,31,33,-2,-3,1
21700619,201152,IND,CLE,Thaddeus Young,170,39.2333333333333,39,0.233333333333334,75,77,-2,-2,0
21700619,201954,IND,CLE,Darren Collison,151,35.0166666666667,35,0.0166666666666657,72,64,8,8,0
21700619,202362,IND,CLE,Lance Stephenson,140,30.3,30,0.300000000000001,67,55,12,14,-2
21700619,202709,IND,CLE,Cory Joseph,83,17.0833333333333,17,0.0833333333333322,34,38,-4,-6,2
21700619,202711,IND,CLE,Bojan Bogdanovic,129,28.4333333333333,29,-0.566666666666666,59,62,-3,-1,-2
21700619,203506,IND,CLE,Victor Oladipo,177,40.1666666666667,40,0.166666666666671,78,75,3,3,0
21700619,1627734,IND,CLE,Domantas Sabonis,121,28.0166666666667,28,0.0166666666666657,55,55,0,-1,1
21700619,1628388,IND,CLE,TJ Leaf,32,6.33333333333333,6,0.333333333333334,14,16,-2,-2,0
21700620,201167,ORL,WAS,Arron Afflalo,32,6.73333333333333,7,-0.266666666666667,16,20,-4,-5,1
21700620,201571,ORL,WAS,D.J. Augustin,44,9.55,10,-0.449999999999999,20,24,-4,-4,0
21700620,201578,ORL,WAS,Marreese Speights,67,13.2166666666667,13,0.216666666666665,30,35,-5,-7,2
21700620,202687,ORL,WAS,Bismack Biyombo,156,33.0166666666667,33,0.0166666666666657,84,88,-4,-2,-2
21700620,203095,ORL,WAS,Evan Fournier,155,31.45,32,-0.550000000000001,80,83,-3,0,-3
21700620,203613,ORL,WAS,Jonathon Simmons,150,32.6333333333333,33,-0.366666666666667,78,75,3,7,-4
21700620,203901,ORL,WAS,Elfrid Payton,187,38.3333333333333,38,0.333333333333329,99,101,-2,-2,0
21700620,203932,ORL,WAS,Aaron Gordon,188,38.4833333333333,38,0.483333333333334,99,101,-2,-2,0
21700620,1626209,ORL,WAS,Mario Hezonja,113,23.1833333333333,23,0.183333333333334,57,64,-7,-11,4
21700620,1628411,ORL,WAS,Wes Iwundu,63,12.8166666666667,13,-0.183333333333334,32,34,-2,-4,2
21700620,101133,WAS,ORL,Ian Mahinmi,97,20.55,21,-0.450000000000003,57,50,7,7,0
21700620,101162,WAS,ORL,Marcin Gortat,131,27.2,27,0.199999999999999,67,69,-2,-2,0
21700620,202322,WAS,ORL,John Wall,177,36.1666666666667,36,0.166666666666671,94,95,-1,-3,2
21700620,202693,WAS,ORL,Markieff Morris,111,22.5833333333333,23,-0.416666666666664,59,63,-4,-4,0
21700620,203078,WAS,ORL,Bradley Beal,175,36.0666666666667,36,0.0666666666666629,101,88,13,9,4
21700620,203107,WAS,ORL,Tomas Satoransky,60,12.1,12,0.0999999999999996,25,31,-6,-2,-4
21700620,203118,WAS,ORL,Mike Scott,78,16.75,17,-0.25,45,41,4,4,0
21700620,203490,WAS,ORL,Otto Porter Jr.,187,39.1166666666667,39,0.116666666666667,104,89,15,19,-4
21700620,1626162,WAS,ORL,Kelly Oubre Jr.,139,28.8833333333333,29,-0.116666666666667,73,69,4,2,2
21700621,101141,ATL,BKN,Ersan Ilyasova,131,26.9666666666667,27,-0.033333333333335,61,61,0,-2,2
21700621,203101,ATL,BKN,Miles Plumlee,88,18.2166666666667,19,-0.783333333333335,33,49,-16,-14,-2
21700621,203145,ATL,BKN,Kent Bazemore,155,30.9833333333333,32,-1.01666666666667,68,76,-8,-7,-1
21700621,203471,ATL,BKN,Dennis Schroder,151,31.5166666666667,32,-0.483333333333334,69,71,-2,0,-2
21700621,203473,ATL,BKN,Dewayne Dedmon,105,23.2166666666667,23,0.216666666666669,60,38,22,18,4
21700621,203488,ATL,BKN,Mike Muscala,60,11.5666666666667,12,-0.433333333333334,20,39,-19,-13,-6
21700621,1627098,ATL,BKN,Malcolm Delaney,128,27.4333333333333,27,0.433333333333334,65,66,-1,-2,1
21700621,1627752,ATL,BKN,Taurean Prince,134,28.0333333333333,27,1.03333333333333,54,60,-6,-8,2
21700621,1627819,ATL,BKN,Isaiah Taylor,56,12.7,13,-0.300000000000001,29,22,7,5,2
21700621,1628381,ATL,BKN,John Collins,67,14.8833333333333,15,-0.116666666666667,34,29,5,5,0
21700621,1628416,ATL,BKN,Tyler Dorsey,65,14.2333333333333,14,0.233333333333334,32,39,-7,-7,0
21700621,201960,BKN,ATL,DeMarre Carroll,135,27.8333333333333,28,-0.166666666666668,64,56,8,6,2
21700621,203092,BKN,ATL,Tyler Zeller,60,12.1833333333333,13,-0.816666666666666,29,20,9,8,1
21700621,203112,BKN,ATL,Quincy Acy,126,27.1,27,0.100000000000001,66,60,6,7,-1
21700621,203459,BKN,ATL,Allen Crabbe,163,32.9333333333333,33,-0.06666666666667,85,73,12,14,-2
21700621,203915,BKN,ATL,Spencer Dinwiddie,143,29.4666666666667,30,-0.533333333333331,68,67,1,3,-2
21700621,203917,BKN,ATL,Nik Stauskas,42,9.31666666666667,9,0.316666666666666,16,23,-7,-7,0
21700621,203925,BKN,ATL,Joe Harris,104,23,23,0,49,53,-4,-4,0
21700621,1626143,BKN,ATL,Jahlil Okafor,57,12.1833333333333,12,0.183333333333334,32,29,3,3,0
21700621,1626178,BKN,ATL,Rondae Hollis-Jefferson,143,28.95,29,-0.0500000000000007,70,63,7,6,1
21700621,1627747,BKN,ATL,Caris LeVert,100,21.4,21,0.399999999999999,50,43,7,5,2
21700621,1628386,BKN,ATL,Jarrett Allen,67,15.3833333333333,15,0.383333333333333,21,38,-17,-16,-1
21700622,2561,GSW,MIL,David West,67,16.6333333333333,17,-0.366666666666667,29,24,5,7,-2
21700622,2585,GSW,MIL,Zaza Pachulia,63,14.2166666666667,14,0.216666666666667,27,35,-8,-8,0
21700622,2733,GSW,MIL,Shaun Livingston,56,14.25,15,-0.75,25,22,3,1,2
21700622,2738,GSW,MIL,Andre Iguodala,115,26.9833333333333,27,-0.0166666666666657,71,50,21,21,0
21700622,201142,GSW,MIL,Kevin Durant,157,35.7166666666667,36,-0.283333333333331,82,72,10,12,-2
21700622,201156,GSW,MIL,Nick Young,58,13.65,13,0.65,33,38,-5,-7,2
21700622,202691,GSW,MIL,Klay Thompson,150,34.75,35,-0.25,77,59,18,20,-2
21700622,203110,GSW,MIL,Draymond Green,159,37.3666666666667,37,0.366666666666667,88,79,9,11,-2
21700622,1626172,GSW,MIL,Kevon Looney,100,22.8333333333333,23,-0.166666666666664,60,42,18,16,2
21700622,1627775,GSW,MIL,Patrick McCaw,100,22.5166666666667,23,-0.483333333333334,48,49,-1,-3,2
21700622,202339,MIL,GSW,Eric Bledsoe,138,31.3,32,-0.700000000000003,64,73,-9,-9,0
21700622,203089,MIL,GSW,John Henson,110,25.2833333333333,26,-0.716666666666669,55,59,-4,-3,-1
21700622,203114,MIL,GSW,Khris Middleton,159,36.2333333333333,37,-0.766666666666666,72,78,-6,-6,0
21700622,203503,MIL,GSW,Tony Snell,95,22.4666666666667,22,0.466666666666665,46,51,-5,-5,0
21700622,203507,MIL,GSW,Giannis Antetokounmpo,151,35.7666666666667,36,-0.233333333333334,70,87,-17,-15,-2
21700622,203521,MIL,GSW,Matthew Dellavedova,74,17.9166666666667,18,-0.0833333333333322,30,37,-7,-7,0
21700622,1627748,MIL,GSW,Thon Maker,88,21.0666666666667,21,0.0666666666666664,39,47,-8,-9,1
21700622,1627763,MIL,GSW,Malcolm Brogdon,173,39.7166666666667,40,-0.283333333333331,74,91,-17,-17,0
21700622,1628425,MIL,GSW,Sterling Brown,37,9.16666666666667,9,0.166666666666668,20,17,3,1,2
21700623,2037,MIN,NYK,Jamal Crawford,70,16.65,17,-0.350000000000001,47,36,11,11,0
21700623,201952,MIN,NYK,Jeff Teague,157,32.5666666666667,33,-0.43333333333333,72,75,-3,-3,0
21700623,201959,MIN,NYK,Taj Gibson,166,34.1666666666667,34,0.166666666666671,76,76,0,0,0
21700623,202357,MIN,NYK,Nemanja Bjelica,44,11.1666666666667,11,0.166666666666668,35,26,9,9,0
21700623,202710,MIN,NYK,Jimmy Butler,164,33.8166666666667,34,-0.183333333333337,78,78,0,0,0
21700623,203476,MIN,NYK,Gorgui Dieng,89,20.6833333333333,21,-0.316666666666666,57,46,11,11,0
21700623,203952,MIN,NYK,Andrew Wiggins,172,35.2666666666667,35,0.266666666666666,80,80,0,0,0
21700623,1626145,MIN,NYK,Tyus Jones,65,15.3333333333333,15,0.333333333333334,46,33,13,13,0
21700623,1626157,MIN,NYK,Karl-Anthony Towns,183,39.85,40,-0.150000000000006,99,90,9,9,0
21700623,101127,NYK,MIN,Jarrett Jack,160,33.4,33,0.399999999999999,78,75,3,3,0
21700623,201563,NYK,MIN,Michael Beasley,65,15.7,16,-0.300000000000001,39,45,-6,-4,-2
21700623,201584,NYK,MIN,Courtney Lee,150,32.5333333333333,32,0.533333333333331,68,84,-16,-17,1
21700623,202498,NYK,MIN,Lance Thomas,139,29.2166666666667,29,0.216666666666669,67,69,-2,-3,1
21700623,202683,NYK,MIN,Enes Kanter,134,27.4333333333333,27,0.433333333333334,58,67,-9,-10,1
21700623,203124,NYK,MIN,Kyle O'Quinn,88,20.4666666666667,21,-0.533333333333331,50,51,-1,0,-1
21700623,203501,NYK,MIN,Tim Hardaway Jr.,119,24.6166666666667,25,-0.383333333333333,62,52,10,11,-1
21700623,203926,NYK,MIN,Doug McDermott,23,5.75,6,-0.25,16,18,-2,-2,0
21700623,204001,NYK,MIN,Kristaps Porzingis,170,35.8833333333333,36,-0.11666666666666,72,86,-14,-15,1
21700623,1628373,NYK,MIN,Frank Ntilikina,62,14.5,15,-0.5,30,43,-13,-13,0
21700624,2749,NOP,POR,Jameer Nelson,53,11.65,12,-0.35,26,19,7,7,0
21700624,200765,NOP,POR,Rajon Rondo,103,20.2166666666667,20,0.216666666666669,39,62,-23,-23,0
21700624,201950,NOP,POR,Jrue Holiday,182,36.25,37,-0.75,93,94,-1,-1,0
21700624,201967,NOP,POR,Dante Cunningham,86,18.3166666666667,18,0.316666666666666,47,39,8,7,1
21700624,202326,NOP,POR,DeMarcus Cousins,171,36.4166666666667,36,0.416666666666671,85,76,9,12,-3
21700624,202734,NOP,POR,E'Twaun Moore,127,24.6166666666667,25,-0.383333333333333,57,72,-15,-15,0
21700624,203076,NOP,POR,Anthony Davis,206,40.5166666666667,41,-0.483333333333334,100,105,-5,-5,0
21700624,203121,NOP,POR,Darius Miller,122,25.6833333333333,26,-0.31666666666667,76,47,29,27,2
21700624,203546,NOP,POR,Ian Clark,125,25.8333333333333,26,-0.166666666666668,72,51,21,21,0
21700624,202329,POR,NOP,Al-Farouq Aminu,176,34.6,35,-0.399999999999999,93,78,15,16,-1
21700624,202334,POR,NOP,Ed Davis,82,17.1166666666667,18,-0.883333333333333,28,46,-18,-18,0
21700624,203081,POR,NOP,Damian Lillard,190,38.0833333333333,38,0.0833333333333357,98,92,6,5,1
21700624,203090,POR,NOP,Maurice Harkless,91,19.6166666666667,20,-0.383333333333333,35,53,-18,-16,-2
21700624,203468,POR,NOP,CJ McCollum,174,35.3666666666667,36,-0.633333333333333,81,82,-1,-3,2
21700624,203894,POR,NOP,Shabazz Napier,177,35.6333333333333,36,-0.366666666666667,93,88,5,3,2
21700624,203994,POR,NOP,Jusuf Nurkic,153,31.6,31,0.599999999999998,79,73,6,7,-1
21700624,1626192,POR,NOP,Pat Connaughton,79,15.4333333333333,16,-0.566666666666666,40,46,-6,-5,-1
21700624,1628380,POR,NOP,Zach Collins,53,12.05,12,0.0500000000000007,18,37,-19,-19,0
21700625,2210,DEN,MEM,Richard Jefferson,82,18.7333333333333,19,-0.266666666666666,39,24,15,16,-1
21700625,201163,DEN,MEM,Wilson Chandler,119,28.9833333333333,29,-0.0166666666666657,47,54,-7,-7,0
21700625,202702,DEN,MEM,Kenneth Faried,65,14.85,15,-0.15,31,20,11,16,-5
21700625,203115,DEN,MEM,Will Barton,170,39.5833333333333,40,-0.416666666666671,74,64,10,9,1
21700625,203486,DEN,MEM,Mason Plumlee,100,24,24,0,39,49,-10,-12,2
21700625,203999,DEN,MEM,Nikola Jokic,114,27.55,28,-0.449999999999999,55,44,11,8,3
21700625,1626168,DEN,MEM,Trey Lyles,119,28.5833333333333,29,-0.416666666666664,47,43,4,6,-2
21700625,1627736,DEN,MEM,Malik Beasley,104,24.35,24,0.350000000000001,47,31,16,19,-3
21700625,1627750,DEN,MEM,Jamal Murray,132,31.95,32,-0.0500000000000007,51,61,-10,-10,0
21700625,201188,MEM,DEN,Marc Gasol,151,35.9666666666667,36,-0.0333333333333314,63,63,0,4,-4
21700625,201596,MEM,DEN,Mario Chalmers,82,20,20,0,27,35,-8,-11,3
21700625,201936,MEM,DEN,Tyreke Evans,136,30.8666666666667,32,-1.13333333333333,45,55,-10,-13,3
21700625,203210,MEM,DEN,JaMychal Green,91,20.75,21,-0.25,27,37,-10,-10,0
21700625,203463,MEM,DEN,Ben McLemore,21,4.65,5,-0.35,6,8,-2,-2,0
21700625,203516,MEM,DEN,James Ennis III,112,26.65,27,-0.350000000000001,41,57,-16,-17,1
21700625,1626150,MEM,DEN,Andrew Harrison,120,29.35,29,0.350000000000001,54,50,4,6,-2
21700625,1626185,MEM,DEN,Jarell Martin,79,19.8333333333333,20,-0.166666666666668,35,29,6,3,3
21700625,1627738,MEM,DEN,Deyonta Davis,51,12.3,12,0.300000000000001,19,32,-13,-14,1
21700625,1627782,MEM,DEN,Wayne Selden,13,2.91666666666667,3,-0.083333333333333,7,4,3,3,0
21700625,1628415,MEM,DEN,Dillon Brooks,149,35.3,36,-0.700000000000003,66,60,6,6,0
21700626,2772,HOU,PHX,Trevor Ariza,177,38,38,0,88,80,8,8,0
21700626,101108,HOU,PHX,Chris Paul,122,27.2666666666667,27,0.266666666666666,68,59,9,8,1
21700626,101123,HOU,PHX,Gerald Green,159,33.45,34,-0.549999999999997,76,64,12,14,-2
21700626,200782,HOU,PHX,PJ Tucker,141,30.4,31,-0.600000000000001,73,53,20,22,-2
21700626,201569,HOU,PHX,Eric Gordon,135,28.6,29,-0.399999999999999,70,54,16,15,1
21700626,201583,HOU,PHX,Ryan Anderson,181,39.0666666666667,40,-0.933333333333337,84,80,4,6,-2
21700626,203991,HOU,PHX,Clint Capela,168,35.4,36,-0.600000000000001,95,69,26,22,4
21700626,1627362,HOU,PHX,Briante Weber,27,6.06666666666667,6,0.0666666666666664,6,16,-10,-10,0
21700626,2199,PHX,HOU,Tyson Chandler,114,23.6166666666667,24,-0.383333333333333,54,56,-2,-1,-1
21700626,201162,PHX,HOU,Jared Dudley,31,6.55,7,-0.45,6,18,-12,-13,1
21700626,203458,PHX,HOU,Alex Len,52,12.3833333333333,12,0.383333333333333,15,31,-16,-17,1
21700626,203584,PHX,HOU,Troy Daniels,124,26.6666666666667,27,-0.333333333333336,49,61,-12,-14,2
21700626,203933,PHX,HOU,T.J. Warren,170,36.7333333333333,37,-0.266666666666666,73,87,-14,-16,2
21700626,1626164,PHX,HOU,Devin Booker,180,37.1833333333333,37,0.18333333333333,76,94,-18,-18,0
21700626,1627733,PHX,HOU,Dragan Bender,147,31.7,32,-0.299999999999997,70,72,-2,-1,-1
21700626,1627755,PHX,HOU,Tyler Ulis,140,31.45,32,-0.549999999999997,65,69,-4,-2,-2
21700626,1627863,PHX,HOU,Danuel House Jr.,85,17.3,17,0.300000000000001,32,39,-7,-7,0
21700626,1628409,PHX,HOU,Alec Peters,67,14.6666666666667,15,-0.333333333333332,35,33,2,4,-2
21700627,1717,DAL,LAL,Dirk Nowitzki,109,23.6833333333333,24,-0.31666666666667,54,48,6,8,-2
21700627,2734,DAL,LAL,Devin Harris,84,19.1166666666667,19,0.116666666666667,39,34,5,5,0
21700627,200826,DAL,LAL,J.J. Barea,86,18.9666666666667,19,-0.0333333333333314,35,30,5,4,1
21700627,202083,DAL,LAL,Wesley Matthews,166,38.85,39,-0.149999999999999,73,84,-11,-11,0
21700627,203084,DAL,LAL,Harrison Barnes,163,38.35,39,-0.649999999999999,71,84,-13,-13,0
21700627,203939,DAL,LAL,Dwight Powell,135,30.2333333333333,30,0.233333333333334,56,64,-8,-8,0
21700627,1626257,DAL,LAL,Salah Mejri,56,12.9666666666667,13,-0.0333333333333332,21,17,4,2,2
21700627,1627812,DAL,LAL,Yogi Ferrell,189,43.05,43,0.0499999999999972,80,90,-10,-8,-2
21700627,1628372,DAL,LAL,Dennis Smith Jr.,165,38.5833333333333,39,-0.416666666666664,76,82,-6,-7,1
21700627,1628467,DAL,LAL,Maxi Kleber,2,0.866666666666667,1,-0.133333333333333,0,2,-2,-2,0
21700627,201147,LAL,DAL,Corey Brewer,41,9,9,0,11,17,-6,-6,0
21700627,201572,LAL,DAL,Brook Lopez,77,17.45,17,0.450000000000003,38,36,2,2,0
21700627,203484,LAL,DAL,Kentavious Caldwell-Pope,171,40.7333333333333,41,-0.266666666666666,90,72,18,16,2
21700627,203898,LAL,DAL,Tyler Ennis,44,9.93333333333333,10,-0.0666666666666664,16,17,-1,-1,0
21700627,203903,LAL,DAL,Jordan Clarkson,135,30.35,30,0.350000000000001,57,57,0,2,-2
21700627,203944,LAL,DAL,Julius Randle,142,33.1166666666667,34,-0.883333333333333,77,64,13,12,1
21700627,1626204,LAL,DAL,Larry Nance Jr.,89,19.8166666666667,19,0.816666666666666,30,37,-7,-6,-1
21700627,1627742,LAL,DAL,Brandon Ingram,63,13.7666666666667,14,-0.233333333333334,30,28,2,2,0
21700627,1628366,LAL,DAL,Lonzo Ball,187,43,43,0,91,84,7,7,0
21700627,1628398,LAL,DAL,Kyle Kuzma,154,35.4833333333333,36,-0.516666666666666,69,65,4,4,0
21700627,1628404,LAL,DAL,Josh Hart,52,12.0166666666667,12,0.0166666666666657,26,28,-2,-2,0
21700628,101150,LAC,SAC,Lou Williams,169,35.0333333333333,35,0.0333333333333314,92,78,14,16,-2
21700628,201933,LAC,SAC,Blake Griffin,129,27.8666666666667,29,-1.13333333333333,75,51,24,22,2
21700628,202325,LAC,SAC,Wesley Johnson,114,24.25,24,0.25,61,52,9,5,4
21700628,203186,LAC,SAC,Willie Reed,119,26.05,26,0.0499999999999972,66,51,15,15,0
21700628,1626149,LAC,SAC,Montrezl Harrell,106,21.4166666666667,22,-0.583333333333332,60,54,6,6,0
21700628,1626155,LAC,SAC,Sam Dekker,96,19.6,19,0.600000000000001,51,54,-3,-1,-2
21700628,1627820,LAC,SAC,Tyrone Wallace,146,30.9666666666667,32,-1.03333333333334,86,63,23,23,0
21700628,1628393,LAC,SAC,Jawun Evans,114,24.7833333333333,25,-0.216666666666669,67,50,17,15,2
21700628,1628414,LAC,SAC,Sindarius Thornwell,21,4.68333333333333,5,-0.316666666666666,13,17,-4,-2,-2
21700628,1628462,LAC,SAC,Milos Teodosic,111,22.6833333333333,23,-0.316666666666666,59,55,4,6,-2
21700628,1713,SAC,LAC,Vince Carter,76,14.4666666666667,14,0.466666666666667,33,41,-8,-8,0
21700628,2216,SAC,LAC,Zach Randolph,83,18.8666666666667,19,-0.133333333333333,33,44,-11,-13,2
21700628,201585,SAC,LAC,Kosta Koufos,80,18.1666666666667,18,0.166666666666664,31,52,-21,-17,-4
21700628,201588,SAC,LAC,George Hill,83,19.3333333333333,19,0.333333333333336,32,44,-12,-12,0
21700628,202066,SAC,LAC,Garrett Temple,119,26.4666666666667,26,0.466666666666669,55,65,-10,-12,2
21700628,203992,SAC,LAC,Bogdan Bogdanovic,116,25.4,25,0.399999999999999,54,65,-11,-8,-3
21700628,1626161,SAC,LAC,Willie Cauley-Stein,155,31.95,33,-1.05,76,80,-4,-6,2
21700628,1627741,SAC,LAC,Buddy Hield,99,21.1333333333333,21,0.133333333333333,49,60,-11,-13,2
21700628,1627746,SAC,LAC,Skal Labissiere,106,21.0333333333333,22,-0.966666666666669,58,61,-3,-3,0
21700628,1628368,SAC,LAC,De'Aaron Fox,175,34.4833333333333,35,-0.516666666666666,81,97,-16,-15,-1
21700628,1628382,SAC,LAC,Justin Jackson,33,6.03333333333333,6,0.0333333333333332,23,21,2,2,0
21700629,2546,OKC,CHA,Carmelo Anthony,159,33.1666666666667,33,0.166666666666664,60,57,3,3,0
21700629,101109,OKC,CHA,Raymond Felton,77,16.2333333333333,16,0.233333333333334,42,31,11,6,5
21700629,201566,OKC,CHA,Russell Westbrook,177,36.3166666666667,37,-0.683333333333337,69,66,3,5,-2
21700629,202331,OKC,CHA,Paul George,172,35.1833333333333,35,0.183333333333337,66,68,-2,-1,-1
21700629,202335,OKC,CHA,Patrick Patterson,80,16.8833333333333,17,-0.116666666666667,43,41,2,4,-2
21700629,203500,OKC,CHA,Steven Adams,148,30.8166666666667,31,-0.183333333333334,58,50,8,6,2
21700629,203518,OKC,CHA,Alex Abrines,64,13.9333333333333,14,-0.0666666666666664,37,24,13,13,0
21700629,203924,OKC,CHA,Jerami Grant,102,21.35,21,0.350000000000001,49,46,3,1,2
21700629,203962,OKC,CHA,Josh Huestis,77,17.05,17,0.0499999999999972,41,39,2,4,-2
21700629,1628390,OKC,CHA,Terrance Ferguson,84,17.5666666666667,18,-0.433333333333334,40,33,7,9,-2
21700629,2730,CHA,OKC,Dwight Howard,166,33.7833333333333,34,-0.216666666666669,62,64,-2,-2,0
21700629,101107,CHA,OKC,Marvin Williams,131,27.25,28,-0.75,47,54,-7,-7,0
21700629,201587,CHA,OKC,Nicolas Batum,161,33.35,34,-0.650000000000006,60,61,-1,-4,3
21700629,202689,CHA,OKC,Kemba Walker,163,33.5833333333333,34,-0.416666666666671,61,62,-1,-4,3
21700629,203077,CHA,OKC,Michael Kidd-Gilchrist,142,29.5833333333333,30,-0.416666666666664,50,58,-8,-10,2
21700629,203087,CHA,OKC,Jeremy Lamb,86,18.1166666666667,18,0.116666666666667,41,43,-2,0,-2
21700629,203487,CHA,OKC,Michael Carter-Williams,71,15.15,15,0.15,34,41,-7,-3,-4
21700629,1626163,CHA,OKC,Frank Kaminsky,88,18.5,19,-0.5,44,47,-3,-3,0
21700629,1626203,CHA,OKC,Treveon Graham,81,17.6166666666667,18,-0.383333333333333,34,40,-6,-6,0
21700629,1628370,CHA,OKC,Malik Monk,51,11.5666666666667,12,-0.433333333333334,22,35,-13,-11,-2
21700630,201960,BKN,WAS,DeMarre Carroll,144,32.6666666666667,33,-0.333333333333336,64,68,-4,-6,2
21700630,203112,BKN,WAS,Quincy Acy,121,25.0166666666667,25,0.0166666666666657,54,60,-6,-11,5
21700630,203459,BKN,WAS,Allen Crabbe,154,32.6666666666667,33,-0.333333333333329,61,76,-15,-16,1
21700630,203915,BKN,WAS,Spencer Dinwiddie,167,35.6,35,0.599999999999994,74,79,-5,-8,3
21700630,203917,BKN,WAS,Nik Stauskas,32,7.31666666666667,7,0.316666666666666,18,14,4,3,1
21700630,203925,BKN,WAS,Joe Harris,100,21.05,21,0.0500000000000007,51,53,-2,-1,-1
21700630,1626143,BKN,WAS,Jahlil Okafor,30,7.68333333333333,8,-0.316666666666666,12,18,-6,-6,0
21700630,1626178,BKN,WAS,Rondae Hollis-Jefferson,175,38.7166666666667,38,0.716666666666669,78,81,-3,-2,-1
21700630,1627747,BKN,WAS,Caris LeVert,170,35.1833333333333,35,0.18333333333333,82,79,3,9,-6
21700630,1628386,BKN,WAS,Jarrett Allen,142,28.9333333333333,29,-0.0666666666666664,71,67,4,8,-4
21700630,101133,WAS,BKN,Ian Mahinmi,70,14.6666666666667,15,-0.333333333333332,35,32,3,1,2
21700630,101162,WAS,BKN,Marcin Gortat,138,30.1,30,0.100000000000001,61,59,2,2,0
21700630,201975,WAS,BKN,Jodie Meeks,20,5.01666666666667,5,0.0166666666666666,9,12,-3,-2,-1
21700630,202322,WAS,BKN,John Wall,186,40.25,40,0.25,88,82,6,6,0
21700630,202693,WAS,BKN,Markieff Morris,181,38.8333333333333,39,-0.166666666666671,84,81,3,5,-2
21700630,203078,WAS,BKN,Bradley Beal,206,43.0333333333333,43,0.0333333333333314,99,95,4,6,-2
21700630,203107,WAS,BKN,Tomas Satoransky,61,12.7166666666667,13,-0.283333333333333,31,31,0,0,0
21700630,203118,WAS,BKN,Mike Scott,66,14.1333333333333,14,0.133333333333333,35,32,3,1,2
21700630,203490,WAS,BKN,Otto Porter Jr.,166,36.7,37,-0.299999999999997,79,71,8,10,-2
21700630,1626162,WAS,BKN,Kelly Oubre Jr.,141,29.3833333333333,29,0.383333333333333,74,70,4,1,3
21700631,2561,GSW,TOR,David West,66,14.95,15,-0.0500000000000007,33,41,-8,-7,-1
21700631,2585,GSW,TOR,Zaza Pachulia,51,11.8333333333333,12,-0.166666666666668,34,36,-2,-2,0
21700631,2733,GSW,TOR,Shaun Livingston,51,11.1666666666667,11,0.166666666666666,31,28,3,1,2
21700631,2738,GSW,TOR,Andre Iguodala,44,8.26666666666667,8,0.266666666666666,29,11,18,18,0
21700631,201142,GSW,TOR,Kevin Durant,174,36.8833333333333,37,-0.116666666666667,98,100,-2,0,-2
21700631,201156,GSW,TOR,Nick Young,21,4.13333333333333,4,0.133333333333333,16,9,7,7,0
21700631,201939,GSW,TOR,Stephen Curry,160,34.6,34,0.600000000000001,89,96,-7,-5,-2
21700631,202691,GSW,TOR,Klay Thompson,170,37.9833333333333,39,-1.01666666666667,94,103,-9,-11,2
21700631,203110,GSW,TOR,Draymond Green,178,38.6,38,0.599999999999994,112,86,26,24,2
21700631,1626172,GSW,TOR,Kevon Looney,101,21.2833333333333,21,0.283333333333331,51,53,-2,-2,0
21700631,1627775,GSW,TOR,Patrick McCaw,99,20.3,20,0.300000000000001,48,62,-14,-13,-1
21700631,101139,TOR,GSW,CJ Miles,105,21.9833333333333,22,-0.0166666666666657,46,54,-8,-6,-2
21700631,201586,TOR,GSW,Serge Ibaka,132,29.2166666666667,29,0.216666666666669,80,79,1,0,1
21700631,201942,TOR,GSW,DeMar DeRozan,177,38.05,38,0.0499999999999972,103,106,-3,-3,0
21700631,202685,TOR,GSW,Jonas Valanciunas,117,25.9,26,-0.100000000000001,76,73,3,3,0
21700631,203485,TOR,GSW,Lorenzo Brown,21,4.48333333333333,5,-0.516666666666667,11,14,-3,-1,-2
21700631,1626153,TOR,GSW,Delon Wright,105,23.45,24,-0.549999999999997,65,63,2,-2,4
21700631,1626181,TOR,GSW,Norman Powell,50,10.3,11,-0.699999999999999,25,23,2,2,0
21700631,1627751,TOR,GSW,Jakob Poeltl,88,18.3,18,0.300000000000001,47,42,5,5,0
21700631,1627783,TOR,GSW,Pascal Siakam,101,20.85,21,-0.149999999999999,47,54,-7,-8,1
21700631,1627832,TOR,GSW,Fred VanVleet,105,21.9,21,0.899999999999999,51,56,-5,-3,-2
21700631,1628384,TOR,GSW,OG Anunoby,114,25.5666666666667,26,-0.433333333333334,74,71,3,3,0
21700632,201577,CHI,DET,Robin Lopez,133,29.5833333333333,29,0.583333333333332,71,56,15,16,-1
21700632,202703,CHI,DET,Nikola Mirotic,98,21.6833333333333,22,-0.316666666666666,45,51,-6,-8,2
21700632,203200,CHI,DET,Justin Holiday,148,31.8833333333333,32,-0.116666666666667,68,69,-1,2,-3
21700632,203897,CHI,DET,Zach LaVine,82,18.9333333333333,19,-0.0666666666666664,49,44,5,3,2
21700632,1626170,CHI,DET,Jerian Grant,62,14.1166666666667,14,0.116666666666667,30,31,-1,-1,0
21700632,1626171,CHI,DET,Bobby Portis,83,17.95,18,-0.0499999999999972,35,47,-12,-12,0
21700632,1627739,CHI,DET,Kris Dunn,147,31.6833333333333,31,0.683333333333334,73,68,5,5,0
21700632,1627756,CHI,DET,Denzel Valentine,96,21.1333333333333,21,0.133333333333333,47,50,-3,-2,-1
21700632,1628021,CHI,DET,David Nwaba,122,26.25,26,0.25,51,53,-2,-1,-1
21700632,1628374,CHI,DET,Lauri Markkanen,124,26.7833333333333,27,-0.216666666666669,61,56,5,8,-3
21700632,201229,DET,CHI,Anthony Tolliver,80,18,18,0,43,40,3,3,0
21700632,202340,DET,CHI,Avery Bradley,174,37.95,38,-0.0499999999999972,80,81,-1,-4,3
21700632,202397,DET,CHI,Ish Smith,124,26.7833333333333,27,-0.216666666666669,56,61,-5,-8,3
21700632,202699,DET,CHI,Tobias Harris,142,30.4666666666667,30,0.466666666666669,64,66,-2,-3,1
21700632,202779,DET,CHI,Dwight Buycks,95,21.2166666666667,21,0.216666666666669,49,45,4,6,-2
21700632,203083,DET,CHI,Andre Drummond,154,33.6166666666667,34,-0.383333333333333,73,79,-6,-6,0
21700632,203493,DET,CHI,Reggie Bullock,160,35.2,35,0.200000000000003,77,79,-2,-1,-1
21700632,203961,DET,CHI,Eric Moreland,62,13.9166666666667,14,-0.0833333333333339,30,27,3,2,1
21700632,1628379,DET,CHI,Luke Kennard,104,22.85,23,-0.149999999999999,53,52,1,1,0
21700633,2210,DEN,SAS,Richard Jefferson,113,23.7833333333333,24,-0.216666666666669,40,52,-12,-14,2
21700633,201163,DEN,SAS,Wilson Chandler,83,20.1666666666667,20,0.166666666666664,36,50,-14,-14,0
21700633,201589,DEN,SAS,Darrell Arthur,28,5.18333333333333,5,0.183333333333334,6,11,-5,-5,0
21700633,202702,DEN,SAS,Kenneth Faried,54,11.3333333333333,11,0.333333333333334,15,24,-9,-7,-2
21700633,203115,DEN,SAS,Will Barton,105,23.6,23,0.600000000000001,40,61,-21,-19,-2
21700633,203486,DEN,SAS,Mason Plumlee,89,20.85,21,-0.149999999999999,38,48,-10,-12,2
21700633,203914,DEN,SAS,Gary Harris,125,30.2333333333333,30,0.233333333333334,59,75,-16,-18,2
21700633,203999,DEN,SAS,Nikola Jokic,125,30.2333333333333,30,0.233333333333334,59,75,-16,-18,2
21700633,1626144,DEN,SAS,Emmanuel Mudiay,33,6.1,6,0.0999999999999996,6,13,-7,-7,0
21700633,1626168,DEN,SAS,Trey Lyles,88,19.7333333333333,20,-0.266666666666666,34,43,-9,-9,0
21700633,1627736,DEN,SAS,Malik Beasley,85,17.1333333333333,17,0.133333333333333,21,35,-14,-12,-2
21700633,1627750,DEN,SAS,Jamal Murray,99,23.8833333333333,24,-0.116666666666667,40,60,-20,-18,-2
21700633,1627823,DEN,SAS,Juancho Hernangomez,33,6.1,6,0.0999999999999996,6,13,-7,-7,0
21700633,1938,SAS,DEN,Manu Ginobili,73,17.4666666666667,17,0.466666666666669,42,30,12,11,1
21700633,2200,SAS,DEN,Pau Gasol,83,20.4666666666667,20,0.466666666666669,41,34,7,12,-5
21700633,2225,SAS,DEN,Tony Parker,81,19.1666666666667,19,0.166666666666664,42,36,6,6,0
21700633,200746,SAS,DEN,LaMarcus Aldridge,118,26.3333333333333,27,-0.666666666666664,63,47,16,16,0
21700633,201980,SAS,DEN,Danny Green,77,18.1666666666667,18,0.166666666666668,37,34,3,4,-1
21700633,201988,SAS,DEN,Patty Mills,82,18.8833333333333,19,-0.116666666666667,46,33,13,14,-1
21700633,202695,SAS,DEN,Kawhi Leonard,124,28,28,0,70,54,16,13,3
21700633,202722,SAS,DEN,Davis Bertans,99,22.95,23,-0.0499999999999972,67,40,27,25,2
21700633,203530,SAS,DEN,Joffrey Lauvergne,48,9.88333333333333,10,-0.116666666666667,19,14,5,3,2
21700633,203937,SAS,DEN,Kyle Anderson,114,25.0333333333333,25,0.0333333333333314,56,42,14,15,-1
21700633,1627749,SAS,DEN,Dejounte Murray,57,11.1166666666667,11,0.116666666666667,30,11,19,19,0
21700633,1627854,SAS,DEN,Bryn Forbes,73,15.0666666666667,15,0.0666666666666664,36,19,17,17,0
21700633,1628401,SAS,DEN,Derrick White,31,5.8,6,-0.199999999999999,11,6,5,5,0
21700634,201609,MIA,MIL,Goran Dragic,151,32.7666666666667,33,-0.233333333333334,67,52,15,17,-2
21700634,201949,MIA,MIL,James Johnson,115,25.15,25,0.149999999999999,51,37,14,14,0
21700634,201961,MIA,MIL,Wayne Ellington,133,32.1,32,0.100000000000001,70,57,13,16,-3
21700634,202355,MIA,MIL,Hassan Whiteside,115,24.8166666666667,25,-0.183333333333334,50,37,13,13,0
21700634,203482,MIA,MIL,Kelly Olynyk,73,17.8666666666667,18,-0.133333333333333,35,34,1,-1,2
21700634,204020,MIA,MIL,Tyler Johnson,154,34.5833333333333,35,-0.416666666666664,69,49,20,22,-2
21700634,1626159,MIA,MIL,Justise Winslow,56,13.2833333333333,13,0.283333333333333,28,30,-2,-4,2
21700634,1626196,MIA,MIL,Josh Richardson,136,30.8666666666667,31,-0.133333333333333,57,49,8,3,5
21700634,1628389,MIA,MIL,Bam Adebayo,117,27.9,28,-0.100000000000001,58,50,8,10,-2
21700634,202339,MIL,MIA,Eric Bledsoe,144,31.3833333333333,31,0.383333333333333,54,68,-14,-16,2
21700634,203089,MIL,MIA,John Henson,115,25.1166666666667,25,0.116666666666667,36,51,-15,-15,0
21700634,203114,MIL,MIA,Khris Middleton,141,32.75,33,-0.25,57,62,-5,-5,0
21700634,203503,MIL,MIA,Tony Snell,84,20.5333333333333,21,-0.466666666666669,33,46,-13,-11,-2
21700634,203507,MIL,MIA,Giannis Antetokounmpo,140,30.6333333333333,31,-0.366666666666667,52,68,-16,-20,4
21700634,203521,MIL,MIA,Matthew Dellavedova,43,11.4833333333333,12,-0.516666666666666,18,20,-2,0,-2
21700634,203930,MIL,MIA,Sean Kilpatrick,57,12.2166666666667,12,0.216666666666667,16,21,-5,-3,-2
21700634,1627748,MIL,MIA,Thon Maker,69,16.6,16,0.600000000000001,35,31,4,4,0
21700634,1627763,MIL,MIA,Malcolm Brogdon,152,34.0166666666667,34,0.0166666666666657,51,68,-17,-21,4
21700634,1628391,MIL,MIA,D.J. Wilson,11,2.23333333333333,2,0.233333333333333,0,4,-4,-2,-2
21700634,1628425,MIL,MIA,Sterling Brown,94,22.3666666666667,22,0.366666666666667,43,46,-3,-1,-2
21700635,200765,NOP,NYK,Rajon Rondo,125,24.25,24,0.25,58,73,-15,-15,0
21700635,201950,NOP,NYK,Jrue Holiday,218,44.6333333333333,45,-0.366666666666667,103,92,11,13,-2
21700635,201967,NOP,NYK,Dante Cunningham,59,11.3666666666667,11,0.366666666666667,26,29,-3,-4,1
21700635,202326,NOP,NYK,DeMarcus Cousins,221,44.8833333333333,45,-0.116666666666667,107,94,13,14,-1
21700635,202734,NOP,NYK,E'Twaun Moore,220,44.7666666666667,45,-0.233333333333334,108,102,6,6,0
21700635,203076,NOP,NYK,Anthony Davis,244,49.6833333333333,50,-0.316666666666663,113,113,0,0,0
21700635,203121,NOP,NYK,Darius Miller,105,20.0666666666667,20,0.0666666666666664,44,49,-5,-7,2
21700635,203546,NOP,NYK,Ian Clark,118,25.1833333333333,25,0.183333333333334,56,38,18,18,0
21700635,101127,NYK,NOP,Jarrett Jack,179,36.8,37,-0.200000000000003,84,84,0,-2,2
21700635,201563,NYK,NOP,Michael Beasley,46,9.18333333333333,9,0.183333333333334,11,25,-14,-16,2
21700635,201584,NYK,NOP,Courtney Lee,168,35.1166666666667,35,0.116666666666667,69,86,-17,-16,-1
21700635,202498,NYK,NOP,Lance Thomas,130,25.9,26,-0.100000000000001,59,58,1,2,-1
21700635,202683,NYK,NOP,Enes Kanter,174,36.25,36,0.25,83,83,0,-1,1
21700635,203124,NYK,NOP,Kyle O'Quinn,84,16.4666666666667,17,-0.533333333333331,35,38,-3,-2,-1
21700635,203501,NYK,NOP,Tim Hardaway Jr.,165,33.1333333333333,33,0.133333333333333,76,77,-1,-1,0
21700635,203926,NYK,NOP,Doug McDermott,66,12.1,12,0.100000000000001,32,29,3,3,0
21700635,204001,NYK,NOP,Kristaps Porzingis,216,43.7833333333333,44,-0.216666666666669,107,98,9,11,-2
21700635,1628373,NYK,NOP,Frank Ntilikina,82,16.1,16,0.100000000000001,34,37,-3,-3,0
21700636,2744,IND,PHX,Al Jefferson,78,19.2166666666667,19,0.216666666666669,47,37,10,10,0
21700636,201152,IND,PHX,Thaddeus Young,114,24.3166666666667,25,-0.683333333333334,64,44,20,19,1
21700636,201954,IND,PHX,Darren Collison,125,27.5666666666667,27,0.566666666666666,75,48,27,25,2
21700636,202362,IND,PHX,Lance Stephenson,79,19.4833333333333,20,-0.516666666666666,50,39,11,11,0
21700636,202709,IND,PHX,Cory Joseph,135,31.7833333333333,32,-0.216666666666665,70,72,-2,0,-2
21700636,202711,IND,PHX,Bojan Bogdanovic,98,21.2666666666667,21,0.266666666666666,60,41,19,19,0
21700636,203506,IND,PHX,Victor Oladipo,102,21.25,21,0.25,56,32,24,24,0
21700636,1626202,IND,PHX,Joe Young,73,17.3,18,-0.699999999999999,40,43,-3,-3,0
21700636,1627734,IND,PHX,Domantas Sabonis,112,23.9,24,-0.100000000000001,64,44,20,20,0
21700636,1627816,IND,PHX,Alex Poythress,21,4.65,5,-0.35,9,16,-7,-7,0
21700636,1628387,IND,PHX,Ike Anigbogu,21,4.65,5,-0.35,9,16,-7,-7,0
21700636,1628388,IND,PHX,TJ Leaf,97,23.45,23,0.449999999999999,56,53,3,4,-1
21700636,2199,PHX,IND,Tyson Chandler,115,25.4666666666667,26,-0.533333333333331,47,67,-20,-20,0
21700636,201162,PHX,IND,Jared Dudley,11,2.98333333333333,3,-0.0166666666666666,10,7,3,3,0
21700636,202328,PHX,IND,Greg Monroe,13,3.16666666666667,3,0.166666666666667,9,10,-1,-1,0
21700636,203458,PHX,IND,Alex Len,83,19.1333333333333,19,0.133333333333333,41,43,-2,-2,0
21700636,203477,PHX,IND,Isaiah Canaan,85,20.1333333333333,20,0.133333333333333,37,47,-10,-9,-1
21700636,203584,PHX,IND,Troy Daniels,81,18.4166666666667,18,0.416666666666664,41,49,-8,-5,-3
21700636,1626164,PHX,IND,Devin Booker,144,32.6333333333333,33,-0.366666666666667,65,82,-17,-18,1
21700636,1627733,PHX,IND,Dragan Bender,138,30.4666666666667,30,0.466666666666669,58,79,-21,-21,0
21700636,1627755,PHX,IND,Tyler Ulis,111,24.2,24,0.200000000000003,50,62,-12,-15,3
21700636,1627863,PHX,IND,Danuel House Jr.,48,11.7,12,-0.300000000000001,16,27,-11,-11,0
21700636,1628367,PHX,IND,Josh Jackson,136,30.05,30,0.0500000000000007,60,80,-20,-20,0
21700636,1628409,PHX,IND,Alec Peters,69,15.8333333333333,16,-0.166666666666668,35,38,-3,-3,0
21700636,1628432,PHX,IND,Davon Reed,21,4.65,5,-0.35,16,9,7,7,0
21700637,2037,MIN,POR,Jamal Crawford,83,19.4833333333333,20,-0.516666666666666,51,31,20,20,0
21700637,201166,MIN,POR,Aaron Brooks,10,2.53333333333333,3,-0.466666666666667,2,8,-6,-6,0
21700637,201952,MIN,POR,Jeff Teague,136,28.6166666666667,29,-0.383333333333333,76,66,10,10,0
21700637,201959,MIN,POR,Taj Gibson,137,28.7833333333333,29,-0.216666666666669,75,65,10,8,2
21700637,202357,MIN,POR,Nemanja Bjelica,74,18.05,19,-0.949999999999999,41,35,6,8,-2
21700637,202710,MIN,POR,Jimmy Butler,160,33.9166666666667,34,-0.0833333333333286,97,74,23,23,0
21700637,203476,MIN,POR,Gorgui Dieng,88,20.0833333333333,20,0.0833333333333357,46,53,-7,-3,-4
21700637,203498,MIN,POR,Shabazz Muhammad,15,3.76666666666667,4,-0.233333333333333,4,13,-9,-9,0
21700637,203952,MIN,POR,Andrew Wiggins,149,31.2333333333333,31,0.233333333333334,85,73,12,10,2
21700637,1626145,MIN,POR,Tyus Jones,48,12,12,0,24,18,6,6,0
21700637,1626157,MIN,POR,Karl-Anthony Towns,165,35.85,36,-0.149999999999999,95,66,29,27,2
21700637,1627875,MIN,POR,Marcus Georges-Hunt,15,3.76666666666667,4,-0.233333333333333,4,13,-9,-9,0
21700637,202323,POR,MIN,Evan Turner,106,23.1333333333333,23,0.133333333333333,31,58,-27,-24,-3
21700637,202329,POR,MIN,Al-Farouq Aminu,97,20.95,21,-0.0500000000000007,38,51,-13,-13,0
21700637,202334,POR,MIN,Ed Davis,98,21.4166666666667,21,0.416666666666668,57,57,0,-7,7
21700637,203081,POR,MIN,Damian Lillard,164,34.6666666666667,35,-0.333333333333329,77,98,-21,-23,2
21700637,203086,POR,MIN,Meyers Leonard,19,4.78333333333333,5,-0.216666666666667,15,6,9,9,0
21700637,203090,POR,MIN,Maurice Harkless,27,6.26666666666667,6,0.266666666666667,8,14,-6,-6,0
21700637,203468,POR,MIN,CJ McCollum,122,25.3666666666667,26,-0.633333333333333,62,70,-8,-8,0
21700637,203894,POR,MIN,Shabazz Napier,53,12.1166666666667,12,0.116666666666667,29,30,-1,-1,0
21700637,203943,POR,MIN,Noah Vonleh,26,6.56666666666667,7,-0.433333333333334,15,10,5,7,-2
21700637,203994,POR,MIN,Jusuf Nurkic,93,19.6333333333333,20,-0.366666666666667,32,53,-21,-17,-4
21700637,1626192,POR,MIN,Pat Connaughton,121,28,29,-1,62,70,-8,-8,0
21700637,1627774,POR,MIN,Jake Layman,26,6.56666666666667,7,-0.433333333333334,15,10,5,7,-2
21700637,1628380,POR,MIN,Zach Collins,128,28.6166666666667,29,-0.383333333333333,74,73,1,-1,2
21700638,201229,DET,CHA,Anthony Tolliver,117,25.7,25,0.700000000000003,54,54,0,2,-2
21700638,202340,DET,CHA,Avery Bradley,173,35.6333333333333,36,-0.366666666666667,82,95,-13,-15,2
21700638,202397,DET,CHA,Ish Smith,172,34.5,35,-0.5,85,90,-5,-4,-1
21700638,202699,DET,CHA,Tobias Harris,126,24.8833333333333,25,-0.116666666666667,56,71,-15,-16,1
21700638,202779,DET,CHA,Dwight Buycks,56,13.2833333333333,13,0.283333333333333,22,28,-6,-7,1
21700638,203083,DET,CHA,Andre Drummond,163,33.1333333333333,34,-0.866666666666667,83,84,-1,-1,0
21700638,203493,DET,CHA,Reggie Bullock,169,34.6666666666667,35,-0.333333333333336,78,90,-12,-12,0
21700638,203961,DET,CHA,Eric Moreland,50,11.85,12,-0.15,21,27,-6,-7,1
21700638,1628379,DET,CHA,Luke Kennard,114,25.2666666666667,25,0.266666666666666,54,51,3,5,-2
21700638,2730,CHA,DET,Dwight Howard,172,35.7833333333333,36,-0.216666666666669,95,82,13,14,-1
21700638,101107,CHA,DET,Marvin Williams,142,28.35,29,-0.649999999999999,84,65,19,18,1
21700638,201587,CHA,DET,Nicolas Batum,162,33.2333333333333,34,-0.766666666666666,84,84,0,0,0
21700638,202689,CHA,DET,Kemba Walker,172,34.6833333333333,35,-0.31666666666667,91,88,3,4,-1
21700638,203077,CHA,DET,Michael Kidd-Gilchrist,159,32.1666666666667,32,0.166666666666671,88,75,13,14,-1
21700638,203087,CHA,DET,Jeremy Lamb,87,18.65,19,-0.350000000000001,39,38,1,1,0
21700638,203487,CHA,DET,Michael Carter-Williams,56,13.1,13,0.0999999999999996,27,19,8,7,1
21700638,203948,CHA,DET,Johnny O'Bryant III,52,11.4333333333333,11,0.433333333333334,20,23,-3,-2,-1
21700638,1626163,CHA,DET,Frank Kaminsky,90,20,20,0,37,44,-7,-8,1
21700638,1626203,CHA,DET,Treveon Graham,48,11.5166666666667,11,0.516666666666666,25,17,8,7,1
21700639,101161,PHI,TOR,Amir Johnson,69,12.4166666666667,13,-0.583333333333334,33,21,12,9,3
21700639,200755,PHI,TOR,JJ Redick,136,27.6833333333333,28,-0.316666666666666,64,62,2,1,1
21700639,201573,PHI,TOR,Jerryd Bayless,109,18.8833333333333,19,-0.116666666666667,49,60,-11,-5,-6
21700639,202344,PHI,TOR,Trevor Booker,72,14.1833333333333,14,0.183333333333334,33,37,-4,-6,2
21700639,203496,PHI,TOR,Robert Covington,194,34.8,35,-0.200000000000003,92,79,13,14,-1
21700639,203954,PHI,TOR,Joel Embiid,179,35.4,35,0.399999999999999,81,87,-6,-2,-4
21700639,203967,PHI,TOR,Dario Saric,166,32.15,33,-0.850000000000001,75,69,6,13,-7
21700639,204456,PHI,TOR,T.J. McConnell,176,32.7833333333333,32,0.783333333333331,83,74,9,6,3
21700639,1627732,PHI,TOR,Ben Simmons,142,26.85,27,-0.149999999999999,63,60,3,1,2
21700639,1627789,PHI,TOR,Timothe Luwawu-Cabarrot,22,4.43333333333333,5,-0.566666666666666,7,6,1,-1,2
21700639,101139,TOR,PHI,CJ Miles,122,21.6333333333333,21,0.633333333333333,49,50,-1,6,-7
21700639,200768,TOR,PHI,Kyle Lowry,197,37.0333333333333,37,0.0333333333333314,89,91,-2,-5,3
21700639,201586,TOR,PHI,Serge Ibaka,84,16.9666666666667,17,-0.033333333333335,36,48,-12,-13,1
21700639,201942,TOR,PHI,DeMar DeRozan,190,34.95,35,-0.0499999999999972,81,95,-14,-15,1
21700639,202685,TOR,PHI,Jonas Valanciunas,67,13.8833333333333,14,-0.116666666666667,26,40,-14,-14,0
21700639,203512,TOR,PHI,Lucas Nogueira,27,4.85,5,-0.15,14,12,2,2,0
21700639,1626153,TOR,PHI,Delon Wright,108,20.1166666666667,20,0.116666666666667,53,42,11,9,2
21700639,1626181,TOR,PHI,Norman Powell,1,0.0166666666666667,0,0.0166666666666667,0,,,0,
21700639,1627751,TOR,PHI,Jakob Poeltl,145,26.9666666666667,27,-0.0333333333333314,67,60,7,7,0
21700639,1627783,TOR,PHI,Pascal Siakam,146,28.85,29,-0.149999999999999,67,58,9,3,6
21700639,1627832,TOR,PHI,Fred VanVleet,84,15.8666666666667,16,-0.133333333333333,33,30,3,4,-1
21700639,1628384,TOR,PHI,OG Anunoby,94,18.45,19,-0.550000000000001,40,54,-14,-14,0
21700640,202339,MIL,WAS,Eric Bledsoe,180,37.6,38,-0.400000000000006,83,68,15,13,2
21700640,203089,MIL,WAS,John Henson,144,29.7833333333333,31,-1.21666666666667,74,52,22,22,0
21700640,203114,MIL,WAS,Khris Middleton,188,39.8833333333333,41,-1.11666666666666,89,70,19,19,0
21700640,203503,MIL,WAS,Tony Snell,77,15.3833333333333,15,0.383333333333333,27,44,-17,-17,0
21700640,203507,MIL,WAS,Giannis Antetokounmpo,186,38.5833333333333,39,-0.416666666666671,90,74,16,16,0
21700640,203521,MIL,WAS,Matthew Dellavedova,76,15.6833333333333,15,0.683333333333334,33,41,-8,-8,0
21700640,1627748,MIL,WAS,Thon Maker,71,14.4,14,0.4,23,37,-14,-14,0
21700640,1627763,MIL,WAS,Malcolm Brogdon,178,36.65,37,-0.350000000000001,85,69,16,19,-3
21700640,1628425,MIL,WAS,Sterling Brown,45,10.2833333333333,10,0.283333333333335,16,20,-4,-5,1
21700640,101133,WAS,MIL,Ian Mahinmi,69,13.1166666666667,13,0.116666666666667,33,27,6,8,-2
21700640,101162,WAS,MIL,Marcin Gortat,120,25.5166666666667,26,-0.483333333333334,45,59,-14,-14,0
21700640,202322,WAS,MIL,John Wall,193,40.6166666666667,41,-0.383333333333333,80,86,-6,-4,-2
21700640,202693,WAS,MIL,Markieff Morris,110,23.2833333333333,24,-0.716666666666669,42,46,-4,-10,6
21700640,203078,WAS,MIL,Bradley Beal,192,40.75,41,-0.25,75,93,-18,-24,6
21700640,203107,WAS,MIL,Tomas Satoransky,64,12.8,13,-0.199999999999999,29,25,4,8,-4
21700640,203118,WAS,MIL,Mike Scott,86,16.7,16,0.699999999999999,39,40,-1,1,-2
21700640,203490,WAS,MIL,Otto Porter Jr.,143,30.2833333333333,31,-0.716666666666669,66,64,2,0,2
21700640,1626162,WAS,MIL,Kelly Oubre Jr.,168,35.1833333333333,35,0.183333333333337,66,80,-14,-10,-4
21700641,101141,ATL,SAS,Ersan Ilyasova,128,28.0333333333333,28,0.0333333333333314,66,58,8,8,0
21700641,201158,ATL,SAS,Marco Belinelli,95,21.1333333333333,21,0.133333333333333,45,38,7,6,1
21700641,203101,ATL,SAS,Miles Plumlee,71,16.5166666666667,17,-0.483333333333334,32,36,-4,-3,-1
21700641,203145,ATL,SAS,Kent Bazemore,137,30.3333333333333,31,-0.666666666666668,66,64,2,1,1
21700641,203471,ATL,SAS,Dennis Schroder,148,32.8,33,-0.200000000000003,69,69,0,-1,1
21700641,203473,ATL,SAS,Dewayne Dedmon,122,26.1333333333333,26,0.133333333333333,59,53,6,4,2
21700641,203488,ATL,SAS,Mike Muscala,15,3.21666666666667,3,0.216666666666667,3,7,-4,-4,0
21700641,1627098,ATL,SAS,Malcolm Delaney,98,20.0333333333333,20,0.0333333333333314,46,43,3,4,-1
21700641,1627752,ATL,SAS,Taurean Prince,113,25.65,25,0.649999999999999,49,56,-7,-4,-3
21700641,1628381,ATL,SAS,John Collins,100,22.0333333333333,22,0.0333333333333314,44,42,2,1,1
21700641,1628416,ATL,SAS,Tyler Dorsey,63,13.95,14,-0.0500000000000007,31,24,7,3,4
21700641,1938,SAS,ATL,Manu Ginobili,21,4.93333333333333,5,-0.0666666666666664,4,13,-9,-7,-2
21700641,2200,SAS,ATL,Pau Gasol,96,21.6,21,0.600000000000001,41,32,9,4,5
21700641,2225,SAS,ATL,Tony Parker,110,25.1833333333333,25,0.18333333333333,54,55,-1,-4,3
21700641,200746,SAS,ATL,LaMarcus Aldridge,155,34.4166666666667,35,-0.583333333333336,71,76,-5,-4,-1
21700641,201980,SAS,ATL,Danny Green,133,28.7166666666667,28,0.716666666666665,64,60,4,7,-3
21700641,201988,SAS,ATL,Patty Mills,109,23.2333333333333,23,0.233333333333334,48,52,-4,-3,-1
21700641,202722,SAS,ATL,Davis Bertans,107,23.9833333333333,24,-0.0166666666666657,48,58,-10,-8,-2
21700641,203464,SAS,ATL,Brandon Paul,11,2.6,2,0.6,5,5,0,0,0
21700641,203530,SAS,ATL,Joffrey Lauvergne,31,6.31666666666667,6,0.316666666666666,15,15,0,0,0
21700641,203937,SAS,ATL,Kyle Anderson,142,31.3833333333333,32,-0.616666666666667,67,65,2,1,1
21700641,1627749,SAS,ATL,Dejounte Murray,82,18.1,18,0.100000000000001,29,34,-5,0,-5
21700641,1627854,SAS,ATL,Bryn Forbes,93,19.3666666666667,19,0.366666666666667,44,45,-1,-1,0
21700642,201960,BKN,NYK,DeMarre Carroll,151,30.7833333333333,30,0.783333333333331,69,79,-10,-8,-2
21700642,203092,BKN,NYK,Tyler Zeller,55,11.2833333333333,12,-0.716666666666667,31,30,1,2,-1
21700642,203112,BKN,NYK,Quincy Acy,111,22.2666666666667,22,0.266666666666666,52,51,1,5,-4
21700642,203459,BKN,NYK,Allen Crabbe,162,34.1333333333333,35,-0.866666666666667,75,90,-15,-13,-2
21700642,203915,BKN,NYK,Spencer Dinwiddie,133,27.2166666666667,28,-0.783333333333335,61,72,-11,-10,-1
21700642,203917,BKN,NYK,Nik Stauskas,31,7.3,7,0.3,18,15,3,5,-2
21700642,203925,BKN,NYK,Joe Harris,106,23.1833333333333,23,0.183333333333334,43,61,-18,-18,0
21700642,1626143,BKN,NYK,Jahlil Okafor,33,7.06666666666667,7,0.0666666666666664,10,17,-7,-7,0
21700642,1626178,BKN,NYK,Rondae Hollis-Jefferson,127,25.9833333333333,26,-0.0166666666666657,54,67,-13,-12,-1
21700642,1627747,BKN,NYK,Caris LeVert,146,29.8333333333333,30,-0.166666666666668,64,71,-7,-11,4
21700642,1628386,BKN,NYK,Jarrett Allen,66,15.0833333333333,15,0.0833333333333339,29,34,-5,-14,9
21700642,1628495,BKN,NYK,Milton Doyle,19,4.28333333333333,4,0.283333333333333,14,8,6,6,0
21700642,101127,NYK,BKN,Jarrett Jack,65,12.6333333333333,13,-0.366666666666667,31,39,-8,-8,0
21700642,201563,NYK,BKN,Michael Beasley,137,29.4833333333333,29,0.483333333333334,71,60,11,12,-1
21700642,201584,NYK,BKN,Courtney Lee,125,25.2666666666667,25,0.266666666666666,58,58,0,0,0
21700642,202498,NYK,BKN,Lance Thomas,78,15.5666666666667,16,-0.433333333333334,39,36,3,1,2
21700642,202683,NYK,BKN,Enes Kanter,46,9.03333333333333,9,0.0333333333333332,25,24,1,0,1
21700642,203124,NYK,BKN,Kyle O'Quinn,106,22.0333333333333,23,-0.966666666666669,52,50,2,5,-3
21700642,203504,NYK,BKN,Trey Burke,35,7.61666666666667,8,-0.383333333333334,21,14,7,5,2
21700642,203926,NYK,BKN,Doug McDermott,134,28.3,29,-0.700000000000003,72,61,11,13,-2
21700642,204001,NYK,BKN,Kristaps Porzingis,130,26.8,27,-0.200000000000003,68,57,11,8,3
21700642,1626195,NYK,BKN,Willy Hernangomez,28,6.36666666666667,6,0.366666666666667,16,10,6,6,0
21700642,1627758,NYK,BKN,Ron Baker,119,26.2333333333333,26,0.233333333333334,69,53,16,16,0
21700642,1628373,NYK,BKN,Frank Ntilikina,137,29.0833333333333,29,0.0833333333333322,73,58,15,17,-2
21700643,201585,SAC,OKC,Kosta Koufos,89,19.1333333333333,19,0.133333333333333,19,35,-16,-12,-4
21700643,201588,SAC,OKC,George Hill,106,24.1833333333333,24,0.18333333333333,37,41,-4,-5,1
21700643,202066,SAC,OKC,Garrett Temple,97,17.5666666666667,18,-0.433333333333334,37,49,-12,-12,0
21700643,203992,SAC,OKC,Bogdan Bogdanovic,159,29.9666666666667,30,-0.0333333333333314,60,69,-9,-8,-1
21700643,1626161,SAC,OKC,Willie Cauley-Stein,191,39.6,40,-0.400000000000006,77,76,1,4,-3
21700643,1627741,SAC,OKC,Buddy Hield,127,27.9833333333333,28,-0.0166666666666657,46,44,2,2,0
21700643,1627746,SAC,OKC,Skal Labissiere,130,27.35,28,-0.649999999999999,56,59,-3,-8,5
21700643,1627834,SAC,OKC,Georgios Papagiannis,10,1.38333333333333,1,0.383333333333333,3,7,-4,-4,0
21700643,1628368,SAC,OKC,De'Aaron Fox,141,26.7166666666667,27,-0.283333333333331,60,56,4,4,0
21700643,1628382,SAC,OKC,Justin Jackson,110,24.2833333333333,24,0.283333333333331,45,39,6,4,2
21700643,2546,OKC,SAC,Carmelo Anthony,165,31.7166666666667,32,-0.283333333333331,71,62,9,7,2
21700643,101109,OKC,SAC,Raymond Felton,75,16.9333333333333,17,-0.0666666666666664,22,29,-7,-12,5
21700643,201566,OKC,SAC,Russell Westbrook,165,32.7833333333333,33,-0.216666666666669,75,64,11,16,-5
21700643,202331,OKC,SAC,Paul George,184,35.5,36,-0.5,74,78,-4,-4,0
21700643,202335,OKC,SAC,Patrick Patterson,67,15.7666666666667,16,-0.233333333333334,23,26,-3,-3,0
21700643,203500,OKC,SAC,Steven Adams,165,31.8666666666667,32,-0.133333333333333,72,62,10,10,0
21700643,203518,OKC,SAC,Alex Abrines,90,18.6833333333333,18,0.683333333333334,37,31,6,6,0
21700643,203924,OKC,SAC,Jerami Grant,83,19.9166666666667,20,-0.0833333333333322,33,28,5,7,-2
21700643,203962,OKC,SAC,Josh Huestis,76,16.8666666666667,17,-0.133333333333333,28,24,4,4,0
21700643,1628390,OKC,SAC,Terrance Ferguson,90,18.1333333333333,18,0.133333333333333,40,36,4,4,0
21700644,201577,CHI,MIA,Robin Lopez,108,23.8333333333333,24,-0.166666666666664,61,36,25,25,0
21700644,202703,CHI,MIA,Nikola Mirotic,118,24.2333333333333,24,0.233333333333334,58,75,-17,-17,0
21700644,203200,CHI,MIA,Justin Holiday,161,35.05,35,0.0499999999999972,98,79,19,20,-1
21700644,203897,CHI,MIA,Zach LaVine,94,19.8833333333333,20,-0.116666666666667,48,41,7,6,1
21700644,1626170,CHI,MIA,Jerian Grant,76,15.6333333333333,15,0.633333333333333,32,45,-13,-13,0
21700644,1626171,CHI,MIA,Bobby Portis,84,17.55,18,-0.450000000000003,37,49,-12,-13,1
21700644,1627739,CHI,MIA,Kris Dunn,148,32.15,33,-0.850000000000001,87,66,21,21,0
21700644,1627756,CHI,MIA,Denzel Valentine,129,27.9166666666667,28,-0.0833333333333357,68,66,2,0,2
21700644,1628021,CHI,MIA,David Nwaba,64,12.7166666666667,13,-0.283333333333333,24,36,-12,-10,-2
21700644,1628374,CHI,MIA,Lauri Markkanen,138,29.95,30,-0.0500000000000007,82,62,20,21,-1
21700644,201609,MIA,CHI,Goran Dragic,171,37.9666666666667,38,-0.0333333333333314,85,95,-10,-12,2
21700644,201949,MIA,CHI,James Johnson,141,29.55,29,0.550000000000001,66,86,-20,-18,-2
21700644,201961,MIA,CHI,Wayne Ellington,153,32.3833333333333,33,-0.616666666666667,80,76,4,4,0
21700644,202355,MIA,CHI,Hassan Whiteside,92,20.1,20,0.100000000000001,33,53,-20,-20,0
21700644,203482,MIA,CHI,Kelly Olynyk,131,27.6166666666667,28,-0.383333333333333,75,66,9,16,-7
21700644,204020,MIA,CHI,Tyler Johnson,94,20.0666666666667,20,0.0666666666666664,41,53,-12,-12,0
21700644,1626159,MIA,CHI,Justise Winslow,102,21.2666666666667,21,0.266666666666666,52,46,6,0,6
21700644,1626196,MIA,CHI,Josh Richardson,153,31.7333333333333,32,-0.266666666666666,78,87,-9,-8,-1
21700644,1628389,MIA,CHI,Bam Adebayo,83,18.2333333333333,19,-0.766666666666666,45,33,12,10,2
21700645,201147,LAL,MEM,Corey Brewer,115,19.7166666666667,20,-0.283333333333331,50,55,-5,-9,4
21700645,201572,LAL,MEM,Brook Lopez,89,19.1666666666667,19,0.166666666666664,42,50,-8,-6,-2
21700645,203484,LAL,MEM,Kentavious Caldwell-Pope,163,33.1,33,0.100000000000001,78,83,-5,-1,-4
21700645,203898,LAL,MEM,Tyler Ennis,80,17.2833333333333,17,0.283333333333331,37,41,-4,-4,0
21700645,203903,LAL,MEM,Jordan Clarkson,99,16.75,17,-0.25,38,50,-12,-10,-2
21700645,203944,LAL,MEM,Julius Randle,99,21.4833333333333,22,-0.516666666666666,45,54,-9,-7,-2
21700645,1626204,LAL,MEM,Larry Nance Jr.,146,26.4833333333333,26,0.483333333333334,69,69,0,-2,2
21700645,1627780,LAL,MEM,Gary Payton II,57,11.9833333333333,12,-0.0166666666666657,37,26,11,11,0
21700645,1627936,LAL,MEM,Alex Caruso,73,13.3166666666667,13,0.316666666666666,26,39,-13,-15,2
21700645,1628398,LAL,MEM,Kyle Kuzma,156,28.8,29,-0.200000000000003,72,73,-1,-3,2
21700645,1628404,LAL,MEM,Josh Hart,148,31.75,32,-0.25,76,75,1,1,0
21700645,201188,MEM,LAL,Marc Gasol,159,34.1333333333333,34,0.133333333333333,87,83,4,6,-2
21700645,201596,MEM,LAL,Mario Chalmers,112,20.15,20,0.149999999999999,61,49,12,12,0
21700645,201936,MEM,LAL,Tyreke Evans,165,35.25,36,-0.75,86,86,0,0,0
21700645,203210,MEM,LAL,JaMychal Green,123,27.1333333333333,27,0.133333333333333,59,61,-2,-2,0
21700645,203516,MEM,LAL,James Ennis III,125,21.3666666666667,21,0.366666666666667,63,46,17,20,-3
21700645,1626150,MEM,LAL,Andrew Harrison,124,26.3833333333333,27,-0.616666666666667,59,58,1,3,-2
21700645,1626185,MEM,LAL,Jarell Martin,122,20.8333333333333,21,-0.166666666666664,64,53,11,11,0
21700645,1627738,MEM,LAL,Deyonta Davis,86,13.8333333333333,14,-0.166666666666668,36,31,5,3,2
21700645,1627782,MEM,LAL,Wayne Selden,89,14.15,14,0.149999999999999,40,35,5,3,2
21700645,1628415,MEM,LAL,Dillon Brooks,120,26.6,27,-0.399999999999999,60,68,-8,-11,3
21700646,2544,CLE,GSW,LeBron James,189,36.15,36,0.149999999999999,86,99,-13,-14,1
21700646,2548,CLE,GSW,Dwyane Wade,133,25.8166666666667,25,0.816666666666666,49,54,-5,-3,-2
21700646,2594,CLE,GSW,Kyle Korver,91,20.3166666666667,21,-0.683333333333334,34,42,-8,-6,-2
21700646,2747,CLE,GSW,JR Smith,171,31.5166666666667,32,-0.483333333333334,76,87,-11,-12,1
21700646,101112,CLE,GSW,Channing Frye,4,1.33333333333333,1,0.333333333333333,4,0,4,4,0
21700646,101181,CLE,GSW,Jose Calderon,4,1.33333333333333,1,0.333333333333333,4,0,4,4,0
21700646,201145,CLE,GSW,Jeff Green,129,25.6166666666667,26,-0.383333333333333,49,56,-7,-3,-4
21700646,201567,CLE,GSW,Kevin Love,141,26.65,27,-0.350000000000001,67,77,-10,-12,2
21700646,202684,CLE,GSW,Tristan Thompson,67,14.8,15,-0.199999999999999,24,29,-5,-3,-2
21700646,202738,CLE,GSW,Isaiah Thomas,152,32.2,32,0.200000000000003,76,87,-11,-9,-2
21700646,203109,CLE,GSW,Jae Crowder,111,21.2666666666667,21,0.266666666666666,58,59,-1,-4,3
21700646,1626224,CLE,GSW,Cedi Osman,4,1.33333333333333,1,0.333333333333333,4,0,4,4,0
21700646,1627790,CLE,GSW,Ante Zizic,4,1.33333333333333,1,0.333333333333333,4,0,4,4,0
21700646,2561,GSW,CLE,David West,74,16.3833333333333,16,0.383333333333333,33,28,5,5,0
21700646,2733,GSW,CLE,Shaun Livingston,62,13.0833333333333,13,0.0833333333333322,22,18,4,5,-1
21700646,2738,GSW,CLE,Andre Iguodala,126,24.8166666666667,25,-0.183333333333334,53,52,1,-2,3
21700646,201142,GSW,CLE,Kevin Durant,183,34.8,35,-0.200000000000003,98,88,10,9,1
21700646,201156,GSW,CLE,Nick Young,62,11.9833333333333,12,-0.0166666666666657,29,25,4,3,1
21700646,201939,GSW,CLE,Stephen Curry,172,33.2833333333333,33,0.283333333333331,96,81,15,13,2
21700646,202691,GSW,CLE,Klay Thompson,169,34.7166666666667,35,-0.283333333333331,84,74,10,10,0
21700646,203110,GSW,CLE,Draymond Green,193,37.8666666666667,38,-0.133333333333333,96,81,15,14,1
21700646,1626172,GSW,CLE,Kevon Looney,58,12.3333333333333,12,0.333333333333334,28,27,1,3,-2
21700646,1627775,GSW,CLE,Patrick McCaw,34,6.75,7,-0.25,15,20,-5,-5,0
21700646,1628395,GSW,CLE,Jordan Bell,67,13.65,14,-0.35,36,41,-5,-5,0
21700647,2744,IND,UTA,Al Jefferson,73,17.0833333333333,17,0.0833333333333322,36,32,4,6,-2
21700647,201152,IND,UTA,Thaddeus Young,153,35.2833333333333,36,-0.716666666666669,84,70,14,15,-1
21700647,201954,IND,UTA,Darren Collison,111,24.5166666666667,25,-0.483333333333334,60,45,15,14,1
21700647,202362,IND,UTA,Lance Stephenson,80,19.65,20,-0.350000000000001,40,49,-9,-10,1
21700647,202709,IND,UTA,Cory Joseph,123,29.5833333333333,29,0.583333333333336,60,61,-1,1,-2
21700647,202711,IND,UTA,Bojan Bogdanovic,121,27.2333333333333,28,-0.766666666666666,67,50,17,17,0
21700647,203506,IND,UTA,Victor Oladipo,151,34.5666666666667,35,-0.433333333333337,88,61,27,27,0
21700647,1626202,IND,UTA,Joe Young,27,6.48333333333333,7,-0.516666666666668,12,13,-1,-1,0
21700647,1627734,IND,UTA,Domantas Sabonis,128,29.55,30,-0.450000000000003,73,59,14,12,2
21700647,1627816,IND,UTA,Alex Poythress,5,1.06666666666667,1,0.0666666666666667,0,3,-3,-3,0
21700647,1628387,IND,UTA,Ike Anigbogu,5,1.06666666666667,1,0.0666666666666667,0,3,-3,-3,0
21700647,1628388,IND,UTA,TJ Leaf,53,12.4166666666667,12,0.416666666666666,25,24,1,0,1
21700647,2207,UTA,IND,Joe Johnson,116,26.4833333333333,26,0.483333333333334,49,62,-13,-13,0
21700647,201937,UTA,IND,Ricky Rubio,95,22.45,23,-0.550000000000001,39,54,-15,-13,-2
21700647,201973,UTA,IND,Jonas Jerebko,90,21.2166666666667,22,-0.783333333333331,45,47,-2,-2,0
21700647,202324,UTA,IND,Derrick Favors,132,29.8166666666667,29,0.816666666666663,47,77,-30,-30,0
21700647,202327,UTA,IND,Ekpe Udoh,74,17.8833333333333,19,-1.11666666666667,47,32,15,15,0
21700647,202692,UTA,IND,Alec Burks,59,14.35,14,0.350000000000001,34,28,6,6,0
21700647,203526,UTA,IND,Raul Neto,48,11.35,12,-0.65,29,25,4,4,0
21700647,203918,UTA,IND,Rodney Hood,92,20.7166666666667,21,-0.283333333333335,35,44,-9,-9,0
21700647,204060,UTA,IND,Joe Ingles,90,20.05,20,0.0499999999999972,33,53,-20,-20,0
21700647,1626220,UTA,IND,Royce O'Neale,88,20.9,21,-0.100000000000001,50,41,9,5,4
21700647,1628378,UTA,IND,Donovan Mitchell,146,33.2833333333333,33,0.283333333333331,62,82,-20,-18,-2
21700648,2772,HOU,LAC,Trevor Ariza,164,33.85,34,-0.150000000000006,73,84,-11,-13,2
21700648,101108,HOU,LAC,Chris Paul,156,33.9833333333333,35,-1.01666666666667,72,79,-7,-10,3
21700648,101123,HOU,LAC,Gerald Green,117,24.35,24,0.350000000000001,53,49,4,5,-1
21700648,200782,HOU,LAC,PJ Tucker,102,21.0833333333333,22,-0.916666666666664,42,49,-7,-4,-3
21700648,201569,HOU,LAC,Eric Gordon,165,33.9166666666667,34,-0.0833333333333286,74,89,-15,-15,0
21700648,201583,HOU,LAC,Ryan Anderson,129,25.25,25,0.25,66,73,-7,-8,1
21700648,201601,HOU,LAC,Luc Mbah a Moute,127,26.15,26,0.149999999999999,48,58,-10,-8,-2
21700648,203991,HOU,LAC,Clint Capela,133,28.2,28,0.199999999999999,59,69,-10,-10,0
21700648,204028,HOU,LAC,Tarik Black,50,9.96666666666667,11,-1.03333333333333,21,15,6,6,0
21700648,1626154,HOU,LAC,RJ Hunter,2,0.5,1,-0.5,2,0,2,2,0
21700648,101150,LAC,HOU,Lou Williams,190,38.8833333333333,40,-1.11666666666667,103,87,16,16,0
21700648,201933,LAC,HOU,Blake Griffin,171,34.1666666666667,35,-0.833333333333336,87,74,13,11,2
21700648,202325,LAC,HOU,Wesley Johnson,142,30.35,31,-0.649999999999999,60,55,5,5,0
21700648,203186,LAC,HOU,Willie Reed,48,9.65,10,-0.350000000000001,30,31,-1,-3,2
21700648,1626149,LAC,HOU,Montrezl Harrell,149,32.15,32,0.149999999999999,69,63,6,8,-2
21700648,1626155,LAC,HOU,Sam Dekker,45,10.2666666666667,10,0.266666666666666,15,22,-7,-5,-2
21700648,1627820,LAC,HOU,Tyrone Wallace,160,32.5833333333333,33,-0.416666666666671,87,71,16,16,0
21700648,1628393,LAC,HOU,Jawun Evans,97,19.9,20,-0.100000000000001,41,49,-8,-8,0
21700648,1628414,LAC,HOU,Sindarius Thornwell,1,0.366666666666667,0,0.366666666666667,,0,,0,
21700648,1628462,LAC,HOU,Milos Teodosic,142,28.9333333333333,29,-0.0666666666666664,73,58,15,15,0
21700649,2037,MIN,ORL,Jamal Crawford,89,18.4833333333333,18,0.483333333333334,39,47,-8,-7,-1
21700649,201952,MIN,ORL,Jeff Teague,169,35.5,35,0.5,78,77,1,1,0
21700649,201959,MIN,ORL,Taj Gibson,180,38.4166666666667,38,0.416666666666664,80,86,-6,-9,3
21700649,202357,MIN,ORL,Nemanja Bjelica,25,4.53333333333333,5,-0.466666666666667,11,9,2,2,0
21700649,202710,MIN,ORL,Jimmy Butler,183,38.8,39,-0.200000000000003,80,85,-5,-5,0
21700649,203476,MIN,ORL,Gorgui Dieng,84,17.3,17,0.300000000000001,39,42,-3,-3,0
21700649,203952,MIN,ORL,Andrew Wiggins,167,34.45,34,0.450000000000003,76,76,0,0,0
21700649,1626145,MIN,ORL,Tyus Jones,61,12.45,13,-0.550000000000001,24,31,-7,-7,0
21700649,1626157,MIN,ORL,Karl-Anthony Towns,192,39.8166666666667,40,-0.183333333333337,83,87,-4,-2,-2
21700649,201167,ORL,MIN,Arron Afflalo,27,4.78333333333333,5,-0.216666666666667,11,11,0,-2,2
21700649,201571,ORL,MIN,D.J. Augustin,114,24.0833333333333,24,0.0833333333333322,67,52,15,13,2
21700649,202687,ORL,MIN,Bismack Biyombo,142,29.1833333333333,29,0.183333333333334,60,67,-7,-7,0
21700649,202714,ORL,MIN,Shelvin Mack,22,4.86666666666667,5,-0.133333333333333,11,8,3,3,0
21700649,203095,ORL,MIN,Evan Fournier,169,35.5,35,0.5,77,78,-1,-1,0
21700649,203613,ORL,MIN,Jonathon Simmons,150,31.4833333333333,32,-0.516666666666666,69,66,3,3,0
21700649,203901,ORL,MIN,Elfrid Payton,116,23.8666666666667,24,-0.133333333333333,41,50,-9,-7,-2
21700649,203920,ORL,MIN,Khem Birch,87,18.6,19,-0.399999999999999,48,35,13,13,0
21700649,203932,ORL,MIN,Aaron Gordon,182,38.5333333333333,39,-0.466666666666669,85,82,3,7,-4
21700649,1626209,ORL,MIN,Mario Hezonja,87,18.1666666666667,18,0.166666666666664,44,39,5,5,0
21700649,1628411,ORL,MIN,Wes Iwundu,54,10.6833333333333,11,-0.316666666666666,27,22,5,3,2
21700650,201143,BOS,NOP,Al Horford,176,37.3666666666667,38,-0.633333333333333,78,78,0,-2,2
21700650,202681,BOS,NOP,Kyrie Irving,203,40.45,41,-0.549999999999997,89,98,-9,-8,-1
21700650,202694,BOS,NOP,Marcus Morris,120,24.8166666666667,25,-0.183333333333334,52,54,-2,0,-2
21700650,203382,BOS,NOP,Aron Baynes,102,19.0166666666667,19,0.0166666666666657,48,48,0,2,-2
21700650,203499,BOS,NOP,Shane Larkin,19,4.71666666666667,5,-0.283333333333333,12,7,5,5,0
21700650,203935,BOS,NOP,Marcus Smart,150,30.55,30,0.549999999999997,54,72,-18,-19,1
21700650,1626179,BOS,NOP,Terry Rozier,115,25.85,26,-0.149999999999999,50,45,5,5,0
21700650,1627759,BOS,NOP,Jaylen Brown,157,31.8,32,-0.200000000000003,76,67,9,7,2
21700650,1628369,BOS,NOP,Jayson Tatum,135,27.1333333333333,27,0.133333333333333,55,61,-6,-2,-4
21700650,1628400,BOS,NOP,Semi Ojeleye,19,2.75,3,-0.25,8,9,-1,-3,2
21700650,1628464,BOS,NOP,Daniel Theis,94,20.1333333333333,20,0.133333333333333,43,41,2,0,2
21700650,200765,NOP,BOS,Rajon Rondo,157,29.9666666666667,30,-0.0333333333333314,67,74,-7,-7,0
21700650,201950,NOP,BOS,Jrue Holiday,194,41.3333333333333,41,0.333333333333329,87,89,-2,-3,1
21700650,201967,NOP,BOS,Dante Cunningham,87,18.6833333333333,19,-0.316666666666666,38,37,1,-1,2
21700650,202326,NOP,BOS,DeMarcus Cousins,206,42.8166666666667,43,-0.183333333333337,88,93,-5,-6,1
21700650,202734,NOP,BOS,E'Twaun Moore,191,37.4333333333333,38,-0.566666666666663,92,84,8,10,-2
21700650,203076,NOP,BOS,Anthony Davis,224,44.4833333333333,45,-0.516666666666666,106,98,8,11,-3
21700650,203121,NOP,BOS,Darius Miller,86,18.1833333333333,18,0.183333333333334,37,30,7,6,1
21700650,203546,NOP,BOS,Ian Clark,145,31.6833333333333,32,-0.316666666666666,65,60,5,5,0
21700651,1717,DAL,DEN,Dirk Nowitzki,104,22.7666666666667,23,-0.233333333333334,41,50,-9,-9,0
21700651,2734,DAL,DEN,Devin Harris,77,18.7,18,0.699999999999999,33,40,-7,-8,1
21700651,202083,DAL,DEN,Wesley Matthews,171,35.1,35,0.100000000000001,80,73,7,9,-2
21700651,203084,DAL,DEN,Harrison Barnes,176,36.0333333333333,36,0.0333333333333314,83,74,9,8,1
21700651,203939,DAL,DEN,Dwight Powell,92,20.9333333333333,21,-0.0666666666666664,39,49,-10,-10,0
21700651,1626257,DAL,DEN,Salah Mejri,64,12.6666666666667,13,-0.333333333333332,35,25,10,9,1
21700651,1627812,DAL,DEN,Yogi Ferrell,168,35.3,35,0.299999999999997,77,74,3,0,3
21700651,1627858,DAL,DEN,Kyle Collinsworth,42,9.96666666666667,10,-0.0333333333333332,15,23,-8,-9,1
21700651,1628372,DAL,DEN,Dennis Smith Jr.,152,31.4333333333333,31,0.43333333333333,71,70,1,1,0
21700651,1628467,DAL,DEN,Maxi Kleber,79,17.0166666666667,17,0.0166666666666657,36,42,-6,-6,0
21700651,201163,DEN,DAL,Wilson Chandler,183,38.35,38,0.349999999999994,82,88,-6,-2,-4
21700651,203115,DEN,DAL,Will Barton,195,42.0333333333333,42,0.0333333333333314,93,90,3,7,-4
21700651,203486,DEN,DAL,Mason Plumlee,60,14.0166666666667,14,0.0166666666666657,33,24,9,8,1
21700651,203914,DEN,DAL,Gary Harris,174,37.3666666666667,37,0.366666666666667,81,82,-1,1,-2
21700651,203999,DEN,DAL,Nikola Jokic,162,33.7166666666667,33,0.716666666666669,71,76,-5,-2,-3
21700651,1626168,DEN,DAL,Trey Lyles,65,15.1,15,0.0999999999999996,36,26,10,9,1
21700651,1627736,DEN,DAL,Malik Beasley,70,13.9333333333333,14,-0.0666666666666664,26,31,-5,-6,1
21700651,1627750,DEN,DAL,Jamal Murray,150,31.5166666666667,31,0.516666666666666,69,68,1,2,-1
21700651,1628470,DEN,DAL,Torrey Craig,66,13.8833333333333,14,-0.116666666666667,29,25,4,-2,6
21700652,2199,PHX,POR,Tyson Chandler,109,22.5333333333333,23,-0.466666666666669,53,58,-5,-5,0
21700652,201162,PHX,POR,Jared Dudley,64,15.3,15,0.299999999999999,36,29,7,7,0
21700652,203458,PHX,POR,Alex Len,111,25.2166666666667,25,0.216666666666669,58,60,-2,-2,0
21700652,203477,PHX,POR,Isaiah Canaan,104,23.5666666666667,24,-0.433333333333334,59,54,5,7,-2
21700652,203584,PHX,POR,Troy Daniels,144,32.25,32,0.25,78,73,5,5,0
21700652,1626164,PHX,POR,Devin Booker,192,40.7666666666667,41,-0.233333333333334,101,107,-6,-6,0
21700652,1627733,PHX,POR,Dragan Bender,156,32.45,33,-0.550000000000004,75,89,-14,-14,0
21700652,1627755,PHX,POR,Tyler Ulis,116,24.1833333333333,24,0.18333333333333,52,64,-12,-14,2
21700652,1628367,PHX,POR,Josh Jackson,104,22.4833333333333,23,-0.516666666666666,43,56,-13,-13,0
21700652,202323,POR,PHX,Evan Turner,130,26.9333333333333,27,-0.06666666666667,71,65,6,5,1
21700652,202329,POR,PHX,Al-Farouq Aminu,139,27.7,28,-0.300000000000001,74,67,7,8,-1
21700652,202334,POR,PHX,Ed Davis,81,20.05,20,0.0500000000000007,44,44,0,-1,1
21700652,203081,POR,PHX,Damian Lillard,170,35.7666666666667,36,-0.233333333333334,91,80,11,11,0
21700652,203086,POR,PHX,Meyers Leonard,31,5.88333333333333,6,-0.116666666666667,17,11,6,7,-1
21700652,203090,POR,PHX,Maurice Harkless,16,4.13333333333333,4,0.133333333333333,7,16,-9,-8,-1
21700652,203468,POR,PHX,CJ McCollum,170,35.7666666666667,36,-0.233333333333334,91,80,11,11,0
21700652,203894,POR,PHX,Shabazz Napier,87,20.4333333333333,20,0.433333333333334,57,43,14,14,0
21700652,203994,POR,PHX,Jusuf Nurkic,108,21.8166666666667,22,-0.183333333333334,57,56,1,1,0
21700652,1626192,POR,PHX,Pat Connaughton,87,20.2166666666667,20,0.216666666666669,37,49,-12,-12,0
21700652,1628380,POR,PHX,Zach Collins,81,20.05,20,0.0500000000000007,44,44,0,-1,1
21700653,101133,WAS,CHA,Ian Mahinmi,41,8.76666666666667,9,-0.233333333333334,22,23,-1,-1,0
21700653,101162,WAS,CHA,Marcin Gortat,100,19.6666666666667,20,-0.333333333333336,40,62,-22,-23,1
21700653,201160,WAS,CHA,Jason Smith,71,13.4,14,-0.600000000000001,33,33,0,0,0
21700653,201975,WAS,CHA,Jodie Meeks,99,19.9333333333333,20,-0.06666666666667,46,54,-8,-10,2
21700653,202322,WAS,CHA,John Wall,121,24.2666666666667,24,0.266666666666666,52,75,-23,-20,-3
21700653,202693,WAS,CHA,Markieff Morris,73,15.25,15,0.25,28,38,-10,-10,0
21700653,203078,WAS,CHA,Bradley Beal,139,27.6333333333333,28,-0.366666666666667,62,79,-17,-14,-3
21700653,203107,WAS,CHA,Tomas Satoransky,128,25.45,26,-0.550000000000001,58,67,-9,-13,4
21700653,203118,WAS,CHA,Mike Scott,120,25.2333333333333,25,0.233333333333334,61,72,-11,-8,-3
21700653,203490,WAS,CHA,Otto Porter Jr.,115,22.7333333333333,23,-0.266666666666666,49,74,-25,-24,-1
21700653,204025,WAS,CHA,Tim Frazier,14,2.8,3,-0.2,8,9,-1,1,-2
21700653,1626162,WAS,CHA,Kelly Oubre Jr.,131,26.3333333333333,27,-0.666666666666668,65,62,3,3,0
21700653,1626191,WAS,CHA,Chris McCullough,38,6.36666666666667,7,-0.633333333333334,16,17,-1,-1,0
21700653,2730,CHA,WAS,Dwight Howard,146,28.7833333333333,29,-0.216666666666669,80,62,18,17,1
21700653,101107,CHA,WAS,Marvin Williams,107,21.3833333333333,22,-0.616666666666667,70,44,26,25,1
21700653,201587,CHA,WAS,Nicolas Batum,129,25.9,26,-0.100000000000001,75,55,20,17,3
21700653,202689,CHA,WAS,Kemba Walker,141,28.8,29,-0.200000000000003,79,64,15,14,1
21700653,202933,CHA,WAS,Julyan Stone,15,2.36666666666667,3,-0.633333333333333,8,4,4,4,0
21700653,203077,CHA,WAS,Michael Kidd-Gilchrist,113,22.9833333333333,23,-0.0166666666666657,72,45,27,26,1
21700653,203087,CHA,WAS,Jeremy Lamb,104,21.0333333333333,21,0.0333333333333314,53,57,-4,-4,0
21700653,203487,CHA,WAS,Michael Carter-Williams,73,15.2,15,0.199999999999999,46,36,10,8,2
21700653,203948,CHA,WAS,Johnny O'Bryant III,95,18.8,19,-0.199999999999999,53,48,5,7,-2
21700653,1626163,CHA,WAS,Frank Kaminsky,116,23.8166666666667,24,-0.183333333333334,55,60,-5,-5,0
21700653,1626203,CHA,WAS,Treveon Graham,109,21.6666666666667,22,-0.333333333333336,58,53,5,7,-2
21700653,1628370,CHA,WAS,Malik Monk,21,3.55,4,-0.45,8,6,2,2,0
21700653,1628407,CHA,WAS,Dwayne Bacon,21,3.55,4,-0.45,8,6,2,2,0
21700654,101141,ATL,NOP,Ersan Ilyasova,128,29,29,0,59,56,3,5,-2
21700654,201158,ATL,NOP,Marco Belinelli,102,24.1833333333333,24,0.183333333333334,57,46,11,13,-2
21700654,203101,ATL,NOP,Miles Plumlee,68,14.85,15,-0.149999999999999,25,31,-6,-6,0
21700654,203145,ATL,NOP,Kent Bazemore,124,27.3666666666667,28,-0.633333333333333,56,56,0,1,-1
21700654,203471,ATL,NOP,Dennis Schroder,151,33.7166666666667,34,-0.283333333333331,76,72,4,2,2
21700654,203473,ATL,NOP,Dewayne Dedmon,88,20.1666666666667,20,0.166666666666668,49,41,8,6,2
21700654,1627098,ATL,NOP,Malcolm Delaney,70,16.9166666666667,16,0.916666666666664,24,22,2,4,-2
21700654,1627752,ATL,NOP,Taurean Prince,158,36,36,0,65,72,-7,-10,3
21700654,1628381,ATL,NOP,John Collins,115,26.9666666666667,26,0.966666666666669,51,48,3,2,1
21700654,1628416,ATL,NOP,Tyler Dorsey,29,5.98333333333333,6,-0.0166666666666666,6,11,-5,-5,0
21700654,1628463,ATL,NOP,Tyler Cavanaugh,22,4.85,5,-0.15,2,10,-8,-7,-1
21700654,2749,NOP,ATL,Jameer Nelson,54,12.3666666666667,12,0.366666666666667,21,16,5,5,0
21700654,200765,NOP,ATL,Rajon Rondo,78,17.0666666666667,17,0.0666666666666664,36,37,-1,0,-1
21700654,201950,NOP,ATL,Jrue Holiday,164,37.0833333333333,37,0.0833333333333357,77,79,-2,-4,2
21700654,201967,NOP,ATL,Dante Cunningham,100,23.0333333333333,23,0.0333333333333314,35,36,-1,0,-1
21700654,202326,NOP,ATL,DeMarcus Cousins,156,35.2666666666667,35,0.266666666666666,70,69,1,-1,2
21700654,202734,NOP,ATL,E'Twaun Moore,95,21.7833333333333,22,-0.216666666666669,49,51,-2,-2,0
21700654,203076,NOP,ATL,Anthony Davis,166,37.7,38,-0.299999999999997,81,83,-2,-1,-1
21700654,203121,NOP,ATL,Darius Miller,132,30.1666666666667,30,0.166666666666664,57,49,8,6,2
21700654,203546,NOP,ATL,Ian Clark,110,25.5333333333333,25,0.533333333333331,39,50,-11,-8,-3
21700655,201960,BKN,SAS,DeMarre Carroll,156,34.7333333333333,34,0.733333333333334,72,72,0,-2,2
21700655,203092,BKN,SAS,Tyler Zeller,72,16.2333333333333,16,0.233333333333334,31,37,-6,-5,-1
21700655,203112,BKN,SAS,Quincy Acy,90,19.0333333333333,19,0.0333333333333314,40,43,-3,1,-4
21700655,203459,BKN,SAS,Allen Crabbe,140,31.2333333333333,31,0.233333333333334,68,68,0,3,-3
21700655,203915,BKN,SAS,Spencer Dinwiddie,155,34.8333333333333,35,-0.166666666666664,73,65,8,0,8
21700655,203925,BKN,SAS,Joe Harris,148,32,32,0,66,59,7,6,1
21700655,1626143,BKN,SAS,Jahlil Okafor,54,12.6166666666667,13,-0.383333333333333,28,20,8,8,0
21700655,1626178,BKN,SAS,Rondae Hollis-Jefferson,84,18.9833333333333,19,-0.0166666666666657,30,43,-13,-12,-1
21700655,1627747,BKN,SAS,Caris LeVert,99,21.7166666666667,21,0.716666666666669,32,49,-17,-15,-2
21700655,1628386,BKN,SAS,Jarrett Allen,82,18.5333333333333,18,0.533333333333331,30,39,-9,-9,0
21700655,2200,SAS,BKN,Pau Gasol,130,29.9166666666667,30,-0.0833333333333322,54,61,-7,-4,-3
21700655,2225,SAS,BKN,Tony Parker,108,24.9166666666667,25,-0.0833333333333357,47,47,0,-1,1
21700655,200746,SAS,BKN,LaMarcus Aldridge,166,37.3333333333333,38,-0.666666666666671,87,74,13,12,1
21700655,201980,SAS,BKN,Danny Green,124,26.9833333333333,27,-0.0166666666666657,52,57,-5,-5,0
21700655,201988,SAS,BKN,Patty Mills,125,26.3833333333333,26,0.383333333333333,57,47,10,9,1
21700655,202722,SAS,BKN,Davis Bertans,93,21.2833333333333,22,-0.716666666666669,43,38,5,6,-1
21700655,203464,SAS,BKN,Brandon Paul,1,0.166666666666667,0,0.166666666666667,,0,,0,
21700655,203530,SAS,BKN,Joffrey Lauvergne,22,5.06666666666667,5,0.0666666666666664,8,7,1,1,0
21700655,203937,SAS,BKN,Kyle Anderson,98,21.7833333333333,22,-0.216666666666669,48,49,-1,-5,4
21700655,1627749,SAS,BKN,Dejounte Murray,106,23.0166666666667,23,0.0166666666666657,52,47,5,5,0
21700655,1627854,SAS,BKN,Bryn Forbes,107,23.0666666666667,23,0.0666666666666664,47,43,4,7,-3
21700656,101139,TOR,DET,CJ Miles,120,25.8166666666667,26,-0.183333333333334,53,50,3,3,0
21700656,200768,TOR,DET,Kyle Lowry,150,32.2,32,0.200000000000003,63,55,8,8,0
21700656,201586,TOR,DET,Serge Ibaka,110,23.55,24,-0.449999999999999,44,41,3,3,0
21700656,201942,TOR,DET,DeMar DeRozan,177,37.05,37,0.0499999999999972,73,66,7,5,2
21700656,202685,TOR,DET,Jonas Valanciunas,130,27.2833333333333,27,0.283333333333331,52,49,3,3,0
21700656,203512,TOR,DET,Lucas Nogueira,18,4.35,4,0.35,11,15,-4,-4,0
21700656,1626153,TOR,DET,Delon Wright,110,23.65,24,-0.350000000000001,50,48,2,4,-2
21700656,1626181,TOR,DET,Norman Powell,54,12.75,13,-0.25,25,27,-2,0,-2
21700656,1627751,TOR,DET,Jakob Poeltl,76,16.3166666666667,16,0.316666666666666,33,27,6,6,0
21700656,1627783,TOR,DET,Pascal Siakam,82,17.7333333333333,18,-0.266666666666666,38,40,-2,-2,0
21700656,1628384,TOR,DET,OG Anunoby,93,19.05,19,0.0499999999999972,38,37,1,-1,2
21700656,201229,DET,TOR,Anthony Tolliver,132,28.55,29,-0.449999999999999,58,62,-4,-2,-2
21700656,202340,DET,TOR,Avery Bradley,171,35.5333333333333,35,0.533333333333331,64,68,-4,-2,-2
21700656,202397,DET,TOR,Ish Smith,147,31.3833333333333,31,0.383333333333333,53,60,-7,-5,-2
21700656,202699,DET,TOR,Tobias Harris,152,32.05,32,0.0499999999999972,56,64,-8,-8,0
21700656,202779,DET,TOR,Dwight Buycks,77,16.5666666666667,17,-0.433333333333334,38,36,2,0,2
21700656,203083,DET,TOR,Andre Drummond,174,37.5166666666667,38,-0.483333333333334,63,69,-6,-6,0
21700656,203493,DET,TOR,Reggie Bullock,108,23.9,24,-0.100000000000001,44,50,-6,-8,2
21700656,204038,DET,TOR,Langston Galloway,110,23.85,24,-0.149999999999999,51,44,7,5,2
21700656,1626246,DET,TOR,Boban Marjanovic,49,10.4,10,0.399999999999999,28,27,1,1,0
21700657,201577,CHI,GSW,Robin Lopez,107,21.95,22,-0.0499999999999972,41,71,-30,-28,-2
21700657,202703,CHI,GSW,Nikola Mirotic,137,27.4,27,0.399999999999999,75,54,21,25,-4
21700657,203200,CHI,GSW,Justin Holiday,164,32.5,33,-0.5,68,90,-22,-22,0
21700657,203897,CHI,GSW,Zach LaVine,92,19.7833333333333,20,-0.216666666666669,39,55,-16,-16,0
21700657,1626170,CHI,GSW,Jerian Grant,43,8.56666666666667,9,-0.433333333333334,15,24,-9,-7,-2
21700657,1626171,CHI,GSW,Bobby Portis,89,17.6,17,0.600000000000001,56,34,22,22,0
21700657,1627739,CHI,GSW,Kris Dunn,143,29.6666666666667,30,-0.333333333333336,70,71,-1,-3,2
21700657,1627756,CHI,GSW,Denzel Valentine,133,25.5833333333333,26,-0.416666666666668,71,66,5,3,2
21700657,1628021,CHI,GSW,David Nwaba,135,27.0833333333333,27,0.0833333333333322,73,49,24,24,0
21700657,1628374,CHI,GSW,Lauri Markkanen,142,28.7,29,-0.300000000000001,52,81,-29,-33,4
21700657,2561,GSW,CHI,David West,74,14.4666666666667,15,-0.533333333333335,28,44,-16,-16,0
21700657,2585,GSW,CHI,Zaza Pachulia,81,17.3,18,-0.700000000000003,58,29,29,31,-2
21700657,2733,GSW,CHI,Shaun Livingston,74,15.0333333333333,15,0.0333333333333332,30,42,-12,-10,-2
21700657,201142,GSW,CHI,Kevin Durant,178,35.2,35,0.200000000000003,92,73,19,21,-2
21700657,201156,GSW,CHI,Nick Young,97,18.6166666666667,19,-0.383333333333333,29,59,-30,-28,-2
21700657,201580,GSW,CHI,JaVale McGee,16,3.26666666666667,3,0.266666666666667,9,12,-3,-3,0
21700657,201939,GSW,CHI,Stephen Curry,172,34.85,35,-0.150000000000006,93,72,21,21,0
21700657,201956,GSW,CHI,Omri Casspi,86,17.95,18,-0.0500000000000007,37,53,-16,-20,4
21700657,202691,GSW,CHI,Klay Thompson,186,36.9333333333333,37,-0.0666666666666629,98,85,13,14,-1
21700657,1626172,GSW,CHI,Kevon Looney,146,29.6666666666667,30,-0.333333333333336,90,57,33,33,0
21700657,1627775,GSW,CHI,Patrick McCaw,74,15.15,15,0.15,31,32,-1,-6,5
21700657,1628395,GSW,CHI,Jordan Bell,1,0.4,0,0.4,,2,,-2,
21700658,101127,NYK,MEM,Jarrett Jack,126,28.1833333333333,28,0.18333333333333,60,65,-5,-7,2
21700658,201563,NYK,MEM,Michael Beasley,112,23.6,24,-0.399999999999999,52,46,6,8,-2
21700658,201584,NYK,MEM,Courtney Lee,157,34.4666666666667,35,-0.533333333333331,64,76,-12,-10,-2
21700658,202498,NYK,MEM,Lance Thomas,66,14.75,15,-0.25,29,38,-9,-9,0
21700658,202683,NYK,MEM,Enes Kanter,125,27.3666666666667,27,0.366666666666667,56,69,-13,-13,0
21700658,203124,NYK,MEM,Kyle O'Quinn,51,11.15,12,-0.85,20,19,1,3,-2
21700658,203501,NYK,MEM,Tim Hardaway Jr.,123,26.45,26,0.449999999999999,55,54,1,1,0
21700658,203926,NYK,MEM,Doug McDermott,49,10.5833333333333,11,-0.416666666666668,25,28,-3,-5,2
21700658,204001,NYK,MEM,Kristaps Porzingis,150,33.1,33,0.100000000000001,68,76,-8,-10,2
21700658,1627758,NYK,MEM,Ron Baker,48,10.0833333333333,10,0.0833333333333322,27,16,11,11,0
21700658,1628373,NYK,MEM,Frank Ntilikina,93,19.6,20,-0.399999999999999,39,38,1,1,0
21700658,201596,MEM,NYK,Mario Chalmers,102,22.0833333333333,22,0.0833333333333357,56,50,6,6,0
21700658,201936,MEM,NYK,Tyreke Evans,150,33.2833333333333,34,-0.716666666666669,78,63,15,11,4
21700658,203210,MEM,NYK,JaMychal Green,123,26.7833333333333,27,-0.216666666666669,63,60,3,7,-4
21700658,203516,MEM,NYK,James Ennis III,99,20.5833333333333,20,0.583333333333332,36,46,-10,-8,-2
21700658,1626150,MEM,NYK,Andrew Harrison,102,22.4,23,-0.600000000000001,40,45,-5,-3,-2
21700658,1626185,MEM,NYK,Jarell Martin,140,30.8333333333333,31,-0.166666666666664,59,64,-5,-5,0
21700658,1627738,MEM,NYK,Deyonta Davis,112,23.7666666666667,24,-0.233333333333334,51,39,12,10,2
21700658,1627782,MEM,NYK,Wayne Selden,66,13.9666666666667,14,-0.0333333333333332,29,35,-6,-4,-2
21700658,1628397,MEM,NYK,Ivan Rabb,65,14.35,14,0.350000000000001,37,35,2,0,2
21700658,1628415,MEM,NYK,Dillon Brooks,141,31.2833333333333,32,-0.716666666666669,76,58,18,16,2
21700659,201609,MIA,MIL,Goran Dragic,151,32.7333333333333,33,-0.266666666666666,66,79,-13,-9,-4
21700659,201949,MIA,MIL,James Johnson,135,29.2166666666667,29,0.216666666666665,66,58,8,7,1
21700659,201961,MIA,MIL,Wayne Ellington,129,27.7166666666667,28,-0.283333333333331,68,64,4,-1,5
21700659,202355,MIA,MIL,Hassan Whiteside,141,31.7666666666667,32,-0.233333333333334,71,63,8,7,1
21700659,203482,MIA,MIL,Kelly Olynyk,68,15.7333333333333,16,-0.266666666666668,33,35,-2,-1,-1
21700659,1626159,MIA,MIL,Justise Winslow,117,26.3333333333333,27,-0.666666666666668,60,63,-3,-3,0
21700659,1626196,MIA,MIL,Josh Richardson,150,35.0666666666667,35,0.0666666666666629,82,61,21,22,-1
21700659,1627884,MIA,MIL,Derrick Jones Jr.,103,22.2166666666667,22,0.216666666666665,44,39,5,5,0
21700659,1628389,MIA,MIL,Bam Adebayo,81,19.05,19,0.0500000000000007,40,43,-3,-2,-1
21700659,202339,MIL,MIA,Eric Bledsoe,136,30.0166666666667,30,0.0166666666666657,56,65,-9,-9,0
21700659,203089,MIL,MIA,John Henson,147,33.2833333333333,33,0.283333333333331,75,70,5,5,0
21700659,203114,MIL,MIA,Khris Middleton,182,40.3,41,-0.700000000000003,81,83,-2,-2,0
21700659,203503,MIL,MIA,Tony Snell,101,23.7166666666667,24,-0.283333333333331,52,59,-7,-10,3
21700659,203507,MIL,MIA,Giannis Antetokounmpo,174,38.5333333333333,38,0.533333333333331,79,88,-9,-9,0
21700659,203521,MIL,MIA,Matthew Dellavedova,84,18.1166666666667,18,0.116666666666667,48,43,5,5,0
21700659,1627748,MIL,MIA,Thon Maker,63,14.5166666666667,14,0.516666666666666,23,34,-11,-9,-2
21700659,1627763,MIL,MIA,Malcolm Brogdon,133,28.8833333333333,29,-0.116666666666667,59,59,0,0,0
21700659,1628425,MIL,MIA,Sterling Brown,55,12.4666666666667,12,0.466666666666665,32,29,3,4,-1
21700660,201147,LAL,OKC,Corey Brewer,56,12.4833333333333,12,0.483333333333333,22,28,-6,-6,0
21700660,201572,LAL,OKC,Brook Lopez,84,16.7333333333333,17,-0.266666666666666,31,49,-18,-17,-1
21700660,203484,LAL,OKC,Kentavious Caldwell-Pope,67,15,15,0,36,45,-9,-11,2
21700660,203898,LAL,OKC,Tyler Ennis,92,20.0333333333333,20,0.0333333333333314,39,55,-16,-16,0
21700660,203903,LAL,OKC,Jordan Clarkson,98,21.6666666666667,21,0.666666666666664,38,46,-8,-6,-2
21700660,203944,LAL,OKC,Julius Randle,113,23.5333333333333,23,0.533333333333331,49,71,-22,-24,2
21700660,1626204,LAL,OKC,Larry Nance Jr.,100,22.8166666666667,23,-0.183333333333334,37,39,-2,-2,0
21700660,1627742,LAL,OKC,Brandon Ingram,122,25.2166666666667,26,-0.783333333333335,58,71,-13,-13,0
21700660,1627780,LAL,OKC,Gary Payton II,27,5.9,6,-0.0999999999999996,6,10,-4,-4,0
21700660,1627826,LAL,OKC,Ivica Zubac,42,9.18333333333333,10,-0.816666666666666,16,15,1,1,0
21700660,1627936,LAL,OKC,Alex Caruso,72,16.3666666666667,17,-0.633333333333333,26,23,3,3,0
21700660,1628398,LAL,OKC,Kyle Kuzma,97,22.6333333333333,23,-0.366666666666667,47,54,-7,-6,-1
21700660,1628404,LAL,OKC,Josh Hart,120,25.6833333333333,26,-0.316666666666666,45,64,-19,-19,0
21700660,2546,OKC,LAL,Carmelo Anthony,128,27.25,27,0.25,82,55,27,27,0
21700660,101109,OKC,LAL,Raymond Felton,75,17.7166666666667,18,-0.283333333333335,30,30,0,0,0
21700660,201566,OKC,LAL,Russell Westbrook,136,28.1833333333333,28,0.18333333333333,80,60,20,20,0
21700660,202331,OKC,LAL,Paul George,146,30.5166666666667,31,-0.483333333333334,83,66,17,17,0
21700660,202335,OKC,LAL,Patrick Patterson,84,19.1333333333333,20,-0.866666666666667,32,30,2,0,2
21700660,203460,OKC,LAL,Andre Roberson,83,16.8833333333333,17,-0.116666666666667,48,29,19,21,-2
21700660,203500,OKC,LAL,Steven Adams,127,26.3666666666667,26,0.366666666666667,80,58,22,24,-2
21700660,203518,OKC,LAL,Alex Abrines,37,7.88333333333333,8,-0.116666666666667,17,15,2,2,0
21700660,203924,OKC,LAL,Jerami Grant,88,20.1333333333333,20,0.133333333333333,30,37,-7,-7,0
21700660,203962,OKC,LAL,Josh Huestis,59,14.2666666666667,15,-0.733333333333334,28,22,6,6,0
21700660,1626177,OKC,LAL,Dakari Johnson,9,2.01666666666667,3,-0.983333333333333,4,0,4,4,0
21700660,1628390,OKC,LAL,Terrance Ferguson,118,26.9,27,-0.100000000000001,56,48,8,6,2
21700661,2216,SAC,UTA,Zach Randolph,94,22.7,22,0.699999999999999,49,55,-6,-2,-4
21700661,201585,SAC,UTA,Kosta Koufos,92,20.8,22,-1.2,46,55,-9,-15,6
21700661,201588,SAC,UTA,George Hill,160,36.5666666666667,37,-0.433333333333337,83,96,-13,-12,-1
21700661,203992,SAC,UTA,Bogdan Bogdanovic,166,39.2166666666667,39,0.216666666666669,86,94,-8,-6,-2
21700661,1626161,SAC,UTA,Willie Cauley-Stein,157,37.2,37,0.200000000000003,79,87,-8,-8,0
21700661,1627741,SAC,UTA,Buddy Hield,105,24.3,25,-0.699999999999999,54,63,-9,-12,3
21700661,1627781,SAC,UTA,Malachi Richardson,36,8.25,9,-0.75,17,23,-6,-6,0
21700661,1627834,SAC,UTA,Georgios Papagiannis,10,2.06666666666667,2,0.0666666666666669,8,7,1,3,-2
21700661,1628368,SAC,UTA,De'Aaron Fox,152,36.2,36,0.200000000000003,78,86,-8,-8,0
21700661,1628382,SAC,UTA,Justin Jackson,53,12.2,12,0.199999999999999,25,34,-9,-9,0
21700661,2207,UTA,SAC,Joe Johnson,113,26.3,26,0.300000000000001,62,56,6,8,-2
21700661,201937,UTA,SAC,Ricky Rubio,119,28.7,29,-0.300000000000001,71,61,10,12,-2
21700661,201973,UTA,SAC,Jonas Jerebko,47,11.1333333333333,11,0.133333333333333,29,26,3,1,2
21700661,202324,UTA,SAC,Derrick Favors,137,31.8166666666667,31,0.816666666666666,80,72,8,5,3
21700661,202327,UTA,SAC,Ekpe Udoh,68,16.0833333333333,17,-0.916666666666668,40,33,7,10,-3
21700661,203526,UTA,SAC,Raul Neto,53,11.8666666666667,12,-0.133333333333333,29,24,5,4,1
21700661,203918,UTA,SAC,Rodney Hood,140,31.5166666666667,31,0.516666666666666,81,74,7,6,1
21700661,204060,UTA,SAC,Joe Ingles,128,30.4833333333333,30,0.483333333333334,77,64,13,10,3
21700661,1626220,UTA,SAC,Royce O'Neale,76,17.7,18,-0.300000000000001,43,33,10,13,-3
21700661,1628378,UTA,SAC,Donovan Mitchell,144,33.9,34,-0.100000000000001,88,82,6,6,0
21700662,2210,DEN,LAC,Richard Jefferson,83,15.0666666666667,15,0.0666666666666664,33,40,-7,-8,1
21700662,201163,DEN,LAC,Wilson Chandler,170,32.9333333333333,33,-0.0666666666666629,71,68,3,3,0
21700662,202702,DEN,LAC,Kenneth Faried,35,6.66666666666667,7,-0.333333333333334,15,17,-2,0,-2
21700662,203115,DEN,LAC,Will Barton,180,35.1833333333333,35,0.183333333333337,72,75,-3,-6,3
21700662,203486,DEN,LAC,Mason Plumlee,154,30.5166666666667,31,-0.483333333333334,64,67,-3,-5,2
21700662,203914,DEN,LAC,Gary Harris,191,35.8,36,-0.200000000000003,74,79,-5,-6,1
21700662,203999,DEN,LAC,Nikola Jokic,182,34.1833333333333,34,0.183333333333337,71,78,-7,-10,3
21700662,1626144,DEN,LAC,Emmanuel Mudiay,83,14.85,15,-0.149999999999999,37,37,0,2,-2
21700662,1626168,DEN,LAC,Trey Lyles,135,24.6333333333333,25,-0.366666666666667,58,54,4,5,-1
21700662,1627736,DEN,LAC,Malik Beasley,52,10.1666666666667,10,0.166666666666668,25,25,0,0,0
21700662,101150,LAC,DEN,Lou Williams,191,35.8166666666667,36,-0.183333333333337,81,75,6,6,0
21700662,201933,LAC,DEN,Blake Griffin,193,36.4333333333333,36,0.433333333333337,78,79,-1,0,-1
21700662,202325,LAC,DEN,Wesley Johnson,156,28.9666666666667,29,-0.033333333333335,66,63,3,5,-2
21700662,203186,LAC,DEN,Willie Reed,81,16.15,17,-0.850000000000001,37,35,2,5,-3
21700662,1626149,LAC,DEN,Montrezl Harrell,168,31.2166666666667,31,0.216666666666669,69,67,2,0,2
21700662,1626155,LAC,DEN,Sam Dekker,60,11.5666666666667,12,-0.433333333333334,30,25,5,5,0
21700662,1627820,LAC,DEN,Tyrone Wallace,164,31.7333333333333,32,-0.266666666666666,64,71,-7,-7,0
21700662,1628393,LAC,DEN,Jawun Evans,81,15.7833333333333,16,-0.216666666666669,36,39,-3,-2,-1
21700662,1628414,LAC,DEN,Sindarius Thornwell,7,0.666666666666667,1,-0.333333333333333,1,2,-1,-1,0
21700662,1628462,LAC,DEN,Milos Teodosic,164,31.6666666666667,31,0.666666666666664,78,64,14,14,0
21700663,201143,BOS,PHI,Al Horford,149,35.0333333333333,35,0.0333333333333314,55,53,2,-2,4
21700663,202694,BOS,PHI,Marcus Morris,123,27.6666666666667,27,0.666666666666664,46,64,-18,-16,-2
21700663,203382,BOS,PHI,Aron Baynes,60,14.4,15,-0.6,25,35,-10,-8,-2
21700663,203499,BOS,PHI,Shane Larkin,98,22.8666666666667,23,-0.133333333333333,47,48,-1,-3,2
21700663,203935,BOS,PHI,Marcus Smart,146,33.7166666666667,34,-0.283333333333331,53,49,4,6,-2
21700663,1626179,BOS,PHI,Terry Rozier,90,20.1833333333333,20,0.183333333333334,35,48,-13,-11,-2
21700663,1627759,BOS,PHI,Jaylen Brown,144,33.7833333333333,34,-0.216666666666669,56,65,-9,-9,0
21700663,1627846,BOS,PHI,Abdel Nader,15,3.46666666666667,3,0.466666666666667,5,6,-1,-1,0
21700663,1628369,BOS,PHI,Jayson Tatum,153,36.3,37,-0.700000000000003,57,57,0,-2,2
21700663,1628400,BOS,PHI,Semi Ojeleye,12,3.2,3,0.2,7,3,4,4,0
21700663,1628464,BOS,PHI,Daniel Theis,35,7.96666666666667,8,-0.0333333333333332,14,17,-3,-3,0
21700663,101161,PHI,BOS,Amir Johnson,57,12.7166666666667,13,-0.283333333333335,19,19,0,0,0
21700663,201573,PHI,BOS,Jerryd Bayless,104,24.6833333333333,25,-0.316666666666666,57,49,8,8,0
21700663,202344,PHI,BOS,Trevor Booker,62,13.95,14,-0.0500000000000007,39,27,12,10,2
21700663,203496,PHI,BOS,Robert Covington,171,39.8166666666667,40,-0.183333333333337,75,64,11,9,2
21700663,203954,PHI,BOS,Joel Embiid,145,34.7833333333333,35,-0.216666666666669,70,60,10,10,0
21700663,203967,PHI,BOS,Dario Saric,143,33.7666666666667,34,-0.233333333333334,50,53,-3,-1,-2
21700663,204456,PHI,BOS,T.J. McConnell,115,25.2333333333333,26,-0.766666666666666,54,47,7,5,2
21700663,1626147,PHI,BOS,Justin Anderson,67,16.2166666666667,16,0.216666666666665,25,22,3,7,-4
21700663,1627732,PHI,BOS,Ben Simmons,144,33.95,34,-0.0499999999999972,50,53,-3,-3,0
21700663,1627789,PHI,BOS,Timothe Luwawu-Cabarrot,17,3.46666666666667,4,-0.533333333333333,6,6,0,0,0
21700664,2544,CLE,ORL,LeBron James,168,34.5333333333333,35,-0.466666666666669,69,72,-3,-4,1
21700664,2548,CLE,ORL,Dwyane Wade,93,18.0333333333333,18,0.0333333333333314,42,40,2,2,0
21700664,2594,CLE,ORL,Kyle Korver,88,16.7666666666667,17,-0.233333333333334,41,36,5,4,1
21700664,2747,CLE,ORL,JR Smith,136,29.75,30,-0.25,57,63,-6,-2,-4
21700664,201145,CLE,ORL,Jeff Green,139,26.9333333333333,27,-0.06666666666667,57,57,0,-3,3
21700664,201565,CLE,ORL,Derrick Rose,67,13.4666666666667,13,0.466666666666665,33,30,3,5,-2
21700664,201567,CLE,ORL,Kevin Love,143,30.8833333333333,31,-0.116666666666667,59,66,-7,-3,-4
21700664,202684,CLE,ORL,Tristan Thompson,92,17.1166666666667,17,0.116666666666667,43,36,7,4,3
21700664,202738,CLE,ORL,Isaiah Thomas,142,29.9666666666667,30,-0.0333333333333314,60,62,-2,-1,-1
21700664,203109,CLE,ORL,Jae Crowder,107,22.55,23,-0.449999999999999,49,48,1,3,-2
21700664,201571,ORL,CLE,D.J. Augustin,88,17.5166666666667,18,-0.483333333333334,34,44,-10,-9,-1
21700664,201578,ORL,CLE,Marreese Speights,29,5.66666666666667,6,-0.333333333333333,12,12,0,-2,2
21700664,202687,ORL,CLE,Bismack Biyombo,125,25.8,26,-0.200000000000003,58,47,11,7,4
21700664,202714,ORL,CLE,Shelvin Mack,58,11.7333333333333,12,-0.266666666666666,26,29,-3,-5,2
21700664,203095,ORL,CLE,Evan Fournier,158,32.65,33,-0.350000000000001,60,68,-8,-7,-1
21700664,203613,ORL,CLE,Jonathon Simmons,170,35.3166666666667,35,0.316666666666663,76,71,5,4,1
21700664,203901,ORL,CLE,Elfrid Payton,147,30.4833333333333,30,0.483333333333334,68,58,10,8,2
21700664,203920,ORL,CLE,Khem Birch,81,16.5333333333333,17,-0.466666666666669,32,43,-11,-6,-5
21700664,203932,ORL,CLE,Aaron Gordon,174,36.0166666666667,36,0.0166666666666657,76,71,5,2,3
21700664,1626209,ORL,CLE,Mario Hezonja,125,24.25,24,0.25,58,55,3,5,-2
21700664,1628411,ORL,CLE,Wes Iwundu,20,4.03333333333333,4,0.0333333333333332,10,12,-2,-2,0
21700665,2403,HOU,MIN,Nene,99,21.6833333333333,22,-0.316666666666666,59,38,21,21,0
21700665,101108,HOU,MIN,Chris Paul,152,34.9166666666667,35,-0.0833333333333286,89,68,21,23,-2
21700665,200782,HOU,MIN,PJ Tucker,151,33.5333333333333,34,-0.466666666666669,90,73,17,19,-2
21700665,201569,HOU,MIN,Eric Gordon,161,35.45,35,0.450000000000003,92,66,26,23,3
21700665,201583,HOU,MIN,Ryan Anderson,126,29.5,29,0.5,84,63,21,20,1
21700665,201601,HOU,MIN,Luc Mbah a Moute,142,32.0333333333333,32,0.0333333333333314,58,67,-9,-5,-4
21700665,201935,HOU,MIN,James Harden,109,25.7166666666667,26,-0.283333333333331,48,55,-7,-11,4
21700665,203991,HOU,MIN,Clint Capela,112,26.2333333333333,26,0.233333333333334,57,60,-3,-3,0
21700665,1626154,HOU,MIN,RJ Hunter,3,0.516666666666667,1,-0.483333333333333,3,0,3,3,0
21700665,2037,MIN,HOU,Jamal Crawford,78,17.8333333333333,18,-0.166666666666668,42,46,-4,0,-4
21700665,201952,MIN,HOU,Jeff Teague,145,32.9166666666667,32,0.916666666666671,61,80,-19,-22,3
21700665,201959,MIN,HOU,Taj Gibson,161,36.9666666666667,37,-0.0333333333333314,67,91,-24,-24,0
21700665,202357,MIN,HOU,Nemanja Bjelica,36,7.3,7,0.300000000000001,21,23,-2,-2,0
21700665,202710,MIN,HOU,Jimmy Butler,183,42.5666666666667,42,0.566666666666663,87,96,-9,-10,1
21700665,203476,MIN,HOU,Gorgui Dieng,64,14.6333333333333,15,-0.366666666666667,27,37,-10,-12,2
21700665,203952,MIN,HOU,Andrew Wiggins,154,34.0833333333333,34,0.0833333333333286,60,88,-28,-31,3
21700665,1626145,MIN,HOU,Tyus Jones,66,15,16,-1,37,36,1,4,-3
21700665,1626157,MIN,HOU,Karl-Anthony Towns,161,36.9333333333333,37,-0.0666666666666629,81,81,0,2,-2
21700665,1627875,MIN,HOU,Marcus Georges-Hunt,7,1.35,2,-0.65,7,2,5,5,0
21700666,2744,IND,POR,Al Jefferson,63,13.8833333333333,14,-0.116666666666667,28,36,-8,-8,0
21700666,201152,IND,POR,Thaddeus Young,171,36.5833333333333,37,-0.416666666666664,67,69,-2,-2,0
21700666,201954,IND,POR,Darren Collison,161,35.4833333333333,36,-0.516666666666666,70,74,-4,-4,0
21700666,202362,IND,POR,Lance Stephenson,52,10.65,10,0.65,16,23,-7,-7,0
21700666,202709,IND,POR,Cory Joseph,122,26.1833333333333,26,0.183333333333334,44,55,-11,-11,0
21700666,202711,IND,POR,Bojan Bogdanovic,117,25.5166666666667,26,-0.483333333333334,47,55,-8,-8,0
21700666,203506,IND,POR,Victor Oladipo,164,35.4666666666667,36,-0.533333333333331,70,66,4,4,0
21700666,1626202,IND,POR,Joe Young,47,9.68333333333333,10,-0.316666666666666,11,24,-13,-13,0
21700666,1627734,IND,POR,Domantas Sabonis,155,33.3,33,0.299999999999997,58,58,0,0,0
21700666,1627816,IND,POR,Alex Poythress,3,0.616666666666667,1,-0.383333333333333,0,3,-3,-3,0
21700666,1628387,IND,POR,Ike Anigbogu,3,0.616666666666667,1,-0.383333333333333,0,3,-3,-3,0
21700666,1628388,IND,POR,TJ Leaf,52,11.35,11,0.35,19,34,-15,-15,0
21700666,202323,POR,IND,Evan Turner,118,25.0666666666667,25,0.0666666666666664,51,45,6,7,-1
21700666,202329,POR,IND,Al-Farouq Aminu,149,31.8833333333333,32,-0.116666666666667,63,56,7,7,0
21700666,202334,POR,IND,Ed Davis,72,15.9166666666667,16,-0.0833333333333322,34,30,4,4,0
21700666,203081,POR,IND,Damian Lillard,184,40.0833333333333,40,0.0833333333333286,85,75,10,10,0
21700666,203468,POR,IND,CJ McCollum,168,35.4666666666667,36,-0.533333333333331,73,61,12,12,0
21700666,203894,POR,IND,Shabazz Napier,136,29.0666666666667,29,0.0666666666666664,60,48,12,12,0
21700666,203994,POR,IND,Jusuf Nurkic,145,30.95,32,-1.05,58,56,2,4,-2
21700666,1626192,POR,IND,Pat Connaughton,61,13.9833333333333,14,-0.0166666666666657,34,29,5,4,1
21700666,1628380,POR,IND,Zach Collins,77,16.9166666666667,16,0.916666666666664,42,30,12,10,2
21700667,2200,SAS,TOR,Pau Gasol,158,34.2,34,0.200000000000003,58,64,-6,-9,3
21700667,2225,SAS,TOR,Tony Parker,75,16.8,17,-0.199999999999999,29,30,-1,1,-2
21700667,200746,SAS,TOR,LaMarcus Aldridge,176,37.6833333333333,37,0.683333333333337,71,68,3,-1,4
21700667,201980,SAS,TOR,Danny Green,107,23.7666666666667,24,-0.233333333333334,28,41,-13,-11,-2
21700667,201988,SAS,TOR,Patty Mills,129,28.3166666666667,28,0.316666666666666,51,56,-5,-5,0
21700667,202722,SAS,TOR,Davis Bertans,84,19.05,19,0.0499999999999972,26,33,-7,-3,-4
21700667,203530,SAS,TOR,Joffrey Lauvergne,20,4.93333333333333,5,-0.0666666666666664,11,7,4,7,-3
21700667,203937,SAS,TOR,Kyle Anderson,140,30.0166666666667,30,0.0166666666666657,58,53,5,5,0
21700667,1627749,SAS,TOR,Dejounte Murray,119,25.95,26,-0.0500000000000007,44,47,-3,-5,2
21700667,1627854,SAS,TOR,Bryn Forbes,87,18.95,19,-0.0499999999999972,39,31,8,6,2
21700667,101139,TOR,SAS,CJ Miles,94,21.5833333333333,21,0.583333333333336,39,32,7,5,2
21700667,200768,TOR,SAS,Kyle Lowry,159,34.4833333333333,35,-0.516666666666666,65,60,5,5,0
21700667,201586,TOR,SAS,Serge Ibaka,138,30,30,0,57,49,8,6,2
21700667,201942,TOR,SAS,DeMar DeRozan,170,36.3666666666667,36,0.366666666666667,63,64,-1,1,-2
21700667,202685,TOR,SAS,Jonas Valanciunas,138,30.05,30,0.0500000000000007,54,51,3,3,0
21700667,1626153,TOR,SAS,Delon Wright,105,21.8666666666667,22,-0.133333333333333,43,43,0,0,0
21700667,1626181,TOR,SAS,Norman Powell,45,10.7666666666667,11,-0.233333333333334,20,19,1,1,0
21700667,1627751,TOR,SAS,Jakob Poeltl,79,17.8,18,-0.199999999999999,32,29,3,3,0
21700667,1627783,TOR,SAS,Pascal Siakam,82,17.9833333333333,18,-0.0166666666666657,29,37,-8,-6,-2
21700667,1628384,TOR,SAS,OG Anunoby,85,18.7666666666667,19,-0.233333333333334,28,31,-3,-3,0
21700668,201609,MIA,BKN,Goran Dragic,144,31.5833333333333,32,-0.416666666666668,64,65,-1,-4,3
21700668,201949,MIA,BKN,James Johnson,112,24.1166666666667,24,0.116666666666667,45,49,-4,-4,0
21700668,201961,MIA,BKN,Wayne Ellington,141,32.85,33,-0.149999999999999,65,73,-8,-7,-1
21700668,202355,MIA,BKN,Hassan Whiteside,144,32.9,33,-0.100000000000001,62,66,-4,-4,0
21700668,203482,MIA,BKN,Kelly Olynyk,108,24.6333333333333,25,-0.366666666666667,54,56,-2,-2,0
21700668,1626159,MIA,BKN,Justise Winslow,106,24.7,25,-0.300000000000001,53,55,-2,-3,1
21700668,1626196,MIA,BKN,Josh Richardson,169,37.4333333333333,37,0.433333333333337,75,81,-6,-3,-3
21700668,1627884,MIA,BKN,Derrick Jones Jr.,81,17.55,18,-0.450000000000003,28,31,-3,-3,0
21700668,1628389,MIA,BKN,Bam Adebayo,60,14.15,14,0.149999999999999,29,29,0,0,0
21700668,201960,BKN,MIA,DeMarre Carroll,140,30.9333333333333,31,-0.06666666666667,64,59,5,5,0
21700668,203092,BKN,MIA,Tyler Zeller,50,10.9833333333333,11,-0.0166666666666657,20,22,-2,-2,0
21700668,203112,BKN,MIA,Quincy Acy,112,24.8333333333333,25,-0.166666666666668,57,43,14,14,0
21700668,203459,BKN,MIA,Allen Crabbe,120,26.5833333333333,27,-0.416666666666668,54,55,-1,0,-1
21700668,203915,BKN,MIA,Spencer Dinwiddie,131,29.2833333333333,29,0.283333333333331,65,60,5,4,1
21700668,203925,BKN,MIA,Joe Harris,99,22.5666666666667,23,-0.433333333333334,51,45,6,5,1
21700668,1626143,BKN,MIA,Jahlil Okafor,32,7.46666666666667,8,-0.533333333333333,13,18,-5,-5,0
21700668,1626156,BKN,MIA,D'Angelo Russell,65,14.4166666666667,14,0.416666666666666,30,27,3,4,-1
21700668,1626178,BKN,MIA,Rondae Hollis-Jefferson,141,32.1666666666667,33,-0.833333333333336,60,63,-3,0,-3
21700668,1627747,BKN,MIA,Caris LeVert,117,27.1833333333333,27,0.183333333333334,64,50,14,11,3
21700668,1628386,BKN,MIA,Jarrett Allen,58,13.5,13,0.5,27,33,-6,-6,0
21700669,101133,WAS,DET,Ian Mahinmi,35,7.96666666666667,8,-0.0333333333333332,14,18,-4,-4,0
21700669,101162,WAS,DET,Marcin Gortat,81,18.55,19,-0.450000000000003,53,48,5,5,0
21700669,201975,WAS,DET,Jodie Meeks,34,7.38333333333333,8,-0.616666666666667,20,10,10,12,-2
21700669,202322,WAS,DET,John Wall,172,36.9333333333333,37,-0.0666666666666629,95,89,6,5,1
21700669,202693,WAS,DET,Markieff Morris,152,31.7333333333333,32,-0.266666666666666,83,78,5,5,0
21700669,203078,WAS,DET,Bradley Beal,186,40.5833333333333,40,0.583333333333329,99,99,0,-2,2
21700669,203107,WAS,DET,Tomas Satoransky,54,11.85,12,-0.15,31,25,6,7,-1
21700669,203118,WAS,DET,Mike Scott,66,15.15,15,0.15,38,35,3,3,0
21700669,203490,WAS,DET,Otto Porter Jr.,179,37.3833333333333,38,-0.616666666666667,98,82,16,14,2
21700669,1626162,WAS,DET,Kelly Oubre Jr.,146,31.55,31,0.549999999999997,79,76,3,5,-2
21700669,201229,DET,WAS,Anthony Tolliver,100,21.05,21,0.0500000000000007,59,61,-2,-4,2
21700669,202340,DET,WAS,Avery Bradley,133,29.5,29,0.5,68,74,-6,-6,0
21700669,202397,DET,WAS,Ish Smith,158,34.1,35,-0.899999999999999,81,86,-5,-5,0
21700669,202699,DET,WAS,Tobias Harris,140,31.3,31,0.299999999999997,68,76,-8,-6,-2
21700669,202779,DET,WAS,Dwight Buycks,32,6.63333333333333,7,-0.366666666666667,10,19,-9,-9,0
21700669,203083,DET,WAS,Andre Drummond,193,42.8333333333333,43,-0.166666666666671,106,103,3,3,0
21700669,203493,DET,WAS,Reggie Bullock,108,23.6166666666667,24,-0.383333333333333,47,54,-7,-5,-2
21700669,203961,DET,WAS,Eric Moreland,24,4.7,5,-0.3,6,15,-9,-11,2
21700669,204038,DET,WAS,Langston Galloway,54,11.4666666666667,11,0.466666666666667,27,30,-3,-5,2
21700669,1626169,DET,WAS,Stanley Johnson,57,11.8166666666667,12,-0.183333333333334,38,31,7,7,0
21700669,1627740,DET,WAS,Henry Ellenson,4,0.283333333333333,0,0.283333333333333,0,4,-4,-2,-2
21700669,1628379,DET,WAS,Luke Kennard,102,21.7833333333333,22,-0.216666666666669,50,57,-7,-7,0
21700670,1713,SAC,MEM,Vince Carter,120,23.7666666666667,23,0.766666666666666,43,65,-22,-22,0
21700670,2216,SAC,MEM,Zach Randolph,86,18.5333333333333,19,-0.466666666666665,21,35,-14,-14,0
21700670,202066,SAC,MEM,Garrett Temple,102,20.2166666666667,20,0.216666666666669,42,39,3,4,-1
21700670,203992,SAC,MEM,Bogdan Bogdanovic,124,28.2166666666667,29,-0.783333333333331,48,58,-10,-10,0
21700670,1626161,SAC,MEM,Willie Cauley-Stein,113,26.2666666666667,27,-0.733333333333334,51,54,-3,-3,0
21700670,1627741,SAC,MEM,Buddy Hield,124,26.0833333333333,26,0.0833333333333357,49,56,-7,-6,-1
21700670,1627746,SAC,MEM,Skal Labissiere,141,28.7666666666667,29,-0.233333333333334,66,69,-3,-1,-2
21700670,1627834,SAC,MEM,Georgios Papagiannis,81,16.0833333333333,16,0.0833333333333322,35,41,-6,-6,0
21700670,1628368,SAC,MEM,De'Aaron Fox,148,31.8,32,-0.200000000000003,59,72,-13,-15,2
21700670,1628382,SAC,MEM,Justin Jackson,81,18.5166666666667,19,-0.483333333333334,26,41,-15,-17,2
21700670,201188,MEM,SAC,Marc Gasol,117,26.2833333333333,27,-0.716666666666669,51,36,15,19,-4
21700670,201596,MEM,SAC,Mario Chalmers,111,21.8,21,0.800000000000001,46,34,12,12,0
21700670,201936,MEM,SAC,Tyreke Evans,120,27.55,28,-0.449999999999999,55,48,7,9,-2
21700670,203210,MEM,SAC,JaMychal Green,111,25.1666666666667,26,-0.833333333333336,49,46,3,3,0
21700670,203463,MEM,SAC,Ben McLemore,131,26.8833333333333,27,-0.116666666666667,68,59,9,9,0
21700670,1626150,MEM,SAC,Andrew Harrison,92,21.6333333333333,22,-0.366666666666667,56,48,8,6,2
21700670,1626185,MEM,SAC,Jarell Martin,107,21.0833333333333,21,0.0833333333333322,55,40,15,15,0
21700670,1627738,MEM,SAC,Deyonta Davis,97,19.3,19,0.300000000000001,47,46,1,-3,4
21700670,1627782,MEM,SAC,Wayne Selden,93,17.85,18,-0.149999999999999,34,28,6,4,2
21700670,1628397,MEM,SAC,Ivan Rabb,16,3.46666666666667,4,-0.533333333333333,10,8,2,2,0
21700670,1628415,MEM,SAC,Dillon Brooks,125,27.2333333333333,28,-0.766666666666666,59,47,12,14,-2
21700671,2210,DEN,PHX,Richard Jefferson,56,14.2333333333333,14,0.233333333333334,30,39,-9,-9,0
21700671,201163,DEN,PHX,Wilson Chandler,144,32.1666666666667,33,-0.833333333333336,64,68,-4,-4,0
21700671,203115,DEN,PHX,Will Barton,99,22.95,23,-0.0500000000000007,48,58,-10,-10,0
21700671,203486,DEN,PHX,Mason Plumlee,57,13.0666666666667,13,0.0666666666666664,22,28,-6,-5,-1
21700671,203914,DEN,PHX,Gary Harris,158,35.0166666666667,35,0.0166666666666657,75,68,7,5,2
21700671,203999,DEN,PHX,Nikola Jokic,149,34.0666666666667,35,-0.933333333333337,75,78,-3,-1,-2
21700671,1626144,DEN,PHX,Emmanuel Mudiay,38,8.78333333333333,9,-0.216666666666667,21,18,3,5,-2
21700671,1626168,DEN,PHX,Trey Lyles,130,28.4,28,0.399999999999999,60,60,0,0,0
21700671,1627736,DEN,PHX,Malik Beasley,54,12.9666666666667,13,-0.0333333333333332,25,41,-16,-13,-3
21700671,1627750,DEN,PHX,Jamal Murray,155,35.0333333333333,35,0.0333333333333314,69,74,-5,-8,3
21700671,1628470,DEN,PHX,Torrey Craig,10,2.06666666666667,2,0.0666666666666664,11,8,3,0,3
21700671,2199,PHX,DEN,Tyson Chandler,118,26.45,27,-0.549999999999997,54,49,5,3,2
21700671,201162,PHX,DEN,Jared Dudley,78,19.3333333333333,20,-0.666666666666664,52,43,9,7,2
21700671,203458,PHX,DEN,Alex Len,90,21.2,21,0.199999999999999,54,49,5,5,0
21700671,203477,PHX,DEN,Isaiah Canaan,108,25.35,26,-0.649999999999999,61,55,6,6,0
21700671,203584,PHX,DEN,Troy Daniels,59,13.3166666666667,13,0.316666666666666,34,35,-1,1,-2
21700671,203933,PHX,DEN,T.J. Warren,156,34.1666666666667,34,0.166666666666671,75,70,5,5,0
21700671,1626164,PHX,DEN,Devin Booker,153,34.5333333333333,35,-0.466666666666669,74,67,7,7,0
21700671,1627733,PHX,DEN,Dragan Bender,132,28.4166666666667,29,-0.583333333333336,56,57,-1,1,-2
21700671,1627755,PHX,DEN,Tyler Ulis,100,21.9666666666667,22,-0.0333333333333314,45,45,0,0,0
21700671,1628367,PHX,DEN,Josh Jackson,56,14.0166666666667,14,0.0166666666666657,35,30,5,5,0
21700672,101127,NYK,UTA,Jarrett Jack,139,28.5,28,0.5,74,59,15,15,0
21700672,201563,NYK,UTA,Michael Beasley,125,24.55,24,0.550000000000001,55,64,-9,-10,1
21700672,201584,NYK,UTA,Courtney Lee,179,36.1333333333333,36,0.133333333333333,92,81,11,10,1
21700672,202498,NYK,UTA,Lance Thomas,30,6.16666666666667,7,-0.833333333333334,13,17,-4,-6,2
21700672,202683,NYK,UTA,Enes Kanter,124,25.7833333333333,26,-0.216666666666669,67,52,15,19,-4
21700672,203124,NYK,UTA,Kyle O'Quinn,74,15.8166666666667,15,0.816666666666666,32,39,-7,-9,2
21700672,203501,NYK,UTA,Tim Hardaway Jr.,139,27.0166666666667,27,0.0166666666666657,73,63,10,7,3
21700672,203504,NYK,UTA,Trey Burke,75,14.9,15,-0.100000000000001,37,43,-6,-7,1
21700672,203926,NYK,UTA,Doug McDermott,59,13.1666666666667,13,0.166666666666666,26,36,-10,-8,-2
21700672,204001,NYK,UTA,Kristaps Porzingis,157,30.65,31,-0.350000000000001,76,76,0,5,-5
21700672,1627758,NYK,UTA,Ron Baker,65,12.65,13,-0.350000000000001,30,32,-2,0,-2
21700672,1628373,NYK,UTA,Frank Ntilikina,24,4.58333333333333,5,-0.416666666666667,5,13,-8,-6,-2
21700672,2207,UTA,NYK,Joe Johnson,138,27.2666666666667,27,0.266666666666666,68,64,4,3,1
21700672,201937,UTA,NYK,Ricky Rubio,162,32.5166666666667,32,0.516666666666666,84,82,2,-3,5
21700672,201973,UTA,NYK,Jonas Jerebko,57,12.1166666666667,12,0.116666666666667,30,22,8,8,0
21700672,202324,UTA,NYK,Derrick Favors,133,26.6,27,-0.399999999999999,60,75,-15,-15,0
21700672,203497,UTA,NYK,Rudy Gobert,148,29.9833333333333,30,-0.0166666666666657,72,71,1,0,1
21700672,203526,UTA,NYK,Raul Neto,40,8.26666666666667,8,0.266666666666666,18,17,1,5,-4
21700672,203918,UTA,NYK,Rodney Hood,139,29.6833333333333,29,0.683333333333334,64,74,-10,-8,-2
21700672,204060,UTA,NYK,Joe Ingles,152,28.95,29,-0.0500000000000007,73,62,11,10,1
21700672,1626220,UTA,NYK,Royce O'Neale,39,8.08333333333333,8,0.0833333333333339,18,20,-2,-2,0
21700672,1628378,UTA,NYK,Donovan Mitchell,182,36.45,37,-0.549999999999997,88,93,-5,-8,3
21700673,201147,LAL,IND,Corey Brewer,140,29.6833333333333,29,0.683333333333334,51,55,-4,-4,0
21700673,201572,LAL,IND,Brook Lopez,72,15.9833333333333,16,-0.0166666666666657,30,20,10,10,0
21700673,203898,LAL,IND,Tyler Ennis,97,20.3,20,0.299999999999997,35,47,-12,-12,0
21700673,203903,LAL,IND,Jordan Clarkson,150,33.2,34,-0.800000000000004,80,55,25,25,0
21700673,203944,LAL,IND,Julius Randle,97,20.1333333333333,20,0.133333333333333,32,41,-9,-9,0
21700673,1626204,LAL,IND,Larry Nance Jr.,122,27.4833333333333,28,-0.516666666666666,67,45,22,22,0
21700673,1627936,LAL,IND,Alex Caruso,122,27.3166666666667,28,-0.683333333333337,64,39,25,25,0
21700673,1628398,LAL,IND,Kyle Kuzma,147,31.6333333333333,32,-0.366666666666667,69,66,3,3,0
21700673,1628404,LAL,IND,Josh Hart,148,32.35,33,-0.649999999999999,67,62,5,5,0
21700673,2744,IND,LAL,Al Jefferson,61,13.35,13,0.349999999999998,20,24,-4,-4,0
21700673,201152,IND,LAL,Thaddeus Young,162,35.2666666666667,35,0.266666666666666,68,77,-9,-9,0
21700673,201954,IND,LAL,Darren Collison,119,25.2666666666667,25,0.266666666666666,52,52,0,0,0
21700673,202362,IND,LAL,Lance Stephenson,73,15.8333333333333,16,-0.166666666666666,24,31,-7,-7,0
21700673,202709,IND,LAL,Cory Joseph,128,28.6333333333333,29,-0.366666666666667,45,66,-21,-21,0
21700673,202711,IND,LAL,Bojan Bogdanovic,144,31.1833333333333,32,-0.816666666666666,58,60,-2,-2,0
21700673,203506,IND,LAL,Victor Oladipo,164,35.5,36,-0.5,68,72,-4,-4,0
21700673,1626202,IND,LAL,Joe Young,43,9.38333333333333,10,-0.616666666666667,16,18,-2,-2,0
21700673,1627734,IND,LAL,Domantas Sabonis,158,34.2666666666667,35,-0.733333333333334,66,75,-9,-9,0
21700673,1627816,IND,LAL,Alex Poythress,3,0.466666666666667,1,-0.533333333333333,0,2,-2,-2,0
21700673,1628388,IND,LAL,TJ Leaf,40,8.93333333333333,9,-0.0666666666666664,13,18,-5,-5,0
21700674,2544,CLE,OKC,LeBron James,202,38.3666666666667,38,0.366666666666667,91,126,-35,-33,-2
21700674,2548,CLE,OKC,Dwyane Wade,102,19.9166666666667,20,-0.0833333333333357,43,53,-10,-5,-5
21700674,2594,CLE,OKC,Kyle Korver,77,14.7333333333333,15,-0.266666666666666,37,36,1,1,0
21700674,2747,CLE,OKC,JR Smith,138,25.85,26,-0.149999999999999,67,89,-22,-21,-1
21700674,101112,CLE,OKC,Channing Frye,45,8.75,9,-0.25,30,28,2,4,-2
21700674,101181,CLE,OKC,Jose Calderon,17,3.86666666666667,4,-0.133333333333333,13,11,2,2,0
21700674,201145,CLE,OKC,Jeff Green,115,21.4666666666667,22,-0.533333333333331,53,59,-6,-5,-1
21700674,201565,CLE,OKC,Derrick Rose,109,20.6166666666667,21,-0.383333333333333,56,55,1,-1,2
21700674,201567,CLE,OKC,Kevin Love,16,3.06666666666667,3,0.0666666666666664,4,10,-6,-5,-1
21700674,202684,CLE,OKC,Tristan Thompson,128,25.2833333333333,26,-0.716666666666669,70,76,-6,-11,5
21700674,202738,CLE,OKC,Isaiah Thomas,140,25.9,26,-0.100000000000001,70,92,-22,-24,2
21700674,203109,CLE,OKC,Jae Crowder,144,26.3166666666667,26,0.316666666666666,73,94,-21,-24,3
21700674,1626224,CLE,OKC,Cedi Osman,17,3.86666666666667,4,-0.133333333333333,13,11,2,2,0
21700674,2546,OKC,CLE,Carmelo Anthony,151,28.2,28,0.200000000000003,98,76,22,22,0
21700674,101109,OKC,CLE,Raymond Felton,85,16.4666666666667,17,-0.533333333333331,45,39,6,6,0
21700674,201566,OKC,CLE,Russell Westbrook,187,34.7333333333333,35,-0.266666666666666,120,92,28,26,2
21700674,202331,OKC,CLE,Paul George,173,32.2666666666667,32,0.266666666666666,111,80,31,29,2
21700674,202335,OKC,CLE,Patrick Patterson,101,19.45,19,0.449999999999999,54,50,4,8,-4
21700674,203460,OKC,CLE,Andre Roberson,152,30.05,30,0.0499999999999972,98,67,31,32,-1
21700674,203500,OKC,CLE,Steven Adams,151,29,29,0,95,62,33,30,3
21700674,203518,OKC,CLE,Alex Abrines,7,1.3,2,-0.7,2,7,-5,-5,0
21700674,203924,OKC,CLE,Jerami Grant,115,22.0166666666667,22,0.0166666666666657,63,67,-4,-6,2
21700674,203962,OKC,CLE,Josh Huestis,71,12.65,13,-0.35,32,43,-11,-9,-2
21700674,1626177,OKC,CLE,Dakari Johnson,7,1.3,2,-0.7,2,7,-5,-5,0
21700674,1628390,OKC,CLE,Terrance Ferguson,50,10.5666666666667,11,-0.433333333333334,20,30,-10,-8,-2
21700675,101141,ATL,CHI,Ersan Ilyasova,108,23.0166666666667,23,0.0166666666666657,38,53,-15,-15,0
21700675,201158,ATL,CHI,Marco Belinelli,130,25.5666666666667,26,-0.433333333333334,43,64,-21,-20,-1
21700675,202337,ATL,CHI,Luke Babbitt,20,4.91666666666667,5,-0.0833333333333339,22,13,9,9,0
21700675,203101,ATL,CHI,Miles Plumlee,60,14.1,15,-0.9,24,32,-8,-8,0
21700675,203145,ATL,CHI,Kent Bazemore,124,26.2,26,0.200000000000003,42,59,-17,-15,-2
21700675,203471,ATL,CHI,Dennis Schroder,149,31.8,31,0.799999999999997,57,72,-15,-15,0
21700675,203473,ATL,CHI,Dewayne Dedmon,115,23.4,23,0.399999999999999,41,49,-8,-5,-3
21700675,203488,ATL,CHI,Mike Muscala,55,11.5666666666667,11,0.566666666666666,34,32,2,1,1
21700675,203705,ATL,CHI,Josh Magette,20,4.91666666666667,5,-0.0833333333333339,22,13,9,9,0
21700675,1627098,ATL,CHI,Malcolm Delaney,75,15.5666666666667,16,-0.433333333333334,32,33,-1,-1,0
21700675,1627752,ATL,CHI,Taurean Prince,90,19.0833333333333,19,0.0833333333333357,29,48,-19,-20,1
21700675,1628381,ATL,CHI,John Collins,114,23.9166666666667,24,-0.0833333333333357,57,60,-3,-5,2
21700675,1628416,ATL,CHI,Tyler Dorsey,70,15.95,16,-0.0500000000000007,44,37,7,5,2
21700675,201577,CHI,ATL,Robin Lopez,116,25.1333333333333,25,0.133333333333333,54,45,9,10,-1
21700675,202347,CHI,ATL,Quincy Pondexter,10,2.35,2,0.35,6,10,-4,-2,-2
21700675,202703,CHI,ATL,Nikola Mirotic,98,19.6,20,-0.399999999999999,53,40,13,11,2
21700675,203200,CHI,ATL,Justin Holiday,151,32.6333333333333,33,-0.366666666666667,82,71,11,13,-2
21700675,203897,CHI,ATL,Zach LaVine,84,18.2666666666667,18,0.266666666666666,37,32,5,5,0
21700675,1626170,CHI,ATL,Jerian Grant,118,26.05,26,0.0499999999999972,54,47,7,7,0
21700675,1626171,CHI,ATL,Bobby Portis,90,18.3,18,0.300000000000001,42,35,7,8,-1
21700675,1627756,CHI,ATL,Denzel Valentine,107,22.1333333333333,22,0.133333333333333,53,36,17,15,2
21700675,1627853,CHI,ATL,Ryan Arcidiacono,108,21.95,22,-0.0499999999999972,59,50,9,9,0
21700675,1628021,CHI,ATL,David Nwaba,110,22.9666666666667,23,-0.0333333333333314,54,55,-1,-1,0
21700675,1628374,CHI,ATL,Lauri Markkanen,138,30.6166666666667,30,0.616666666666667,71,64,7,5,2
21700676,201949,MIA,CHA,James Johnson,136,29.2,29,0.199999999999999,75,65,10,10,0
21700676,201961,MIA,CHA,Wayne Ellington,169,36.4833333333333,36,0.483333333333334,82,82,0,-2,2
21700676,202355,MIA,CHA,Hassan Whiteside,111,24.3666666666667,24,0.366666666666667,54,59,-5,-7,2
21700676,203482,MIA,CHA,Kelly Olynyk,107,24.25,24,0.25,50,49,1,1,0
21700676,1626159,MIA,CHA,Justise Winslow,110,25.2166666666667,25,0.216666666666665,43,57,-14,-13,-1
21700676,1626196,MIA,CHA,Josh Richardson,165,35.8,36,-0.200000000000003,87,77,10,9,1
21700676,1627884,MIA,CHA,Derrick Jones Jr.,93,20.15,20,0.149999999999999,46,44,2,0,2
21700676,1628389,MIA,CHA,Bam Adebayo,107,23.6333333333333,24,-0.366666666666667,52,46,6,8,-2
21700676,1628476,MIA,CHA,Derrick Walton Jr.,92,20.9,21,-0.100000000000001,41,46,-5,-1,-4
21700676,2730,CHA,MIA,Dwight Howard,161,35.2833333333333,35,0.283333333333331,79,83,-4,-2,-2
21700676,101107,CHA,MIA,Marvin Williams,129,27.6,28,-0.399999999999999,62,71,-9,-10,1
21700676,201587,CHA,MIA,Nicolas Batum,153,33.4,33,0.399999999999999,80,77,3,3,0
21700676,202689,CHA,MIA,Kemba Walker,166,36.4666666666667,37,-0.533333333333331,82,83,-1,1,-2
21700676,203077,CHA,MIA,Michael Kidd-Gilchrist,128,27.9166666666667,28,-0.0833333333333357,64,72,-8,-8,0
21700676,203087,CHA,MIA,Jeremy Lamb,90,20.0833333333333,20,0.0833333333333357,41,34,7,7,0
21700676,203487,CHA,MIA,Michael Carter-Williams,52,11.5333333333333,12,-0.466666666666667,23,23,0,-2,2
21700676,203948,CHA,MIA,Johnny O'Bryant III,57,12.7166666666667,13,-0.283333333333333,26,23,3,1,2
21700676,1626163,CHA,MIA,Frank Kaminsky,89,20.4,20,0.399999999999999,43,35,8,9,-1
21700676,1626203,CHA,MIA,Treveon Graham,65,14.6,15,-0.4,25,29,-4,-4,0
21700677,200765,NOP,MEM,Rajon Rondo,128,28.5333333333333,28,0.533333333333331,66,68,-2,-2,0
21700677,201950,NOP,MEM,Jrue Holiday,161,36.8166666666667,37,-0.183333333333337,90,74,16,14,2
21700677,201967,NOP,MEM,Dante Cunningham,84,18.8,19,-0.200000000000003,43,43,0,0,0
21700677,202326,NOP,MEM,DeMarcus Cousins,171,38.4166666666667,39,-0.583333333333329,91,80,11,9,2
21700677,202734,NOP,MEM,E'Twaun Moore,146,33.6166666666667,33,0.616666666666667,77,75,2,2,0
21700677,203076,NOP,MEM,Anthony Davis,169,38.6833333333333,38,0.683333333333337,88,85,3,5,-2
21700677,203121,NOP,MEM,Darius Miller,135,30.55,31,-0.450000000000003,66,66,0,2,-2
21700677,203546,NOP,MEM,Ian Clark,66,14.3333333333333,15,-0.666666666666668,34,29,5,5,0
21700677,201188,MEM,NOP,Marc Gasol,150,34.3666666666667,34,0.36666666666666,78,75,3,2,1
21700677,201936,MEM,NOP,Tyreke Evans,158,35.6,35,0.599999999999994,74,79,-5,-3,-2
21700677,203210,MEM,NOP,JaMychal Green,113,24.3833333333333,24,0.383333333333333,53,56,-3,-3,0
21700677,203463,MEM,NOP,Ben McLemore,98,22.3166666666667,22,0.316666666666666,46,49,-3,-4,1
21700677,1626185,MEM,NOP,Jarell Martin,151,34.9333333333333,35,-0.0666666666666629,78,87,-9,-11,2
21700677,1627738,MEM,NOP,Deyonta Davis,77,17.7333333333333,18,-0.266666666666666,38,42,-4,-4,0
21700677,1627782,MEM,NOP,Wayne Selden,116,26.6333333333333,27,-0.366666666666667,58,64,-6,-3,-3
21700677,1627988,MEM,NOP,Myke Henry,64,13.7666666666667,14,-0.233333333333334,34,37,-3,-4,1
21700677,1628397,MEM,NOP,Ivan Rabb,1,0.05,0,0.05,,1,,0,
21700677,1628415,MEM,NOP,Dillon Brooks,132,29.9666666666667,30,-0.0333333333333314,61,65,-4,-5,1
21700678,1891,MIL,PHI,Jason Terry,36,7.95,8,-0.0500000000000007,12,21,-9,-9,0
21700678,202339,MIL,PHI,Eric Bledsoe,181,38.1166666666667,38,0.116666666666667,75,90,-15,-14,-1
21700678,203089,MIL,PHI,John Henson,101,22.4333333333333,23,-0.566666666666666,43,57,-14,-15,1
21700678,203114,MIL,PHI,Khris Middleton,192,40.0333333333333,40,0.0333333333333314,85,96,-11,-11,0
21700678,203503,MIL,PHI,Tony Snell,181,37.95,38,-0.0499999999999972,79,92,-13,-13,0
21700678,203521,MIL,PHI,Matthew Dellavedova,82,17.45,17,0.450000000000003,33,47,-14,-15,1
21700678,203930,MIL,PHI,Sean Kilpatrick,24,5.93333333333333,6,-0.0666666666666664,7,15,-8,-8,0
21700678,204098,MIL,PHI,Xavier Munford,8,1.83333333333333,2,-0.166666666666667,0,4,-4,-4,0
21700678,1626173,MIL,PHI,Rashad Vaughn,8,1.83333333333333,2,-0.166666666666667,0,4,-4,-4,0
21700678,1627748,MIL,PHI,Thon Maker,75,16.25,16,0.25,36,39,-3,-2,-1
21700678,1627850,MIL,PHI,Marshall Plumlee,50,9.31666666666667,9,0.316666666666666,15,20,-5,-5,0
21700678,1628391,MIL,PHI,D.J. Wilson,8,1.83333333333333,2,-0.166666666666667,0,4,-4,-4,0
21700678,1628425,MIL,PHI,Sterling Brown,184,39.0666666666667,39,0.0666666666666629,85,91,-6,-6,0
21700678,101161,PHI,MIL,Amir Johnson,73,15.5,16,-0.5,35,28,7,6,1
21700678,202344,PHI,MIL,Trevor Booker,75,15.95,16,-0.0500000000000007,41,24,17,19,-2
21700678,203496,PHI,MIL,Robert Covington,133,28.5833333333333,29,-0.416666666666664,78,50,28,28,0
21700678,203923,PHI,MIL,James Young,39,8.31666666666667,8,0.316666666666666,18,13,5,7,-2
21700678,203954,PHI,MIL,Joel Embiid,153,32.5,32,0.5,81,66,15,16,-1
21700678,203967,PHI,MIL,Dario Saric,151,32.05,32,0.0499999999999972,75,70,5,3,2
21700678,204456,PHI,MIL,T.J. McConnell,156,32.7333333333333,32,0.733333333333334,72,60,12,12,0
21700678,1626147,PHI,MIL,Justin Anderson,73,14.6,14,0.600000000000001,27,39,-12,-14,2
21700678,1627732,PHI,MIL,Ben Simmons,141,30.35,31,-0.649999999999999,79,65,14,12,2
21700678,1627789,PHI,MIL,Timothe Luwawu-Cabarrot,136,29.4166666666667,30,-0.583333333333332,74,55,19,21,-2
21700679,2561,GSW,HOU,David West,61,13.7,14,-0.300000000000001,27,24,3,1,2
21700679,2585,GSW,HOU,Zaza Pachulia,75,16.15,16,0.149999999999999,37,40,-3,-3,0
21700679,2733,GSW,HOU,Shaun Livingston,69,15.3833333333333,16,-0.616666666666667,31,31,0,-2,2
21700679,201142,GSW,HOU,Kevin Durant,166,35.0833333333333,35,0.0833333333333286,76,86,-10,-10,0
21700679,201156,GSW,HOU,Nick Young,86,17.2833333333333,18,-0.716666666666665,42,42,0,0,0
21700679,201939,GSW,HOU,Stephen Curry,175,35.55,36,-0.450000000000003,83,94,-11,-11,0
21700679,202691,GSW,HOU,Klay Thompson,172,36.7333333333333,37,-0.266666666666666,78,80,-2,0,-2
21700679,203110,GSW,HOU,Draymond Green,175,35.7666666666667,36,-0.233333333333334,80,87,-7,-5,-2
21700679,1626172,GSW,HOU,Kevon Looney,71,13.0333333333333,13,0.0333333333333332,40,39,1,3,-2
21700679,1627775,GSW,HOU,Patrick McCaw,90,19.9833333333333,20,-0.0166666666666657,46,57,-11,-13,2
21700679,2403,HOU,GSW,Nene,80,16.35,16,0.350000000000001,46,37,9,8,1
21700679,101108,HOU,GSW,Chris Paul,167,34.5666666666667,35,-0.433333333333337,90,83,7,6,1
21700679,200782,HOU,GSW,PJ Tucker,126,26.5166666666667,27,-0.483333333333334,63,59,4,6,-2
21700679,201569,HOU,GSW,Eric Gordon,167,34.45,35,-0.549999999999997,86,72,14,15,-1
21700679,201583,HOU,GSW,Ryan Anderson,148,30.2833333333333,30,0.283333333333335,74,75,-1,-2,1
21700679,201601,HOU,GSW,Luc Mbah a Moute,156,32.0666666666667,33,-0.933333333333337,83,68,15,13,2
21700679,201935,HOU,GSW,James Harden,158,34.35,35,-0.649999999999999,73,77,-4,-6,2
21700679,203991,HOU,GSW,Clint Capela,138,30.0833333333333,30,0.0833333333333322,65,69,-4,0,-4
21700680,201952,MIN,TOR,Jeff Teague,155,33.1333333333333,33,0.133333333333333,80,79,1,5,-4
21700680,201959,MIN,TOR,Taj Gibson,184,40.25,40,0.25,97,91,6,7,-1
21700680,202357,MIN,TOR,Nemanja Bjelica,124,25.7333333333333,26,-0.266666666666666,65,61,4,3,1
21700680,203476,MIN,TOR,Gorgui Dieng,99,20.2666666666667,20,0.266666666666666,46,43,3,6,-3
21700680,203498,MIN,TOR,Shabazz Muhammad,55,11.6,12,-0.399999999999999,27,21,6,7,-1
21700680,203952,MIN,TOR,Andrew Wiggins,167,36.3333333333333,36,0.333333333333329,87,88,-1,-1,0
21700680,1626145,MIN,TOR,Tyus Jones,68,14.8166666666667,15,-0.183333333333334,35,30,5,2,3
21700680,1626157,MIN,TOR,Karl-Anthony Towns,123,27.6666666666667,28,-0.333333333333332,68,66,2,0,2
21700680,1627875,MIN,TOR,Marcus Georges-Hunt,135,29.8666666666667,29,0.866666666666667,65,66,-1,1,-2
21700680,101139,TOR,MIN,CJ Miles,79,15.35,15,0.350000000000001,31,36,-5,-5,0
21700680,200768,TOR,MIN,Kyle Lowry,157,34.0833333333333,34,0.0833333333333286,83,76,7,6,1
21700680,201586,TOR,MIN,Serge Ibaka,147,32.7833333333333,33,-0.216666666666669,79,78,1,0,1
21700680,201942,TOR,MIN,DeMar DeRozan,155,34.1666666666667,34,0.166666666666671,78,83,-5,-3,-2
21700680,202685,TOR,MIN,Jonas Valanciunas,50,11.6,11,0.600000000000001,24,25,-1,1,-2
21700680,203512,TOR,MIN,Lucas Nogueira,49,10.95,11,-0.0500000000000007,26,23,3,3,0
21700680,1626153,TOR,MIN,Delon Wright,131,28.6666666666667,29,-0.333333333333336,63,68,-5,-6,1
21700680,1627751,TOR,MIN,Jakob Poeltl,104,21.8666666666667,22,-0.133333333333333,50,57,-7,-12,5
21700680,1627783,TOR,MIN,Pascal Siakam,92,18.55,18,0.549999999999997,38,45,-7,-5,-2
21700680,1627832,TOR,MIN,Fred VanVleet,64,13.6333333333333,14,-0.366666666666667,31,35,-4,-5,1
21700680,1628384,TOR,MIN,OG Anunoby,82,18.0166666666667,18,0.0166666666666657,42,44,-2,-4,2
21700681,101150,LAC,UTA,Lou Williams,201,40.0666666666667,40,0.0666666666666629,97,107,-10,-8,-2
21700681,201933,LAC,UTA,Blake Griffin,187,37.3,38,-0.700000000000003,94,98,-4,-7,3
21700681,202325,LAC,UTA,Wesley Johnson,138,26.5666666666667,27,-0.433333333333334,69,75,-6,-7,1
21700681,203186,LAC,UTA,Willie Reed,69,12.4833333333333,12,0.483333333333333,31,43,-12,-10,-2
21700681,1626149,LAC,UTA,Montrezl Harrell,86,18.6333333333333,18,0.633333333333333,39,39,0,-8,8
21700681,1626155,LAC,UTA,Sam Dekker,41,8.85,9,-0.15,17,23,-6,-2,-4
21700681,1627820,LAC,UTA,Tyrone Wallace,194,39.2666666666667,39,0.266666666666666,93,100,-7,-11,4
21700681,1628393,LAC,UTA,Jawun Evans,94,18.8666666666667,19,-0.133333333333333,44,45,-1,1,-2
21700681,1628414,LAC,UTA,Sindarius Thornwell,29,6.01666666666667,6,0.0166666666666666,12,20,-8,-5,-3
21700681,1628462,LAC,UTA,Milos Teodosic,151,30.95,32,-1.05,69,75,-6,-3,-3
21700681,2207,UTA,LAC,Joe Johnson,115,22.3833333333333,22,0.383333333333333,51,55,-4,-6,2
21700681,201937,UTA,LAC,Ricky Rubio,151,31,31,0,81,71,10,10,0
21700681,201973,UTA,LAC,Jonas Jerebko,61,12.65,13,-0.35,34,26,8,6,2
21700681,202324,UTA,LAC,Derrick Favors,160,31.8833333333333,32,-0.116666666666667,86,72,14,18,-4
21700681,202692,UTA,LAC,Alec Burks,93,18.7,18,0.699999999999999,48,46,2,6,-4
21700681,203497,UTA,LAC,Rudy Gobert,136,28,28,0,76,73,3,5,-2
21700681,203526,UTA,LAC,Raul Neto,75,14.3,14,0.300000000000001,40,33,7,9,-2
21700681,204060,UTA,LAC,Joe Ingles,162,32.5333333333333,33,-0.466666666666669,87,80,7,5,2
21700681,1626220,UTA,LAC,Royce O'Neale,62,12.2333333333333,12,0.233333333333333,32,25,7,-1,8
21700681,1628378,UTA,LAC,Donovan Mitchell,175,35.3166666666667,36,-0.683333333333337,90,84,6,8,-2
21700682,1717,DAL,POR,Dirk Nowitzki,128,28.7666666666667,29,-0.233333333333334,59,65,-6,-6,0
21700682,2734,DAL,POR,Devin Harris,28,6.15,6,0.15,10,17,-7,-7,0
21700682,200826,DAL,POR,J.J. Barea,105,23.25,23,0.25,52,57,-5,-6,1
21700682,202083,DAL,POR,Wesley Matthews,170,37.55,38,-0.450000000000003,88,91,-3,-3,0
21700682,203084,DAL,POR,Harrison Barnes,157,34.7,35,-0.299999999999997,79,86,-7,-7,0
21700682,203939,DAL,POR,Dwight Powell,52,10.8166666666667,11,-0.183333333333334,23,27,-4,-2,-2
21700682,1626257,DAL,POR,Salah Mejri,98,21.8333333333333,22,-0.166666666666664,55,56,-1,-1,0
21700682,1627812,DAL,POR,Yogi Ferrell,137,29.25,29,0.25,58,70,-12,-11,-1
21700682,1628372,DAL,POR,Dennis Smith Jr.,142,31.5666666666667,32,-0.433333333333334,76,78,-2,-2,0
21700682,1628467,DAL,POR,Maxi Kleber,68,16.1166666666667,16,0.116666666666667,40,38,2,0,2
21700682,202323,POR,DAL,Evan Turner,138,30.2833333333333,31,-0.716666666666669,72,71,1,1,0
21700682,202329,POR,DAL,Al-Farouq Aminu,155,34.4666666666667,34,0.466666666666669,87,74,13,11,2
21700682,202334,POR,DAL,Ed Davis,111,23.6166666666667,24,-0.383333333333333,61,52,9,8,1
21700682,203081,POR,DAL,Damian Lillard,174,38,38,0,94,81,13,13,0
21700682,203468,POR,DAL,CJ McCollum,170,37.85,38,-0.149999999999999,78,94,-16,-14,-2
21700682,203894,POR,DAL,Shabazz Napier,79,17.7166666666667,17,0.716666666666669,45,37,8,8,0
21700682,203994,POR,DAL,Jusuf Nurkic,105,24.2666666666667,24,0.266666666666666,54,56,-2,-1,-1
21700682,1626192,POR,DAL,Pat Connaughton,95,20.9,21,-0.100000000000001,64,45,19,19,0
21700682,1628380,POR,DAL,Zach Collins,58,12.9,13,-0.0999999999999996,30,30,0,0,0
21700683,201143,BOS,ORL,Al Horford,151,32.2666666666667,33,-0.733333333333334,76,71,5,3,2
21700683,202681,BOS,ORL,Kyrie Irving,184,40.4666666666667,40,0.466666666666669,83,80,3,6,-3
21700683,202694,BOS,ORL,Marcus Morris,115,26.0333333333333,26,0.0333333333333314,56,55,1,2,-1
21700683,203382,BOS,ORL,Aron Baynes,25,5.01666666666667,5,0.0166666666666666,6,15,-9,-7,-2
21700683,203499,BOS,ORL,Shane Larkin,31,7.23333333333333,7,0.233333333333333,9,17,-8,-10,2
21700683,203935,BOS,ORL,Marcus Smart,91,19.55,20,-0.449999999999999,41,47,-6,-11,5
21700683,1626179,BOS,ORL,Terry Rozier,94,20.6333333333333,21,-0.366666666666667,38,40,-2,-2,0
21700683,1627759,BOS,ORL,Jaylen Brown,174,36.8833333333333,37,-0.116666666666667,76,74,2,2,0
21700683,1628369,BOS,ORL,Jayson Tatum,141,30.7,31,-0.300000000000001,62,61,1,3,-2
21700683,1628400,BOS,ORL,Semi Ojeleye,46,9.76666666666667,10,-0.233333333333334,10,28,-18,-16,-2
21700683,1628464,BOS,ORL,Daniel Theis,48,11.2833333333333,11,0.283333333333333,18,27,-9,-10,1
21700683,201571,ORL,BOS,D.J. Augustin,64,13.4833333333333,14,-0.516666666666666,28,28,0,0,0
21700683,201578,ORL,BOS,Marreese Speights,33,7.4,8,-0.6,25,14,11,11,0
21700683,202687,ORL,BOS,Bismack Biyombo,98,20.8333333333333,21,-0.166666666666668,49,43,6,6,0
21700683,202714,ORL,BOS,Shelvin Mack,112,24.9,25,-0.100000000000001,53,43,10,10,0
21700683,203095,ORL,BOS,Evan Fournier,161,35.45,35,0.450000000000003,73,73,0,0,0
21700683,203613,ORL,BOS,Jonathon Simmons,117,25.4833333333333,26,-0.516666666666666,55,54,1,1,0
21700683,203901,ORL,BOS,Elfrid Payton,159,34.5833333333333,35,-0.416666666666664,75,69,6,6,0
21700683,203920,ORL,BOS,Khem Birch,78,17.4333333333333,17,0.433333333333334,26,32,-6,-6,0
21700683,203932,ORL,BOS,Aaron Gordon,178,37.7166666666667,38,-0.283333333333331,81,77,4,4,0
21700683,1626209,ORL,BOS,Mario Hezonja,53,12.55,13,-0.449999999999999,25,24,1,1,0
21700683,1628411,ORL,BOS,Wes Iwundu,47,10,10,0,25,18,7,7,0
21700684,201147,LAL,NYK,Corey Brewer,93,22.5833333333333,23,-0.416666666666664,64,49,15,16,-1
21700684,201572,LAL,NYK,Brook Lopez,70,14.6333333333333,15,-0.366666666666667,33,43,-10,-8,-2
21700684,203898,LAL,NYK,Tyler Ennis,53,11.1166666666667,11,0.116666666666667,23,28,-5,-3,-2
21700684,203903,LAL,NYK,Jordan Clarkson,163,37.7,38,-0.299999999999997,103,80,23,23,0
21700684,203944,LAL,NYK,Julius Randle,160,36.35,37,-0.650000000000006,87,69,18,18,0
21700684,1626204,LAL,NYK,Larry Nance Jr.,137,31.9833333333333,32,-0.0166666666666657,89,62,27,27,0
21700684,1627742,LAL,NYK,Brandon Ingram,116,24.4,24,0.399999999999999,60,56,4,3,1
21700684,1627826,LAL,NYK,Ivica Zubac,4,0.833333333333333,1,-0.166666666666667,3,2,1,1,0
21700684,1627936,LAL,NYK,Alex Caruso,129,30.5,31,-0.5,88,62,26,24,2
21700684,1628398,LAL,NYK,Kyle Kuzma,47,10.4,10,0.399999999999999,37,34,3,-1,4
21700684,1628404,LAL,NYK,Josh Hart,85,16.9166666666667,17,-0.0833333333333357,42,46,-4,-2,-2
21700684,1628418,LAL,NYK,Thomas Bryant,4,0.833333333333333,1,-0.166666666666667,3,2,1,1,0
21700684,1628502,LAL,NYK,Nigel Hayes,4,0.833333333333333,1,-0.166666666666667,3,2,1,1,0
21700684,101127,NYK,LAL,Jarrett Jack,116,25.6333333333333,26,-0.366666666666667,60,64,-4,-3,-1
21700684,201563,NYK,LAL,Michael Beasley,61,13.45,14,-0.550000000000001,33,42,-9,-9,0
21700684,201584,NYK,LAL,Courtney Lee,152,33.7666666666667,34,-0.233333333333334,74,82,-8,-7,-1
21700684,202498,NYK,LAL,Lance Thomas,42,8.85,9,-0.15,19,20,-1,0,-1
21700684,202683,NYK,LAL,Enes Kanter,132,29.35,29,0.350000000000001,66,70,-4,-4,0
21700684,203124,NYK,LAL,Kyle O'Quinn,60,13.6333333333333,14,-0.366666666666667,31,46,-15,-13,-2
21700684,203501,NYK,LAL,Tim Hardaway Jr.,129,29.1166666666667,29,0.116666666666667,71,72,-1,-1,0
21700684,203504,NYK,LAL,Trey Burke,28,7.23333333333333,7,0.233333333333333,14,19,-5,-5,0
21700684,203926,NYK,LAL,Doug McDermott,62,13.5333333333333,13,0.533333333333333,24,43,-19,-20,1
21700684,204001,NYK,LAL,Kristaps Porzingis,125,28.6833333333333,28,0.68333333333333,59,69,-10,-13,3
21700684,1626195,NYK,LAL,Willy Hernangomez,34,7.81666666666667,8,-0.183333333333334,20,23,-3,-3,0
21700684,1627758,NYK,LAL,Ron Baker,45,10.35,11,-0.65,25,33,-8,-8,0
21700684,1628373,NYK,LAL,Frank Ntilikina,79,17.6666666666667,18,-0.333333333333336,39,52,-13,-14,1
21700685,201960,BKN,DET,DeMarre Carroll,148,34.0833333333333,34,0.0833333333333357,79,78,1,0,1
21700685,203092,BKN,DET,Tyler Zeller,71,16.35,16,0.350000000000001,43,31,12,11,1
21700685,203112,BKN,DET,Quincy Acy,100,22.05,22,0.0499999999999972,43,51,-8,-5,-3
21700685,203459,BKN,DET,Allen Crabbe,122,27.7833333333333,28,-0.216666666666669,66,58,8,7,1
21700685,203915,BKN,DET,Spencer Dinwiddie,135,30.65,31,-0.349999999999998,71,70,1,1,0
21700685,203925,BKN,DET,Joe Harris,105,23.15,23,0.149999999999999,41,42,-1,0,-1
21700685,1626143,BKN,DET,Jahlil Okafor,27,6.36666666666667,7,-0.633333333333334,12,11,1,-1,2
21700685,1626156,BKN,DET,D'Angelo Russell,65,14.4833333333333,14,0.483333333333333,24,28,-4,-2,-2
21700685,1626178,BKN,DET,Rondae Hollis-Jefferson,133,30.7833333333333,31,-0.216666666666669,70,65,5,4,1
21700685,1627747,BKN,DET,Caris LeVert,102,22.0666666666667,22,0.0666666666666664,41,45,-4,-4,0
21700685,1628386,BKN,DET,Jarrett Allen,57,12.15,12,0.149999999999999,15,21,-6,-6,0
21700685,201229,DET,BKN,Anthony Tolliver,103,23.4166666666667,23,0.416666666666664,42,45,-3,-1,-2
21700685,202340,DET,BKN,Avery Bradley,115,25.9833333333333,26,-0.0166666666666657,60,62,-2,-4,2
21700685,202397,DET,BKN,Ish Smith,119,26.8833333333333,27,-0.116666666666667,56,64,-8,-5,-3
21700685,202699,DET,BKN,Tobias Harris,162,35.35,36,-0.650000000000006,88,74,14,14,0
21700685,203083,DET,BKN,Andre Drummond,117,25.9833333333333,26,-0.0166666666666657,57,61,-4,-6,2
21700685,203493,DET,BKN,Reggie Bullock,95,21.6833333333333,22,-0.316666666666666,45,56,-11,-10,-1
21700685,203961,DET,BKN,Eric Moreland,44,11.2166666666667,11,0.216666666666665,13,22,-9,-9,0
21700685,204038,DET,BKN,Langston Galloway,94,21.1,21,0.100000000000001,44,37,7,4,3
21700685,1626169,DET,BKN,Stanley Johnson,117,26.15,26,0.149999999999999,53,45,8,7,1
21700685,1628379,DET,BKN,Luke Kennard,99,22.15,22,0.149999999999999,42,39,3,5,-2
21700686,2744,IND,SAS,Al Jefferson,84,18.4166666666667,18,0.416666666666664,36,35,1,2,-1
21700686,201152,IND,SAS,Thaddeus Young,168,38.8333333333333,39,-0.166666666666671,75,69,6,8,-2
21700686,201954,IND,SAS,Darren Collison,146,33.85,34,-0.150000000000006,70,58,12,12,0
21700686,202362,IND,SAS,Lance Stephenson,104,22.9166666666667,22,0.916666666666664,47,42,5,4,1
21700686,202709,IND,SAS,Cory Joseph,142,30.9,31,-0.100000000000001,62,57,5,3,2
21700686,202711,IND,SAS,Bojan Bogdanovic,114,26.3333333333333,26,0.333333333333336,46,49,-3,-3,0
21700686,203506,IND,SAS,Victor Oladipo,157,35.4833333333333,36,-0.516666666666666,68,62,6,7,-1
21700686,1626202,IND,SAS,Joe Young,23,3.63333333333333,4,-0.366666666666667,5,7,-2,-2,0
21700686,1627734,IND,SAS,Domantas Sabonis,118,27.3,28,-0.699999999999999,56,46,10,9,1
21700686,1628388,IND,SAS,TJ Leaf,14,2.25,2,0.25,5,5,0,0,0
21700686,2200,SAS,IND,Pau Gasol,135,31.4833333333333,31,0.483333333333334,58,59,-1,-2,1
21700686,2225,SAS,IND,Tony Parker,86,20.7,20,0.699999999999999,33,46,-13,-9,-4
21700686,200746,SAS,IND,LaMarcus Aldridge,157,36.0833333333333,37,-0.916666666666671,59,66,-7,-8,1
21700686,201980,SAS,IND,Danny Green,96,22.6166666666667,23,-0.383333333333333,35,41,-6,-8,2
21700686,201988,SAS,IND,Patty Mills,99,22.5833333333333,22,0.583333333333332,38,49,-11,-9,-2
21700686,202722,SAS,IND,Davis Bertans,91,21.1666666666667,21,0.166666666666664,34,44,-10,-8,-2
21700686,203464,SAS,IND,Brandon Paul,9,0.783333333333333,1,-0.216666666666667,5,2,3,3,0
21700686,203937,SAS,IND,Kyle Anderson,152,33.85,34,-0.149999999999999,64,66,-2,-2,0
21700686,1627749,SAS,IND,Dejounte Murray,128,27.2833333333333,28,-0.716666666666669,53,48,5,1,4
21700686,1627854,SAS,IND,Bryn Forbes,109,22.75,22,0.75,46,47,-1,-1,0
21700686,1628401,SAS,IND,Derrick White,8,0.616666666666667,1,-0.383333333333333,5,2,3,3,0
21700687,1713,SAC,CHA,Vince Carter,90,18.45,19,-0.550000000000001,41,40,1,1,0
21700687,201585,SAC,CHA,Kosta Koufos,81,16.7166666666667,17,-0.283333333333331,37,42,-5,-5,0
21700687,201588,SAC,CHA,George Hill,90,18.8666666666667,19,-0.133333333333333,39,52,-13,-13,0
21700687,203992,SAC,CHA,Bogdan Bogdanovic,138,28.5833333333333,29,-0.416666666666664,69,58,11,11,0
21700687,1626161,SAC,CHA,Willie Cauley-Stein,181,36.9833333333333,37,-0.0166666666666657,82,86,-4,-2,-2
21700687,1627741,SAC,CHA,Buddy Hield,128,26.6666666666667,27,-0.333333333333336,57,64,-7,-7,0
21700687,1627746,SAC,CHA,Skal Labissiere,144,29.5833333333333,29,0.583333333333332,70,63,7,5,2
21700687,1627834,SAC,CHA,Georgios Papagiannis,60,12.4833333333333,13,-0.516666666666668,25,33,-8,-8,0
21700687,1628368,SAC,CHA,De'Aaron Fox,151,31.0833333333333,31,0.0833333333333322,71,70,1,1,0
21700687,1628382,SAC,CHA,Justin Jackson,102,20,20,0,44,52,-8,-8,0
21700687,2730,CHA,SAC,Dwight Howard,166,33.05,33,0.0499999999999972,79,76,3,1,2
21700687,101107,CHA,SAC,Marvin Williams,146,29.6666666666667,30,-0.333333333333332,65,68,-3,-5,2
21700687,201587,CHA,SAC,Nicolas Batum,170,34.95,35,-0.0499999999999972,77,81,-4,-5,1
21700687,202689,CHA,SAC,Kemba Walker,193,39.9333333333333,40,-0.0666666666666629,93,84,9,7,2
21700687,203087,CHA,SAC,Jeremy Lamb,128,26.35,27,-0.649999999999999,62,65,-3,-1,-2
21700687,203487,CHA,SAC,Michael Carter-Williams,73,15.1166666666667,15,0.116666666666667,39,32,7,8,-1
21700687,203948,CHA,SAC,Johnny O'Bryant III,57,12.65,13,-0.35,29,25,4,6,-2
21700687,1626163,CHA,SAC,Frank Kaminsky,97,20.4,21,-0.600000000000001,51,45,6,8,-2
21700687,1626203,CHA,SAC,Treveon Graham,105,21.5333333333333,21,0.533333333333331,50,42,8,6,2
21700687,1628370,CHA,SAC,Malik Monk,30,5.76666666666667,6,-0.233333333333333,15,17,-2,0,-2
21700688,101141,ATL,UTA,Ersan Ilyasova,109,23.8,24,-0.200000000000003,42,36,6,5,1
21700688,201158,ATL,UTA,Marco Belinelli,122,25.4666666666667,26,-0.533333333333331,51,58,-7,-8,1
21700688,202337,ATL,UTA,Luke Babbitt,43,10.75,11,-0.25,26,27,-1,-3,2
21700688,203101,ATL,UTA,Miles Plumlee,45,10.0833333333333,10,0.0833333333333339,14,14,0,-1,1
21700688,203145,ATL,UTA,Kent Bazemore,105,22.8166666666667,23,-0.183333333333334,46,37,9,13,-4
21700688,203471,ATL,UTA,Dennis Schroder,118,24.6166666666667,25,-0.383333333333333,48,44,4,4,0
21700688,203473,ATL,UTA,Dewayne Dedmon,102,20.8833333333333,21,-0.116666666666667,41,45,-4,-4,0
21700688,203488,ATL,UTA,Mike Muscala,71,15.95,16,-0.0500000000000007,49,33,16,17,-1
21700688,1627098,ATL,UTA,Malcolm Delaney,99,23.3333333333333,24,-0.666666666666664,61,36,25,25,0
21700688,1627752,ATL,UTA,Taurean Prince,115,24.7,25,-0.300000000000001,54,35,19,20,-1
21700688,1627819,ATL,UTA,Isaiah Taylor,21,4.13333333333333,4,0.133333333333333,9,17,-8,-8,0
21700688,1628381,ATL,UTA,John Collins,92,21.05,21,0.0499999999999972,53,37,16,17,-1
21700688,1628416,ATL,UTA,Tyler Dorsey,48,10.8333333333333,11,-0.166666666666668,26,31,-5,-7,2
21700688,2207,UTA,ATL,Joe Johnson,72,16.8833333333333,16,0.883333333333333,28,43,-15,-17,2
21700688,201937,UTA,ATL,Ricky Rubio,122,26.2,26,0.199999999999999,41,47,-6,-10,4
21700688,201973,UTA,ATL,Jonas Jerebko,86,17.6666666666667,18,-0.333333333333332,43,40,3,5,-2
21700688,202324,UTA,ATL,Derrick Favors,118,26.7666666666667,27,-0.233333333333334,43,59,-16,-16,0
21700688,202327,UTA,ATL,Ekpe Udoh,33,6.66666666666667,7,-0.333333333333334,21,13,8,8,0
21700688,202692,UTA,ATL,Alec Burks,105,23.0166666666667,23,0.0166666666666657,53,62,-9,-7,-2
21700688,203497,UTA,ATL,Rudy Gobert,127,27.3833333333333,28,-0.616666666666667,45,53,-8,-8,0
21700688,203526,UTA,ATL,Raul Neto,63,14.35,15,-0.65,33,35,-2,1,-3
21700688,204060,UTA,ATL,Joe Ingles,127,27.4833333333333,28,-0.516666666666666,46,54,-8,-6,-2
21700688,1626220,UTA,ATL,Royce O'Neale,95,20.85,20,0.850000000000001,44,56,-12,-14,2
21700688,1628378,UTA,ATL,Donovan Mitchell,142,31.15,32,-0.850000000000001,53,58,-5,-6,1
21700689,2403,HOU,MIA,Nene,45,9.75,10,-0.25,16,19,-3,-3,0
21700689,2772,HOU,MIA,Trevor Ariza,120,28.3333333333333,28,0.333333333333332,55,64,-9,-9,0
21700689,101108,HOU,MIA,Chris Paul,149,35.3166666666667,36,-0.683333333333337,78,66,12,12,0
21700689,200782,HOU,MIA,PJ Tucker,107,24.1333333333333,24,0.133333333333333,51,46,5,5,0
21700689,201569,HOU,MIA,Eric Gordon,131,29.7,30,-0.300000000000001,62,53,9,9,0
21700689,201583,HOU,MIA,Ryan Anderson,122,28.9333333333333,29,-0.06666666666667,57,58,-1,-1,0
21700689,201601,HOU,MIA,Luc Mbah a Moute,99,22.4666666666667,22,0.466666666666669,46,30,16,16,0
21700689,201935,HOU,MIA,James Harden,153,34.6333333333333,35,-0.366666666666667,69,63,6,6,0
21700689,203991,HOU,MIA,Clint Capela,114,25.9,26,-0.100000000000001,61,51,10,10,0
21700689,201949,MIA,HOU,James Johnson,127,28.6,29,-0.399999999999999,56,64,-8,-9,1
21700689,201961,MIA,HOU,Wayne Ellington,174,38.6,39,-0.400000000000006,73,82,-9,-7,-2
21700689,202355,MIA,HOU,Hassan Whiteside,133,29.85,30,-0.149999999999999,58,64,-6,-6,0
21700689,203482,MIA,HOU,Kelly Olynyk,84,19.3666666666667,20,-0.633333333333333,34,37,-3,-2,-1
21700689,1626159,MIA,HOU,Justise Winslow,118,28.0166666666667,28,0.0166666666666657,51,58,-7,-7,0
21700689,1626196,MIA,HOU,Josh Richardson,156,36.7,37,-0.299999999999997,75,74,1,1,0
21700689,1627884,MIA,HOU,Derrick Jones Jr.,132,29.2333333333333,30,-0.766666666666666,55,61,-6,-9,3
21700689,1628389,MIA,HOU,Bam Adebayo,72,17.85,17,0.850000000000001,32,33,-1,-1,0
21700689,1628476,MIA,HOU,Derrick Walton Jr.,44,10.95,11,-0.0500000000000007,16,22,-6,-5,-1
21700690,101161,PHI,MEM,Amir Johnson,77,16.5166666666667,16,0.516666666666666,40,37,3,1,2
21700690,202344,PHI,MEM,Trevor Booker,63,12.8166666666667,13,-0.183333333333334,29,39,-10,-8,-2
21700690,203496,PHI,MEM,Robert Covington,158,34.8666666666667,34,0.866666666666667,72,75,-3,-6,3
21700690,203954,PHI,MEM,Joel Embiid,143,31.4666666666667,32,-0.533333333333335,61,68,-7,-5,-2
21700690,203967,PHI,MEM,Dario Saric,155,35.0833333333333,35,0.0833333333333357,72,66,6,6,0
21700690,204456,PHI,MEM,T.J. McConnell,128,27.1666666666667,28,-0.833333333333336,58,70,-12,-15,3
21700690,1626147,PHI,MEM,Justin Anderson,81,17.4,17,0.399999999999999,38,37,1,3,-2
21700690,1627732,PHI,MEM,Ben Simmons,157,34.75,35,-0.25,70,67,3,6,-3
21700690,1627789,PHI,MEM,Timothe Luwawu-Cabarrot,138,29.85,30,-0.149999999999999,65,66,-1,-2,1
21700690,201188,MEM,PHI,Marc Gasol,164,37.1166666666667,37,0.11666666666666,72,73,-1,-1,0
21700690,201596,MEM,PHI,Mario Chalmers,106,21.15,21,0.149999999999999,56,44,12,8,4
21700690,201936,MEM,PHI,Tyreke Evans,158,35,35,0,77,70,7,11,-4
21700690,203463,MEM,PHI,Ben McLemore,25,5.03333333333333,5,0.0333333333333332,13,17,-4,-6,2
21700690,1626150,MEM,PHI,Andrew Harrison,97,23.3833333333333,23,0.383333333333333,38,51,-13,-9,-4
21700690,1626185,MEM,PHI,Jarell Martin,146,31.4666666666667,32,-0.533333333333331,65,69,-4,-5,1
21700690,1627738,MEM,PHI,Deyonta Davis,60,11.9,12,-0.100000000000001,35,31,4,4,0
21700690,1627782,MEM,PHI,Wayne Selden,66,13.9333333333333,14,-0.0666666666666664,33,38,-5,-7,2
21700690,1627988,MEM,PHI,Myke Henry,79,15.9333333333333,16,-0.0666666666666664,42,28,14,12,2
21700690,1628397,MEM,PHI,Ivan Rabb,70,15.4833333333333,15,0.483333333333334,38,29,9,10,-1
21700690,1628415,MEM,PHI,Dillon Brooks,129,29.5166666666667,29,0.516666666666666,56,55,1,3,-2
21700691,1891,MIL,PHX,Jason Terry,59,13.5833333333333,13,0.583333333333334,20,30,-10,-10,0
21700691,202339,MIL,PHX,Eric Bledsoe,160,33.15,33,0.150000000000006,81,67,14,14,0
21700691,203089,MIL,PHX,John Henson,147,29.9,30,-0.100000000000001,73,70,3,5,-2
21700691,203114,MIL,PHX,Khris Middleton,185,38.9666666666667,39,-0.0333333333333314,97,87,10,9,1
21700691,203503,MIL,PHX,Tony Snell,89,20.25,21,-0.75,43,44,-1,-3,2
21700691,203521,MIL,PHX,Matthew Dellavedova,113,24.4833333333333,25,-0.516666666666666,57,60,-3,-3,0
21700691,1627748,MIL,PHX,Thon Maker,39,9.8,10,-0.199999999999999,15,24,-9,-11,2
21700691,1627763,MIL,PHX,Malcolm Brogdon,166,34.6,35,-0.399999999999999,89,75,14,16,-2
21700691,1627850,MIL,PHX,Marshall Plumlee,38,8.3,8,0.300000000000001,21,11,10,10,0
21700691,1628425,MIL,PHX,Sterling Brown,124,26.9666666666667,27,-0.0333333333333314,49,57,-8,-7,-1
21700691,201162,PHX,MIL,Jared Dudley,73,17.1333333333333,17,0.133333333333333,33,31,2,4,-2
21700691,202328,PHX,MIL,Greg Monroe,148,30.1333333333333,30,0.133333333333333,73,77,-4,-4,0
21700691,203458,PHX,MIL,Alex Len,76,17.8666666666667,18,-0.133333333333333,32,32,0,0,0
21700691,203477,PHX,MIL,Isaiah Canaan,133,28.3,28,0.299999999999997,62,61,1,5,-4
21700691,203584,PHX,MIL,Troy Daniels,104,22.9,23,-0.100000000000001,55,53,2,4,-2
21700691,203933,PHX,MIL,T.J. Warren,163,34.1333333333333,34,0.133333333333333,72,82,-10,-10,0
21700691,1626164,PHX,MIL,Devin Booker,178,36.35,36,0.349999999999994,84,92,-8,-7,-1
21700691,1627733,PHX,MIL,Dragan Bender,131,27.9166666666667,28,-0.0833333333333322,62,67,-5,-10,5
21700691,1627755,PHX,MIL,Tyler Ulis,69,14.8333333333333,15,-0.166666666666668,31,32,-1,-2,1
21700691,1628367,PHX,MIL,Josh Jackson,45,10.4333333333333,11,-0.566666666666666,21,18,3,0,3
21700692,2749,NOP,CHI,Jameer Nelson,97,18.9333333333333,19,-0.0666666666666664,46,48,-2,-4,2
21700692,200765,NOP,CHI,Rajon Rondo,67,14.7333333333333,15,-0.266666666666666,27,37,-10,-10,0
21700692,201950,NOP,CHI,Jrue Holiday,202,42.6666666666667,43,-0.333333333333336,93,89,4,5,-1
21700692,201967,NOP,CHI,Dante Cunningham,106,21.9666666666667,22,-0.033333333333335,45,52,-7,-9,2
21700692,202326,NOP,CHI,DeMarcus Cousins,241,51.05,52,-0.950000000000003,113,103,10,13,-3
21700692,202734,NOP,CHI,E'Twaun Moore,195,41.6166666666667,42,-0.383333333333333,93,87,6,8,-2
21700692,203076,NOP,CHI,Anthony Davis,214,42.6,43,-0.399999999999999,106,101,5,2,3
21700692,203121,NOP,CHI,Darius Miller,203,40.55,41,-0.450000000000003,98,84,14,14,0
21700692,203546,NOP,CHI,Ian Clark,80,15.4666666666667,15,0.466666666666667,39,39,0,1,-1
21700692,201577,CHI,NOP,Robin Lopez,180,39.25,39,0.25,83,87,-4,-2,-2
21700692,202703,CHI,NOP,Nikola Mirotic,130,25.1666666666667,25,0.166666666666664,58,63,-5,-3,-2
21700692,203200,CHI,NOP,Justin Holiday,193,41.5333333333333,42,-0.466666666666669,86,95,-9,-7,-2
21700692,203897,CHI,NOP,Zach LaVine,123,23.7833333333333,24,-0.216666666666669,54,65,-11,-10,-1
21700692,1626170,CHI,NOP,Jerian Grant,226,47.6666666666667,47,0.666666666666664,105,102,3,2,1
21700692,1626171,CHI,NOP,Bobby Portis,80,14.85,15,-0.150000000000002,34,35,-1,-3,2
21700692,1627756,CHI,NOP,Denzel Valentine,181,38,38,0,91,81,10,7,3
21700692,1627853,CHI,NOP,Ryan Arcidiacono,23,4.93333333333333,5,-0.0666666666666664,5,10,-5,-5,0
21700692,1628021,CHI,NOP,David Nwaba,86,15.4166666666667,16,-0.583333333333332,40,33,7,5,2
21700692,1628374,CHI,NOP,Lauri Markkanen,183,38.9833333333333,40,-1.01666666666667,84,89,-5,-4,-1
21700693,1717,DAL,WAS,Dirk Nowitzki,100,22.1833333333333,22,0.18333333333333,35,30,5,5,0
21700693,200826,DAL,WAS,J.J. Barea,99,21.2166666666667,21,0.216666666666669,41,21,20,20,0
21700693,201177,DAL,WAS,Josh McRoberts,14,3.08333333333333,3,0.0833333333333335,12,9,3,3,0
21700693,202083,DAL,WAS,Wesley Matthews,139,29.15,30,-0.850000000000001,55,49,6,6,0
21700693,203084,DAL,WAS,Harrison Barnes,145,30.9833333333333,31,-0.0166666666666657,63,49,14,12,2
21700693,203939,DAL,WAS,Dwight Powell,108,23.15,23,0.149999999999999,50,25,25,24,1
21700693,1626257,DAL,WAS,Salah Mejri,42,9.73333333333333,10,-0.266666666666668,20,20,0,-2,2
21700693,1627812,DAL,WAS,Yogi Ferrell,138,30.3333333333333,31,-0.666666666666668,64,39,25,22,3
21700693,1627858,DAL,WAS,Kyle Collinsworth,83,18.8,18,0.799999999999997,43,24,19,17,2
21700693,1627883,DAL,WAS,Jalen Jones,14,3.08333333333333,3,0.0833333333333335,12,9,3,3,0
21700693,1628372,DAL,WAS,Dennis Smith Jr.,145,30.65,31,-0.350000000000001,64,58,6,5,1
21700693,1628467,DAL,WAS,Maxi Kleber,83,17.3833333333333,17,0.383333333333333,31,32,-1,0,-1
21700693,101133,WAS,DAL,Ian Mahinmi,40,9.28333333333333,9,0.283333333333333,8,17,-9,-8,-1
21700693,101162,WAS,DAL,Marcin Gortat,78,17.4833333333333,18,-0.516666666666666,31,30,1,3,-2
21700693,201160,WAS,DAL,Jason Smith,66,13.9666666666667,14,-0.0333333333333332,23,32,-9,-10,1
21700693,201975,WAS,DAL,Jodie Meeks,55,11.9166666666667,12,-0.0833333333333322,18,26,-8,-8,0
21700693,202322,WAS,DAL,John Wall,168,35.5166666666667,36,-0.483333333333334,57,61,-4,-1,-3
21700693,202693,WAS,DAL,Markieff Morris,123,25.9666666666667,26,-0.0333333333333314,46,51,-5,-3,-2
21700693,203078,WAS,DAL,Bradley Beal,167,36.0333333333333,36,0.0333333333333314,55,72,-17,-15,-2
21700693,203107,WAS,DAL,Tomas Satoransky,88,19.3166666666667,19,0.316666666666666,25,47,-22,-22,0
21700693,203118,WAS,DAL,Mike Scott,27,7.05,7,0.0500000000000007,4,13,-9,-12,3
21700693,203490,WAS,DAL,Otto Porter Jr.,108,22.7,22,0.699999999999999,34,51,-17,-15,-2
21700693,204025,WAS,DAL,Tim Frazier,22,4.48333333333333,5,-0.516666666666667,12,14,-2,-2,0
21700693,1626162,WAS,DAL,Kelly Oubre Jr.,146,31.55,32,-0.450000000000003,40,62,-22,-20,-2
21700693,1626191,WAS,DAL,Chris McCullough,22,4.48333333333333,5,-0.516666666666667,12,14,-2,-2,0
21700694,201163,DEN,POR,Wilson Chandler,145,30.5666666666667,31,-0.433333333333334,59,68,-9,-8,-1
21700694,203115,DEN,POR,Will Barton,165,33.7833333333333,34,-0.216666666666669,76,66,10,12,-2
21700694,203486,DEN,POR,Mason Plumlee,137,28.8,29,-0.200000000000003,72,66,6,14,-8
21700694,203914,DEN,POR,Gary Harris,180,37.2666666666667,37,0.266666666666666,90,81,9,11,-2
21700694,203999,DEN,POR,Nikola Jokic,151,32.2666666666667,33,-0.733333333333334,76,66,10,9,1
21700694,1626144,DEN,POR,Emmanuel Mudiay,56,11.3333333333333,11,0.333333333333332,21,27,-6,-5,-1
21700694,1626168,DEN,POR,Trey Lyles,110,23.95,24,-0.0500000000000007,39,47,-8,-7,-1
21700694,1627750,DEN,POR,Jamal Murray,157,33.9333333333333,34,-0.0666666666666629,75,70,5,11,-6
21700694,1628470,DEN,POR,Torrey Craig,39,8.01666666666667,8,0.0166666666666657,12,14,-2,-2,0
21700694,202323,POR,DEN,Evan Turner,139,29.1166666666667,29,0.116666666666667,66,69,-3,-7,4
21700694,202329,POR,DEN,Al-Farouq Aminu,130,28.3833333333333,28,0.383333333333333,57,68,-11,-11,0
21700694,202334,POR,DEN,Ed Davis,96,20.7833333333333,21,-0.216666666666669,40,35,5,9,-4
21700694,203081,POR,DEN,Damian Lillard,184,38.4166666666667,38,0.416666666666671,83,91,-8,-8,0
21700694,203468,POR,DEN,CJ McCollum,172,35.3666666666667,35,0.366666666666667,71,79,-8,-7,-1
21700694,203894,POR,DEN,Shabazz Napier,100,21.4,22,-0.600000000000001,45,42,3,4,-1
21700694,203994,POR,DEN,Jusuf Nurkic,131,26.9333333333333,27,-0.0666666666666664,61,69,-8,-8,0
21700694,1626192,POR,DEN,Pat Connaughton,96,19.9833333333333,20,-0.0166666666666657,42,32,10,9,1
21700694,1628380,POR,DEN,Zach Collins,92,19.5333333333333,20,-0.466666666666669,40,35,5,4,1
21700695,101150,LAC,MIN,Lou Williams,187,35.55,36,-0.450000000000003,89,97,-8,-3,-5
21700695,201933,LAC,MIN,Blake Griffin,185,36.65,37,-0.350000000000001,88,102,-14,-14,0
21700695,202325,LAC,MIN,Wesley Johnson,154,29.6,30,-0.399999999999999,71,84,-13,-15,2
21700695,203186,LAC,MIN,Willie Reed,74,16.0666666666667,16,0.0666666666666664,40,38,2,-2,4
21700695,1626149,LAC,MIN,Montrezl Harrell,162,31.7,31,0.699999999999999,78,83,-5,-2,-3
21700695,1626155,LAC,MIN,Sam Dekker,56,11.2333333333333,11,0.233333333333334,30,24,6,6,0
21700695,1627820,LAC,MIN,Tyrone Wallace,157,31.1333333333333,32,-0.866666666666667,81,78,3,-1,4
21700695,1628414,LAC,MIN,Sindarius Thornwell,91,19.25,19,0.25,49,45,4,3,1
21700695,1628462,LAC,MIN,Milos Teodosic,139,28.2333333333333,28,0.233333333333334,64,79,-15,-12,-3
21700695,201952,MIN,LAC,Jeff Teague,172,33.95,34,-0.0499999999999972,94,82,12,12,0
21700695,201959,MIN,LAC,Taj Gibson,191,38.1333333333333,38,0.133333333333333,105,91,14,10,4
21700695,202357,MIN,LAC,Nemanja Bjelica,175,34.7333333333333,35,-0.266666666666666,89,85,4,6,-2
21700695,203476,MIN,LAC,Gorgui Dieng,78,15.55,15,0.550000000000001,38,39,-1,0,-1
21700695,203498,MIN,LAC,Shabazz Muhammad,43,8.56666666666667,9,-0.433333333333334,16,24,-8,-8,0
21700695,203952,MIN,LAC,Andrew Wiggins,205,41.3333333333333,41,0.333333333333329,112,101,11,11,0
21700695,1626145,MIN,LAC,Tyus Jones,70,13.9666666666667,14,-0.0333333333333332,33,36,-3,1,-4
21700695,1626157,MIN,LAC,Karl-Anthony Towns,163,32.3333333333333,33,-0.666666666666664,88,79,9,8,1
21700695,1627875,MIN,LAC,Marcus Georges-Hunt,108,20.85,21,-0.149999999999999,55,53,2,0,2
21700696,201571,ORL,SAC,D.J. Augustin,73,16.2833333333333,16,0.283333333333335,29,36,-7,-8,1
21700696,201578,ORL,SAC,Marreese Speights,31,6.5,7,-0.5,16,16,0,0,0
21700696,202687,ORL,SAC,Bismack Biyombo,128,28,28,0,58,62,-4,-6,2
21700696,202714,ORL,SAC,Shelvin Mack,51,11.95,12,-0.0500000000000007,20,24,-4,-6,2
21700696,203095,ORL,SAC,Evan Fournier,177,38.1666666666667,38,0.166666666666671,80,83,-3,-2,-1
21700696,203613,ORL,SAC,Jonathon Simmons,161,34.9666666666667,35,-0.0333333333333314,74,80,-6,-4,-2
21700696,203901,ORL,SAC,Elfrid Payton,156,33.6166666666667,34,-0.383333333333333,75,72,3,4,-1
21700696,203920,ORL,SAC,Khem Birch,58,13.3,13,0.300000000000001,23,25,-2,-2,0
21700696,203932,ORL,SAC,Aaron Gordon,162,35.2833333333333,35,0.283333333333331,76,78,-2,-2,0
21700696,1626209,ORL,SAC,Mario Hezonja,59,12.9166666666667,13,-0.0833333333333339,25,29,-4,-2,-2
21700696,1628411,ORL,SAC,Wes Iwundu,39,9.01666666666667,9,0.0166666666666657,19,20,-1,-2,1
21700696,1713,SAC,ORL,Vince Carter,135,29.7166666666667,29,0.716666666666669,68,63,5,5,0
21700696,202066,SAC,ORL,Garrett Temple,174,40.3333333333333,40,0.333333333333336,87,81,6,8,-2
21700696,203992,SAC,ORL,Bogdan Bogdanovic,153,32.9333333333333,33,-0.0666666666666629,73,67,6,6,0
21700696,1626161,SAC,ORL,Willie Cauley-Stein,145,32.95,33,-0.0499999999999972,82,54,28,27,1
21700696,1627741,SAC,ORL,Buddy Hield,127,28.4166666666667,28,0.416666666666664,61,57,4,4,0
21700696,1627746,SAC,ORL,Skal Labissiere,115,22.7333333333333,23,-0.266666666666666,46,55,-9,-8,-1
21700696,1627781,SAC,ORL,Malachi Richardson,69,14.9333333333333,15,-0.0666666666666664,33,31,2,2,0
21700696,1627834,SAC,ORL,Georgios Papagiannis,16,2.96666666666667,3,-0.0333333333333332,4,13,-9,-9,0
21700696,1628368,SAC,ORL,De'Aaron Fox,55,10.35,11,-0.65,22,21,1,-1,2
21700696,1628382,SAC,ORL,Justin Jackson,106,24.6666666666667,25,-0.333333333333336,49,53,-4,-4,0
21700697,201960,BKN,OKC,DeMarre Carroll,129,29.1,29,0.100000000000001,58,57,1,-2,3
21700697,203092,BKN,OKC,Tyler Zeller,68,14.95,15,-0.0499999999999989,29,32,-3,-4,1
21700697,203112,BKN,OKC,Quincy Acy,84,17.6166666666667,18,-0.383333333333333,50,46,4,6,-2
21700697,203459,BKN,OKC,Allen Crabbe,143,32.0333333333333,32,0.0333333333333314,64,71,-7,-7,0
21700697,203915,BKN,OKC,Spencer Dinwiddie,128,28.9,29,-0.100000000000001,61,60,1,0,1
21700697,203925,BKN,OKC,Joe Harris,108,23.0666666666667,23,0.0666666666666664,57,60,-3,-2,-1
21700697,1626143,BKN,OKC,Jahlil Okafor,40,9.26666666666667,10,-0.733333333333334,23,25,-2,-1,-1
21700697,1626156,BKN,OKC,D'Angelo Russell,69,14.2333333333333,15,-0.766666666666666,43,34,9,12,-3
21700697,1626178,BKN,OKC,Rondae Hollis-Jefferson,125,28,27,1,52,59,-7,-10,3
21700697,1627747,BKN,OKC,Caris LeVert,91,19.1,19,0.100000000000001,47,49,-2,-1,-1
21700697,1628386,BKN,OKC,Jarrett Allen,110,23.7333333333333,23,0.733333333333334,56,52,4,4,0
21700697,2546,OKC,BKN,Carmelo Anthony,149,32.8333333333333,33,-0.166666666666664,63,70,-7,-7,0
21700697,101109,OKC,BKN,Raymond Felton,76,16.8833333333333,17,-0.116666666666667,50,35,15,12,3
21700697,201566,OKC,BKN,Russell Westbrook,167,36.6666666666667,36,0.666666666666664,71,82,-11,-10,-1
21700697,202331,OKC,BKN,Paul George,177,37.2,37,0.200000000000003,81,82,-1,1,-2
21700697,202335,OKC,BKN,Patrick Patterson,76,17.3166666666667,17,0.316666666666666,45,46,-1,-5,4
21700697,203460,OKC,BKN,Andre Roberson,130,28.5833333333333,28,0.583333333333336,57,61,-4,-1,-3
21700697,203500,OKC,BKN,Steven Adams,158,34.3666666666667,34,0.366666666666667,79,68,11,15,-4
21700697,203924,OKC,BKN,Jerami Grant,55,11.4833333333333,12,-0.516666666666668,31,32,-1,-1,0
21700697,203962,OKC,BKN,Josh Huestis,42,10.8,11,-0.199999999999999,28,26,2,0,2
21700697,1628390,OKC,BKN,Terrance Ferguson,65,13.8666666666667,14,-0.133333333333333,40,38,2,1,1
21700698,2544,CLE,SAS,LeBron James,173,38.1833333333333,38,0.18333333333333,82,90,-8,-10,2
21700698,2548,CLE,SAS,Dwyane Wade,77,17.2333333333333,18,-0.766666666666666,37,40,-3,-7,4
21700698,2594,CLE,SAS,Kyle Korver,69,14.1333333333333,14,0.133333333333333,38,37,1,3,-2
21700698,2747,CLE,SAS,JR Smith,129,28.3,29,-0.700000000000003,58,67,-9,-3,-6
21700698,201145,CLE,SAS,Jeff Green,80,16.7333333333333,16,0.733333333333334,36,43,-7,-7,0
21700698,201565,CLE,SAS,Derrick Rose,61,12.3333333333333,13,-0.666666666666668,29,30,-1,1,-2
21700698,201567,CLE,SAS,Kevin Love,115,26.6666666666667,27,-0.333333333333336,47,59,-12,-14,2
21700698,202684,CLE,SAS,Tristan Thompson,90,18.9666666666667,19,-0.0333333333333314,46,51,-5,-3,-2
21700698,202697,CLE,SAS,Iman Shumpert,29,5.88333333333333,6,-0.116666666666667,15,15,0,-2,2
21700698,202738,CLE,SAS,Isaiah Thomas,124,28.1833333333333,28,0.18333333333333,52,65,-13,-15,2
21700698,203109,CLE,SAS,Jae Crowder,138,30.9833333333333,32,-1.01666666666667,66,71,-5,-5,0
21700698,1626224,CLE,SAS,Cedi Osman,5,0.983333333333333,1,-0.0166666666666667,4,2,2,2,0
21700698,2225,SAS,CLE,Tony Parker,83,18.5666666666667,18,0.566666666666666,50,43,7,9,-2
21700698,200746,SAS,CLE,LaMarcus Aldridge,182,40.1833333333333,41,-0.81666666666667,97,79,18,23,-5
21700698,201980,SAS,CLE,Danny Green,132,29.9666666666667,30,-0.0333333333333314,75,56,19,14,5
21700698,201988,SAS,CLE,Patty Mills,96,19.5833333333333,20,-0.416666666666664,50,50,0,-5,5
21700698,202722,SAS,CLE,Davis Bertans,136,29.25,30,-0.75,63,60,3,5,-2
21700698,203464,SAS,CLE,Brandon Paul,17,3.43333333333333,3,0.433333333333334,6,10,-4,-4,0
21700698,203530,SAS,CLE,Joffrey Lauvergne,52,11.4333333333333,12,-0.566666666666666,27,39,-12,-15,3
21700698,203937,SAS,CLE,Kyle Anderson,152,33.9166666666667,34,-0.0833333333333357,80,69,11,13,-2
21700698,1626199,SAS,CLE,Darrun Hilliard,5,0.983333333333333,1,-0.0166666666666667,2,4,-2,0,-2
21700698,1627749,SAS,CLE,Dejounte Murray,135,29.15,30,-0.850000000000001,64,59,5,3,2
21700698,1627854,SAS,CLE,Bryn Forbes,100,22.1166666666667,23,-0.883333333333333,56,41,15,17,-2
21700699,2561,GSW,NYK,David West,65,15.1833333333333,15,0.183333333333334,41,25,16,16,0
21700699,2585,GSW,NYK,Zaza Pachulia,65,14.2333333333333,14,0.233333333333334,39,36,3,3,0
21700699,2733,GSW,NYK,Shaun Livingston,51,12.65,13,-0.350000000000001,32,18,14,14,0
21700699,2738,GSW,NYK,Andre Iguodala,86,20.1333333333333,20,0.133333333333333,49,47,2,2,0
21700699,201142,GSW,NYK,Kevin Durant,153,32.2666666666667,32,0.266666666666666,94,80,14,10,4
21700699,201156,GSW,NYK,Nick Young,77,17.5,17,0.5,32,42,-10,-12,2
21700699,201580,GSW,NYK,JaVale McGee,11,1.96666666666667,2,-0.0333333333333334,2,9,-7,-7,0
21700699,201939,GSW,NYK,Stephen Curry,156,33.2333333333333,33,0.233333333333334,89,85,4,4,0
21700699,201956,GSW,NYK,Omri Casspi,11,1.96666666666667,2,-0.0333333333333334,2,9,-7,-7,0
21700699,202691,GSW,NYK,Klay Thompson,154,33.4666666666667,34,-0.533333333333331,99,76,23,25,-2
21700699,203110,GSW,NYK,Draymond Green,146,32.8333333333333,33,-0.166666666666664,81,74,7,11,-4
21700699,1626172,GSW,NYK,Kevon Looney,70,15.1666666666667,15,0.166666666666668,35,33,2,2,0
21700699,1627775,GSW,NYK,Patrick McCaw,45,8.65,9,-0.350000000000001,20,26,-6,-6,0
21700699,101127,NYK,GSW,Jarrett Jack,137,28.2666666666667,29,-0.733333333333334,74,86,-12,-11,-1
21700699,201149,NYK,GSW,Joakim Noah,18,4.43333333333333,5,-0.566666666666666,4,10,-6,-6,0
21700699,201563,NYK,GSW,Michael Beasley,165,35.3,35,0.299999999999997,87,95,-8,-8,0
21700699,201584,NYK,GSW,Courtney Lee,178,38.4166666666667,38,0.416666666666671,93,103,-10,-10,0
21700699,202498,NYK,GSW,Lance Thomas,84,20.2833333333333,20,0.283333333333331,37,45,-8,-8,0
21700699,202683,NYK,GSW,Enes Kanter,125,25.4,26,-0.600000000000001,67,74,-7,-8,1
21700699,203501,NYK,GSW,Tim Hardaway Jr.,159,34.5333333333333,35,-0.466666666666669,79,98,-19,-18,-1
21700699,203504,NYK,GSW,Trey Burke,11,1.96666666666667,2,-0.0333333333333334,9,2,7,7,0
21700699,203926,NYK,GSW,Doug McDermott,46,11.0833333333333,11,0.0833333333333322,22,24,-2,-3,1
21700699,1626195,NYK,GSW,Willy Hernangomez,75,18.0166666666667,18,0.0166666666666657,41,39,2,3,-1
21700699,1627758,NYK,GSW,Ron Baker,11,1.96666666666667,2,-0.0333333333333334,9,2,7,7,0
21700699,1628373,NYK,GSW,Frank Ntilikina,81,19.5833333333333,19,0.583333333333332,38,37,1,0,1
21700700,201143,BOS,LAL,Al Horford,153,31.7333333333333,32,-0.266666666666666,68,66,2,2,0
21700700,202681,BOS,LAL,Kyrie Irving,188,38.6666666666667,38,0.666666666666671,94,80,14,16,-2
21700700,202694,BOS,LAL,Marcus Morris,128,26.3333333333333,26,0.333333333333336,66,62,4,6,-2
21700700,203382,BOS,LAL,Aron Baynes,49,10.7333333333333,11,-0.266666666666668,13,22,-9,-7,-2
21700700,203935,BOS,LAL,Marcus Smart,168,33.4666666666667,33,0.466666666666669,78,85,-7,-7,0
21700700,204067,BOS,LAL,Jarell Eddie,14,3.55,4,-0.45,6,10,-4,-4,0
21700700,1626179,BOS,LAL,Terry Rozier,109,23.2333333333333,24,-0.766666666666666,55,54,1,-3,4
21700700,1627759,BOS,LAL,Jaylen Brown,125,25.9,26,-0.100000000000001,54,55,-1,-1,0
21700700,1628369,BOS,LAL,Jayson Tatum,145,30.5,31,-0.5,66,66,0,-2,2
21700700,1628464,BOS,LAL,Daniel Theis,71,15.8833333333333,16,-0.116666666666667,35,40,-5,-5,0
21700700,201572,LAL,BOS,Brook Lopez,70,14.6333333333333,15,-0.366666666666667,31,27,4,4,0
21700700,203484,LAL,BOS,Kentavious Caldwell-Pope,115,23.65,24,-0.350000000000001,51,52,-1,-1,0
21700700,203898,LAL,BOS,Tyler Ennis,65,13.6,14,-0.399999999999999,29,27,2,2,0
21700700,203903,LAL,BOS,Jordan Clarkson,165,34.4,34,0.400000000000006,79,80,-1,-1,0
21700700,203944,LAL,BOS,Julius Randle,132,26.2166666666667,26,0.216666666666665,56,59,-3,-3,0
21700700,1626204,LAL,BOS,Larry Nance Jr.,117,25.9833333333333,26,-0.0166666666666657,60,60,0,0,0
21700700,1627742,LAL,BOS,Brandon Ingram,161,33.25,33,0.25,73,75,-2,-2,0
21700700,1627936,LAL,BOS,Alex Caruso,86,18.7666666666667,19,-0.233333333333334,38,41,-3,-3,0
21700700,1628398,LAL,BOS,Kyle Kuzma,126,26.6,27,-0.399999999999999,61,59,2,2,0
21700700,1628404,LAL,BOS,Josh Hart,113,22.9,23,-0.100000000000001,62,55,7,7,0
21700701,2749,NOP,CHA,Jameer Nelson,66,16.45,17,-0.550000000000001,31,38,-7,-7,0
21700701,200765,NOP,CHA,Rajon Rondo,78,14.9,15,-0.100000000000001,26,29,-3,-1,-2
21700701,201600,NOP,CHA,Omer Asik,19,4.46666666666667,4,0.466666666666667,8,7,1,1,0
21700701,201950,NOP,CHA,Jrue Holiday,174,34.25,34,0.25,75,64,11,12,-1
21700701,201967,NOP,CHA,Dante Cunningham,101,21.7833333333333,21,0.783333333333331,49,40,9,11,-2
21700701,202326,NOP,CHA,DeMarcus Cousins,139,29.3333333333333,30,-0.666666666666668,60,61,-1,-3,2
21700701,202732,NOP,CHA,DeAndre Liggins,25,5.28333333333333,5,0.283333333333333,12,14,-2,-3,1
21700701,202734,NOP,CHA,E'Twaun Moore,168,32.95,33,-0.0499999999999972,74,63,11,10,1
21700701,203076,NOP,CHA,Anthony Davis,179,36.65,37,-0.349999999999994,78,74,4,4,0
21700701,203121,NOP,CHA,Darius Miller,146,31.4333333333333,31,0.433333333333334,70,63,7,6,1
21700701,203546,NOP,CHA,Ian Clark,50,12.25,12,0.25,22,27,-5,-5,0
21700701,2730,CHA,NOP,Dwight Howard,183,36.7166666666667,37,-0.283333333333331,69,81,-12,-12,0
21700701,101107,CHA,NOP,Marvin Williams,171,35.55,36,-0.450000000000003,74,68,6,5,1
21700701,201587,CHA,NOP,Nicolas Batum,158,30.7,30,0.699999999999999,58,67,-9,-11,2
21700701,202689,CHA,NOP,Kemba Walker,171,33.7666666666667,34,-0.233333333333334,67,74,-7,-6,-1
21700701,203077,CHA,NOP,Michael Kidd-Gilchrist,113,22.4166666666667,22,0.416666666666664,47,45,2,-2,4
21700701,203087,CHA,NOP,Jeremy Lamb,108,24.0333333333333,24,0.0333333333333314,48,51,-3,1,-4
21700701,203487,CHA,NOP,Michael Carter-Williams,58,14.1833333333333,14,0.183333333333334,29,27,2,1,1
21700701,203948,CHA,NOP,Johnny O'Bryant III,13,2.63333333333333,3,-0.366666666666667,3,8,-5,-5,0
21700701,1626163,CHA,NOP,Frank Kaminsky,91,21,21,0,46,45,1,2,-1
21700701,1626203,CHA,NOP,Treveon Graham,79,18.75,19,-0.25,39,39,0,2,-2
21700702,2207,UTA,DET,Joe Johnson,118,26.1166666666667,26,0.116666666666667,50,46,4,6,-2
21700702,201937,UTA,DET,Ricky Rubio,173,37.4166666666667,37,0.416666666666664,68,61,7,7,0
21700702,201973,UTA,DET,Jonas Jerebko,80,17.55,17,0.550000000000001,31,29,2,-3,5
21700702,202324,UTA,DET,Derrick Favors,113,24.1,24,0.100000000000001,41,42,-1,0,-1
21700702,202692,UTA,DET,Alec Burks,67,15.1666666666667,15,0.166666666666666,29,27,2,2,0
21700702,203497,UTA,DET,Rudy Gobert,177,37.8833333333333,38,-0.116666666666667,74,73,1,3,-2
21700702,203526,UTA,DET,Raul Neto,49,10.5,10,0.5,20,20,0,0,0
21700702,204060,UTA,DET,Joe Ingles,169,35.85,36,-0.150000000000006,69,62,7,7,0
21700702,1626220,UTA,DET,Royce O'Neale,84,17.35,17,0.350000000000001,28,40,-12,-9,-3
21700702,1628378,UTA,DET,Donovan Mitchell,200,43.0666666666667,43,0.0666666666666629,80,75,5,2,3
21700702,201229,DET,UTA,Anthony Tolliver,65,13.0666666666667,13,0.0666666666666664,29,22,7,6,1
21700702,202340,DET,UTA,Avery Bradley,186,40.05,41,-0.950000000000003,66,76,-10,-7,-3
21700702,202397,DET,UTA,Ish Smith,148,32.4166666666667,33,-0.583333333333329,59,60,-1,-1,0
21700702,202699,DET,UTA,Tobias Harris,183,40.2166666666667,40,0.216666666666669,66,76,-10,-9,-1
21700702,203083,DET,UTA,Andre Drummond,185,39.0833333333333,39,0.0833333333333357,66,74,-8,-3,-5
21700702,204038,DET,UTA,Langston Galloway,97,20.5166666666667,20,0.516666666666666,36,38,-2,-2,0
21700702,1626169,DET,UTA,Stanley Johnson,185,39.0333333333333,39,0.0333333333333314,74,77,-3,-6,3
21700702,1626246,DET,UTA,Boban Marjanovic,61,13.9166666666667,14,-0.0833333333333339,29,24,5,0,5
21700702,1628379,DET,UTA,Luke Kennard,120,26.7,26,0.700000000000003,50,43,7,7,0
21700703,2744,IND,PHX,Al Jefferson,98,20.2666666666667,21,-0.733333333333334,49,43,6,7,-1
21700703,201152,IND,PHX,Thaddeus Young,146,31.3666666666667,31,0.366666666666667,91,54,37,37,0
21700703,202362,IND,PHX,Lance Stephenson,102,21.7333333333333,22,-0.266666666666666,45,56,-11,-13,2
21700703,202709,IND,PHX,Cory Joseph,156,32.55,33,-0.450000000000003,73,81,-8,-8,0
21700703,202711,IND,PHX,Bojan Bogdanovic,152,31.5166666666667,32,-0.483333333333334,80,56,24,24,0
21700703,203506,IND,PHX,Victor Oladipo,156,33,33,0,92,59,33,35,-2
21700703,1626202,IND,PHX,Joe Young,151,32.7833333333333,34,-1.21666666666667,71,69,2,2,0
21700703,1627734,IND,PHX,Domantas Sabonis,110,23.9333333333333,24,-0.06666666666667,62,39,23,23,0
21700703,1627816,IND,PHX,Alex Poythress,17,3.41666666666667,3,0.416666666666667,5,19,-14,-15,1
21700703,1628388,IND,PHX,TJ Leaf,22,4.61666666666667,5,-0.383333333333333,8,11,-3,-3,0
21700703,1628500,IND,PHX,Ben Moore,15,2.9,3,-0.1,4,18,-14,-14,0
21700703,2199,PHX,IND,Tyson Chandler,46,10.05,10,0.0500000000000007,11,35,-24,-23,-1
21700703,201162,PHX,IND,Jared Dudley,98,20.4333333333333,20,0.433333333333334,44,51,-7,-6,-1
21700703,202328,PHX,IND,Greg Monroe,137,29.3833333333333,29,0.383333333333333,60,70,-10,-11,1
21700703,203477,PHX,IND,Isaiah Canaan,102,22.2666666666667,22,0.266666666666666,42,51,-9,-10,1
21700703,203584,PHX,IND,Troy Daniels,131,26.95,27,-0.0500000000000007,71,60,11,12,-1
21700703,203933,PHX,IND,T.J. Warren,107,23.1666666666667,24,-0.833333333333336,35,64,-29,-30,1
21700703,1626164,PHX,IND,Devin Booker,124,25.6,26,-0.399999999999999,41,74,-33,-33,0
21700703,1627733,PHX,IND,Dragan Bender,107,22.7166666666667,23,-0.283333333333331,49,57,-8,-9,1
21700703,1627755,PHX,IND,Tyler Ulis,93,20.4166666666667,21,-0.583333333333336,48,47,1,1,0
21700703,1628367,PHX,IND,Josh Jackson,123,25.4666666666667,25,0.466666666666669,68,54,14,15,-1
21700703,1628409,PHX,IND,Alec Peters,57,11.6333333333333,12,-0.366666666666667,36,17,19,19,0
21700704,201577,CHI,PHI,Robin Lopez,85,18.1166666666667,19,-0.883333333333333,26,52,-26,-26,0
21700704,202347,CHI,PHI,Quincy Pondexter,10,2.08333333333333,2,0.083333333333333,3,0,3,1,2
21700704,202703,CHI,PHI,Nikola Mirotic,123,26.4,26,0.399999999999999,69,58,11,12,-1
21700704,203200,CHI,PHI,Justin Holiday,126,25.5833333333333,26,-0.416666666666664,46,72,-26,-24,-2
21700704,203897,CHI,PHI,Zach LaVine,104,23.5833333333333,24,-0.416666666666664,52,58,-6,-5,-1
21700704,1626170,CHI,PHI,Jerian Grant,115,25.05,25,0.0499999999999972,48,69,-21,-22,1
21700704,1626171,CHI,PHI,Bobby Portis,116,25.1666666666667,25,0.166666666666668,69,48,21,20,1
21700704,1626245,CHI,PHI,Cristiano Felicio,18,3.31666666666667,3,0.316666666666666,6,4,2,0,2
21700704,1627756,CHI,PHI,Denzel Valentine,115,24.15,24,0.149999999999999,55,61,-6,-6,0
21700704,1627835,CHI,PHI,Paul Zipser,18,3.31666666666667,3,0.316666666666666,6,4,2,0,2
21700704,1627853,CHI,PHI,Ryan Arcidiacono,89,18.05,18,0.0500000000000007,46,31,15,15,0
21700704,1628021,CHI,PHI,David Nwaba,101,21.6833333333333,22,-0.316666666666666,47,47,0,-1,1
21700704,1628374,CHI,PHI,Lauri Markkanen,110,22.6666666666667,23,-0.333333333333332,32,66,-34,-34,0
21700704,101161,PHI,CHI,Amir Johnson,61,12.2666666666667,12,0.266666666666666,32,19,13,11,2
21700704,202344,PHI,CHI,Trevor Booker,80,17.6833333333333,18,-0.316666666666666,35,50,-15,-16,1
21700704,203496,PHI,CHI,Robert Covington,148,31.75,32,-0.25,73,76,-3,-1,-2
21700704,203580,PHI,CHI,Larry Drew II,37,9.01666666666667,9,0.0166666666666657,14,20,-6,-4,-2
21700704,203923,PHI,CHI,James Young,63,12.3333333333333,12,0.333333333333332,20,31,-11,-12,1
21700704,203954,PHI,CHI,Joel Embiid,139,31.2,32,-0.799999999999997,74,69,5,9,-4
21700704,203967,PHI,CHI,Dario Saric,133,27.95,28,-0.0500000000000007,79,48,31,31,0
21700704,1626147,PHI,CHI,Justin Anderson,107,20.85,21,-0.149999999999999,61,35,26,23,3
21700704,1626158,PHI,CHI,Richaun Holmes,23,4,4,0,6,11,-5,-4,-1
21700704,1627732,PHI,CHI,Ben Simmons,189,38.8166666666667,39,-0.183333333333337,100,81,19,18,1
21700704,1627789,PHI,CHI,Timothe Luwawu-Cabarrot,150,33.3,34,-0.700000000000003,76,65,11,15,-4
21700705,101141,ATL,TOR,Ersan Ilyasova,95,19.4166666666667,20,-0.583333333333336,30,50,-20,-20,0
21700705,201158,ATL,TOR,Marco Belinelli,119,22.4333333333333,23,-0.56666666666667,43,61,-18,-16,-2
21700705,202337,ATL,TOR,Luke Babbitt,85,16.0833333333333,16,0.0833333333333322,36,27,9,8,1
21700705,203101,ATL,TOR,Miles Plumlee,93,18.9666666666667,19,-0.0333333333333314,35,38,-3,-3,0
21700705,203145,ATL,TOR,Kent Bazemore,137,26.85,27,-0.149999999999999,51,67,-16,-16,0
21700705,203471,ATL,TOR,Dennis Schroder,138,27.0666666666667,27,0.0666666666666664,51,67,-16,-18,2
21700705,203473,ATL,TOR,Dewayne Dedmon,99,18.5666666666667,18,0.566666666666666,32,50,-18,-18,0
21700705,203488,ATL,TOR,Mike Muscala,63,12.1833333333333,12,0.183333333333334,25,29,-4,-4,0
21700705,1627098,ATL,TOR,Malcolm Delaney,71,13.8333333333333,14,-0.166666666666668,26,32,-6,-4,-2
21700705,1627752,ATL,TOR,Taurean Prince,61,12.9333333333333,13,-0.0666666666666664,20,27,-7,-7,0
21700705,1627819,ATL,TOR,Isaiah Taylor,53,10.6,11,-0.399999999999999,27,11,16,16,0
21700705,1628381,ATL,TOR,John Collins,138,26.3,26,0.300000000000001,64,49,15,15,0
21700705,1628416,ATL,TOR,Tyler Dorsey,68,13.35,14,-0.65,25,32,-7,-8,1
21700705,101139,TOR,ATL,CJ Miles,84,15.3666666666667,15,0.366666666666667,36,24,12,8,4
21700705,200768,TOR,ATL,Kyle Lowry,141,27.7,28,-0.300000000000001,69,53,16,16,0
21700705,201586,TOR,ATL,Serge Ibaka,118,24.0833333333333,24,0.0833333333333322,62,42,20,17,3
21700705,201942,TOR,ATL,DeMar DeRozan,136,27.0166666666667,27,0.0166666666666657,62,49,13,11,2
21700705,202685,TOR,ATL,Jonas Valanciunas,118,23.8166666666667,24,-0.183333333333334,63,42,21,19,2
21700705,203512,TOR,ATL,Lucas Nogueira,31,6.06666666666667,6,0.0666666666666664,6,21,-15,-15,0
21700705,1626153,TOR,ATL,Delon Wright,93,18.45,18,0.449999999999999,37,35,2,2,0
21700705,1626181,TOR,ATL,Norman Powell,55,10.85,11,-0.15,19,29,-10,-8,-2
21700705,1627751,TOR,ATL,Jakob Poeltl,95,17.8333333333333,18,-0.166666666666664,39,30,9,11,-2
21700705,1627783,TOR,ATL,Pascal Siakam,110,20.55,20,0.549999999999997,44,39,5,6,-1
21700705,1627832,TOR,ATL,Fred VanVleet,99,18.2166666666667,18,0.216666666666669,47,34,13,13,0
21700705,1628035,TOR,ATL,Alfonzo McKinnie,28,5.58333333333333,6,-0.416666666666666,6,19,-13,-13,0
21700705,1628384,TOR,ATL,OG Anunoby,112,23.05,24,-0.950000000000003,50,48,2,8,-6
21700706,1717,DAL,HOU,Dirk Nowitzki,62,14.7166666666667,15,-0.283333333333333,25,40,-15,-16,1
21700706,200826,DAL,HOU,J.J. Barea,109,26.75,27,-0.25,45,39,6,6,0
21700706,202083,DAL,HOU,Wesley Matthews,161,37.9666666666667,38,-0.0333333333333314,76,92,-16,-17,1
21700706,203084,DAL,HOU,Harrison Barnes,142,33.2833333333333,33,0.283333333333331,66,85,-19,-20,1
21700706,203939,DAL,HOU,Dwight Powell,99,23.2333333333333,24,-0.766666666666666,42,35,7,6,1
21700706,1626257,DAL,HOU,Salah Mejri,69,14.5333333333333,15,-0.466666666666667,31,37,-6,-5,-1
21700706,1627812,DAL,HOU,Yogi Ferrell,145,32.05,32,0.0499999999999972,71,66,5,8,-3
21700706,1627858,DAL,HOU,Kyle Collinsworth,68,15.1666666666667,15,0.166666666666668,31,19,12,13,-1
21700706,1628372,DAL,HOU,Dennis Smith Jr.,136,30.5666666666667,30,0.566666666666666,67,80,-13,-15,2
21700706,1628405,DAL,HOU,Johnathan Motley,13,2.45,2,0.45,10,2,8,9,-1
21700706,1628467,DAL,HOU,Maxi Kleber,41,8.95,9,-0.0500000000000007,21,25,-4,-4,0
21700706,2772,HOU,DAL,Trevor Ariza,141,31.3,32,-0.699999999999999,79,67,12,12,0
21700706,101108,HOU,DAL,Chris Paul,126,30.3666666666667,30,0.366666666666667,60,51,9,7,2
21700706,101123,HOU,DAL,Gerald Green,21,4.31666666666667,4,0.316666666666666,5,18,-13,-13,0
21700706,200782,HOU,DAL,PJ Tucker,83,19.5,19,0.5,39,37,2,2,0
21700706,201569,HOU,DAL,Eric Gordon,134,30.65,30,0.649999999999999,56,67,-11,-9,-2
21700706,201583,HOU,DAL,Ryan Anderson,106,24.5,25,-0.5,62,42,20,20,0
21700706,201601,HOU,DAL,Luc Mbah a Moute,97,22.2166666666667,22,0.216666666666669,30,51,-21,-21,0
21700706,201935,HOU,DAL,James Harden,139,32.2333333333333,33,-0.766666666666666,88,58,30,30,0
21700706,203991,HOU,DAL,Clint Capela,144,32.4,33,-0.600000000000001,79,54,25,24,1
21700706,204028,HOU,DAL,Tarik Black,54,12.1833333333333,12,0.183333333333334,22,40,-18,-17,-1
21700707,2200,SAS,MEM,Pau Gasol,152,33.4833333333333,33,0.483333333333334,74,60,14,16,-2
21700707,2225,SAS,MEM,Tony Parker,97,21.5333333333333,21,0.533333333333331,40,42,-2,-6,4
21700707,201980,SAS,MEM,Danny Green,121,28.3833333333333,29,-0.616666666666667,68,41,27,24,3
21700707,201988,SAS,MEM,Patty Mills,113,24.2333333333333,24,0.233333333333334,52,52,0,0,0
21700707,202722,SAS,MEM,Davis Bertans,143,32.8166666666667,33,-0.18333333333333,71,53,18,16,2
21700707,203464,SAS,MEM,Brandon Paul,10,2.03333333333333,2,0.0333333333333332,4,1,3,4,-1
21700707,203530,SAS,MEM,Joffrey Lauvergne,80,18.4,19,-0.600000000000001,43,34,9,7,2
21700707,203937,SAS,MEM,Kyle Anderson,124,27.6666666666667,28,-0.333333333333336,64,48,16,18,-2
21700707,1626199,SAS,MEM,Darrun Hilliard,10,2.03333333333333,2,0.0333333333333332,4,1,3,4,-1
21700707,1627749,SAS,MEM,Dejounte Murray,109,24.3833333333333,24,0.383333333333333,64,42,22,25,-3
21700707,1627854,SAS,MEM,Bryn Forbes,121,24.7833333333333,25,-0.216666666666669,56,51,5,7,-2
21700707,201148,MEM,SAS,Brandan Wright,52,10.9333333333333,12,-1.06666666666667,21,25,-4,-6,2
21700707,201188,MEM,SAS,Marc Gasol,133,30.0833333333333,30,0.0833333333333357,48,70,-22,-22,0
21700707,201596,MEM,SAS,Mario Chalmers,108,23.15,23,0.149999999999999,44,56,-12,-9,-3
21700707,203463,MEM,SAS,Ben McLemore,86,18.3166666666667,18,0.316666666666666,40,39,1,3,-2
21700707,1626150,MEM,SAS,Andrew Harrison,118,27.4666666666667,28,-0.533333333333331,43,62,-19,-22,3
21700707,1627738,MEM,SAS,Deyonta Davis,98,20.9333333333333,21,-0.0666666666666664,47,51,-4,-3,-1
21700707,1627782,MEM,SAS,Wayne Selden,120,27.0666666666667,27,0.0666666666666664,38,63,-25,-27,2
21700707,1627988,MEM,SAS,Myke Henry,103,21.95,22,-0.0500000000000007,38,48,-10,-6,-4
21700707,1628397,MEM,SAS,Ivan Rabb,69,15.8666666666667,17,-1.13333333333333,27,29,-2,-3,1
21700707,1628415,MEM,SAS,Dillon Brooks,129,30.0833333333333,30,0.0833333333333357,46,68,-22,-22,0
21700707,1628424,MEM,SAS,Kobi Simmons,64,13.9,14,-0.100000000000001,33,29,4,2,2
21700708,2037,MIN,POR,Jamal Crawford,84,20.2333333333333,20,0.233333333333334,46,51,-5,-10,5
21700708,201166,MIN,POR,Aaron Brooks,9,1.31666666666667,2,-0.683333333333333,8,0,8,6,2
21700708,201952,MIN,POR,Jeff Teague,116,26.6333333333333,27,-0.366666666666667,62,77,-15,-15,0
21700708,201959,MIN,POR,Taj Gibson,123,28.4833333333333,29,-0.516666666666666,66,82,-16,-16,0
21700708,202332,MIN,POR,Cole Aldrich,17,3.38333333333333,4,-0.616666666666667,12,2,10,10,0
21700708,202357,MIN,POR,Nemanja Bjelica,153,35.45,36,-0.549999999999997,85,95,-10,-8,-2
21700708,203476,MIN,POR,Gorgui Dieng,73,16.9166666666667,17,-0.0833333333333322,41,35,6,5,1
21700708,203498,MIN,POR,Shabazz Muhammad,17,3.38333333333333,4,-0.616666666666667,12,2,10,10,0
21700708,203952,MIN,POR,Andrew Wiggins,138,31.9,32,-0.100000000000001,74,95,-21,-24,3
21700708,1626145,MIN,POR,Tyus Jones,90,21.0833333333333,21,0.0833333333333322,52,46,6,6,0
21700708,1626157,MIN,POR,Karl-Anthony Towns,133,30.8,31,-0.199999999999999,73,88,-15,-14,-1
21700708,1627875,MIN,POR,Marcus Georges-Hunt,77,19,19,0,39,42,-3,5,-8
21700708,202323,POR,MIN,Evan Turner,112,25.3666666666667,26,-0.633333333333333,74,61,13,12,1
21700708,202329,POR,MIN,Al-Farouq Aminu,114,26.1,26,0.100000000000001,76,61,15,11,4
21700708,202334,POR,MIN,Ed Davis,104,24.7166666666667,25,-0.283333333333335,67,56,11,14,-3
21700708,203081,POR,MIN,Damian Lillard,139,32.1166666666667,32,0.116666666666667,91,79,12,11,1
21700708,203086,POR,MIN,Meyers Leonard,14,2.55,3,-0.45,0,10,-10,-10,0
21700708,203090,POR,MIN,Maurice Harkless,14,2.55,3,-0.45,0,10,-10,-10,0
21700708,203468,POR,MIN,CJ McCollum,150,35.2,35,0.200000000000003,93,76,17,19,-2
21700708,203894,POR,MIN,Shabazz Napier,96,22.7333333333333,23,-0.266666666666666,50,55,-5,0,-5
21700708,203943,POR,MIN,Noah Vonleh,14,2.55,3,-0.45,0,10,-10,-10,0
21700708,203994,POR,MIN,Jusuf Nurkic,88,20.45,20,0.449999999999999,56,48,8,3,5
21700708,1626192,POR,MIN,Pat Connaughton,93,22.6333333333333,23,-0.366666666666667,61,51,10,9,1
21700708,1627774,POR,MIN,Jake Layman,14,2.55,3,-0.45,0,10,-10,-10,0
21700708,1628380,POR,MIN,Zach Collins,78,19.0666666666667,19,0.0666666666666664,47,43,4,6,-2
21700709,202681,BOS,LAC,Kyrie Irving,147,28.3666666666667,28,0.366666666666667,69,65,4,2,2
21700709,202694,BOS,LAC,Marcus Morris,136,27.3666666666667,28,-0.633333333333333,65,64,1,-1,2
21700709,203382,BOS,LAC,Aron Baynes,123,24.6833333333333,25,-0.31666666666667,58,52,6,3,3
21700709,203499,BOS,LAC,Shane Larkin,113,23.0166666666667,23,0.0166666666666657,54,50,4,3,1
21700709,204067,BOS,LAC,Jarell Eddie,8,1.7,2,-0.3,0,5,-5,-5,0
21700709,1626179,BOS,LAC,Terry Rozier,119,23.8166666666667,24,-0.183333333333334,60,40,20,19,1
21700709,1627759,BOS,LAC,Jaylen Brown,148,28.35,28,0.350000000000001,66,58,8,6,2
21700709,1627846,BOS,LAC,Abdel Nader,37,7.15,7,0.15,20,17,3,4,-1
21700709,1628369,BOS,LAC,Jayson Tatum,158,33.4833333333333,34,-0.516666666666666,80,76,4,6,-2
21700709,1628400,BOS,LAC,Semi Ojeleye,87,17.3333333333333,18,-0.666666666666668,40,29,11,8,3
21700709,1628464,BOS,LAC,Daniel Theis,114,22.9,23,-0.100000000000001,53,49,4,10,-6
21700709,101150,LAC,BOS,Lou Williams,168,32.9833333333333,33,-0.0166666666666657,74,82,-8,-8,0
21700709,201599,LAC,BOS,DeAndre Jordan,155,30.7,31,-0.300000000000001,68,74,-6,-2,-4
21700709,201933,LAC,BOS,Blake Griffin,172,33.8333333333333,34,-0.166666666666671,70,83,-13,-11,-2
21700709,202325,LAC,BOS,Wesley Johnson,172,34.2333333333333,35,-0.766666666666666,73,76,-3,0,-3
21700709,203186,LAC,BOS,Willie Reed,8,1.7,2,-0.3,5,0,5,5,0
21700709,1626149,LAC,BOS,Montrezl Harrell,83,16.9333333333333,18,-1.06666666666667,33,39,-6,-9,3
21700709,1626155,LAC,BOS,Sam Dekker,66,13.8,14,-0.199999999999999,31,30,1,0,1
21700709,1627820,LAC,BOS,Tyrone Wallace,173,33.95,34,-0.0499999999999972,70,82,-12,-12,0
21700709,1628414,LAC,BOS,Sindarius Thornwell,78,15.8,16,-0.199999999999999,33,40,-7,-8,1
21700709,1628462,LAC,BOS,Milos Teodosic,115,24.2333333333333,24,0.233333333333334,48,59,-11,-10,-1
21700710,201609,MIA,SAC,Goran Dragic,135,31.35,31,0.349999999999998,54,68,-14,-14,0
21700710,201949,MIA,SAC,James Johnson,126,28.8,29,-0.199999999999999,46,57,-11,-11,0
21700710,201961,MIA,SAC,Wayne Ellington,150,34.5833333333333,34,0.583333333333329,68,68,0,0,0
21700710,202355,MIA,SAC,Hassan Whiteside,118,27.55,27,0.549999999999997,46,57,-11,-11,0
21700710,203482,MIA,SAC,Kelly Olynyk,82,19.25,19,0.25,42,32,10,10,0
21700710,1626159,MIA,SAC,Justise Winslow,114,27.2,27,0.199999999999999,63,42,21,19,2
21700710,1626196,MIA,SAC,Josh Richardson,156,35.8333333333333,36,-0.166666666666671,58,57,1,1,0
21700710,1627884,MIA,SAC,Derrick Jones Jr.,66,15.0333333333333,15,0.0333333333333314,21,32,-11,-9,-2
21700710,1628389,MIA,SAC,Bam Adebayo,88,20.4,21,-0.600000000000001,42,32,10,10,0
21700710,2216,SAC,MIA,Zach Randolph,127,28.4333333333333,28,0.433333333333334,64,46,18,18,0
21700710,201585,SAC,MIA,Kosta Koufos,79,19.1333333333333,19,0.133333333333333,29,41,-12,-12,0
21700710,202066,SAC,MIA,Garrett Temple,73,18.2333333333333,19,-0.766666666666666,24,39,-15,-15,0
21700710,203992,SAC,MIA,Bogdan Bogdanovic,155,35.3166666666667,35,0.316666666666663,71,58,13,13,0
21700710,1626161,SAC,MIA,Willie Cauley-Stein,138,31.1666666666667,31,0.166666666666664,61,52,9,9,0
21700710,1627741,SAC,MIA,Buddy Hield,126,28.9,29,-0.100000000000001,55,57,-2,-2,0
21700710,1627746,SAC,MIA,Skal Labissiere,69,17.2166666666667,18,-0.783333333333331,24,37,-13,-13,0
21700710,1627781,SAC,MIA,Malachi Richardson,50,12.6333333333333,13,-0.366666666666667,16,30,-14,-14,0
21700710,1628368,SAC,MIA,De'Aaron Fox,135,29.8166666666667,30,-0.183333333333334,65,49,16,16,0
21700710,1628382,SAC,MIA,Justin Jackson,83,19.15,19,0.149999999999999,36,31,5,5,0
21700711,2546,OKC,WAS,Carmelo Anthony,170,33.7,34,-0.299999999999997,80,84,-4,-3,-1
21700711,101109,OKC,WAS,Raymond Felton,61,13.5833333333333,13,0.583333333333332,36,27,9,8,1
21700711,201566,OKC,WAS,Russell Westbrook,190,36.4666666666667,37,-0.533333333333331,93,93,0,0,0
21700711,202331,OKC,WAS,Paul George,189,37.7333333333333,38,-0.266666666666666,93,93,0,1,-1
21700711,202335,OKC,WAS,Patrick Patterson,64,13.3166666666667,13,0.316666666666666,40,28,12,13,-1
21700711,203460,OKC,WAS,Andre Roberson,121,23.4333333333333,23,0.433333333333334,53,55,-2,-6,4
21700711,203500,OKC,WAS,Steven Adams,181,34.9833333333333,36,-1.01666666666667,87,86,1,2,-1
21700711,203924,OKC,WAS,Jerami Grant,61,13.6333333333333,13,0.633333333333333,35,26,9,6,3
21700711,203962,OKC,WAS,Josh Huestis,36,7.85,8,-0.15,20,11,9,9,0
21700711,1628390,OKC,WAS,Terrance Ferguson,117,24.3833333333333,25,-0.616666666666667,68,57,11,15,-4
21700711,101133,WAS,OKC,Ian Mahinmi,47,10.4166666666667,11,-0.583333333333332,21,23,-2,-2,0
21700711,101162,WAS,OKC,Marcin Gortat,110,21,21,0,51,46,5,3,2
21700711,201160,WAS,OKC,Jason Smith,12,2.51666666666667,3,-0.483333333333333,0,7,-7,-7,0
21700711,202322,WAS,OKC,John Wall,184,34.9833333333333,35,-0.0166666666666657,91,91,0,1,-1
21700711,202693,WAS,OKC,Markieff Morris,187,37.2666666666667,38,-0.733333333333334,93,89,4,2,2
21700711,203078,WAS,OKC,Bradley Beal,226,45.3,46,-0.700000000000003,112,114,-2,-2,0
21700711,203107,WAS,OKC,Tomas Satoransky,54,12.8333333333333,13,-0.166666666666668,21,30,-9,-10,1
21700711,203118,WAS,OKC,Mike Scott,61,13.4166666666667,13,0.416666666666666,24,37,-13,-11,-2
21700711,203490,WAS,OKC,Otto Porter Jr.,190,36.85,37,-0.149999999999999,91,91,0,0,0
21700711,1626162,WAS,OKC,Kelly Oubre Jr.,119,24.5,25,-0.5,56,77,-21,-19,-2
21700712,201163,DEN,NYK,Wilson Chandler,130,29.2166666666667,29,0.216666666666669,82,70,12,10,2
21700712,201589,DEN,NYK,Darrell Arthur,3,0.666666666666667,1,-0.333333333333333,3,4,-1,-1,0
21700712,203115,DEN,NYK,Will Barton,175,39.5833333333333,39,0.583333333333329,108,99,9,10,-1
21700712,203486,DEN,NYK,Mason Plumlee,109,23.9333333333333,24,-0.0666666666666664,62,57,5,6,-1
21700712,203914,DEN,NYK,Gary Harris,143,31.5166666666667,31,0.516666666666666,77,73,4,5,-1
21700712,203999,DEN,NYK,Nikola Jokic,153,34.9,35,-0.100000000000001,90,75,15,12,3
21700712,1626144,DEN,NYK,Emmanuel Mudiay,58,13.15,13,0.15,43,38,5,5,0
21700712,1626168,DEN,NYK,Trey Lyles,99,21.5666666666667,22,-0.433333333333334,63,62,1,3,-2
21700712,1627736,DEN,NYK,Malik Beasley,3,0.666666666666667,1,-0.333333333333333,3,4,-1,-1,0
21700712,1627750,DEN,NYK,Jamal Murray,156,34.5166666666667,35,-0.483333333333334,87,80,7,7,0
21700712,1628470,DEN,NYK,Torrey Craig,41,8.61666666666667,9,-0.383333333333333,32,28,4,4,0
21700712,101127,NYK,DEN,Jarrett Jack,117,26.2833333333333,26,0.283333333333331,58,63,-5,-5,0
21700712,201563,NYK,DEN,Michael Beasley,127,28.5333333333333,29,-0.466666666666669,74,73,1,2,-1
21700712,201584,NYK,DEN,Courtney Lee,154,34.2666666666667,34,0.266666666666666,77,88,-11,-10,-1
21700712,202498,NYK,DEN,Lance Thomas,94,20.3833333333333,20,0.383333333333333,51,54,-3,-4,1
21700712,202683,NYK,DEN,Enes Kanter,119,27.15,27,0.149999999999999,61,74,-13,-11,-2
21700712,203504,NYK,DEN,Trey Burke,128,28.75,29,-0.25,76,80,-4,-6,2
21700712,203926,NYK,DEN,Doug McDermott,3,0.666666666666667,1,-0.333333333333333,4,3,1,1,0
21700712,204001,NYK,DEN,Kristaps Porzingis,119,26.4666666666667,27,-0.533333333333335,62,65,-3,-4,1
21700712,1626195,NYK,DEN,Willy Hernangomez,67,14.5833333333333,15,-0.416666666666668,41,50,-9,-9,0
21700712,1627758,NYK,DEN,Ron Baker,53,11.7166666666667,12,-0.283333333333335,29,34,-5,-5,0
21700712,1628373,NYK,DEN,Frank Ntilikina,86,18.8666666666667,19,-0.133333333333333,53,63,-10,-10,0
21700712,1628422,NYK,DEN,Damyean Dotson,3,0.666666666666667,1,-0.333333333333333,4,3,1,1,0
21700713,2561,GSW,MIN,David West,52,11.1333333333333,11,0.133333333333333,16,24,-8,-9,1
21700713,2585,GSW,MIN,Zaza Pachulia,81,16.3666666666667,16,0.366666666666667,50,47,3,3,0
21700713,2733,GSW,MIN,Shaun Livingston,72,15.7833333333333,16,-0.216666666666667,35,39,-4,-5,1
21700713,2738,GSW,MIN,Andre Iguodala,124,25.85,26,-0.149999999999999,64,50,14,14,0
21700713,201142,GSW,MIN,Kevin Durant,179,36.3333333333333,37,-0.666666666666671,107,88,19,19,0
21700713,201156,GSW,MIN,Nick Young,74,15.2833333333333,15,0.283333333333333,43,37,6,8,-2
21700713,201939,GSW,MIN,Stephen Curry,183,37.3833333333333,37,0.383333333333333,110,90,20,20,0
21700713,202691,GSW,MIN,Klay Thompson,173,35.5166666666667,36,-0.483333333333334,87,83,4,4,0
21700713,203110,GSW,MIN,Draymond Green,162,32.55,32,0.549999999999997,79,77,2,3,-1
21700713,1626172,GSW,MIN,Kevon Looney,65,13.55,14,-0.449999999999999,39,30,9,8,1
21700713,2037,MIN,GSW,Jamal Crawford,121,25.4666666666667,26,-0.533333333333331,52,55,-3,-3,0
21700713,201952,MIN,GSW,Jeff Teague,172,35.2833333333333,35,0.283333333333331,85,98,-13,-13,0
21700713,201959,MIN,GSW,Taj Gibson,166,33.4333333333333,34,-0.566666666666663,79,95,-16,-16,0
21700713,202357,MIN,GSW,Nemanja Bjelica,179,37,37,0,95,102,-7,-7,0
21700713,203476,MIN,GSW,Gorgui Dieng,59,12.1333333333333,12,0.133333333333333,22,21,1,-1,2
21700713,203952,MIN,GSW,Andrew Wiggins,186,37.4166666666667,37,0.416666666666671,97,103,-6,-6,0
21700713,1626145,MIN,GSW,Tyus Jones,59,12.5166666666667,12,0.516666666666666,28,26,2,2,0
21700713,1626157,MIN,GSW,Karl-Anthony Towns,174,35.8166666666667,36,-0.183333333333337,91,105,-14,-12,-2
21700713,1627875,MIN,GSW,Marcus Georges-Hunt,49,10.6833333333333,11,-0.316666666666666,16,25,-9,-9,0
21700714,101141,ATL,CHA,Ersan Ilyasova,138,28.1166666666667,29,-0.883333333333333,65,81,-16,-19,3
21700714,201158,ATL,CHA,Marco Belinelli,106,21.7666666666667,22,-0.233333333333334,46,47,-1,-1,0
21700714,203101,ATL,CHA,Miles Plumlee,46,10.1166666666667,10,0.116666666666667,28,31,-3,-3,0
21700714,203145,ATL,CHA,Kent Bazemore,152,31.3666666666667,31,0.366666666666667,70,85,-15,-16,1
21700714,203471,ATL,CHA,Dennis Schroder,102,21.2,22,-0.800000000000001,45,63,-18,-20,2
21700714,203473,ATL,CHA,Dewayne Dedmon,102,20.9833333333333,21,-0.0166666666666657,42,48,-6,-2,-4
21700714,203488,ATL,CHA,Mike Muscala,68,14.0333333333333,14,0.0333333333333332,35,33,2,0,2
21700714,1627098,ATL,CHA,Malcolm Delaney,130,26.7666666666667,26,0.766666666666666,65,57,8,9,-1
21700714,1627752,ATL,CHA,Taurean Prince,149,31.3333333333333,31,0.333333333333332,71,87,-16,-16,0
21700714,1628381,ATL,CHA,John Collins,103,21.3166666666667,21,0.316666666666666,50,42,8,7,1
21700714,1628416,ATL,CHA,Tyler Dorsey,64,12.8333333333333,13,-0.166666666666668,33,26,7,6,1
21700714,2730,CHA,ATL,Dwight Howard,164,33.7,34,-0.299999999999997,92,80,12,15,-3
21700714,101107,CHA,ATL,Marvin Williams,117,24.4833333333333,25,-0.516666666666666,74,58,16,15,1
21700714,201587,CHA,ATL,Nicolas Batum,133,27.9833333333333,28,-0.0166666666666657,78,67,11,14,-3
21700714,202689,CHA,ATL,Kemba Walker,173,35.3166666666667,35,0.316666666666663,102,75,27,28,-1
21700714,203077,CHA,ATL,Michael Kidd-Gilchrist,145,29.8666666666667,30,-0.133333333333333,87,64,23,22,1
21700714,203087,CHA,ATL,Jeremy Lamb,114,23.3,23,0.299999999999997,46,50,-4,-4,0
21700714,203487,CHA,ATL,Michael Carter-Williams,78,16.1333333333333,16,0.133333333333333,29,43,-14,-13,-1
21700714,203948,CHA,ATL,Johnny O'Bryant III,54,11.5166666666667,11,0.516666666666666,26,26,0,1,-1
21700714,1626163,CHA,ATL,Frank Kaminsky,129,26.2333333333333,26,0.233333333333334,48,56,-8,-9,1
21700714,1626203,CHA,ATL,Treveon Graham,53,11.3,11,0.300000000000001,18,31,-13,-14,1
21700715,2544,CLE,IND,LeBron James,185,39.7666666666667,40,-0.233333333333334,99,87,12,12,0
21700715,2594,CLE,IND,Kyle Korver,51,11.7,12,-0.300000000000001,25,32,-7,-7,0
21700715,2747,CLE,IND,JR Smith,178,37.3833333333333,37,0.383333333333333,94,78,16,14,2
21700715,101112,CLE,IND,Channing Frye,57,13.3,13,0.300000000000001,33,38,-5,-5,0
21700715,201145,CLE,IND,Jeff Green,57,13.7833333333333,14,-0.216666666666667,30,35,-5,-5,0
21700715,201565,CLE,IND,Derrick Rose,68,15.0166666666667,15,0.0166666666666657,41,30,11,12,-1
21700715,201567,CLE,IND,Kevin Love,158,32.4833333333333,33,-0.516666666666666,78,66,12,12,0
21700715,202684,CLE,IND,Tristan Thompson,151,31.1833333333333,31,0.183333333333334,74,63,11,13,-2
21700715,202738,CLE,IND,Isaiah Thomas,138,29.2166666666667,29,0.216666666666665,68,65,3,2,1
21700715,203109,CLE,IND,Jae Crowder,71,15.8666666666667,16,-0.133333333333333,33,44,-11,-11,0
21700715,1626224,CLE,IND,Cedi Osman,1,0.05,0,0.05,,2,,-2,
21700715,2744,IND,CLE,Al Jefferson,59,12.5333333333333,12,0.533333333333333,29,32,-3,-3,0
21700715,201152,IND,CLE,Thaddeus Young,161,33.3666666666667,33,0.366666666666667,66,83,-17,-17,0
21700715,201954,IND,CLE,Darren Collison,170,36.2333333333333,36,0.233333333333334,87,81,6,8,-2
21700715,202362,IND,CLE,Lance Stephenson,103,22.65,23,-0.350000000000001,54,50,4,4,0
21700715,202709,IND,CLE,Cory Joseph,92,20.4833333333333,20,0.483333333333334,50,51,-1,-2,1
21700715,202711,IND,CLE,Bojan Bogdanovic,127,26.5166666666667,27,-0.483333333333334,60,62,-2,-2,0
21700715,203506,IND,CLE,Victor Oladipo,181,37.9833333333333,38,-0.0166666666666657,82,93,-11,-13,2
21700715,1626202,IND,CLE,Joe Young,20,5.2,5,0.2,11,13,-2,-1,-1
21700715,1627734,IND,CLE,Domantas Sabonis,164,35.4166666666667,36,-0.583333333333329,79,83,-4,-4,0
21700715,1627816,IND,CLE,Alex Poythress,38,9.36666666666667,9,0.366666666666667,22,27,-5,-5,0
21700716,101139,TOR,UTA,CJ Miles,77,16.8166666666667,17,-0.183333333333334,33,31,2,2,0
21700716,200768,TOR,UTA,Kyle Lowry,171,35.3833333333333,35,0.383333333333333,65,73,-8,-6,-2
21700716,201586,TOR,UTA,Serge Ibaka,145,29.6333333333333,30,-0.366666666666667,56,63,-7,-9,2
21700716,201942,TOR,UTA,DeMar DeRozan,183,37.0666666666667,37,0.0666666666666629,72,79,-7,-7,0
21700716,202685,TOR,UTA,Jonas Valanciunas,133,27.1166666666667,27,0.116666666666667,56,54,2,4,-2
21700716,1626153,TOR,UTA,Delon Wright,90,19.25,19,0.25,38,38,0,-2,2
21700716,1627751,TOR,UTA,Jakob Poeltl,95,20.8333333333333,21,-0.166666666666668,37,43,-6,-6,0
21700716,1627783,TOR,UTA,Pascal Siakam,82,18.3333333333333,18,0.333333333333332,37,32,5,5,0
21700716,1627832,TOR,UTA,Fred VanVleet,84,18.5166666666667,18,0.516666666666666,34,34,0,0,0
21700716,1628384,TOR,UTA,OG Anunoby,85,17.05,17,0.0499999999999972,37,38,-1,-1,0
21700716,2207,UTA,TOR,Joe Johnson,91,19.5333333333333,20,-0.466666666666669,35,36,-1,1,-2
21700716,201937,UTA,TOR,Ricky Rubio,153,30.9,31,-0.100000000000001,64,61,3,4,-1
21700716,201973,UTA,TOR,Jonas Jerebko,86,18.1666666666667,18,0.166666666666664,37,33,4,4,0
21700716,202324,UTA,TOR,Derrick Favors,125,27.5166666666667,27,0.516666666666666,57,53,4,-1,5
21700716,202692,UTA,TOR,Alec Burks,78,17.3666666666667,17,0.366666666666667,33,34,-1,0,-1
21700716,203497,UTA,TOR,Rudy Gobert,153,30.7,31,-0.300000000000001,63,64,-1,2,-3
21700716,203526,UTA,TOR,Raul Neto,44,10.1166666666667,10,0.116666666666667,17,24,-7,-7,0
21700716,204060,UTA,TOR,Joe Ingles,155,31.55,32,-0.450000000000003,65,58,7,8,-1
21700716,1626220,UTA,TOR,Royce O'Neale,77,16.5333333333333,17,-0.466666666666665,34,35,-1,-2,1
21700716,1628378,UTA,TOR,Donovan Mitchell,183,37.6166666666667,37,0.61666666666666,80,67,13,11,2
21700717,201577,CHI,LAL,Robin Lopez,95,19.2,19,0.199999999999999,28,49,-21,-21,0
21700717,202703,CHI,LAL,Nikola Mirotic,125,23.8833333333333,24,-0.116666666666667,55,48,7,7,0
21700717,203200,CHI,LAL,Justin Holiday,167,34.8666666666667,35,-0.13333333333334,77,75,2,1,1
21700717,203897,CHI,LAL,Zach LaVine,126,25.4333333333333,26,-0.566666666666666,57,64,-7,-8,1
21700717,1626170,CHI,LAL,Jerian Grant,145,30.3166666666667,30,0.316666666666666,60,63,-3,-5,2
21700717,1626171,CHI,LAL,Bobby Portis,104,22.15,22,0.149999999999999,60,43,17,19,-2
21700717,1627756,CHI,LAL,Denzel Valentine,151,30.2166666666667,30,0.216666666666669,63,71,-8,-9,1
21700717,1627853,CHI,LAL,Ryan Arcidiacono,20,3.66666666666667,4,-0.333333333333333,10,7,3,5,-2
21700717,1628021,CHI,LAL,David Nwaba,98,19.4333333333333,19,0.433333333333334,42,42,0,1,-1
21700717,1628374,CHI,LAL,Lauri Markkanen,149,30.75,31,-0.25,63,78,-15,-15,0
21700717,201572,LAL,CHI,Brook Lopez,96,19.2,20,-0.800000000000001,49,28,21,19,2
21700717,203484,LAL,CHI,Kentavious Caldwell-Pope,113,23.3333333333333,24,-0.666666666666668,52,46,6,6,0
21700717,203898,LAL,CHI,Tyler Ennis,70,14.2333333333333,14,0.233333333333333,28,24,4,5,-1
21700717,203903,LAL,CHI,Jordan Clarkson,153,30.2833333333333,30,0.283333333333331,73,68,5,4,1
21700717,203944,LAL,CHI,Julius Randle,136,27.5,28,-0.5,66,60,6,8,-2
21700717,1626204,LAL,CHI,Larry Nance Jr.,108,21.8333333333333,22,-0.166666666666668,47,52,-5,-5,0
21700717,1627742,LAL,CHI,Brandon Ingram,165,33.3333333333333,33,0.333333333333329,84,64,20,22,-2
21700717,1627936,LAL,CHI,Alex Caruso,95,19.7666666666667,20,-0.233333333333334,40,43,-3,-5,2
21700717,1628398,LAL,CHI,Kyle Kuzma,132,27.4333333333333,27,0.43333333333333,54,66,-12,-12,0
21700717,1628404,LAL,CHI,Josh Hart,112,23,23,0,47,64,-17,-17,0
21700718,101150,LAC,MEM,Lou Williams,156,34.05,34,0.0499999999999972,85,67,18,19,-1
21700718,201599,LAC,MEM,DeAndre Jordan,138,30.7666666666667,30,0.766666666666666,72,67,5,5,0
21700718,201933,LAC,MEM,Blake Griffin,168,37.15,37,0.150000000000006,88,78,10,10,0
21700718,202325,LAC,MEM,Wesley Johnson,170,36.95,37,-0.0499999999999972,82,77,5,5,0
21700718,1626149,LAC,MEM,Montrezl Harrell,78,16.9666666666667,18,-1.03333333333334,36,33,3,4,-1
21700718,1626155,LAC,MEM,Sam Dekker,48,10.5833333333333,11,-0.416666666666666,20,22,-2,-1,-1
21700718,1627820,LAC,MEM,Tyrone Wallace,149,32.2833333333333,33,-0.716666666666669,73,62,11,10,1
21700718,1628414,LAC,MEM,Sindarius Thornwell,55,12.3166666666667,13,-0.683333333333334,26,28,-2,-1,-1
21700718,1628462,LAC,MEM,Milos Teodosic,118,27.6,28,-0.399999999999999,58,66,-8,-6,-2
21700718,201188,MEM,LAC,Marc Gasol,163,36.3333333333333,37,-0.666666666666671,78,83,-5,-6,1
21700718,201596,MEM,LAC,Mario Chalmers,149,32.8666666666667,33,-0.133333333333333,72,69,3,3,0
21700718,1626150,MEM,LAC,Andrew Harrison,114,25.4833333333333,26,-0.516666666666666,44,56,-12,-13,1
21700718,1626185,MEM,LAC,Jarell Martin,100,23.35,23,0.350000000000001,54,49,5,5,0
21700718,1627738,MEM,LAC,Deyonta Davis,58,11.6166666666667,11,0.616666666666667,18,27,-9,-10,1
21700718,1627782,MEM,LAC,Wayne Selden,133,28.8833333333333,30,-1.11666666666667,65,73,-8,-7,-1
21700718,1627988,MEM,LAC,Myke Henry,112,24.7166666666667,25,-0.283333333333331,52,52,0,-5,5
21700718,1628397,MEM,LAC,Ivan Rabb,95,20.4833333333333,21,-0.516666666666666,36,47,-11,-10,-1
21700718,1628415,MEM,LAC,Dillon Brooks,156,34.9333333333333,35,-0.0666666666666629,81,84,-3,-2,-1
21700719,1891,MIL,BKN,Jason Terry,59,13.7666666666667,14,-0.233333333333334,35,38,-3,-3,0
21700719,202339,MIL,BKN,Eric Bledsoe,136,29.5666666666667,30,-0.433333333333337,72,54,18,18,0
21700719,203089,MIL,BKN,John Henson,128,27.8333333333333,28,-0.166666666666664,74,49,25,25,0
21700719,203114,MIL,BKN,Khris Middleton,156,33.4166666666667,34,-0.583333333333336,84,63,21,22,-1
21700719,203503,MIL,BKN,Tony Snell,149,31.5333333333333,32,-0.466666666666669,82,54,28,27,1
21700719,203507,MIL,BKN,Giannis Antetokounmpo,147,33.1833333333333,33,0.18333333333333,84,64,20,19,1
21700719,203521,MIL,BKN,Matthew Dellavedova,90,20.6,20,0.600000000000001,43,36,7,8,-1
21700719,203930,MIL,BKN,Sean Kilpatrick,8,1.23333333333333,2,-0.766666666666667,7,5,2,1,1
21700719,1626173,MIL,BKN,Rashad Vaughn,4,0.7,1,-0.3,3,5,-2,-2,0
21700719,1627748,MIL,BKN,Thon Maker,85,19.2,19,0.199999999999999,39,37,2,2,0
21700719,1628391,MIL,BKN,D.J. Wilson,4,0.7,1,-0.3,3,5,-2,-2,0
21700719,1628425,MIL,BKN,Sterling Brown,119,26.9333333333333,27,-0.0666666666666664,54,45,9,10,-1
21700719,201960,BKN,MIL,DeMarre Carroll,124,27.9666666666667,28,-0.0333333333333314,55,65,-10,-12,2
21700719,203092,BKN,MIL,Tyler Zeller,50,10.5333333333333,11,-0.466666666666667,24,28,-4,-5,1
21700719,203112,BKN,MIL,Quincy Acy,98,21.2166666666667,22,-0.783333333333331,33,53,-20,-22,2
21700719,203459,BKN,MIL,Allen Crabbe,110,24.1666666666667,25,-0.833333333333336,47,51,-4,-7,3
21700719,203915,BKN,MIL,Spencer Dinwiddie,110,23.7833333333333,24,-0.216666666666669,45,52,-7,-9,2
21700719,203917,BKN,MIL,Nik Stauskas,54,12.1166666666667,12,0.116666666666667,27,38,-11,-9,-2
21700719,203925,BKN,MIL,Joe Harris,114,25.2666666666667,25,0.266666666666666,49,50,-1,-3,2
21700719,1626143,BKN,MIL,Jahlil Okafor,43,8.91666666666667,9,-0.0833333333333322,15,28,-13,-13,0
21700719,1626156,BKN,MIL,D'Angelo Russell,98,21.5333333333333,21,0.533333333333331,39,61,-22,-20,-2
21700719,1626178,BKN,MIL,Rondae Hollis-Jefferson,59,12.9166666666667,13,-0.0833333333333339,21,31,-10,-8,-2
21700719,1627747,BKN,MIL,Caris LeVert,132,29.25,29,0.25,56,76,-20,-17,-3
21700719,1628386,BKN,MIL,Jarrett Allen,93,21,20,1,44,47,-3,0,-3
21700720,2749,NOP,HOU,Jameer Nelson,49,10.9,11,-0.100000000000001,23,24,-1,2,-3
21700720,200765,NOP,HOU,Rajon Rondo,79,17,17,0,37,30,7,5,2
21700720,201950,NOP,HOU,Jrue Holiday,168,37.0833333333333,37,0.0833333333333357,92,89,3,0,3
21700720,201967,NOP,HOU,Dante Cunningham,71,14.2833333333333,14,0.283333333333333,36,34,2,3,-1
21700720,202326,NOP,HOU,DeMarcus Cousins,131,29.8833333333333,30,-0.116666666666667,75,57,18,16,2
21700720,202732,NOP,HOU,DeAndre Liggins,82,19.1166666666667,19,0.116666666666667,45,55,-10,-10,0
21700720,202734,NOP,HOU,E'Twaun Moore,142,31.2166666666667,31,0.216666666666669,76,67,9,7,2
21700720,203076,NOP,HOU,Anthony Davis,169,37.25,37,0.25,87,92,-5,-4,-1
21700720,203121,NOP,HOU,Darius Miller,133,28.8833333333333,29,-0.116666666666667,73,76,-3,-1,-2
21700720,203546,NOP,HOU,Ian Clark,61,14.3,14,0.300000000000001,31,41,-10,-8,-2
21700720,2403,HOU,NOP,Nene,49,10.0833333333333,10,0.0833333333333322,20,29,-9,-7,-2
21700720,2772,HOU,NOP,Trevor Ariza,133,28.4666666666667,29,-0.533333333333331,57,70,-13,-10,-3
21700720,101108,HOU,NOP,Chris Paul,153,34.1833333333333,34,0.183333333333337,85,81,4,1,3
21700720,200782,HOU,NOP,PJ Tucker,131,30.75,31,-0.25,78,69,9,9,0
21700720,201569,HOU,NOP,Eric Gordon,151,34.15,34,0.149999999999999,90,81,9,11,-2
21700720,201583,HOU,NOP,Ryan Anderson,67,13.5333333333333,14,-0.466666666666667,18,38,-20,-20,0
21700720,201601,HOU,NOP,Luc Mbah a Moute,110,24.55,24,0.549999999999997,69,51,18,17,1
21700720,201935,HOU,NOP,James Harden,156,33.7666666666667,34,-0.233333333333334,71,85,-14,-12,-2
21700720,203991,HOU,NOP,Clint Capela,135,30.4333333333333,30,0.43333333333333,77,71,6,1,5
21700721,1717,DAL,POR,Dirk Nowitzki,94,21.0666666666667,21,0.0666666666666664,43,44,-1,-3,2
21700721,200826,DAL,POR,J.J. Barea,79,17.75,17,0.75,28,42,-14,-14,0
21700721,202083,DAL,POR,Wesley Matthews,139,31.9666666666667,32,-0.0333333333333314,61,66,-5,-5,0
21700721,203084,DAL,POR,Harrison Barnes,151,34.65,34,0.650000000000006,65,74,-9,-7,-2
21700721,203939,DAL,POR,Dwight Powell,74,16.8,17,-0.199999999999999,34,46,-12,-14,2
21700721,1626257,DAL,POR,Salah Mejri,71,16.3,17,-0.699999999999999,27,35,-8,-5,-3
21700721,1627812,DAL,POR,Yogi Ferrell,121,27.1,28,-0.899999999999999,55,65,-10,-12,2
21700721,1627858,DAL,POR,Kyle Collinsworth,67,14.8666666666667,15,-0.133333333333333,30,40,-10,-10,0
21700721,1628372,DAL,POR,Dennis Smith Jr.,143,32.0833333333333,33,-0.916666666666671,65,71,-6,-4,-2
21700721,1628467,DAL,POR,Maxi Kleber,111,25.75,26,-0.25,57,52,5,4,1
21700721,202329,POR,DAL,Al-Farouq Aminu,124,27.25,27,0.25,59,49,10,8,2
21700721,202334,POR,DAL,Ed Davis,117,27.3,28,-0.699999999999999,59,45,14,16,-2
21700721,203081,POR,DAL,Damian Lillard,159,36.3333333333333,36,0.333333333333329,82,67,15,14,1
21700721,203086,POR,DAL,Meyers Leonard,12,2.95,3,-0.0499999999999998,7,11,-4,-6,2
21700721,203090,POR,DAL,Maurice Harkless,80,17.4333333333333,18,-0.566666666666666,31,41,-10,-10,0
21700721,203468,POR,DAL,CJ McCollum,147,33.0166666666667,33,0.0166666666666657,79,65,14,14,0
21700721,203894,POR,DAL,Shabazz Napier,119,26.5833333333333,27,-0.416666666666668,70,49,21,20,1
21700721,203943,POR,DAL,Noah Vonleh,12,2.95,3,-0.0499999999999998,7,11,-4,-6,2
21700721,203994,POR,DAL,Jusuf Nurkic,81,17.4166666666667,17,0.416666666666664,41,37,4,4,0
21700721,1626192,POR,DAL,Pat Connaughton,126,29.25,30,-0.75,61,55,6,12,-6
21700721,1627774,POR,DAL,Jake Layman,12,2.95,3,-0.0499999999999998,7,11,-4,-6,2
21700721,1628380,POR,DAL,Zach Collins,61,14.9,15,-0.100000000000001,32,24,8,10,-2
21700722,101161,PHI,SAS,Amir Johnson,62,16.25,16,0.25,33,28,5,2,3
21700722,202344,PHI,SAS,Trevor Booker,67,17.0833333333333,17,0.0833333333333357,35,30,5,9,-4
21700722,203496,PHI,SAS,Robert Covington,112,27.6666666666667,28,-0.333333333333332,53,39,14,13,1
21700722,203580,PHI,SAS,Larry Drew II,10,2.61666666666667,3,-0.383333333333333,0,4,-4,-4,0
21700722,203923,PHI,SAS,James Young,33,8.65,9,-0.35,13,17,-4,-3,-1
21700722,203954,PHI,SAS,Joel Embiid,120,29.0166666666667,29,0.0166666666666657,64,46,18,21,-3
21700722,203967,PHI,SAS,Dario Saric,115,28.1833333333333,28,0.183333333333334,62,44,18,14,4
21700722,204456,PHI,SAS,T.J. McConnell,90,24.4666666666667,24,0.466666666666669,46,42,4,8,-4
21700722,1626147,PHI,SAS,Justin Anderson,80,20.2166666666667,20,0.216666666666669,44,39,5,6,-1
21700722,1626158,PHI,SAS,Richaun Holmes,10,2.61666666666667,3,-0.383333333333333,0,4,-4,-4,0
21700722,1627732,PHI,SAS,Ben Simmons,140,34.0666666666667,34,0.0666666666666629,77,54,23,20,3
21700722,1627789,PHI,SAS,Timothe Luwawu-Cabarrot,121,28.5833333333333,29,-0.416666666666664,58,43,15,13,2
21700722,2200,SAS,PHI,Pau Gasol,75,17.6,18,-0.399999999999999,23,40,-17,-18,1
21700722,2225,SAS,PHI,Tony Parker,52,13.6666666666667,13,0.666666666666668,24,29,-5,-5,0
21700722,200746,SAS,PHI,LaMarcus Aldridge,135,32.7333333333333,33,-0.266666666666666,52,71,-19,-16,-3
21700722,201980,SAS,PHI,Danny Green,103,24.0833333333333,24,0.0833333333333357,40,55,-15,-15,0
21700722,201988,SAS,PHI,Patty Mills,86,20.95,21,-0.0499999999999972,38,51,-13,-12,-1
21700722,202722,SAS,PHI,Davis Bertans,84,21.8333333333333,22,-0.166666666666664,39,40,-1,-2,1
21700722,203464,SAS,PHI,Brandon Paul,25,6.83333333333333,7,-0.166666666666667,8,7,1,1,0
21700722,203530,SAS,PHI,Joffrey Lauvergne,54,14.3166666666667,14,0.316666666666666,26,22,4,3,1
21700722,203937,SAS,PHI,Kyle Anderson,106,26.0833333333333,26,0.0833333333333357,37,54,-17,-16,-1
21700722,1626199,SAS,PHI,Darrun Hilliard,14,3.96666666666667,4,-0.0333333333333332,6,2,4,4,0
21700722,1627749,SAS,PHI,Dejounte Murray,137,33.4166666666667,34,-0.583333333333329,55,71,-16,-16,0
21700722,1627854,SAS,PHI,Bryn Forbes,89,23.9333333333333,24,-0.06666666666667,42,43,-1,-3,2
21700723,101127,NYK,PHX,Jarrett Jack,104,21.1333333333333,21,0.133333333333333,59,36,23,23,0
21700723,201563,NYK,PHX,Michael Beasley,88,18.2,18,0.199999999999999,40,35,5,7,-2
21700723,201584,NYK,PHX,Courtney Lee,129,26.5,27,-0.5,68,41,27,27,0
21700723,202498,NYK,PHX,Lance Thomas,76,16.3666666666667,16,0.366666666666667,30,23,7,7,0
21700723,202683,NYK,PHX,Enes Kanter,142,29.2333333333333,29,0.233333333333334,73,51,22,22,0
21700723,203124,NYK,PHX,Kyle O'Quinn,82,16.9333333333333,17,-0.0666666666666664,32,29,3,3,0
21700723,203501,NYK,PHX,Tim Hardaway Jr.,171,34.45,35,-0.549999999999997,86,67,19,19,0
21700723,203504,NYK,PHX,Trey Burke,83,17.5,18,-0.5,37,35,2,4,-2
21700723,203926,NYK,PHX,Doug McDermott,67,14.4333333333333,14,0.433333333333334,26,32,-6,-6,0
21700723,204001,NYK,PHX,Kristaps Porzingis,131,27.3833333333333,28,-0.616666666666667,65,48,17,15,2
21700723,1626195,NYK,PHX,Willy Hernangomez,19,4.01666666666667,4,0.0166666666666666,4,7,-3,-3,0
21700723,1627758,NYK,PHX,Ron Baker,19,4.01666666666667,4,0.0166666666666666,4,7,-3,-3,0
21700723,1628373,NYK,PHX,Frank Ntilikina,44,9.25,9,0.25,11,14,-3,-5,2
21700723,201162,PHX,NYK,Jared Dudley,99,21.4666666666667,22,-0.533333333333331,43,43,0,0,0
21700723,202328,PHX,NYK,Greg Monroe,129,25.9666666666667,26,-0.0333333333333314,43,68,-25,-25,0
21700723,203477,PHX,NYK,Isaiah Canaan,93,19.5166666666667,20,-0.483333333333334,37,33,4,4,0
21700723,203584,PHX,NYK,Troy Daniels,116,23.0833333333333,23,0.0833333333333357,39,71,-32,-32,0
21700723,203933,PHX,NYK,T.J. Warren,166,34.0833333333333,34,0.0833333333333286,63,80,-17,-17,0
21700723,1626164,PHX,NYK,Devin Booker,124,25.15,25,0.149999999999999,41,65,-24,-24,0
21700723,1627733,PHX,NYK,Dragan Bender,84,17.4666666666667,18,-0.533333333333331,40,35,5,5,0
21700723,1627737,PHX,NYK,Marquese Chriss,98,20.2333333333333,20,0.233333333333334,25,50,-25,-25,0
21700723,1627755,PHX,NYK,Tyler Ulis,57,13.2,13,0.199999999999999,21,23,-2,-2,0
21700723,1627863,PHX,NYK,Danuel House Jr.,25,5.13333333333333,5,0.133333333333333,7,4,3,3,0
21700723,1628367,PHX,NYK,Josh Jackson,142,29.55,29,0.550000000000001,59,59,0,0,0
21700723,1628409,PHX,NYK,Alec Peters,22,4.56666666666667,5,-0.433333333333334,7,4,3,3,0
21700724,2546,OKC,DET,Carmelo Anthony,168,34.9666666666667,35,-0.0333333333333314,94,70,24,25,-1
21700724,101109,OKC,DET,Raymond Felton,63,13.4833333333333,14,-0.516666666666668,24,39,-15,-16,1
21700724,201566,OKC,DET,Russell Westbrook,177,36.6166666666667,36,0.616666666666667,99,79,20,20,0
21700724,202331,OKC,DET,Paul George,176,36.2,36,0.200000000000003,99,72,27,28,-1
21700724,202335,OKC,DET,Patrick Patterson,81,16.7166666666667,17,-0.283333333333335,34,50,-16,-19,3
21700724,203460,OKC,DET,Andre Roberson,105,22.0833333333333,22,0.0833333333333322,68,37,31,32,-1
21700724,203500,OKC,DET,Steven Adams,151,31.95,32,-0.0499999999999972,89,63,26,28,-2
21700724,203518,OKC,DET,Alex Abrines,28,6.03333333333333,6,0.0333333333333332,16,22,-6,-7,1
21700724,203924,OKC,DET,Jerami Grant,58,12.0333333333333,12,0.0333333333333332,25,33,-8,-8,0
21700724,203962,OKC,DET,Josh Huestis,27,6.03333333333333,6,0.0333333333333332,9,16,-7,-7,0
21700724,1628390,OKC,DET,Terrance Ferguson,111,23.05,23,0.0499999999999972,48,59,-11,-11,0
21700724,201229,DET,OKC,Anthony Tolliver,88,18.8833333333333,19,-0.116666666666667,53,37,16,18,-2
21700724,202340,DET,OKC,Avery Bradley,121,26.2,26,0.199999999999999,50,76,-26,-28,2
21700724,202397,DET,OKC,Ish Smith,168,35.4333333333333,35,0.433333333333337,86,80,6,6,0
21700724,202699,DET,OKC,Tobias Harris,158,32.5333333333333,32,0.533333333333331,67,91,-24,-24,0
21700724,203083,DET,OKC,Andre Drummond,146,30.5,31,-0.5,61,87,-26,-30,4
21700724,203493,DET,OKC,Reggie Bullock,164,33.85,34,-0.149999999999999,86,81,5,6,-1
21700724,204038,DET,OKC,Langston Galloway,61,12.4,13,-0.600000000000001,22,41,-19,-19,0
21700724,1626169,DET,OKC,Stanley Johnson,49,10.4,11,-0.600000000000001,15,31,-16,-17,1
21700724,1626246,DET,OKC,Boban Marjanovic,66,13.75,14,-0.25,35,27,8,10,-2
21700724,1628379,DET,OKC,Luke Kennard,124,25.2166666666667,25,0.216666666666669,65,54,11,13,-2
21700725,201571,ORL,IND,D.J. Augustin,85,19.4833333333333,20,-0.516666666666666,55,46,9,9,0
21700725,201578,ORL,IND,Marreese Speights,33,5.78333333333333,6,-0.216666666666667,19,16,3,3,0
21700725,202687,ORL,IND,Bismack Biyombo,94,21.15,21,0.149999999999999,39,54,-15,-15,0
21700725,202714,ORL,IND,Shelvin Mack,65,16.4666666666667,16,0.466666666666669,42,41,1,1,0
21700725,203095,ORL,IND,Evan Fournier,155,33.4666666666667,33,0.466666666666669,69,78,-9,-8,-1
21700725,203613,ORL,IND,Jonathon Simmons,101,21.6333333333333,22,-0.366666666666667,51,53,-2,-2,0
21700725,203901,ORL,IND,Elfrid Payton,134,29.0333333333333,29,0.0333333333333314,59,70,-11,-13,2
21700725,203920,ORL,IND,Khem Birch,80,19,19,0,48,41,7,7,0
21700725,203932,ORL,IND,Aaron Gordon,186,40.4333333333333,40,0.433333333333337,90,94,-4,-4,0
21700725,1626209,ORL,IND,Mario Hezonja,118,26.65,27,-0.350000000000001,64,60,4,6,-2
21700725,1628411,ORL,IND,Wes Iwundu,34,6.73333333333333,7,-0.266666666666667,24,17,7,6,1
21700725,2744,IND,ORL,Al Jefferson,63,13.4333333333333,13,0.433333333333334,36,34,2,5,-3
21700725,201152,IND,ORL,Thaddeus Young,163,36.7,37,-0.299999999999997,89,79,10,10,0
21700725,201954,IND,ORL,Darren Collison,118,25.8,26,-0.199999999999999,62,61,1,3,-2
21700725,202362,IND,ORL,Lance Stephenson,139,31.0833333333333,31,0.0833333333333322,75,74,1,2,-1
21700725,202709,IND,ORL,Cory Joseph,123,28.6166666666667,28,0.616666666666667,63,64,-1,-3,2
21700725,202711,IND,ORL,Bojan Bogdanovic,105,22.7166666666667,23,-0.283333333333331,57,60,-3,-3,0
21700725,203506,IND,ORL,Victor Oladipo,179,38.6166666666667,39,-0.383333333333333,94,85,9,9,0
21700725,1626167,IND,ORL,Myles Turner,53,10.35,11,-0.649999999999999,20,28,-8,-12,4
21700725,1626202,IND,ORL,Joe Young,19,4.03333333333333,4,0.0333333333333332,10,15,-5,-5,0
21700725,1627734,IND,ORL,Domantas Sabonis,123,28.4833333333333,28,0.483333333333334,64,60,4,4,0
21700726,101141,ATL,WAS,Ersan Ilyasova,106,23.4666666666667,24,-0.533333333333331,45,60,-15,-13,-2
21700726,201158,ATL,WAS,Marco Belinelli,133,28.55,29,-0.450000000000003,65,79,-14,-16,2
21700726,202337,ATL,WAS,Luke Babbitt,18,3.6,4,-0.4,8,12,-4,-4,0
21700726,203101,ATL,WAS,Miles Plumlee,41,9.58333333333333,10,-0.416666666666668,17,27,-10,-10,0
21700726,203145,ATL,WAS,Kent Bazemore,84,18.3166666666667,18,0.316666666666666,33,43,-10,-10,0
21700726,203471,ATL,WAS,Dennis Schroder,132,28.9,29,-0.100000000000001,62,77,-15,-13,-2
21700726,203473,ATL,WAS,Dewayne Dedmon,106,23.2166666666667,23,0.216666666666669,54,58,-4,-4,0
21700726,203488,ATL,WAS,Mike Muscala,78,17.6,18,-0.399999999999999,40,53,-13,-11,-2
21700726,1627098,ATL,WAS,Malcolm Delaney,75,15.8,16,-0.199999999999999,35,35,0,2,-2
21700726,1627752,ATL,WAS,Taurean Prince,133,30.9,31,-0.100000000000001,66,93,-27,-29,2
21700726,1628381,ATL,WAS,John Collins,87,18.3333333333333,18,0.333333333333332,44,48,-4,-8,4
21700726,1628416,ATL,WAS,Tyler Dorsey,97,21.2333333333333,21,0.233333333333334,51,60,-9,-9,0
21700726,101133,WAS,ATL,Ian Mahinmi,64,14.1666666666667,14,0.166666666666668,36,32,4,4,0
21700726,101162,WAS,ATL,Marcin Gortat,85,18.4833333333333,19,-0.516666666666666,47,34,13,12,1
21700726,201160,WAS,ATL,Jason Smith,18,3.6,4,-0.4,12,8,4,4,0
21700726,201975,WAS,ATL,Jodie Meeks,45,9.78333333333333,10,-0.216666666666667,28,17,11,11,0
21700726,202693,WAS,ATL,Markieff Morris,134,30.3,30,0.299999999999997,81,62,19,22,-3
21700726,203078,WAS,ATL,Bradley Beal,141,30.7833333333333,30,0.783333333333331,79,64,15,15,0
21700726,203107,WAS,ATL,Tomas Satoransky,94,21.2666666666667,21,0.266666666666666,54,42,12,12,0
21700726,203118,WAS,ATL,Mike Scott,108,23.4,23,0.399999999999999,64,62,2,0,2
21700726,203490,WAS,ATL,Otto Porter Jr.,138,30.9166666666667,31,-0.0833333333333357,84,73,11,11,0
21700726,204025,WAS,ATL,Tim Frazier,124,26.6333333333333,27,-0.366666666666667,75,62,13,13,0
21700726,1626162,WAS,ATL,Kelly Oubre Jr.,121,26.5666666666667,27,-0.433333333333334,73,56,17,17,0
21700726,1626191,WAS,ATL,Chris McCullough,18,3.6,4,-0.4,12,8,4,4,0
21700727,201609,MIA,CHA,Goran Dragic,116,23.2666666666667,23,0.266666666666666,38,60,-22,-22,0
21700727,201949,MIA,CHA,James Johnson,149,32.05,32,0.0499999999999972,58,66,-8,-8,0
21700727,201961,MIA,CHA,Wayne Ellington,158,34.9833333333333,34,0.983333333333334,72,61,11,17,-6
21700727,202355,MIA,CHA,Hassan Whiteside,92,18.1666666666667,18,0.166666666666664,32,48,-16,-15,-1
21700727,203482,MIA,CHA,Kelly Olynyk,86,19.9,20,-0.100000000000001,49,31,18,18,0
21700727,204020,MIA,CHA,Tyler Johnson,99,21.1666666666667,21,0.166666666666664,39,47,-8,-8,0
21700727,1626159,MIA,CHA,Justise Winslow,131,30.9,31,-0.100000000000001,72,45,27,25,2
21700727,1626196,MIA,CHA,Josh Richardson,150,33.6833333333333,34,-0.316666666666663,64,60,4,0,4
21700727,1628389,MIA,CHA,Bam Adebayo,109,25.8833333333333,26,-0.116666666666667,51,37,14,13,1
21700727,2730,CHA,MIA,Dwight Howard,175,37.9,38,-0.100000000000001,78,69,9,9,0
21700727,101107,CHA,MIA,Marvin Williams,117,24.4333333333333,25,-0.566666666666666,59,42,17,15,2
21700727,201587,CHA,MIA,Nicolas Batum,160,33.5666666666667,34,-0.433333333333337,74,61,13,13,0
21700727,202689,CHA,MIA,Kemba Walker,188,41,41,0,81,75,6,6,0
21700727,203077,CHA,MIA,Michael Kidd-Gilchrist,128,26.8,27,-0.200000000000003,62,49,13,14,-1
21700727,203087,CHA,MIA,Jeremy Lamb,90,21.2,21,0.199999999999999,29,46,-17,-18,1
21700727,203948,CHA,MIA,Johnny O'Bryant III,43,10.1,10,0.0999999999999996,13,26,-13,-13,0
21700727,1626163,CHA,MIA,Frank Kaminsky,94,22.4166666666667,22,0.416666666666668,29,51,-22,-19,-3
21700727,1626203,CHA,MIA,Treveon Graham,65,15.5833333333333,16,-0.416666666666668,20,36,-16,-17,1
21700727,1628370,CHA,MIA,Malik Monk,30,7,7,0,10,20,-10,-10,0
21700728,201143,BOS,GSW,Al Horford,161,33.9166666666667,34,-0.0833333333333357,71,68,3,7,-4
21700728,202681,BOS,GSW,Kyrie Irving,164,35.9833333333333,36,-0.0166666666666657,89,88,1,0,1
21700728,202694,BOS,GSW,Marcus Morris,152,33.0666666666667,33,0.0666666666666629,68,72,-4,3,-7
21700728,203382,BOS,GSW,Aron Baynes,73,15.9,16,-0.0999999999999996,33,39,-6,-5,-1
21700728,203499,BOS,GSW,Shane Larkin,74,15.7166666666667,16,-0.283333333333335,29,28,1,1,0
21700728,1626179,BOS,GSW,Terry Rozier,119,24.6833333333333,24,0.68333333333333,46,67,-21,-19,-2
21700728,1627759,BOS,GSW,Jaylen Brown,159,34.6,35,-0.399999999999999,83,82,1,-8,9
21700728,1628369,BOS,GSW,Jayson Tatum,127,27.85,28,-0.149999999999999,61,56,5,7,-2
21700728,1628400,BOS,GSW,Semi Ojeleye,26,5.91666666666667,6,-0.0833333333333339,10,11,-1,-1,0
21700728,1628464,BOS,GSW,Daniel Theis,55,12.3666666666667,12,0.366666666666667,35,34,1,-5,6
21700728,2561,GSW,BOS,David West,69,15.65,16,-0.350000000000001,24,30,-6,-6,0
21700728,2585,GSW,BOS,Zaza Pachulia,69,15.0666666666667,15,0.0666666666666664,37,36,1,0,1
21700728,2733,GSW,BOS,Shaun Livingston,65,14.15,14,0.149999999999999,26,27,-1,1,-2
21700728,2738,GSW,BOS,Andre Iguodala,131,28.7666666666667,28,0.766666666666666,66,61,5,6,-1
21700728,201142,GSW,BOS,Kevin Durant,164,35.2833333333333,36,-0.716666666666669,89,78,11,9,2
21700728,201156,GSW,BOS,Nick Young,29,6.63333333333333,7,-0.366666666666667,7,12,-5,-5,0
21700728,201939,GSW,BOS,Stephen Curry,171,36.7833333333333,37,-0.216666666666669,92,86,6,6,0
21700728,201956,GSW,BOS,Omri Casspi,21,4,4,0,10,8,2,3,-1
21700728,202691,GSW,BOS,Klay Thompson,170,36.4166666666667,36,0.416666666666671,87,80,7,6,1
21700728,203110,GSW,BOS,Draymond Green,179,38.2833333333333,38,0.283333333333331,87,86,1,-1,2
21700728,1626172,GSW,BOS,Kevon Looney,42,8.96666666666667,9,-0.0333333333333332,20,21,-1,1,-2
21700729,2037,MIN,BKN,Jamal Crawford,97,19.8333333333333,20,-0.166666666666664,53,44,9,9,0
21700729,201166,MIN,BKN,Aaron Brooks,2,0.516666666666667,0,0.516666666666667,2,0,2,0,2
21700729,201952,MIN,BKN,Jeff Teague,112,24.35,24,0.350000000000001,49,44,5,5,0
21700729,201959,MIN,BKN,Taj Gibson,155,34.1166666666667,34,0.116666666666667,76,60,16,16,0
21700729,202357,MIN,BKN,Nemanja Bjelica,69,13.7666666666667,14,-0.233333333333334,35,37,-2,-2,0
21700729,202710,MIN,BKN,Jimmy Butler,161,35.1,35,0.0999999999999943,76,67,9,10,-1
21700729,203476,MIN,BKN,Gorgui Dieng,69,14.2166666666667,14,0.216666666666667,37,30,7,6,1
21700729,203952,MIN,BKN,Andrew Wiggins,171,37.1833333333333,37,0.183333333333337,82,75,7,10,-3
21700729,1626145,MIN,BKN,Tyus Jones,111,23.15,24,-0.850000000000001,62,53,9,9,0
21700729,1626157,MIN,BKN,Karl-Anthony Towns,153,33.15,34,-0.850000000000001,72,67,5,8,-3
21700729,1627875,MIN,BKN,Marcus Georges-Hunt,20,4.03333333333333,3,1.03333333333333,11,8,3,-1,4
21700729,201960,BKN,MIN,DeMarre Carroll,136,29.55,29,0.550000000000001,56,63,-7,-7,0
21700729,203092,BKN,MIN,Tyler Zeller,43,8.66666666666667,9,-0.333333333333334,24,20,4,4,0
21700729,203112,BKN,MIN,Quincy Acy,113,24.2333333333333,24,0.233333333333334,44,50,-6,-6,0
21700729,203459,BKN,MIN,Allen Crabbe,111,23.6166666666667,24,-0.383333333333333,40,58,-18,-20,2
21700729,203915,BKN,MIN,Spencer Dinwiddie,153,33.2166666666667,33,0.216666666666669,66,71,-5,-6,1
21700729,203917,BKN,MIN,Nik Stauskas,153,32.2833333333333,33,-0.716666666666669,75,78,-3,-2,-1
21700729,203925,BKN,MIN,Joe Harris,149,31.25,31,0.25,63,78,-15,-14,-1
21700729,1626143,BKN,MIN,Jahlil Okafor,104,23.5333333333333,24,-0.466666666666669,51,60,-9,-6,-3
21700729,1627785,BKN,MIN,Isaiah Whitehead,48,9.95,10,-0.0500000000000007,28,23,5,6,-1
21700729,1627821,BKN,MIN,James Webb III,22,5.15,5,0.15,16,13,3,3,0
21700729,1628386,BKN,MIN,Jarrett Allen,88,17.9666666666667,18,-0.0333333333333314,22,41,-19,-22,3
21700730,1717,DAL,DEN,Dirk Nowitzki,111,24.5666666666667,25,-0.433333333333334,42,49,-7,-8,1
21700730,202083,DAL,DEN,Wesley Matthews,142,33.0333333333333,33,0.0333333333333314,54,69,-15,-18,3
21700730,203084,DAL,DEN,Harrison Barnes,154,35.5166666666667,35,0.516666666666666,70,70,0,0,0
21700730,203939,DAL,DEN,Dwight Powell,66,15.05,15,0.0499999999999989,20,24,-4,-5,1
21700730,1626257,DAL,DEN,Salah Mejri,89,20.8,20,0.800000000000001,46,37,9,9,0
21700730,1627812,DAL,DEN,Yogi Ferrell,136,31.0333333333333,31,0.0333333333333314,59,53,6,5,1
21700730,1627858,DAL,DEN,Kyle Collinsworth,63,14.2166666666667,14,0.216666666666667,35,21,14,16,-2
21700730,1628372,DAL,DEN,Dennis Smith Jr.,140,30.9666666666667,31,-0.033333333333335,49,61,-12,-13,1
21700730,1628467,DAL,DEN,Maxi Kleber,149,34.65,35,-0.350000000000001,70,66,4,4,0
21700730,201163,DEN,DAL,Wilson Chandler,40,9.2,9,0.199999999999999,14,22,-8,-8,0
21700730,203115,DEN,DAL,Will Barton,169,38.7166666666667,39,-0.283333333333331,80,60,20,21,-1
21700730,203486,DEN,DAL,Mason Plumlee,131,29.6833333333333,30,-0.31666666666667,62,53,9,9,0
21700730,203914,DEN,DAL,Gary Harris,155,35.7,35,0.700000000000003,69,64,5,5,0
21700730,203999,DEN,DAL,Nikola Jokic,175,39.95,40,-0.0499999999999972,82,72,10,9,1
21700730,1626144,DEN,DAL,Emmanuel Mudiay,17,3.93333333333333,4,-0.0666666666666669,5,9,-4,-4,0
21700730,1626168,DEN,DAL,Trey Lyles,112,26.1333333333333,26,0.133333333333333,36,53,-17,-14,-3
21700730,1627750,DEN,DAL,Jamal Murray,135,30.7666666666667,31,-0.233333333333334,52,59,-7,-4,-3
21700730,1628470,DEN,DAL,Torrey Craig,116,25.75,26,-0.25,50,53,-3,-4,1
21700731,201577,CHI,MIL,Robin Lopez,88,19.55,20,-0.449999999999999,34,47,-13,-14,1
21700731,202347,CHI,MIL,Quincy Pondexter,6,1.48333333333333,2,-0.516666666666667,2,3,-1,-1,0
21700731,202703,CHI,MIL,Nikola Mirotic,124,27.2666666666667,28,-0.733333333333334,60,63,-3,-1,-2
21700731,203200,CHI,MIL,Justin Holiday,138,31.7,32,-0.299999999999997,63,68,-5,-3,-2
21700731,203897,CHI,MIL,Zach LaVine,120,26.35,26,0.350000000000001,47,54,-7,-10,3
21700731,1626170,CHI,MIL,Jerian Grant,139,31.6333333333333,32,-0.366666666666667,61,71,-10,-8,-2
21700731,1626171,CHI,MIL,Bobby Portis,66,13.2166666666667,13,0.216666666666667,29,34,-5,-5,0
21700731,1626245,CHI,MIL,Cristiano Felicio,8,1.98333333333333,2,-0.0166666666666666,4,3,1,-1,2
21700731,1627756,CHI,MIL,Denzel Valentine,135,30.0166666666667,30,0.0166666666666657,69,73,-4,-1,-3
21700731,1627835,CHI,MIL,Paul Zipser,8,1.98333333333333,2,-0.0166666666666666,4,3,1,-1,2
21700731,1627853,CHI,MIL,Ryan Arcidiacono,30,5.98333333333333,6,-0.0166666666666666,11,17,-6,-8,2
21700731,1628021,CHI,MIL,David Nwaba,78,16.2833333333333,16,0.283333333333335,33,41,-8,-11,3
21700731,1628374,CHI,MIL,Lauri Markkanen,140,32.4666666666667,33,-0.533333333333331,63,68,-5,-6,1
21700731,1891,MIL,CHI,Jason Terry,87,17.5833333333333,18,-0.416666666666668,40,42,-2,-1,-1
21700731,202339,MIL,CHI,Eric Bledsoe,132,29.7166666666667,30,-0.283333333333331,67,54,13,12,1
21700731,203089,MIL,CHI,John Henson,119,27.9166666666667,28,-0.0833333333333357,62,53,9,10,-1
21700731,203114,MIL,CHI,Khris Middleton,139,32.1333333333333,32,0.133333333333333,70,60,10,8,2
21700731,203503,MIL,CHI,Tony Snell,121,28.4166666666667,28,0.416666666666664,66,50,16,14,2
21700731,203507,MIL,CHI,Giannis Antetokounmpo,156,34.7833333333333,35,-0.216666666666669,78,70,8,8,0
21700731,203521,MIL,CHI,Matthew Dellavedova,76,16.2833333333333,16,0.283333333333331,39,38,1,1,0
21700731,203930,MIL,CHI,Sean Kilpatrick,8,1.98333333333333,2,-0.0166666666666666,3,4,-1,1,-2
21700731,1626173,MIL,CHI,Rashad Vaughn,8,1.98333333333333,2,-0.0166666666666666,3,4,-1,1,-2
21700731,1627748,MIL,CHI,Thon Maker,89,18.0833333333333,19,-0.916666666666668,44,39,5,3,2
21700731,1627850,MIL,CHI,Marshall Plumlee,8,1.98333333333333,2,-0.0166666666666666,3,4,-1,1,-2
21700731,1628391,MIL,CHI,D.J. Wilson,8,1.98333333333333,2,-0.0166666666666666,3,4,-1,1,-2
21700731,1628425,MIL,CHI,Sterling Brown,129,27.0666666666667,28,-0.933333333333334,67,58,9,11,-2
21700732,2403,HOU,PHX,Nene,71,15.1833333333333,15,0.183333333333334,35,35,0,-2,2
21700732,2772,HOU,PHX,Trevor Ariza,2,0.5,1,-0.5,2,3,-1,-1,0
21700732,101108,HOU,PHX,Chris Paul,133,26.9833333333333,27,-0.0166666666666657,70,63,7,5,2
21700732,101123,HOU,PHX,Gerald Green,83,17.9833333333333,18,-0.0166666666666657,40,43,-3,-3,0
21700732,200782,HOU,PHX,PJ Tucker,121,26.15,26,0.149999999999999,54,45,9,8,1
21700732,201569,HOU,PHX,Eric Gordon,155,33.4833333333333,33,0.483333333333334,72,69,3,3,0
21700732,201583,HOU,PHX,Ryan Anderson,119,25.3166666666667,26,-0.68333333333333,61,63,-2,-1,-1
21700732,201601,HOU,PHX,Luc Mbah a Moute,151,31.9,32,-0.100000000000001,73,59,14,14,0
21700732,201935,HOU,PHX,James Harden,181,38.0833333333333,38,0.0833333333333357,94,80,14,16,-2
21700732,203991,HOU,PHX,Clint Capela,119,24.1666666666667,24,0.166666666666664,64,50,14,16,-2
21700732,2199,PHX,HOU,Tyson Chandler,137,30.0333333333333,30,0.033333333333335,64,68,-4,-7,3
21700732,201162,PHX,HOU,Jared Dudley,41,9,9,0,16,20,-4,-3,-1
21700732,202328,PHX,HOU,Greg Monroe,83,16.05,16,0.0500000000000007,35,43,-8,-5,-3
21700732,203477,PHX,HOU,Isaiah Canaan,112,24.3,24,0.300000000000001,53,51,2,3,-1
21700732,203584,PHX,HOU,Troy Daniels,70,15.2833333333333,16,-0.716666666666665,36,38,-2,-7,5
21700732,203933,PHX,HOU,T.J. Warren,180,38.75,39,-0.25,87,91,-4,-8,4
21700732,1626164,PHX,HOU,Devin Booker,191,41.35,41,0.350000000000001,84,98,-14,-11,-3
21700732,1627733,PHX,HOU,Dragan Bender,114,24.5166666666667,25,-0.483333333333334,55,58,-3,-5,2
21700732,1627737,PHX,HOU,Marquese Chriss,79,16.3,16,0.299999999999997,34,37,-3,-2,-1
21700732,1627755,PHX,HOU,Tyler Ulis,14,2.13333333333333,2,0.133333333333333,7,9,-2,-2,0
21700732,1628367,PHX,HOU,Josh Jackson,114,22.0333333333333,22,0.0333333333333314,39,52,-13,-8,-5
21700733,2749,NOP,LAC,Jameer Nelson,39,8.41666666666667,8,0.416666666666668,17,26,-9,-10,1
21700733,200765,NOP,LAC,Rajon Rondo,113,22.9166666666667,23,-0.0833333333333357,40,51,-11,-10,-1
21700733,201600,NOP,LAC,Omer Asik,34,7.46666666666667,7,0.466666666666667,26,14,12,12,0
21700733,201950,NOP,LAC,Jrue Holiday,182,37,37,0,84,92,-8,-3,-5
21700733,201967,NOP,LAC,Dante Cunningham,138,28.3166666666667,28,0.316666666666666,49,65,-16,-16,0
21700733,202732,NOP,LAC,DeAndre Liggins,72,15.7,16,-0.300000000000001,44,36,8,8,0
21700733,202734,NOP,LAC,E'Twaun Moore,160,32.1166666666667,32,0.116666666666667,59,76,-17,-17,0
21700733,203076,NOP,LAC,Anthony Davis,198,40.35,41,-0.649999999999999,77,98,-21,-21,0
21700733,203121,NOP,LAC,Darius Miller,130,26.6666666666667,27,-0.333333333333336,69,62,7,4,3
21700733,203546,NOP,LAC,Ian Clark,94,20.1333333333333,20,0.133333333333333,50,40,10,8,2
21700733,101150,LAC,NOP,Lou Williams,165,35.5833333333333,35,0.583333333333329,83,83,0,3,-3
21700733,201599,LAC,NOP,DeAndre Jordan,171,34.75,35,-0.25,84,66,18,16,2
21700733,201933,LAC,NOP,Blake Griffin,183,37.1,37,0.100000000000001,89,72,17,17,0
21700733,202325,LAC,NOP,Wesley Johnson,156,31.05,31,0.0500000000000007,70,58,12,9,3
21700733,1626149,LAC,NOP,Montrezl Harrell,61,13.0666666666667,13,0.0666666666666664,28,37,-9,-7,-2
21700733,1626155,LAC,NOP,Sam Dekker,49,10.7166666666667,11,-0.283333333333333,23,31,-8,-8,0
21700733,1627820,LAC,NOP,Tyrone Wallace,160,32.1166666666667,32,0.116666666666667,83,62,21,22,-1
21700733,1628414,LAC,NOP,Sindarius Thornwell,80,16.95,17,-0.0499999999999972,43,46,-3,-4,1
21700733,1628462,LAC,NOP,Milos Teodosic,135,27.75,28,-0.25,57,60,-3,-3,0
21700734,2544,CLE,DET,LeBron James,173,37.7666666666667,38,-0.233333333333334,99,81,18,18,0
21700734,2594,CLE,DET,Kyle Korver,102,22.9666666666667,23,-0.0333333333333314,51,34,17,16,1
21700734,2747,CLE,DET,JR Smith,131,28.3,29,-0.700000000000003,84,74,10,10,0
21700734,101112,CLE,DET,Channing Frye,91,20.6333333333333,21,-0.366666666666667,44,37,7,7,0
21700734,201145,CLE,DET,Jeff Green,87,20.1333333333333,20,0.133333333333333,41,44,-3,-1,-2
21700734,201565,CLE,DET,Derrick Rose,48,8.53333333333333,9,-0.466666666666667,22,23,-1,-1,0
21700734,201567,CLE,DET,Kevin Love,127,26.5833333333333,27,-0.416666666666664,79,68,11,10,1
21700734,202684,CLE,DET,Tristan Thompson,90,20.2333333333333,20,0.233333333333334,60,50,10,7,3
21700734,202738,CLE,DET,Isaiah Thomas,117,27.45,27,0.449999999999999,68,64,4,4,0
21700734,203109,CLE,DET,Jae Crowder,112,25.5833333333333,26,-0.416666666666668,54,45,9,12,-3
21700734,1626224,CLE,DET,Cedi Osman,2,0.566666666666667,1,-0.433333333333333,3,0,3,3,0
21700734,201229,DET,CLE,Anthony Tolliver,181,39.8666666666667,40,-0.13333333333334,83,101,-18,-17,-1
21700734,202397,DET,CLE,Ish Smith,123,26.6666666666667,27,-0.333333333333336,64,76,-12,-16,4
21700734,202699,DET,CLE,Tobias Harris,118,26.45,27,-0.550000000000001,58,79,-21,-23,2
21700734,202779,DET,CLE,Dwight Buycks,93,21.0833333333333,21,0.0833333333333322,40,45,-5,-1,-4
21700734,203083,DET,CLE,Andre Drummond,160,35.1,35,0.100000000000001,76,97,-21,-22,1
21700734,203493,DET,CLE,Reggie Bullock,138,29.7,30,-0.300000000000001,72,85,-13,-16,3
21700734,203961,DET,CLE,Eric Moreland,56,12.65,13,-0.350000000000001,28,24,4,5,-1
21700734,1626169,DET,CLE,Stanley Johnson,131,28.6166666666667,28,0.616666666666667,67,59,8,9,-1
21700734,1628379,DET,CLE,Luke Kennard,80,18.6166666666667,19,-0.383333333333333,32,39,-7,-4,-3
21700735,201572,LAL,TOR,Brook Lopez,81,16.3833333333333,17,-0.616666666666667,32,43,-11,-9,-2
21700735,203484,LAL,TOR,Kentavious Caldwell-Pope,172,33.85,34,-0.150000000000006,79,80,-1,-1,0
21700735,203898,LAL,TOR,Tyler Ennis,100,18.9333333333333,19,-0.0666666666666664,45,49,-4,-4,0
21700735,203903,LAL,TOR,Jordan Clarkson,111,21.9333333333333,22,-0.0666666666666664,45,55,-10,-12,2
21700735,203944,LAL,TOR,Julius Randle,130,24.7,25,-0.300000000000001,56,66,-10,-12,2
21700735,1626204,LAL,TOR,Larry Nance Jr.,129,25.3166666666667,25,0.316666666666666,62,68,-6,-6,0
21700735,1627742,LAL,TOR,Brandon Ingram,173,34.0833333333333,35,-0.916666666666664,78,84,-6,-6,0
21700735,1627936,LAL,TOR,Alex Caruso,92,17.5833333333333,18,-0.416666666666664,47,47,0,4,-4
21700735,1628398,LAL,TOR,Kyle Kuzma,124,23.3,23,0.300000000000001,49,56,-7,-7,0
21700735,1628404,LAL,TOR,Josh Hart,72,13.6666666666667,14,-0.333333333333332,30,42,-12,-14,2
21700735,1628502,LAL,TOR,Nigel Hayes,46,9.58333333333333,10,-0.416666666666668,32,25,7,7,0
21700735,101139,TOR,LAL,CJ Miles,116,23.9333333333333,24,-0.0666666666666664,62,55,7,5,2
21700735,200768,TOR,LAL,Kyle Lowry,142,26.7666666666667,27,-0.233333333333334,69,58,11,11,0
21700735,201586,TOR,LAL,Serge Ibaka,128,24.3666666666667,24,0.366666666666667,64,54,10,10,0
21700735,201942,TOR,LAL,DeMar DeRozan,158,30.1166666666667,30,0.116666666666667,72,66,6,8,-2
21700735,202685,TOR,LAL,Jonas Valanciunas,123,23.7833333333333,24,-0.216666666666669,58,49,9,7,2
21700735,1626153,TOR,LAL,Delon Wright,104,21.1,21,0.100000000000001,54,53,1,1,0
21700735,1627751,TOR,LAL,Jakob Poeltl,123,24.0833333333333,24,0.0833333333333357,65,62,3,5,-2
21700735,1627783,TOR,LAL,Pascal Siakam,118,23.5,24,-0.5,59,57,2,2,0
21700735,1627832,TOR,LAL,Fred VanVleet,103,20.2833333333333,20,0.283333333333331,55,52,3,3,0
21700735,1628384,TOR,LAL,OG Anunoby,115,21.4,22,-0.600000000000001,57,49,8,8,0
21700736,101161,PHI,OKC,Amir Johnson,59,12.2833333333333,12,0.283333333333333,22,39,-17,-18,1
21700736,202344,PHI,OKC,Trevor Booker,89,17.7333333333333,17,0.733333333333334,33,46,-13,-13,0
21700736,203496,PHI,OKC,Robert Covington,170,36.05,36,0.0499999999999972,94,90,4,0,4
21700736,203923,PHI,OKC,James Young,13,2.68333333333333,3,-0.316666666666666,13,8,5,5,0
21700736,203954,PHI,OKC,Joel Embiid,162,34.8833333333333,36,-1.11666666666667,86,79,7,10,-3
21700736,203967,PHI,OKC,Dario Saric,94,20.4666666666667,21,-0.533333333333331,53,55,-2,-2,0
21700736,204456,PHI,OKC,T.J. McConnell,66,15.9166666666667,16,-0.0833333333333339,27,46,-19,-17,-2
21700736,1626147,PHI,OKC,Justin Anderson,99,20.3,21,-0.700000000000003,39,53,-14,-12,-2
21700736,1626158,PHI,OKC,Richaun Holmes,29,6.23333333333333,6,0.233333333333333,19,12,7,7,0
21700736,1627732,PHI,OKC,Ben Simmons,192,39.35,39,0.349999999999994,91,101,-10,-12,2
21700736,1627789,PHI,OKC,Timothe Luwawu-Cabarrot,152,31.9333333333333,33,-1.06666666666667,83,81,2,2,0
21700736,2546,OKC,PHI,Carmelo Anthony,152,30.45,31,-0.549999999999997,84,73,11,9,2
21700736,101109,OKC,PHI,Raymond Felton,63,13.6333333333333,14,-0.366666666666667,26,36,-10,-9,-1
21700736,201566,OKC,PHI,Russell Westbrook,196,40.3833333333333,41,-0.616666666666667,109,85,24,22,2
21700736,202331,OKC,PHI,Paul George,179,37.35,38,-0.649999999999999,103,88,15,15,0
21700736,202335,OKC,PHI,Patrick Patterson,54,12.3833333333333,12,0.383333333333333,28,29,-1,3,-4
21700736,203500,OKC,PHI,Steven Adams,145,32.1166666666667,33,-0.883333333333333,83,73,10,10,0
21700736,203518,OKC,PHI,Alex Abrines,8,2.36666666666667,3,-0.633333333333333,5,6,-1,-1,0
21700736,203924,OKC,PHI,Jerami Grant,105,22.0333333333333,22,0.0333333333333314,62,52,10,7,3
21700736,203962,OKC,PHI,Josh Huestis,81,18.7666666666667,19,-0.233333333333334,45,39,6,5,1
21700736,1626177,OKC,PHI,Dakari Johnson,29,5.5,6,-0.5,11,12,-1,-1,0
21700736,1628390,OKC,PHI,Terrance Ferguson,113,22.85,23,-0.149999999999999,54,67,-13,-10,-3
21700737,1713,SAC,SAS,Vince Carter,120,26.6666666666667,27,-0.333333333333336,65,62,3,5,-2
21700737,2216,SAC,SAS,Zach Randolph,132,31.6,32,-0.400000000000002,68,76,-8,-6,-2
21700737,201585,SAC,SAS,Kosta Koufos,123,30.9,31,-0.100000000000001,51,69,-18,-18,0
21700737,201588,SAC,SAS,George Hill,116,25.9166666666667,26,-0.0833333333333357,57,64,-7,-9,2
21700737,203960,SAC,SAS,JaKarr Sampson,35,8.31666666666667,8,0.316666666666666,14,19,-5,-5,0
21700737,203992,SAC,SAS,Bogdan Bogdanovic,136,32.4,33,-0.599999999999994,66,78,-12,-14,2
21700737,1627741,SAC,SAS,Buddy Hield,84,20.0166666666667,20,0.0166666666666657,38,48,-10,-8,-2
21700737,1628368,SAC,SAS,De'Aaron Fox,140,33.4166666666667,33,0.416666666666671,68,76,-8,-8,0
21700737,1628382,SAC,SAS,Justin Jackson,124,29.6833333333333,30,-0.316666666666666,63,73,-10,-12,2
21700737,1938,SAS,SAC,Manu Ginobili,111,25.25,25,0.25,66,59,7,7,0
21700737,2200,SAS,SAC,Pau Gasol,103,24.9166666666667,25,-0.0833333333333357,52,44,8,10,-2
21700737,2225,SAS,SAC,Tony Parker,97,20.7166666666667,21,-0.283333333333331,49,43,6,6,0
21700737,200746,SAS,SAC,LaMarcus Aldridge,124,31.0333333333333,31,0.0333333333333314,76,62,14,14,0
21700737,201980,SAS,SAC,Danny Green,36,9.05,9,0.0500000000000007,17,18,-1,-1,0
21700737,201988,SAS,SAC,Patty Mills,95,20.7166666666667,21,-0.283333333333331,48,49,-1,-1,0
21700737,202722,SAS,SAC,Davis Bertans,92,20.75,21,-0.25,54,47,7,7,0
21700737,203464,SAS,SAC,Brandon Paul,3,0.616666666666667,1,-0.383333333333333,2,0,2,2,0
21700737,203530,SAS,SAC,Joffrey Lauvergne,22,4.35,4,0.35,11,10,1,-1,2
21700737,203937,SAS,SAC,Kyle Anderson,89,21.2166666666667,21,0.216666666666665,41,37,4,4,0
21700737,1626199,SAS,SAC,Darrun Hilliard,24,6.46666666666667,7,-0.533333333333333,17,12,5,5,0
21700737,1627749,SAS,SAC,Dejounte Murray,102,26.45,26,0.450000000000003,62,55,7,7,0
21700737,1627854,SAS,SAC,Bryn Forbes,112,27.3833333333333,28,-0.616666666666667,70,54,16,16,0
21700738,201152,IND,CHA,Thaddeus Young,150,35.6,35,0.600000000000001,81,70,11,9,2
21700738,201954,IND,CHA,Darren Collison,129,30.0833333333333,30,0.0833333333333357,66,63,3,-1,4
21700738,202362,IND,CHA,Lance Stephenson,98,21.75,22,-0.25,47,38,9,7,2
21700738,202709,IND,CHA,Cory Joseph,110,24.15,24,0.149999999999999,48,47,1,3,-2
21700738,202711,IND,CHA,Bojan Bogdanovic,101,24.1,24,0.100000000000001,55,51,4,6,-2
21700738,203506,IND,CHA,Victor Oladipo,156,36.9,37,-0.100000000000001,84,74,10,10,0
21700738,1626167,IND,CHA,Myles Turner,96,21.2166666666667,21,0.216666666666669,49,47,2,1,1
21700738,1626202,IND,CHA,Joe Young,36,7.01666666666667,8,-0.983333333333333,15,15,0,2,-2
21700738,1627734,IND,CHA,Domantas Sabonis,119,27.75,28,-0.25,59,53,6,7,-1
21700738,1628388,IND,CHA,TJ Leaf,55,11.4333333333333,12,-0.566666666666666,21,22,-1,1,-2
21700738,2730,CHA,IND,Dwight Howard,162,37.5,37,0.5,76,83,-7,-4,-3
21700738,101107,CHA,IND,Marvin Williams,108,25.4333333333333,25,0.43333333333333,50,62,-12,-12,0
21700738,201587,CHA,IND,Nicolas Batum,150,35.15,35,0.150000000000006,71,75,-4,-4,0
21700738,202689,CHA,IND,Kemba Walker,149,34.6666666666667,35,-0.333333333333336,70,75,-5,-3,-2
21700738,203077,CHA,IND,Michael Kidd-Gilchrist,98,23.3333333333333,23,0.333333333333336,49,53,-4,-3,-1
21700738,203087,CHA,IND,Jeremy Lamb,105,23.2,23,0.199999999999999,47,48,-1,-2,1
21700738,203487,CHA,IND,Michael Carter-Williams,81,17.8,18,-0.200000000000003,32,40,-8,-8,0
21700738,203948,CHA,IND,Johnny O'Bryant III,48,10.5,11,-0.5,20,22,-2,-5,3
21700738,1626163,CHA,IND,Frank Kaminsky,102,22.5666666666667,23,-0.433333333333334,46,43,3,3,0
21700738,1626203,CHA,IND,Treveon Graham,47,9.85,10,-0.15,19,24,-5,-7,2
21700739,101141,ATL,MIN,Ersan Ilyasova,137,29.6833333333333,30,-0.316666666666666,62,51,11,12,-1
21700739,201158,ATL,MIN,Marco Belinelli,80,17.2666666666667,17,0.266666666666666,38,42,-4,0,-4
21700739,203101,ATL,MIN,Miles Plumlee,59,13.0166666666667,13,0.0166666666666657,23,29,-6,-6,0
21700739,203145,ATL,MIN,Kent Bazemore,140,30.05,30,0.0500000000000007,75,59,16,20,-4
21700739,203471,ATL,MIN,Dennis Schroder,153,34.0166666666667,34,0.0166666666666657,69,73,-4,-2,-2
21700739,203473,ATL,MIN,Dewayne Dedmon,88,19.0833333333333,19,0.0833333333333322,41,46,-5,-3,-2
21700739,203488,ATL,MIN,Mike Muscala,57,13.15,14,-0.850000000000001,35,19,16,11,5
21700739,1627098,ATL,MIN,Malcolm Delaney,124,25.2666666666667,25,0.266666666666666,56,48,8,9,-1
21700739,1627752,ATL,MIN,Taurean Prince,108,24.35,25,-0.649999999999999,43,55,-12,-19,7
21700739,1628381,ATL,MIN,John Collins,99,21.0666666666667,20,1.06666666666667,47,55,-8,-4,-4
21700739,1628416,ATL,MIN,Tyler Dorsey,55,13.05,13,0.0500000000000007,31,23,8,7,1
21700739,2037,MIN,ATL,Jamal Crawford,83,17.95,18,-0.0500000000000007,32,46,-14,-14,0
21700739,201952,MIN,ATL,Jeff Teague,159,34.9666666666667,35,-0.0333333333333314,78,73,5,5,0
21700739,201959,MIN,ATL,Taj Gibson,154,34.2,34,0.200000000000003,76,73,3,2,1
21700739,202357,MIN,ATL,Nemanja Bjelica,66,13.8,14,-0.199999999999999,24,31,-7,-7,0
21700739,202710,MIN,ATL,Jimmy Butler,164,36.3,36,0.299999999999997,75,73,2,1,1
21700739,203476,MIN,ATL,Gorgui Dieng,76,15.9833333333333,16,-0.0166666666666657,35,40,-5,-3,-2
21700739,203952,MIN,ATL,Andrew Wiggins,173,37.7,38,-0.299999999999997,85,77,8,7,1
21700739,1626145,MIN,ATL,Tyus Jones,61,13.0333333333333,13,0.0333333333333332,22,31,-9,-10,1
21700739,1626157,MIN,ATL,Karl-Anthony Towns,144,32.0166666666667,32,0.0166666666666657,65,64,1,-2,3
21700739,1627875,MIN,ATL,Marcus Georges-Hunt,20,4.05,4,0.0499999999999998,8,12,-4,-4,0
21700740,201162,PHX,MEM,Jared Dudley,133,27.5833333333333,28,-0.416666666666664,73,75,-2,0,-2
21700740,202328,PHX,MEM,Greg Monroe,113,23.1666666666667,23,0.166666666666664,42,58,-16,-16,0
21700740,203458,PHX,MEM,Alex Len,123,24.5166666666667,25,-0.483333333333334,67,62,5,5,0
21700740,203477,PHX,MEM,Isaiah Canaan,84,16.3666666666667,17,-0.633333333333333,31,38,-7,-4,-3
21700740,203584,PHX,MEM,Troy Daniels,112,23.2666666666667,23,0.266666666666666,45,58,-13,-15,2
21700740,203933,PHX,MEM,T.J. Warren,171,35.25,35,0.25,80,81,-1,-1,0
21700740,1627733,PHX,MEM,Dragan Bender,103,20.1,20,0.100000000000001,36,45,-9,-11,2
21700740,1627755,PHX,MEM,Tyler Ulis,152,31.3166666666667,31,0.316666666666666,78,82,-4,-7,3
21700740,1628367,PHX,MEM,Josh Jackson,151,29.25,29,0.25,76,81,-5,-5,0
21700740,1628432,PHX,MEM,Davon Reed,38,7.6,8,-0.4,17,20,-3,-1,-2
21700740,201188,MEM,PHX,Marc Gasol,121,23.5666666666667,24,-0.433333333333334,52,40,12,10,2
21700740,201596,MEM,PHX,Mario Chalmers,101,19.3833333333333,20,-0.616666666666667,49,33,16,18,-2
21700740,201936,MEM,PHX,Tyreke Evans,136,26.1333333333333,26,0.133333333333333,70,50,20,25,-5
21700740,1626150,MEM,PHX,Andrew Harrison,138,29.5833333333333,30,-0.416666666666668,78,80,-2,-4,2
21700740,1626185,MEM,PHX,Jarell Martin,165,33.7833333333333,34,-0.216666666666669,90,85,5,4,1
21700740,1627738,MEM,PHX,Deyonta Davis,84,17.1833333333333,17,0.183333333333334,49,44,5,7,-2
21700740,1627782,MEM,PHX,Wayne Selden,144,30.0666666666667,31,-0.933333333333334,75,65,10,6,4
21700740,1627988,MEM,PHX,Myke Henry,63,12.9166666666667,13,-0.0833333333333322,32,42,-10,-10,0
21700740,1628397,MEM,PHX,Ivan Rabb,100,20.1166666666667,20,0.116666666666667,45,43,2,2,0
21700740,1628415,MEM,PHX,Dillon Brooks,128,25.6833333333333,26,-0.316666666666666,60,63,-3,-3,0
21700741,1891,MIL,PHI,Jason Terry,67,15.3666666666667,16,-0.633333333333333,35,24,11,9,2
21700741,202339,MIL,PHI,Eric Bledsoe,11,2.46666666666667,3,-0.533333333333333,6,8,-2,-4,2
21700741,203089,MIL,PHI,John Henson,133,29.8833333333333,30,-0.116666666666667,68,68,0,0,0
21700741,203114,MIL,PHI,Khris Middleton,165,38.0333333333333,38,0.0333333333333314,83,81,2,4,-2
21700741,203503,MIL,PHI,Tony Snell,140,31.7,31,0.700000000000003,73,69,4,8,-4
21700741,203507,MIL,PHI,Giannis Antetokounmpo,162,35.5833333333333,36,-0.416666666666671,81,68,13,15,-2
21700741,203521,MIL,PHI,Matthew Dellavedova,113,25.8333333333333,26,-0.166666666666664,56,43,13,17,-4
21700741,203930,MIL,PHI,Sean Kilpatrick,2,0.0833333333333333,0,0.0833333333333333,2,2,0,-2,2
21700741,1626173,MIL,PHI,Rashad Vaughn,1,0.0666666666666667,0,0.0666666666666667,,2,,-2,
21700741,1627748,MIL,PHI,Thon Maker,77,17.65,18,-0.350000000000001,37,25,12,14,-2
21700741,1627763,MIL,PHI,Malcolm Brogdon,97,21.7,22,-0.300000000000001,49,50,-1,-3,2
21700741,1627850,MIL,PHI,Marshall Plumlee,2,0.0833333333333333,0,0.0833333333333333,2,2,0,-2,2
21700741,1628425,MIL,PHI,Sterling Brown,90,19.6333333333333,20,-0.366666666666667,43,33,10,6,4
21700741,101161,PHI,MIL,Amir Johnson,81,18.3,18,0.299999999999997,33,42,-9,-7,-2
21700741,202344,PHI,MIL,Trevor Booker,59,13.1166666666667,13,0.116666666666667,28,31,-3,-1,-2
21700741,203496,PHI,MIL,Robert Covington,143,33.3,33,0.299999999999997,63,72,-9,-9,0
21700741,203580,PHI,MIL,Larry Drew II,12,2.26666666666667,3,-0.733333333333333,8,5,3,3,0
21700741,203923,PHI,MIL,James Young,85,19.5333333333333,20,-0.466666666666669,35,41,-6,-6,0
21700741,203967,PHI,MIL,Dario Saric,150,33.8,33,0.799999999999997,64,77,-13,-13,0
21700741,204456,PHI,MIL,T.J. McConnell,86,19.5166666666667,20,-0.483333333333334,36,45,-9,-9,0
21700741,1626147,PHI,MIL,Justin Anderson,110,24.1166666666667,24,0.116666666666667,53,59,-6,-6,0
21700741,1626158,PHI,MIL,Richaun Holmes,100,22.3666666666667,23,-0.633333333333333,48,45,3,-1,4
21700741,1627732,PHI,MIL,Ben Simmons,133,29.6,29,0.600000000000001,59,67,-8,-8,0
21700741,1627789,PHI,MIL,Timothe Luwawu-Cabarrot,101,22.1666666666667,23,-0.833333333333336,48,51,-3,-3,0
21700742,1717,DAL,MIA,Dirk Nowitzki,111,26.7166666666667,27,-0.283333333333331,44,59,-15,-14,-1
21700742,2734,DAL,MIA,Devin Harris,68,16.4833333333333,16,0.483333333333334,21,27,-6,-6,0
21700742,202083,DAL,MIA,Wesley Matthews,152,34.2833333333333,34,0.283333333333331,70,72,-2,-2,0
21700742,203084,DAL,MIA,Harrison Barnes,150,33.3833333333333,34,-0.616666666666667,70,69,1,1,0
21700742,203939,DAL,MIA,Dwight Powell,88,20.9833333333333,21,-0.0166666666666657,41,33,8,6,2
21700742,1626257,DAL,MIA,Salah Mejri,67,14.4166666666667,14,0.416666666666666,21,29,-8,-9,1
21700742,1627812,DAL,MIA,Yogi Ferrell,141,32.6833333333333,33,-0.316666666666663,69,60,9,12,-3
21700742,1627858,DAL,MIA,Kyle Collinsworth,40,9.91666666666667,10,-0.0833333333333339,14,17,-3,-3,0
21700742,1628372,DAL,MIA,Dennis Smith Jr.,156,35.15,35,0.149999999999999,71,74,-3,-3,0
21700742,1628467,DAL,MIA,Maxi Kleber,67,15.5666666666667,15,0.566666666666666,19,35,-16,-17,1
21700742,201609,MIA,DAL,Goran Dragic,126,28.45,28,0.449999999999999,63,58,5,5,0
21700742,201949,MIA,DAL,James Johnson,130,29,29,0,65,58,7,7,0
21700742,201961,MIA,DAL,Wayne Ellington,118,27.3333333333333,27,0.333333333333336,50,59,-9,-12,3
21700742,202355,MIA,DAL,Hassan Whiteside,116,26.1333333333333,26,0.133333333333333,58,49,9,11,-2
21700742,203482,MIA,DAL,Kelly Olynyk,89,21.3,22,-0.699999999999999,35,39,-4,-4,0
21700742,204020,MIA,DAL,Tyler Johnson,121,27.1666666666667,28,-0.833333333333336,59,47,12,13,-1
21700742,1626159,MIA,DAL,Justise Winslow,98,22.7666666666667,23,-0.233333333333334,35,30,5,7,-2
21700742,1626196,MIA,DAL,Josh Richardson,163,38.3,38,0.299999999999997,80,70,10,8,2
21700742,1628389,MIA,DAL,Bam Adebayo,79,19.1333333333333,19,0.133333333333333,30,30,0,0,0
21700743,201143,BOS,DEN,Al Horford,143,32.4166666666667,32,0.416666666666671,62,74,-12,-11,-1
21700743,202681,BOS,DEN,Kyrie Irving,167,36.5166666666667,37,-0.483333333333334,79,81,-2,-2,0
21700743,202694,BOS,DEN,Marcus Morris,100,19.9166666666667,20,-0.0833333333333322,53,47,6,5,1
21700743,203382,BOS,DEN,Aron Baynes,80,17.3666666666667,17,0.366666666666667,33,38,-5,-5,0
21700743,1626179,BOS,DEN,Terry Rozier,143,30.5,30,0.5,66,66,0,0,0
21700743,1627759,BOS,DEN,Jaylen Brown,153,33.8833333333333,34,-0.116666666666667,70,84,-14,-13,-1
21700743,1628369,BOS,DEN,Jayson Tatum,139,32.0666666666667,33,-0.933333333333337,87,75,12,10,2
21700743,1628400,BOS,DEN,Semi Ojeleye,80,16.4166666666667,16,0.416666666666664,43,39,4,5,-1
21700743,1628464,BOS,DEN,Daniel Theis,100,20.9166666666667,21,-0.0833333333333357,62,46,16,16,0
21700743,202702,DEN,BOS,Kenneth Faried,28,5.61666666666667,5,0.616666666666667,8,12,-4,-4,0
21700743,203115,DEN,BOS,Will Barton,198,43.4166666666667,44,-0.583333333333329,100,94,6,6,0
21700743,203486,DEN,BOS,Mason Plumlee,133,27.95,28,-0.0500000000000007,63,57,6,6,0
21700743,203914,DEN,BOS,Gary Harris,164,36.1166666666667,36,0.116666666666667,83,77,6,6,0
21700743,203999,DEN,BOS,Nikola Jokic,155,34.9,35,-0.100000000000001,90,80,10,10,0
21700743,1626144,DEN,BOS,Emmanuel Mudiay,57,11.4666666666667,12,-0.533333333333333,22,31,-9,-9,0
21700743,1626168,DEN,BOS,Trey Lyles,124,27.0666666666667,27,0.0666666666666664,59,73,-14,-14,0
21700743,1627750,DEN,BOS,Jamal Murray,174,38.9,39,-0.100000000000001,92,84,8,8,0
21700743,1628470,DEN,BOS,Torrey Craig,72,14.5666666666667,14,0.566666666666666,33,47,-14,-14,0
21700744,2546,OKC,WAS,Carmelo Anthony,174,33.5666666666667,34,-0.433333333333337,67,80,-13,-11,-2
21700744,101109,OKC,WAS,Raymond Felton,60,13.3666666666667,14,-0.633333333333333,30,20,10,6,4
21700744,201566,OKC,WAS,Russell Westbrook,188,36.5,36,0.5,75,84,-9,-7,-2
21700744,202331,OKC,WAS,Paul George,181,36.0333333333333,36,0.0333333333333314,67,82,-15,-15,0
21700744,202335,OKC,WAS,Patrick Patterson,53,11.7333333333333,12,-0.266666666666666,23,17,6,6,0
21700744,203500,OKC,WAS,Steven Adams,199,39.2666666666667,39,0.266666666666666,81,91,-10,-6,-4
21700744,203518,OKC,WAS,Alex Abrines,61,12.6666666666667,13,-0.333333333333332,31,22,9,9,0
21700744,203924,OKC,WAS,Jerami Grant,80,16.7833333333333,17,-0.216666666666665,33,28,5,-1,6
21700744,203962,OKC,WAS,Josh Huestis,97,20.55,21,-0.450000000000003,37,38,-1,0,-1
21700744,1628390,OKC,WAS,Terrance Ferguson,92,18.6166666666667,19,-0.383333333333333,36,48,-12,-11,-1
21700744,101133,WAS,OKC,Ian Mahinmi,46,9.38333333333333,9,0.383333333333333,17,21,-4,-4,0
21700744,101162,WAS,OKC,Marcin Gortat,133,25.4,26,-0.600000000000001,68,45,23,23,0
21700744,201975,WAS,OKC,Jodie Meeks,36,7.63333333333333,7,0.633333333333333,7,18,-11,-9,-2
21700744,202693,WAS,OKC,Markieff Morris,188,37.1,37,0.100000000000001,81,77,4,6,-2
21700744,203078,WAS,OKC,Bradley Beal,205,41,41,0,95,78,17,15,2
21700744,203107,WAS,OKC,Tomas Satoransky,157,29.95,30,-0.0500000000000007,77,54,23,21,2
21700744,203118,WAS,OKC,Mike Scott,78,17.5166666666667,18,-0.483333333333334,25,40,-15,-15,0
21700744,203490,WAS,OKC,Otto Porter Jr.,168,33.6166666666667,34,-0.383333333333333,84,64,20,21,-1
21700744,204025,WAS,OKC,Tim Frazier,65,14.9833333333333,15,-0.0166666666666657,22,33,-11,-11,0
21700744,1626162,WAS,OKC,Kelly Oubre Jr.,109,22.5,22,0.5,34,50,-16,-17,1
21700745,201960,BKN,NYK,DeMarre Carroll,112,23.8333333333333,24,-0.166666666666664,47,57,-10,-10,0
21700745,203112,BKN,NYK,Quincy Acy,107,22.1666666666667,22,0.166666666666664,52,55,-3,-3,0
21700745,203459,BKN,NYK,Allen Crabbe,115,24.0666666666667,24,0.0666666666666664,54,55,-1,-1,0
21700745,203915,BKN,NYK,Spencer Dinwiddie,120,25.2166666666667,25,0.216666666666669,54,59,-5,-5,0
21700745,203917,BKN,NYK,Nik Stauskas,120,25.0833333333333,25,0.0833333333333357,48,56,-8,-8,0
21700745,203925,BKN,NYK,Joe Harris,105,22.8333333333333,23,-0.166666666666664,31,54,-23,-23,0
21700745,1626143,BKN,NYK,Jahlil Okafor,116,24.1833333333333,25,-0.816666666666666,40,51,-11,-11,0
21700745,1626156,BKN,NYK,D'Angelo Russell,95,20.35,20,0.350000000000001,37,51,-14,-14,0
21700745,1627785,BKN,NYK,Isaiah Whitehead,51,9.55,10,-0.449999999999999,21,19,2,2,0
21700745,1627821,BKN,NYK,James Webb III,104,21.3333333333333,22,-0.666666666666664,41,50,-9,-9,0
21700745,1628386,BKN,NYK,Jarrett Allen,95,20.05,20,0.0500000000000007,50,48,2,2,0
21700745,101127,NYK,BKN,Jarrett Jack,93,19.5666666666667,20,-0.433333333333334,48,40,8,9,-1
21700745,201563,NYK,BKN,Michael Beasley,106,22.35,23,-0.649999999999999,52,41,11,8,3
21700745,201584,NYK,BKN,Courtney Lee,146,31.3666666666667,31,0.366666666666667,72,61,11,15,-4
21700745,202498,NYK,BKN,Lance Thomas,27,5.63333333333333,6,-0.366666666666667,12,5,7,7,0
21700745,202683,NYK,BKN,Enes Kanter,143,30.75,30,0.75,71,62,9,11,-2
21700745,203124,NYK,BKN,Kyle O'Quinn,53,11.0333333333333,11,0.0333333333333332,27,22,5,2,3
21700745,203501,NYK,BKN,Tim Hardaway Jr.,120,25.3,25,0.299999999999997,61,57,4,8,-4
21700745,203504,NYK,BKN,Trey Burke,84,16.6666666666667,17,-0.333333333333336,41,36,5,0,5
21700745,203926,NYK,BKN,Doug McDermott,89,18.55,19,-0.449999999999999,39,38,1,-1,2
21700745,204001,NYK,BKN,Kristaps Porzingis,146,30.2333333333333,30,0.233333333333334,69,65,4,8,-4
21700745,1626195,NYK,BKN,Willy Hernangomez,8,1.1,1,0.1,3,0,3,3,0
21700745,1627758,NYK,BKN,Ron Baker,1,0.25,1,-0.75,0,,,0,
21700745,1628373,NYK,BKN,Frank Ntilikina,124,25.8666666666667,26,-0.133333333333333,60,48,12,10,2
21700746,2037,MIN,TOR,Jamal Crawford,70,16.2333333333333,16,0.233333333333334,33,39,-6,-6,0
21700746,201952,MIN,TOR,Jeff Teague,134,30.75,31,-0.25,67,74,-7,-6,-1
21700746,201959,MIN,TOR,Taj Gibson,126,28.5833333333333,29,-0.416666666666664,62,67,-5,-5,0
21700746,202357,MIN,TOR,Nemanja Bjelica,85,19.3666666666667,19,0.366666666666667,42,42,0,0,0
21700746,202710,MIN,TOR,Jimmy Butler,164,38.2333333333333,38,0.233333333333334,82,84,-2,-2,0
21700746,203476,MIN,TOR,Gorgui Dieng,89,19.2,19,0.199999999999999,43,44,-1,-1,0
21700746,203498,MIN,TOR,Shabazz Muhammad,33,6.88333333333333,7,-0.116666666666667,18,18,0,0,0
21700746,203952,MIN,TOR,Andrew Wiggins,155,34.55,34,0.549999999999997,75,77,-2,-2,0
21700746,1626145,MIN,TOR,Tyus Jones,77,17.2,17,0.199999999999999,37,35,2,1,1
21700746,1626157,MIN,TOR,Karl-Anthony Towns,122,28.75,29,-0.25,61,65,-4,-4,0
21700746,200768,TOR,MIN,Kyle Lowry,152,34.0666666666667,34,0.0666666666666629,87,76,11,9,2
21700746,201586,TOR,MIN,Serge Ibaka,150,33.8666666666667,34,-0.133333333333333,80,71,9,7,2
21700746,201942,TOR,MIN,DeMar DeRozan,159,36.85,37,-0.150000000000006,82,81,1,1,0
21700746,202685,TOR,MIN,Jonas Valanciunas,128,28.5666666666667,29,-0.433333333333334,72,59,13,14,-1
21700746,1626153,TOR,MIN,Delon Wright,73,16.5333333333333,17,-0.466666666666669,31,37,-6,-4,-2
21700746,1626181,TOR,MIN,Norman Powell,88,19.7,20,-0.300000000000001,38,41,-3,-1,-2
21700746,1627751,TOR,MIN,Jakob Poeltl,83,19.3833333333333,19,0.383333333333333,37,45,-8,-9,1
21700746,1627783,TOR,MIN,Pascal Siakam,61,14.0833333333333,14,0.0833333333333322,29,33,-4,-2,-2
21700746,1627832,TOR,MIN,Fred VanVleet,94,21.2666666666667,21,0.266666666666666,54,48,6,6,0
21700746,1628384,TOR,MIN,OG Anunoby,67,15.4333333333333,16,-0.566666666666666,35,29,6,4,2
21700747,2544,CLE,DET,LeBron James,188,37.6833333333333,38,-0.31666666666667,85,101,-16,-13,-3
21700747,2548,CLE,DET,Dwyane Wade,140,27.15,28,-0.850000000000001,81,69,12,15,-3
21700747,2594,CLE,DET,Kyle Korver,116,23.3,24,-0.700000000000003,61,59,2,2,0
21700747,2747,CLE,DET,JR Smith,120,24.1166666666667,24,0.116666666666667,53,66,-13,-13,0
21700747,101112,CLE,DET,Channing Frye,109,20.8666666666667,21,-0.133333333333333,53,58,-5,-3,-2
21700747,101181,CLE,DET,Jose Calderon,10,2.05,2,0.0499999999999998,8,3,5,3,2
21700747,201145,CLE,DET,Jeff Green,57,11.7,12,-0.300000000000001,32,26,6,7,-1
21700747,201567,CLE,DET,Kevin Love,23,4.68333333333333,5,-0.316666666666666,6,10,-4,-4,0
21700747,202684,CLE,DET,Tristan Thompson,127,26.55,27,-0.450000000000003,61,67,-6,-8,2
21700747,202738,CLE,DET,Isaiah Thomas,159,32.7666666666667,33,-0.233333333333334,70,92,-22,-25,3
21700747,203109,CLE,DET,Jae Crowder,131,26.2166666666667,27,-0.783333333333331,60,74,-14,-16,2
21700747,201229,DET,CLE,Anthony Tolliver,185,36.4833333333333,37,-0.516666666666666,104,83,21,21,0
21700747,202397,DET,CLE,Ish Smith,160,32.4333333333333,33,-0.56666666666667,85,75,10,12,-2
21700747,202779,DET,CLE,Dwight Buycks,76,14.9833333333333,15,-0.0166666666666675,40,39,1,-1,2
21700747,203083,DET,CLE,Andre Drummond,180,37.1333333333333,38,-0.866666666666667,96,81,15,18,-3
21700747,203493,DET,CLE,Reggie Bullock,143,28.5833333333333,30,-1.41666666666667,73,63,10,12,-2
21700747,203961,DET,CLE,Eric Moreland,35,5.68333333333333,6,-0.316666666666666,15,19,-4,-7,3
21700747,204038,DET,CLE,Langston Galloway,42,9.53333333333333,9,0.533333333333333,22,27,-5,-5,0
21700747,1626169,DET,CLE,Stanley Johnson,199,39.7333333333333,40,-0.266666666666666,104,94,10,10,0
21700747,1627740,DET,CLE,Henry Ellenson,51,10.6,11,-0.4,27,32,-5,-5,0
21700747,1628379,DET,CLE,Luke Kennard,109,21.9166666666667,22,-0.0833333333333357,59,57,2,0,2
21700748,2403,HOU,ORL,Nene,59,13.5666666666667,13,0.566666666666666,37,41,-4,-6,2
21700748,101123,HOU,ORL,Gerald Green,139,32.4333333333333,32,0.43333333333333,84,80,4,2,2
21700748,200782,HOU,ORL,PJ Tucker,148,35.4,36,-0.600000000000001,82,79,3,3,0
21700748,201569,HOU,ORL,Eric Gordon,45,9.8,10,-0.199999999999999,22,19,3,5,-2
21700748,201583,HOU,ORL,Ryan Anderson,134,32.5666666666667,33,-0.433333333333337,78,72,6,8,-2
21700748,201601,HOU,ORL,Luc Mbah a Moute,163,39.1,39,0.0999999999999943,88,85,3,3,0
21700748,201935,HOU,ORL,James Harden,198,46.3166666666667,46,0.316666666666663,111,104,7,7,0
21700748,203991,HOU,ORL,Clint Capela,129,29.3166666666667,30,-0.683333333333334,68,55,13,13,0
21700748,201167,ORL,HOU,Arron Afflalo,57,14.4833333333333,15,-0.516666666666666,30,28,2,0,2
21700748,201571,ORL,HOU,D.J. Augustin,114,27.55,28,-0.450000000000003,63,62,1,1,0
21700748,201578,ORL,HOU,Marreese Speights,83,21.0166666666667,21,0.0166666666666657,44,43,1,7,-6
21700748,202687,ORL,HOU,Bismack Biyombo,94,20.7833333333333,21,-0.216666666666669,49,52,-3,-5,2
21700748,202714,ORL,HOU,Shelvin Mack,101,24.95,25,-0.0500000000000007,50,53,-3,-1,-2
21700748,203095,ORL,HOU,Evan Fournier,122,27.2166666666667,27,0.216666666666669,63,67,-4,-4,0
21700748,203613,ORL,HOU,Jonathon Simmons,150,34.65,35,-0.349999999999994,76,88,-12,-15,3
21700748,203901,ORL,HOU,Elfrid Payton,79,17.4666666666667,18,-0.533333333333331,44,45,-1,-1,0
21700748,203920,ORL,HOU,Khem Birch,23,5.18333333333333,5,0.183333333333334,12,17,-5,-5,0
21700748,1626209,ORL,HOU,Mario Hezonja,103,24.5333333333333,25,-0.466666666666669,56,65,-9,-13,4
21700748,1628411,ORL,HOU,Wes Iwundu,89,20.6666666666667,21,-0.333333333333332,48,50,-2,1,-3
21700749,2749,NOP,SAC,Jameer Nelson,91,18.9,19,-0.100000000000001,45,45,0,-1,1
21700749,200765,NOP,SAC,Rajon Rondo,87,18.1666666666667,18,0.166666666666664,34,42,-8,-10,2
21700749,201600,NOP,SAC,Omer Asik,108,23.7333333333333,24,-0.266666666666666,52,51,1,-1,2
21700749,201950,NOP,SAC,Jrue Holiday,159,34.2166666666667,34,0.216666666666669,68,76,-8,-6,-2
21700749,201967,NOP,SAC,Dante Cunningham,55,10.2166666666667,10,0.216666666666667,23,23,0,0,0
21700749,202734,NOP,SAC,E'Twaun Moore,142,29,29,0,64,67,-3,-1,-2
21700749,203076,NOP,SAC,Anthony Davis,172,36.6666666666667,36,0.666666666666671,78,91,-13,-13,0
21700749,203121,NOP,SAC,Darius Miller,132,28.35,29,-0.649999999999999,67,64,3,4,-1
21700749,203546,NOP,SAC,Ian Clark,138,29,30,-1,67,75,-8,-8,0
21700749,1627767,NOP,SAC,Cheick Diallo,33,6.58333333333333,6,0.583333333333334,10,21,-11,-11,0
21700749,1628455,NOP,SAC,Mike James,18,3.83333333333333,4,-0.166666666666667,7,15,-8,-8,0
21700749,1713,SAC,NOP,Vince Carter,71,15.15,15,0.15,35,43,-8,-7,-1
21700749,2216,SAC,NOP,Zach Randolph,155,32.5833333333333,32,0.583333333333329,78,60,18,18,0
21700749,201585,SAC,NOP,Kosta Koufos,179,37.1,37,0.100000000000001,93,75,18,17,1
21700749,201588,SAC,NOP,George Hill,124,27.0666666666667,28,-0.933333333333334,63,59,4,6,-2
21700749,202066,SAC,NOP,Garrett Temple,151,31.6333333333333,32,-0.366666666666667,76,72,4,2,2
21700749,203992,SAC,NOP,Bogdan Bogdanovic,91,18.35,18,0.350000000000001,45,36,9,9,0
21700749,1627741,SAC,NOP,Buddy Hield,99,21.2166666666667,22,-0.783333333333331,49,53,-4,-2,-2
21700749,1627834,SAC,NOP,Georgios Papagiannis,48,10.6333333333333,11,-0.366666666666667,21,28,-7,-6,-1
21700749,1628368,SAC,NOP,De'Aaron Fox,132,27.4,27,0.399999999999999,65,54,11,9,2
21700749,1628382,SAC,NOP,Justin Jackson,85,17.5333333333333,18,-0.466666666666665,45,35,10,9,1
21700750,2210,DEN,SAS,Richard Jefferson,27,5.6,6,-0.4,12,12,0,0,0
21700750,201589,DEN,SAS,Darrell Arthur,87,18.8,19,-0.199999999999999,44,40,4,6,-2
21700750,203115,DEN,SAS,Will Barton,174,38.5166666666667,39,-0.483333333333334,86,82,4,4,0
21700750,203914,DEN,SAS,Gary Harris,155,35,35,0,74,79,-5,-5,0
21700750,203999,DEN,SAS,Nikola Jokic,150,34.2833333333333,34,0.283333333333331,73,81,-8,-8,0
21700750,1626144,DEN,SAS,Emmanuel Mudiay,72,13.9333333333333,14,-0.0666666666666664,33,27,6,6,0
21700750,1626168,DEN,SAS,Trey Lyles,118,25.0333333333333,25,0.0333333333333314,55,53,2,2,0
21700750,1627736,DEN,SAS,Malik Beasley,63,12.95,13,-0.0500000000000007,28,29,-1,-1,0
21700750,1627750,DEN,SAS,Jamal Murray,147,34.05,34,0.0499999999999972,71,79,-8,-8,0
21700750,1628470,DEN,SAS,Torrey Craig,102,21.75,22,-0.25,44,48,-4,-6,2
21700750,1938,SAS,DEN,Manu Ginobili,107,23.5,23,0.5,56,52,4,4,0
21700750,2200,SAS,DEN,Pau Gasol,106,21.7666666666667,22,-0.233333333333334,45,61,-16,-18,2
21700750,2225,SAS,DEN,Tony Parker,87,17.35,17,0.350000000000001,38,39,-1,1,-2
21700750,200746,SAS,DEN,LaMarcus Aldridge,168,38.4333333333333,39,-0.566666666666663,87,73,14,14,0
21700750,201980,SAS,DEN,Danny Green,117,25.4333333333333,26,-0.566666666666666,52,57,-5,-5,0
21700750,201988,SAS,DEN,Patty Mills,94,20.3666666666667,20,0.366666666666667,48,49,-1,-1,0
21700750,202722,SAS,DEN,Davis Bertans,76,15.6833333333333,16,-0.316666666666666,33,40,-7,-5,-2
21700750,203937,SAS,DEN,Kyle Anderson,153,34.3833333333333,35,-0.616666666666667,75,70,5,5,0
21700750,1627749,SAS,DEN,Dejounte Murray,116,25.8,26,-0.199999999999999,56,54,2,0,2
21700750,1627854,SAS,DEN,Bryn Forbes,71,17.2,17,0.200000000000003,40,25,15,15,0
21700751,2561,GSW,UTA,David West,73,15.9833333333333,16,-0.0166666666666657,28,42,-14,-14,0
21700751,2585,GSW,UTA,Zaza Pachulia,86,18.6333333333333,19,-0.366666666666667,38,49,-11,-10,-1
21700751,2733,GSW,UTA,Shaun Livingston,51,11.1333333333333,12,-0.866666666666667,19,24,-5,-5,0
21700751,2738,GSW,UTA,Andre Iguodala,100,20.15,20,0.149999999999999,49,55,-6,-5,-1
21700751,201142,GSW,UTA,Kevin Durant,148,29.8666666666667,30,-0.133333333333333,71,88,-17,-17,0
21700751,201156,GSW,UTA,Nick Young,68,14.6,15,-0.4,24,37,-13,-14,1
21700751,201580,GSW,UTA,JaVale McGee,81,16.1,16,0.100000000000001,35,45,-10,-11,1
21700751,201939,GSW,UTA,Stephen Curry,148,29.8666666666667,30,-0.133333333333333,71,88,-17,-17,0
21700751,201956,GSW,UTA,Omri Casspi,51,10.5333333333333,11,-0.466666666666667,18,25,-7,-7,0
21700751,202691,GSW,UTA,Klay Thompson,141,30.1833333333333,31,-0.816666666666666,60,79,-19,-19,0
21700751,203110,GSW,UTA,Draymond Green,138,29.9666666666667,30,-0.033333333333335,57,80,-23,-23,0
21700751,1627775,GSW,UTA,Patrick McCaw,55,11.5666666666667,12,-0.433333333333334,25,33,-8,-8,0
21700751,2207,UTA,GSW,Joe Johnson,104,21.5,22,-0.5,59,42,17,18,-1
21700751,201937,UTA,GSW,Ricky Rubio,164,34.9666666666667,35,-0.0333333333333314,98,65,33,31,2
21700751,201973,UTA,GSW,Jonas Jerebko,67,13.5833333333333,14,-0.416666666666668,39,30,9,7,2
21700751,202324,UTA,GSW,Derrick Favors,123,25.7,26,-0.299999999999997,62,56,6,6,0
21700751,202327,UTA,GSW,Ekpe Udoh,17,4.01666666666667,4,0.0166666666666666,8,5,3,3,0
21700751,202692,UTA,GSW,Alec Burks,144,29.3166666666667,29,0.316666666666666,76,63,13,13,0
21700751,203497,UTA,GSW,Rudy Gobert,133,27.9,28,-0.100000000000001,86,60,26,26,0
21700751,203526,UTA,GSW,Raul Neto,29,5.98333333333333,6,-0.0166666666666666,13,16,-3,-1,-2
21700751,204060,UTA,GSW,Joe Ingles,127,26.5666666666667,27,-0.433333333333334,80,57,23,26,-3
21700751,1626220,UTA,GSW,Royce O'Neale,108,23.0166666666667,23,0.0166666666666657,51,46,5,2,3
21700751,1627777,UTA,GSW,Georges Niang,5,0.866666666666667,1,-0.133333333333333,2,1,1,2,-1
21700751,1628378,UTA,GSW,Donovan Mitchell,119,25.1666666666667,26,-0.833333333333336,71,54,17,17,0
21700752,101150,LAC,POR,Lou Williams,192,39.4666666666667,39,0.466666666666669,83,83,0,0,0
21700752,201568,LAC,POR,Danilo Gallinari,121,25.0833333333333,25,0.0833333333333322,44,46,-2,-2,0
21700752,201599,LAC,POR,DeAndre Jordan,157,32.7833333333333,33,-0.216666666666669,56,69,-13,-11,-2
21700752,202325,LAC,POR,Wesley Johnson,137,27.15,27,0.149999999999999,44,61,-17,-15,-2
21700752,1626149,LAC,POR,Montrezl Harrell,86,17.1666666666667,17,0.166666666666668,45,41,4,2,2
21700752,1626155,LAC,POR,Sam Dekker,77,15.3166666666667,15,0.316666666666666,40,37,3,1,2
21700752,1627820,LAC,POR,Tyrone Wallace,178,36.3333333333333,36,0.333333333333336,74,83,-9,-9,0
21700752,1628414,LAC,POR,Sindarius Thornwell,91,18,18,0,37,42,-5,-9,4
21700752,1628462,LAC,POR,Milos Teodosic,136,28.45,29,-0.550000000000001,57,58,-1,3,-4
21700752,202323,POR,LAC,Evan Turner,146,30.0166666666667,30,0.0166666666666657,61,51,10,8,2
21700752,202329,POR,LAC,Al-Farouq Aminu,153,31.65,32,-0.350000000000001,65,52,13,14,-1
21700752,202334,POR,LAC,Ed Davis,103,20.1666666666667,20,0.166666666666664,49,53,-4,-2,-2
21700752,203081,POR,LAC,Damian Lillard,177,35.7666666666667,36,-0.233333333333334,75,64,11,11,0
21700752,203468,POR,LAC,CJ McCollum,173,35.6166666666667,36,-0.383333333333333,81,70,11,11,0
21700752,203894,POR,LAC,Shabazz Napier,104,21.3833333333333,21,0.383333333333333,47,51,-4,-2,-2
21700752,203994,POR,LAC,Jusuf Nurkic,132,27.7833333333333,28,-0.216666666666669,55,43,12,10,2
21700752,1626192,POR,LAC,Pat Connaughton,106,21.5166666666667,22,-0.483333333333334,48,52,-4,-4,0
21700752,1628380,POR,LAC,Zach Collins,81,15.85,16,-0.150000000000002,39,44,-5,-6,1
21700753,201152,IND,MEM,Thaddeus Young,154,35.7166666666667,36,-0.283333333333331,85,78,7,8,-1
21700753,201954,IND,MEM,Darren Collison,152,34.3833333333333,34,0.383333333333333,70,68,2,5,-3
21700753,202362,IND,MEM,Lance Stephenson,63,14.9666666666667,15,-0.033333333333335,33,36,-3,-5,2
21700753,202709,IND,MEM,Cory Joseph,96,21.75,22,-0.25,46,47,-1,-3,2
21700753,202711,IND,MEM,Bojan Bogdanovic,152,35.1333333333333,35,0.133333333333333,85,78,7,6,1
21700753,203506,IND,MEM,Victor Oladipo,152,34.6333333333333,35,-0.366666666666667,72,69,3,6,-3
21700753,1626167,IND,MEM,Myles Turner,150,33.1166666666667,33,0.116666666666667,73,60,13,15,-2
21700753,1626202,IND,MEM,Joe Young,16,4.15,4,0.15,9,9,0,-2,2
21700753,1627734,IND,MEM,Domantas Sabonis,90,21.15,21,0.149999999999999,41,47,-6,-6,0
21700753,1628388,IND,MEM,TJ Leaf,20,5,5,0,11,13,-2,-4,2
21700753,201148,MEM,IND,Brandan Wright,59,13.55,14,-0.449999999999999,27,21,6,5,1
21700753,201188,MEM,IND,Marc Gasol,152,35.4,36,-0.600000000000001,72,76,-4,-5,1
21700753,203463,MEM,IND,Ben McLemore,75,16.8833333333333,16,0.883333333333333,30,39,-9,-7,-2
21700753,1626150,MEM,IND,Andrew Harrison,112,25.0666666666667,25,0.0666666666666664,49,56,-7,-11,4
21700753,1626185,MEM,IND,Jarell Martin,142,32.6,33,-0.399999999999999,76,77,-1,1,-2
21700753,1627782,MEM,IND,Wayne Selden,124,29.9,31,-1.1,67,64,3,2,1
21700753,1627988,MEM,IND,Myke Henry,99,23.65,24,-0.350000000000001,58,47,11,11,0
21700753,1628397,MEM,IND,Ivan Rabb,106,23.2166666666667,23,0.216666666666669,46,56,-10,-6,-4
21700753,1628415,MEM,IND,Dillon Brooks,176,39.7333333333333,40,-0.266666666666666,80,89,-9,-10,1
21700754,201147,LAL,ORL,Corey Brewer,71,13.35,14,-0.649999999999999,26,36,-10,-7,-3
21700754,201572,LAL,ORL,Brook Lopez,45,8.76666666666667,9,-0.233333333333334,14,25,-11,-12,1
21700754,203484,LAL,ORL,Kentavious Caldwell-Pope,151,31.55,32,-0.450000000000003,74,80,-6,-10,4
21700754,203898,LAL,ORL,Tyler Ennis,51,10.2166666666667,10,0.216666666666667,21,26,-5,-8,3
21700754,203903,LAL,ORL,Jordan Clarkson,125,24.5333333333333,24,0.533333333333331,59,71,-12,-9,-3
21700754,203944,LAL,ORL,Julius Randle,127,26.35,27,-0.649999999999999,57,75,-18,-21,3
21700754,1626204,LAL,ORL,Larry Nance Jr.,119,24.8166666666667,25,-0.183333333333334,49,62,-13,-10,-3
21700754,1627742,LAL,ORL,Brandon Ingram,156,34.6833333333333,35,-0.31666666666667,79,87,-8,-7,-1
21700754,1627936,LAL,ORL,Alex Caruso,76,14.85,15,-0.15,26,46,-20,-19,-1
21700754,1628398,LAL,ORL,Kyle Kuzma,140,28.05,28,0.0500000000000007,69,76,-7,-7,0
21700754,1628404,LAL,ORL,Josh Hart,61,13.4166666666667,14,-0.583333333333332,30,36,-6,-6,0
21700754,1628418,LAL,ORL,Thomas Bryant,28,7.08333333333333,7,0.083333333333333,21,15,6,6,0
21700754,201167,ORL,LAL,Arron Afflalo,25,6.2,7,-0.8,13,17,-4,-4,0
21700754,201571,ORL,LAL,D.J. Augustin,102,20.8333333333333,21,-0.166666666666668,53,46,7,3,4
21700754,201578,ORL,LAL,Marreese Speights,110,22.8166666666667,23,-0.183333333333334,68,47,21,22,-1
21700754,202687,ORL,LAL,Bismack Biyombo,141,30.45,31,-0.550000000000001,74,67,7,7,0
21700754,202714,ORL,LAL,Shelvin Mack,117,24.1,24,0.100000000000001,59,57,2,4,-2
21700754,203095,ORL,LAL,Evan Fournier,135,27.5666666666667,27,0.566666666666666,80,63,17,19,-2
21700754,203613,ORL,LAL,Jonathon Simmons,113,23.4333333333333,24,-0.566666666666666,68,48,20,18,2
21700754,203901,ORL,LAL,Elfrid Payton,119,24.1,24,0.0999999999999979,68,52,16,16,0
21700754,203920,ORL,LAL,Khem Birch,63,12.5666666666667,13,-0.433333333333334,33,25,8,8,0
21700754,1626209,ORL,LAL,Mario Hezonja,126,24.9666666666667,25,-0.033333333333335,72,59,13,14,-1
21700754,1628411,ORL,LAL,Wes Iwundu,99,20.6333333333333,21,-0.366666666666667,47,44,3,3,0
21700755,101141,ATL,CHA,Ersan Ilyasova,113,24.4333333333333,25,-0.566666666666666,59,72,-13,-17,4
21700755,201158,ATL,CHA,Marco Belinelli,104,24.5666666666667,25,-0.43333333333333,52,63,-11,-11,0
21700755,202337,ATL,CHA,Luke Babbitt,14,3.48333333333333,4,-0.516666666666667,11,5,6,6,0
21700755,203101,ATL,CHA,Miles Plumlee,40,8.9,9,-0.100000000000001,22,26,-4,-2,-2
21700755,203145,ATL,CHA,Kent Bazemore,126,26.95,28,-1.05,64,77,-13,-15,2
21700755,203471,ATL,CHA,Dennis Schroder,135,29.5166666666667,30,-0.483333333333334,75,85,-10,-10,0
21700755,203473,ATL,CHA,Dewayne Dedmon,95,22.9,23,-0.100000000000001,54,56,-2,-4,2
21700755,203488,ATL,CHA,Mike Muscala,79,17.85,18,-0.149999999999999,44,37,7,10,-3
21700755,1627098,ATL,CHA,Malcolm Delaney,56,13.4666666666667,13,0.466666666666667,24,33,-9,-9,0
21700755,1627752,ATL,CHA,Taurean Prince,113,25.2666666666667,25,0.266666666666666,59,66,-7,-5,-2
21700755,1627819,ATL,CHA,Isaiah Taylor,14,3.48333333333333,4,-0.516666666666667,11,5,6,6,0
21700755,1628381,ATL,CHA,John Collins,93,21.55,21,0.550000000000001,41,55,-14,-13,-1
21700755,1628416,ATL,CHA,Tyler Dorsey,68,16.7166666666667,17,-0.283333333333331,34,35,-1,-1,0
21700755,2730,CHA,ATL,Dwight Howard,140,30.9666666666667,31,-0.0333333333333314,91,76,15,17,-2
21700755,201587,CHA,ATL,Nicolas Batum,163,35.5833333333333,36,-0.416666666666664,104,84,20,20,0
21700755,202689,CHA,ATL,Kemba Walker,172,38.4833333333333,39,-0.516666666666666,106,84,22,24,-2
21700755,202933,CHA,ATL,Julyan Stone,11,2.53333333333333,3,-0.466666666666667,3,9,-6,-6,0
21700755,203077,CHA,ATL,Michael Kidd-Gilchrist,88,19.5666666666667,20,-0.433333333333334,58,43,15,17,-2
21700755,203087,CHA,ATL,Jeremy Lamb,79,19.4833333333333,19,0.483333333333334,44,40,4,2,2
21700755,203487,CHA,ATL,Michael Carter-Williams,59,14.45,15,-0.550000000000001,30,25,5,3,2
21700755,203948,CHA,ATL,Johnny O'Bryant III,70,16.85,17,-0.149999999999999,32,34,-2,-4,2
21700755,1626163,CHA,ATL,Frank Kaminsky,130,29.2666666666667,30,-0.733333333333334,83,74,9,11,-2
21700755,1626203,CHA,ATL,Treveon Graham,116,26.8333333333333,26,0.833333333333332,58,63,-5,-7,2
21700755,1628370,CHA,ATL,Malik Monk,11,2.53333333333333,3,-0.466666666666667,3,9,-6,-6,0
21700755,1628407,CHA,ATL,Dwayne Bacon,11,2.53333333333333,3,-0.466666666666667,3,9,-6,-6,0
21700756,201960,BKN,PHI,DeMarre Carroll,149,35.6666666666667,36,-0.333333333333329,86,88,-2,-6,4
21700756,203092,BKN,PHI,Tyler Zeller,34,7.45,7,0.449999999999999,24,20,4,1,3
21700756,203112,BKN,PHI,Quincy Acy,116,28.3833333333333,29,-0.616666666666667,65,70,-5,-7,2
21700756,203459,BKN,PHI,Allen Crabbe,122,29.2666666666667,29,0.266666666666666,67,76,-9,-6,-3
21700756,203915,BKN,PHI,Spencer Dinwiddie,143,33.9666666666667,34,-0.0333333333333314,86,83,3,2,1
21700756,203917,BKN,PHI,Nik Stauskas,77,17.15,18,-0.850000000000001,42,30,12,15,-3
21700756,203925,BKN,PHI,Joe Harris,80,17.7666666666667,18,-0.233333333333334,47,31,16,17,-1
21700756,1626143,BKN,PHI,Jahlil Okafor,62,14.2833333333333,14,0.283333333333333,35,23,12,10,2
21700756,1626156,BKN,PHI,D'Angelo Russell,75,16.4666666666667,17,-0.533333333333331,41,34,7,7,0
21700756,1627821,BKN,PHI,James Webb III,52,11.2,11,0.199999999999999,25,22,3,9,-6
21700756,1628386,BKN,PHI,Jarrett Allen,110,26.2333333333333,26,0.233333333333334,62,63,-1,-2,1
21700756,101161,PHI,BKN,Amir Johnson,53,11.55,12,-0.449999999999999,20,34,-14,-16,2
21700756,200755,PHI,BKN,JJ Redick,113,26.8833333333333,26,0.883333333333333,69,62,7,10,-3
21700756,202344,PHI,BKN,Trevor Booker,64,14.3666666666667,14,0.366666666666667,27,39,-12,-10,-2
21700756,203496,PHI,BKN,Robert Covington,130,31.3,32,-0.700000000000003,71,82,-11,-10,-1
21700756,203954,PHI,BKN,Joel Embiid,150,35.7666666666667,36,-0.233333333333334,88,81,7,9,-2
21700756,203967,PHI,BKN,Dario Saric,139,32.95,33,-0.0499999999999972,81,76,5,3,2
21700756,204456,PHI,BKN,T.J. McConnell,87,19.7166666666667,20,-0.283333333333331,37,52,-15,-17,2
21700756,1626147,PHI,BKN,Justin Anderson,78,17.3,18,-0.699999999999999,37,41,-4,-2,-2
21700756,1627732,PHI,BKN,Ben Simmons,157,37.2166666666667,38,-0.783333333333331,93,90,3,2,1
21700756,1627789,PHI,BKN,Timothe Luwawu-Cabarrot,49,10.7833333333333,11,-0.216666666666669,17,23,-6,-9,3
21700757,2544,CLE,MIA,LeBron James,186,38.1166666666667,38,0.11666666666666,72,71,1,3,-2
21700757,2548,CLE,MIA,Dwyane Wade,122,26.15,26,0.149999999999999,47,45,2,1,1
21700757,2594,CLE,MIA,Kyle Korver,96,19.5333333333333,19,0.533333333333331,30,34,-4,-3,-1
21700757,2747,CLE,MIA,JR Smith,140,28.7166666666667,29,-0.283333333333331,59,57,2,2,0
21700757,101112,CLE,MIA,Channing Frye,101,20.7666666666667,21,-0.233333333333334,34,40,-6,-7,1
21700757,201145,CLE,MIA,Jeff Green,106,21.7333333333333,22,-0.266666666666666,36,36,0,0,0
21700757,201565,CLE,MIA,Derrick Rose,25,5.51666666666667,5,0.516666666666667,14,10,4,2,2
21700757,202684,CLE,MIA,Tristan Thompson,114,22.7666666666667,23,-0.233333333333334,47,41,6,8,-2
21700757,202738,CLE,MIA,Isaiah Thomas,148,29.4,30,-0.600000000000001,58,56,2,2,0
21700757,203109,CLE,MIA,Jae Crowder,132,26.7166666666667,27,-0.283333333333331,58,55,3,2,1
21700757,201609,MIA,CLE,Goran Dragic,163,33.2666666666667,34,-0.733333333333334,69,62,7,5,2
21700757,201949,MIA,CLE,James Johnson,115,24.2833333333333,24,0.283333333333331,47,49,-2,-4,2
21700757,201961,MIA,CLE,Wayne Ellington,127,26.4333333333333,26,0.433333333333334,50,48,2,-1,3
21700757,202355,MIA,CLE,Hassan Whiteside,116,23.5166666666667,24,-0.483333333333334,47,49,-2,-2,0
21700757,203482,MIA,CLE,Kelly Olynyk,106,21.3,21,0.299999999999997,39,35,4,4,0
21700757,204020,MIA,CLE,Tyler Johnson,149,31.1333333333333,31,0.133333333333333,59,66,-7,-7,0
21700757,1626159,MIA,CLE,Justise Winslow,129,25.3166666666667,25,0.316666666666666,42,50,-8,-5,-3
21700757,1626196,MIA,CLE,Josh Richardson,172,35.4166666666667,35,0.416666666666671,62,62,0,2,-2
21700757,1628389,MIA,CLE,Bam Adebayo,93,18.75,19,-0.25,30,34,-4,-2,-2
21700758,201143,BOS,NYK,Al Horford,111,23.4833333333333,23,0.483333333333334,55,46,9,9,0
21700758,202694,BOS,NYK,Marcus Morris,90,19.2166666666667,19,0.216666666666669,41,37,4,5,-1
21700758,203382,BOS,NYK,Aron Baynes,104,22.7,23,-0.300000000000001,45,34,11,9,2
21700758,1626179,BOS,NYK,Terry Rozier,151,32.6333333333333,33,-0.366666666666667,80,51,29,32,-3
21700758,1627759,BOS,NYK,Jaylen Brown,129,28.0333333333333,28,0.0333333333333314,61,51,10,10,0
21700758,1627824,BOS,NYK,Guerschon Yabusele,21,5.01666666666667,5,0.0166666666666666,2,3,-1,-1,0
21700758,1627846,BOS,NYK,Abdel Nader,119,27.9666666666667,28,-0.0333333333333314,55,33,22,23,-1
21700758,1628369,BOS,NYK,Jayson Tatum,144,30.7833333333333,31,-0.216666666666669,77,49,28,29,-1
21700758,1628400,BOS,NYK,Semi Ojeleye,113,25.8666666666667,26,-0.133333333333333,49,32,17,17,0
21700758,1628443,BOS,NYK,Kadeem Allen,26,6.15,6,0.15,4,6,-2,-2,0
21700758,1628464,BOS,NYK,Daniel Theis,77,17.8166666666667,18,-0.183333333333334,41,23,18,19,-1
21700758,101127,NYK,BOS,Jarrett Jack,96,20.2,20,0.200000000000003,39,48,-9,-9,0
21700758,201563,NYK,BOS,Michael Beasley,53,11.7833333333333,12,-0.216666666666667,19,28,-9,-9,0
21700758,201584,NYK,BOS,Courtney Lee,139,29.05,29,0.0499999999999972,54,68,-14,-15,1
21700758,202498,NYK,BOS,Lance Thomas,79,18.3166666666667,18,0.316666666666666,22,27,-5,-5,0
21700758,202683,NYK,BOS,Enes Kanter,125,26.6666666666667,27,-0.333333333333336,46,65,-19,-19,0
21700758,203124,NYK,BOS,Kyle O'Quinn,40,8.71666666666667,9,-0.283333333333333,16,12,4,3,1
21700758,203501,NYK,BOS,Tim Hardaway Jr.,127,27.4833333333333,27,0.483333333333334,44,70,-26,-26,0
21700758,203504,NYK,BOS,Trey Burke,27,5.3,5,0.300000000000001,8,13,-5,-6,1
21700758,203926,NYK,BOS,Doug McDermott,55,12.6833333333333,13,-0.316666666666666,15,25,-10,-11,1
21700758,204001,NYK,BOS,Kristaps Porzingis,159,35,35,0,53,89,-36,-37,1
21700758,1626195,NYK,BOS,Willy Hernangomez,31,7.55,8,-0.449999999999999,6,6,0,0,0
21700758,1628373,NYK,BOS,Frank Ntilikina,94,22.4333333333333,22,0.43333333333333,26,41,-15,-15,0
21700758,1628422,NYK,BOS,Damyean Dotson,60,14.4833333333333,14,0.483333333333333,17,18,-1,-1,0
21700759,201577,CHI,POR,Robin Lopez,138,28.4,28,0.399999999999999,58,87,-29,-29,0
21700759,202347,CHI,POR,Quincy Pondexter,30,6.65,6,0.65,19,14,5,4,1
21700759,203200,CHI,POR,Justin Holiday,145,30.25,30,0.25,64,89,-25,-25,0
21700759,203897,CHI,POR,Zach LaVine,102,22.6,22,0.600000000000001,42,70,-28,-27,-1
21700759,1626170,CHI,POR,Jerian Grant,110,23.6666666666667,24,-0.333333333333336,49,68,-19,-19,0
21700759,1626171,CHI,POR,Bobby Portis,136,27.9333333333333,28,-0.0666666666666664,64,68,-4,-2,-2
21700759,1626245,CHI,POR,Cristiano Felicio,88,19.5666666666667,20,-0.433333333333334,50,37,13,13,0
21700759,1627756,CHI,POR,Denzel Valentine,117,23.65,24,-0.350000000000001,55,60,-5,-4,-1
21700759,1627835,CHI,POR,Paul Zipser,90,20.0333333333333,20,0.0333333333333314,44,56,-12,-14,2
21700759,1627853,CHI,POR,Ryan Arcidiacono,77,16.8833333333333,17,-0.116666666666667,42,33,9,9,0
21700759,1628021,CHI,POR,David Nwaba,67,13.55,14,-0.449999999999999,34,24,10,10,0
21700759,1628469,CHI,POR,Antonio Blakeney,30,6.65,6,0.65,19,14,5,4,1
21700759,202323,POR,CHI,Evan Turner,106,22.5833333333333,23,-0.416666666666668,68,47,21,19,2
21700759,202329,POR,CHI,Al-Farouq Aminu,99,21.3,21,0.300000000000001,62,40,22,20,2
21700759,202334,POR,CHI,Ed Davis,94,19.35,19,0.350000000000001,47,49,-2,0,-2
21700759,203081,POR,CHI,Damian Lillard,143,29.8166666666667,30,-0.183333333333334,90,67,23,23,0
21700759,203090,POR,CHI,Maurice Harkless,52,11.9666666666667,12,-0.033333333333335,22,33,-11,-11,0
21700759,203468,POR,CHI,CJ McCollum,142,29.2333333333333,29,0.233333333333334,89,60,29,29,0
21700759,203894,POR,CHI,Shabazz Napier,107,22.7333333333333,23,-0.266666666666666,52,47,5,7,-2
21700759,203943,POR,CHI,Noah Vonleh,33,7.31666666666667,7,0.316666666666666,15,19,-4,-4,0
21700759,203994,POR,CHI,Jusuf Nurkic,99,21.3,21,0.300000000000001,62,40,22,20,2
21700759,1626192,POR,CHI,Pat Connaughton,102,21.8666666666667,22,-0.133333333333333,42,52,-10,-10,0
21700759,1627774,POR,CHI,Jake Layman,26,5.7,6,-0.300000000000001,9,18,-9,-9,0
21700759,1628380,POR,CHI,Zach Collins,127,26.6666666666667,27,-0.333333333333332,62,68,-6,-4,-2
21700760,1717,DAL,PHX,Dirk Nowitzki,119,26.5666666666667,27,-0.433333333333334,47,57,-10,-10,0
21700760,2734,DAL,PHX,Devin Harris,116,23.1833333333333,23,0.183333333333334,50,45,5,5,0
21700760,202083,DAL,PHX,Wesley Matthews,167,35.6333333333333,36,-0.366666666666667,68,77,-9,-6,-3
21700760,203084,DAL,PHX,Harrison Barnes,154,32.9333333333333,33,-0.0666666666666629,52,71,-19,-19,0
21700760,203939,DAL,PHX,Dwight Powell,123,27.1,28,-0.899999999999999,55,58,-3,-3,0
21700760,1626257,DAL,PHX,Salah Mejri,19,4.01666666666667,4,0.0166666666666666,8,12,-4,-4,0
21700760,1627812,DAL,PHX,Yogi Ferrell,158,32.3,33,-0.700000000000003,68,69,-1,-1,0
21700760,1627858,DAL,PHX,Kyle Collinsworth,49,9.5,10,-0.5,14,19,-5,-6,1
21700760,1628372,DAL,PHX,Dennis Smith Jr.,151,32.75,33,-0.25,55,72,-17,-19,2
21700760,1628467,DAL,PHX,Maxi Kleber,74,14.2666666666667,14,0.266666666666666,23,30,-7,-7,0
21700760,2199,PHX,DAL,Tyson Chandler,120,27.1833333333333,27,0.183333333333334,53,46,7,7,0
21700760,201162,PHX,DAL,Jared Dudley,98,20.7666666666667,20,0.766666666666666,40,37,3,2,1
21700760,203477,PHX,DAL,Isaiah Canaan,22,4.9,5,-0.0999999999999996,18,11,7,7,0
21700760,203584,PHX,DAL,Troy Daniels,96,19.3666666666667,20,-0.633333333333333,44,39,5,6,-1
21700760,203933,PHX,DAL,T.J. Warren,174,36.7666666666667,37,-0.233333333333334,77,68,9,8,1
21700760,1626164,PHX,DAL,Devin Booker,145,31.7666666666667,32,-0.233333333333334,66,59,7,7,0
21700760,1627733,PHX,DAL,Dragan Bender,100,20.2666666666667,21,-0.733333333333334,52,43,9,8,1
21700760,1627737,PHX,DAL,Marquese Chriss,135,27.1666666666667,28,-0.833333333333336,60,50,10,12,-2
21700760,1627755,PHX,DAL,Tyler Ulis,58,10.9,11,-0.100000000000001,17,18,-1,-1,0
21700760,1627863,PHX,DAL,Danuel House Jr.,52,10.8833333333333,11,-0.116666666666667,25,20,5,6,-1
21700760,1628367,PHX,DAL,Josh Jackson,130,28.2833333333333,28,0.283333333333331,58,49,9,8,1
21700761,201188,MEM,DET,Marc Gasol,153,32.75,33,-0.25,53,75,-22,-19,-3
21700761,203210,MEM,DET,JaMychal Green,95,20.85,20,0.850000000000001,35,52,-17,-18,1
21700761,203463,MEM,DET,Ben McLemore,50,9.93333333333333,10,-0.0666666666666664,26,20,6,6,0
21700761,203516,MEM,DET,James Ennis III,71,14.8666666666667,15,-0.133333333333333,32,39,-7,-13,6
21700761,1626150,MEM,DET,Andrew Harrison,156,34.1833333333333,34,0.183333333333337,73,63,10,16,-6
21700761,1626185,MEM,DET,Jarell Martin,128,27.25,28,-0.75,67,54,13,14,-1
21700761,1627738,MEM,DET,Deyonta Davis,70,15.3166666666667,15,0.316666666666666,51,30,21,16,5
21700761,1627782,MEM,DET,Wayne Selden,141,31.1666666666667,31,0.166666666666664,56,70,-14,-15,1
21700761,1627988,MEM,DET,Myke Henry,97,21.6666666666667,22,-0.333333333333336,49,44,5,6,-1
21700761,1628415,MEM,DET,Dillon Brooks,144,32.0166666666667,32,0.0166666666666657,68,73,-5,-3,-2
21700761,201229,DET,MEM,Anthony Tolliver,98,21.7833333333333,22,-0.216666666666669,40,59,-19,-16,-3
21700761,201933,DET,MEM,Blake Griffin,165,35.5833333333333,35,0.583333333333329,85,59,26,23,3
21700761,202397,DET,MEM,Ish Smith,127,28.3833333333333,29,-0.616666666666667,59,48,11,12,-1
21700761,202779,DET,MEM,Dwight Buycks,90,19.45,19,0.450000000000003,42,52,-10,-9,-1
21700761,203083,DET,MEM,Andre Drummond,138,28.4,28,0.399999999999999,62,61,1,2,-1
21700761,203186,DET,MEM,Willie Reed,22,5.38333333333333,5,0.383333333333333,14,10,4,4,0
21700761,203493,DET,MEM,Reggie Bullock,163,35.2833333333333,35,0.283333333333331,75,64,11,10,1
21700761,203961,DET,MEM,Eric Moreland,21,4.91666666666667,5,-0.0833333333333339,8,17,-9,-8,-1
21700761,204038,DET,MEM,Langston Galloway,18,3.55,4,-0.45,5,18,-13,-11,-2
21700761,1626169,DET,MEM,Stanley Johnson,166,36.65,36,0.650000000000006,87,65,22,16,6
21700761,1628379,DET,MEM,Luke Kennard,97,20.6166666666667,21,-0.383333333333333,43,57,-14,-13,-1
21700762,200768,TOR,WAS,Kyle Lowry,172,35.2333333333333,35,0.233333333333334,93,89,4,3,1
21700762,201586,TOR,WAS,Serge Ibaka,172,35.2333333333333,35,0.233333333333334,93,89,4,3,1
21700762,201942,TOR,WAS,DeMar DeRozan,188,38.3,38,0.299999999999997,99,98,1,2,-1
21700762,202685,TOR,WAS,Jonas Valanciunas,143,29.1333333333333,29,0.133333333333333,77,75,2,4,-2
21700762,203485,TOR,WAS,Lorenzo Brown,48,10.7833333333333,11,-0.216666666666667,21,28,-7,-9,2
21700762,203512,TOR,WAS,Lucas Nogueira,13,3.05,3,0.0499999999999998,8,7,1,1,0
21700762,1626153,TOR,WAS,Delon Wright,59,12.7333333333333,13,-0.266666666666666,25,33,-8,-6,-2
21700762,1626181,TOR,WAS,Norman Powell,125,25.9166666666667,26,-0.0833333333333357,65,65,0,0,0
21700762,1627751,TOR,WAS,Jakob Poeltl,72,15.7666666666667,16,-0.233333333333334,33,40,-7,-7,0
21700762,1627783,TOR,WAS,Pascal Siakam,62,12.75,13,-0.25,25,33,-8,-7,-1
21700762,1628384,TOR,WAS,OG Anunoby,101,20.9333333333333,21,-0.0666666666666664,51,53,-2,1,-3
21700762,101133,WAS,TOR,Ian Mahinmi,90,19.45,19,0.449999999999999,53,49,4,4,0
21700762,101162,WAS,TOR,Marcin Gortat,127,25.8666666666667,26,-0.133333333333333,61,61,0,0,0
21700762,201975,WAS,TOR,Jodie Meeks,42,9.03333333333333,9,0.0333333333333332,24,19,5,5,0
21700762,202693,WAS,TOR,Markieff Morris,156,32.0833333333333,32,0.0833333333333286,81,77,4,0,4
21700762,203078,WAS,TOR,Bradley Beal,186,38.3,38,0.299999999999997,95,99,-4,-5,1
21700762,203107,WAS,TOR,Tomas Satoransky,133,27.2166666666667,28,-0.783333333333331,65,68,-3,-1,-2
21700762,203118,WAS,TOR,Mike Scott,87,18.45,19,-0.550000000000001,49,47,2,5,-3
21700762,203490,WAS,TOR,Otto Porter Jr.,144,29.4,29,0.399999999999999,72,69,3,1,2
21700762,204025,WAS,TOR,Tim Frazier,80,16.9,17,-0.100000000000001,49,42,7,4,3
21700762,1626162,WAS,TOR,Kelly Oubre Jr.,110,23.1333333333333,23,0.133333333333333,61,59,2,2,0
21700763,203089,MIL,MIN,John Henson,142,31.5666666666667,32,-0.433333333333334,60,67,-7,-8,1
21700763,203114,MIL,MIN,Khris Middleton,159,35.3333333333333,35,0.333333333333329,69,83,-14,-14,0
21700763,203503,MIL,MIN,Tony Snell,132,28.6833333333333,29,-0.316666666666666,54,61,-7,-9,2
21700763,203507,MIL,MIN,Giannis Antetokounmpo,154,35.5666666666667,36,-0.433333333333337,64,69,-5,-5,0
21700763,203521,MIL,MIN,Matthew Dellavedova,106,25.15,25,0.149999999999999,41,54,-13,-13,0
21700763,203930,MIL,MIN,Sean Kilpatrick,87,17.9833333333333,18,-0.0166666666666657,36,50,-14,-12,-2
21700763,204098,MIL,MIN,Xavier Munford,39,7.16666666666667,7,0.166666666666666,18,19,-1,-1,0
21700763,1626173,MIL,MIN,Rashad Vaughn,23,3.81666666666667,4,-0.183333333333333,11,9,2,2,0
21700763,1627748,MIL,MIN,Thon Maker,53,12.5166666666667,13,-0.483333333333334,18,32,-14,-13,-1
21700763,1627763,MIL,MIN,Malcolm Brogdon,41,9.41666666666667,10,-0.583333333333332,18,20,-2,-2,0
21700763,1627850,MIL,MIN,Marshall Plumlee,28,4.75,5,-0.25,11,13,-2,-2,0
21700763,1628391,MIL,MIN,D.J. Wilson,23,3.81666666666667,4,-0.183333333333333,11,9,2,2,0
21700763,1628425,MIL,MIN,Sterling Brown,103,23.7333333333333,24,-0.266666666666666,34,54,-20,-20,0
21700763,2037,MIN,MIL,Jamal Crawford,78,16.8666666666667,17,-0.133333333333333,49,31,18,18,0
21700763,201166,MIN,MIL,Aaron Brooks,16,2.58333333333333,3,-0.416666666666667,4,9,-5,-5,0
21700763,201952,MIN,MIL,Jeff Teague,131,28.0833333333333,28,0.0833333333333357,64,49,15,18,-3
21700763,201959,MIN,MIL,Taj Gibson,150,33.0833333333333,33,0.0833333333333286,72,59,13,11,2
21700763,202332,MIN,MIL,Cole Aldrich,16,2.58333333333333,3,-0.416666666666667,4,9,-5,-5,0
21700763,202357,MIN,MIL,Nemanja Bjelica,62,13.9166666666667,14,-0.0833333333333322,36,24,12,16,-4
21700763,202710,MIN,MIL,Jimmy Butler,175,39.3833333333333,40,-0.616666666666667,86,70,16,18,-2
21700763,203476,MIN,MIL,Gorgui Dieng,62,13.35,13,0.350000000000001,26,27,-1,-5,4
21700763,203498,MIN,MIL,Shabazz Muhammad,21,3.16666666666667,3,0.166666666666667,7,11,-4,-5,1
21700763,203952,MIN,MIL,Andrew Wiggins,131,30.3833333333333,30,0.383333333333333,61,49,12,11,1
21700763,1626145,MIN,MIL,Tyus Jones,71,17.2333333333333,17,0.233333333333334,40,31,9,6,3
21700763,1626157,MIN,MIL,Karl-Anthony Towns,146,32.8666666666667,33,-0.133333333333333,78,59,19,21,-2
21700763,1627875,MIN,MIL,Marcus Georges-Hunt,31,6,6,0,13,17,-4,-4,0
21700764,2403,HOU,SAS,Nene,57,12.4,13,-0.600000000000001,24,25,-1,1,-2
21700764,101108,HOU,SAS,Chris Paul,139,30.2666666666667,30,0.266666666666666,59,63,-4,-6,2
21700764,101123,HOU,SAS,Gerald Green,129,29.9,30,-0.100000000000001,58,50,8,8,0
21700764,200782,HOU,SAS,PJ Tucker,138,30.55,31,-0.449999999999999,68,59,9,9,0
21700764,201583,HOU,SAS,Ryan Anderson,125,28.75,29,-0.25,67,54,13,17,-4
21700764,201601,HOU,SAS,Luc Mbah a Moute,153,34.6166666666667,35,-0.383333333333333,67,67,0,-2,2
21700764,201935,HOU,SAS,James Harden,164,36.45,37,-0.549999999999997,89,71,18,18,0
21700764,203991,HOU,SAS,Clint Capela,155,35.2333333333333,35,0.233333333333334,78,66,12,10,2
21700764,1938,SAS,HOU,Manu Ginobili,89,20.2166666666667,20,0.216666666666669,36,42,-6,-8,2
21700764,2200,SAS,HOU,Pau Gasol,88,19.95,20,-0.0500000000000007,35,37,-2,-4,2
21700764,2225,SAS,HOU,Tony Parker,74,17.3166666666667,17,0.316666666666666,31,30,1,1,0
21700764,200746,SAS,HOU,LaMarcus Aldridge,148,33.9166666666667,34,-0.0833333333333286,62,80,-18,-16,-2
21700764,201980,SAS,HOU,Danny Green,125,28.2,28,0.199999999999999,52,66,-14,-10,-4
21700764,201988,SAS,HOU,Patty Mills,109,23.3666666666667,24,-0.633333333333333,47,52,-5,-7,2
21700764,202722,SAS,HOU,Davis Bertans,54,13,13,0,20,26,-6,-4,-2
21700764,203464,SAS,HOU,Brandon Paul,7,1.23333333333333,2,-0.766666666666667,6,3,3,3,0
21700764,203530,SAS,HOU,Joffrey Lauvergne,7,1.23333333333333,2,-0.766666666666667,6,3,3,3,0
21700764,203937,SAS,HOU,Kyle Anderson,129,29.8333333333333,30,-0.166666666666664,57,66,-9,-9,0
21700764,1626199,SAS,HOU,Darrun Hilliard,36,8.11666666666667,8,0.116666666666667,22,11,11,9,2
21700764,1627749,SAS,HOU,Dejounte Murray,111,23.9833333333333,24,-0.0166666666666657,47,58,-11,-11,0
21700764,1627854,SAS,HOU,Bryn Forbes,83,17.8,18,-0.199999999999999,34,36,-2,-2,0
21700765,201163,DEN,OKC,Wilson Chandler,163,34.1333333333333,34,0.133333333333333,98,97,1,3,-2
21700765,201589,DEN,OKC,Darrell Arthur,6,1.01666666666667,1,0.0166666666666666,2,2,0,0,0
21700765,202702,DEN,OKC,Kenneth Faried,50,9.48333333333333,10,-0.516666666666666,18,17,1,1,0
21700765,203115,DEN,OKC,Will Barton,176,35.3666666666667,36,-0.63333333333334,95,89,6,9,-3
21700765,203914,DEN,OKC,Gary Harris,180,38.0166666666667,38,0.0166666666666657,106,107,-1,-1,0
21700765,203999,DEN,OKC,Nikola Jokic,173,37.1,37,0.0999999999999943,105,100,5,5,0
21700765,1626144,DEN,OKC,Emmanuel Mudiay,70,13.8666666666667,14,-0.133333333333333,29,27,2,0,2
21700765,1626168,DEN,OKC,Trey Lyles,76,14.8833333333333,15,-0.116666666666667,31,29,2,0,2
21700765,1627750,DEN,OKC,Jamal Murray,163,34.1333333333333,34,0.133333333333333,98,97,1,3,-2
21700765,1628470,DEN,OKC,Torrey Craig,108,22,22,0,53,55,-2,-5,3
21700765,2546,OKC,DEN,Carmelo Anthony,159,33.55,34,-0.450000000000003,97,98,-1,-3,2
21700765,101109,OKC,DEN,Raymond Felton,71,14.25,14,0.25,29,28,1,3,-2
21700765,201566,OKC,DEN,Russell Westbrook,192,39.3,39,0.299999999999997,107,115,-8,-8,0
21700765,202331,OKC,DEN,Paul George,173,36.4666666666667,36,0.466666666666669,105,107,-2,-2,0
21700765,202335,OKC,DEN,Patrick Patterson,77,15.25,15,0.25,29,32,-3,-1,-2
21700765,203500,OKC,DEN,Steven Adams,156,31.6833333333333,32,-0.316666666666663,80,92,-12,-12,0
21700765,203518,OKC,DEN,Alex Abrines,135,28.4666666666667,29,-0.533333333333335,66,65,1,-1,2
21700765,203924,OKC,DEN,Jerami Grant,121,25.0166666666667,25,0.0166666666666657,76,60,16,16,0
21700765,203962,OKC,DEN,Josh Huestis,62,11.85,12,-0.149999999999999,19,23,-4,-4,0
21700765,1628390,OKC,DEN,Terrance Ferguson,19,4.16666666666667,4,0.166666666666667,12,15,-3,-3,0
21700766,2744,IND,CHA,Al Jefferson,6,1.15,1,0.15,0,2,-2,0,-2
21700766,201152,IND,CHA,Thaddeus Young,132,29.1833333333333,29,0.183333333333334,76,75,1,-2,3
21700766,201954,IND,CHA,Darren Collison,141,29.8,30,-0.200000000000003,77,81,-4,-4,0
21700766,202362,IND,CHA,Lance Stephenson,117,23.25,23,0.25,60,68,-8,-6,-2
21700766,202709,IND,CHA,Cory Joseph,126,25.7333333333333,26,-0.266666666666666,74,79,-5,-5,0
21700766,202711,IND,CHA,Bojan Bogdanovic,158,32.8,33,-0.200000000000003,79,83,-4,-4,0
21700766,203506,IND,CHA,Victor Oladipo,184,37.3166666666667,37,0.316666666666663,104,104,0,0,0
21700766,1626167,IND,CHA,Myles Turner,153,31.8333333333333,32,-0.166666666666664,85,85,0,1,-1
21700766,1626202,IND,CHA,Joe Young,17,3.75,4,-0.25,8,8,0,0,0
21700766,1627734,IND,CHA,Domantas Sabonis,76,16.2166666666667,17,-0.783333333333335,45,48,-3,-8,5
21700766,1628388,IND,CHA,TJ Leaf,40,8.46666666666667,8,0.466666666666667,22,32,-10,-7,-3
21700766,2730,CHA,IND,Dwight Howard,152,31.6,32,-0.399999999999999,80,87,-7,-4,-3
21700766,201587,CHA,IND,Nicolas Batum,174,34.9666666666667,35,-0.0333333333333314,97,96,1,1,0
21700766,202689,CHA,IND,Kemba Walker,202,41.9166666666667,42,-0.0833333333333357,115,107,8,8,0
21700766,203077,CHA,IND,Michael Kidd-Gilchrist,108,23.4833333333333,24,-0.516666666666666,63,59,4,0,4
21700766,203087,CHA,IND,Jeremy Lamb,106,21.8,22,-0.200000000000003,60,61,-1,3,-4
21700766,203469,CHA,IND,Cody Zeller,75,16.1,16,0.100000000000001,51,37,14,11,3
21700766,203487,CHA,IND,Michael Carter-Williams,120,24.8166666666667,25,-0.183333333333334,71,65,6,4,2
21700766,1626163,CHA,IND,Frank Kaminsky,136,29.9166666666667,30,-0.0833333333333357,79,74,5,10,-5
21700766,1626203,CHA,IND,Treveon Graham,77,14.9,15,-0.100000000000001,49,44,5,2,3
21700767,101141,ATL,BOS,Ersan Ilyasova,120,25.25,25,0.25,59,63,-4,-7,3
21700767,201158,ATL,BOS,Marco Belinelli,103,21.5666666666667,22,-0.433333333333334,51,59,-8,-8,0
21700767,202337,ATL,BOS,Luke Babbitt,10,2.16666666666667,2,0.166666666666667,6,2,4,6,-2
21700767,203101,ATL,BOS,Miles Plumlee,42,9.28333333333333,10,-0.716666666666667,12,26,-14,-15,1
21700767,203145,ATL,BOS,Kent Bazemore,109,24.4333333333333,25,-0.566666666666666,50,60,-10,-13,3
21700767,203471,ATL,BOS,Dennis Schroder,141,29.8833333333333,30,-0.116666666666667,62,74,-12,-13,1
21700767,203473,ATL,BOS,Dewayne Dedmon,100,20.7333333333333,21,-0.266666666666666,55,52,3,5,-2
21700767,203488,ATL,BOS,Mike Muscala,73,15.8833333333333,16,-0.116666666666667,36,33,3,2,1
21700767,1627098,ATL,BOS,Malcolm Delaney,43,9.35,9,0.35,21,22,-1,-5,4
21700767,1627752,ATL,BOS,Taurean Prince,146,30.45,31,-0.550000000000001,66,83,-17,-17,0
21700767,1627819,ATL,BOS,Isaiah Taylor,47,9.55,10,-0.449999999999999,31,19,12,13,-1
21700767,1628381,ATL,BOS,John Collins,111,24.3833333333333,25,-0.616666666666667,58,64,-6,-3,-3
21700767,1628416,ATL,BOS,Tyler Dorsey,70,15.9,16,-0.100000000000001,43,38,5,10,-5
21700767,201143,BOS,ATL,Al Horford,135,29.2666666666667,29,0.266666666666666,69,69,0,-1,1
21700767,203382,BOS,ATL,Aron Baynes,107,23.4833333333333,24,-0.516666666666666,69,41,28,26,2
21700767,1626179,BOS,ATL,Terry Rozier,166,35.5,36,-0.5,101,71,30,31,-1
21700767,1627759,BOS,ATL,Jaylen Brown,158,33.55,33,0.549999999999997,86,80,6,3,3
21700767,1627824,BOS,ATL,Guerschon Yabusele,9,1.91666666666667,2,-0.0833333333333333,0,6,-6,-4,-2
21700767,1627846,BOS,ATL,Abdel Nader,121,26.5166666666667,27,-0.483333333333334,55,69,-14,-12,-2
21700767,1628369,BOS,ATL,Jayson Tatum,148,31.4333333333333,32,-0.56666666666667,91,63,28,27,1
21700767,1628400,BOS,ATL,Semi Ojeleye,125,26.75,27,-0.25,63,65,-2,-1,-1
21700767,1628443,BOS,ATL,Kadeem Allen,37,7.81666666666667,8,-0.183333333333334,13,23,-10,-9,-1
21700767,1628464,BOS,ATL,Daniel Theis,109,22.6,23,-0.399999999999999,48,63,-15,-15,0
21700768,201147,LAL,BKN,Corey Brewer,65,12.6833333333333,13,-0.316666666666666,27,22,5,5,0
21700768,201572,LAL,BKN,Brook Lopez,120,27.6,28,-0.399999999999999,57,53,4,5,-1
21700768,203484,LAL,BKN,Kentavious Caldwell-Pope,104,22.6833333333333,23,-0.316666666666666,51,56,-5,-4,-1
21700768,203903,LAL,BKN,Jordan Clarkson,124,25.9,26,-0.100000000000001,50,45,5,5,0
21700768,203944,LAL,BKN,Julius Randle,146,32.2666666666667,32,0.266666666666666,68,68,0,0,0
21700768,1626204,LAL,BKN,Larry Nance Jr.,79,15.7166666666667,16,-0.283333333333333,33,31,2,3,-1
21700768,1627742,LAL,BKN,Brandon Ingram,170,36.9666666666667,37,-0.0333333333333314,82,82,0,1,-1
21700768,1627936,LAL,BKN,Alex Caruso,55,11.0166666666667,11,0.0166666666666675,19,17,2,2,0
21700768,1628398,LAL,BKN,Kyle Kuzma,104,20.2666666666667,20,0.266666666666666,44,46,-2,-2,0
21700768,1628404,LAL,BKN,Josh Hart,158,34.8166666666667,35,-0.183333333333337,74,75,-1,0,-1
21700768,201960,BKN,LAL,DeMarre Carroll,159,35.0166666666667,35,0.0166666666666657,69,71,-2,-3,1
21700768,203112,BKN,LAL,Quincy Acy,114,24.9166666666667,25,-0.0833333333333357,58,57,1,0,1
21700768,203459,BKN,LAL,Allen Crabbe,137,30.1166666666667,30,0.116666666666667,64,55,9,10,-1
21700768,203915,BKN,LAL,Spencer Dinwiddie,144,31.95,32,-0.0500000000000007,66,63,3,3,0
21700768,203925,BKN,LAL,Joe Harris,125,24.6333333333333,25,-0.366666666666667,51,65,-14,-13,-1
21700768,1626143,BKN,LAL,Jahlil Okafor,72,15.0166666666667,15,0.0166666666666657,33,36,-3,-4,1
21700768,1626156,BKN,LAL,D'Angelo Russell,114,23.75,24,-0.25,47,45,2,1,1
21700768,1627747,BKN,LAL,Caris LeVert,88,17.8666666666667,18,-0.133333333333333,35,46,-11,-13,2
21700768,1627821,BKN,LAL,James Webb III,63,12.3333333333333,12,0.333333333333332,28,30,-2,-2,0
21700768,1628386,BKN,LAL,Jarrett Allen,109,24.3166666666667,24,0.316666666666666,44,37,7,6,1
21700769,202323,POR,TOR,Evan Turner,105,22.8166666666667,23,-0.183333333333334,45,64,-19,-23,4
21700769,202329,POR,TOR,Al-Farouq Aminu,138,29.9,30,-0.100000000000001,73,84,-11,-9,-2
21700769,202334,POR,TOR,Ed Davis,55,12.8,12,0.800000000000001,18,40,-22,-22,0
21700769,203081,POR,TOR,Damian Lillard,166,36.5333333333333,37,-0.466666666666669,84,101,-17,-17,0
21700769,203086,POR,TOR,Meyers Leonard,34,7.6,8,-0.4,16,15,1,1,0
21700769,203090,POR,TOR,Maurice Harkless,31,6.81666666666667,7,-0.183333333333334,14,13,1,1,0
21700769,203468,POR,TOR,CJ McCollum,150,33.6166666666667,34,-0.383333333333333,78,92,-14,-10,-4
21700769,203894,POR,TOR,Shabazz Napier,92,21.5166666666667,21,0.516666666666666,49,65,-16,-14,-2
21700769,203943,POR,TOR,Noah Vonleh,46,10.6666666666667,10,0.666666666666668,23,24,-1,-1,0
21700769,203994,POR,TOR,Jusuf Nurkic,112,24.7,25,-0.300000000000001,63,65,-2,0,-2
21700769,1626192,POR,TOR,Pat Connaughton,73,15.8833333333333,15,0.883333333333333,31,42,-11,-13,2
21700769,1627774,POR,TOR,Jake Layman,31,6.81666666666667,7,-0.183333333333334,14,13,1,1,0
21700769,1628380,POR,TOR,Zach Collins,47,10.3333333333333,10,0.333333333333332,17,32,-15,-19,4
21700769,200768,TOR,POR,Kyle Lowry,120,25.6333333333333,26,-0.366666666666667,67,60,7,5,2
21700769,201586,TOR,POR,Serge Ibaka,106,22.5666666666667,23,-0.433333333333334,60,52,8,9,-1
21700769,201942,TOR,POR,DeMar DeRozan,142,30.3333333333333,30,0.333333333333332,87,64,23,24,-1
21700769,202685,TOR,POR,Jonas Valanciunas,113,24.0333333333333,24,0.0333333333333314,65,56,9,11,-2
21700769,203512,TOR,POR,Lucas Nogueira,20,4.13333333333333,4,0.133333333333333,8,9,-1,-1,0
21700769,1626153,TOR,POR,Delon Wright,96,22.3666666666667,22,0.366666666666667,63,45,18,20,-2
21700769,1626181,TOR,POR,Norman Powell,83,19.2333333333333,19,0.233333333333334,46,48,-2,-2,0
21700769,1627751,TOR,POR,Jakob Poeltl,83,19.8333333333333,20,-0.166666666666664,57,40,17,15,2
21700769,1627783,TOR,POR,Pascal Siakam,83,19.5166666666667,19,0.516666666666666,60,40,20,19,1
21700769,1627832,TOR,POR,Fred VanVleet,90,21.6166666666667,21,0.616666666666667,61,47,14,11,3
21700769,1628035,TOR,POR,Alfonzo McKinnie,20,4.13333333333333,4,0.133333333333333,8,9,-1,-1,0
21700769,1628384,TOR,POR,OG Anunoby,124,26.6,27,-0.399999999999999,68,55,13,15,-2
21700770,201609,MIA,PHI,Goran Dragic,103,22.5666666666667,23,-0.433333333333334,32,54,-22,-22,0
21700770,201949,MIA,PHI,James Johnson,104,22.4,23,-0.600000000000001,34,53,-19,-17,-2
21700770,201961,MIA,PHI,Wayne Ellington,139,30.8666666666667,31,-0.133333333333333,70,61,9,9,0
21700770,202355,MIA,PHI,Hassan Whiteside,86,18.4333333333333,18,0.433333333333334,27,43,-16,-16,0
21700770,203482,MIA,PHI,Kelly Olynyk,113,25.4,25,0.399999999999999,63,50,13,11,2
21700770,204020,MIA,PHI,Tyler Johnson,158,33.85,34,-0.150000000000006,72,73,-1,0,-1
21700770,1626159,MIA,PHI,Justise Winslow,126,28.0666666666667,28,0.0666666666666664,66,55,11,9,2
21700770,1626196,MIA,PHI,Josh Richardson,136,29.3,29,0.299999999999997,54,68,-14,-13,-1
21700770,1628389,MIA,PHI,Bam Adebayo,125,29.0333333333333,29,0.0333333333333314,67,58,9,9,0
21700770,101161,PHI,MIA,Amir Johnson,71,16.2833333333333,16,0.283333333333331,32,34,-2,-4,2
21700770,200755,PHI,MIA,JJ Redick,133,28.5333333333333,29,-0.466666666666669,70,62,8,12,-4
21700770,201573,PHI,MIA,Jerryd Bayless,54,12.6,12,0.600000000000001,23,27,-4,-6,2
21700770,202344,PHI,MIA,Trevor Booker,62,14.55,14,0.550000000000001,32,28,4,2,2
21700770,203496,PHI,MIA,Robert Covington,157,34.4833333333333,35,-0.516666666666666,67,68,-1,-1,0
21700770,203954,PHI,MIA,Joel Embiid,140,31.1833333333333,31,0.183333333333334,69,60,9,11,-2
21700770,203967,PHI,MIA,Dario Saric,149,32.9166666666667,33,-0.0833333333333286,69,66,3,5,-2
21700770,204456,PHI,MIA,T.J. McConnell,103,22.7833333333333,23,-0.216666666666669,47,45,2,-2,4
21700770,1626147,PHI,MIA,Justin Anderson,56,11.3833333333333,12,-0.616666666666667,27,25,2,2,0
21700770,1627732,PHI,MIA,Ben Simmons,165,35.2,35,0.200000000000003,79,70,9,11,-2
21700771,202339,MIL,NYK,Eric Bledsoe,97,20.0166666666667,21,-0.983333333333334,39,45,-6,-10,4
21700771,203089,MIL,NYK,John Henson,127,28.3166666666667,28,0.316666666666666,52,52,0,-2,2
21700771,203114,MIL,NYK,Khris Middleton,162,36.15,36,0.150000000000006,64,67,-3,-3,0
21700771,203503,MIL,NYK,Tony Snell,160,35.2666666666667,35,0.266666666666666,65,64,1,1,0
21700771,203507,MIL,NYK,Giannis Antetokounmpo,173,37.35,37,0.349999999999994,72,67,5,3,2
21700771,203521,MIL,NYK,Matthew Dellavedova,124,27.9833333333333,27,0.983333333333334,53,45,8,12,-4
21700771,203930,MIL,NYK,Sean Kilpatrick,29,5.61666666666667,6,-0.383333333333333,16,14,2,2,0
21700771,203953,MIL,NYK,Jabari Parker,69,15.0333333333333,15,0.0333333333333332,23,29,-6,-4,-2
21700771,1627748,MIL,NYK,Thon Maker,80,16.6666666666667,17,-0.333333333333332,39,34,5,7,-2
21700771,1628425,MIL,NYK,Sterling Brown,84,17.6,17,0.600000000000001,37,33,4,4,0
21700771,101127,NYK,MIL,Jarrett Jack,145,31.4,32,-0.600000000000001,60,58,2,2,0
21700771,201563,NYK,MIL,Michael Beasley,64,13.4666666666667,13,0.466666666666667,25,29,-4,-4,0
21700771,201584,NYK,MIL,Courtney Lee,175,38.4,38,0.400000000000006,75,70,5,5,0
21700771,202498,NYK,MIL,Lance Thomas,83,18.4833333333333,19,-0.516666666666666,29,34,-5,-5,0
21700771,202683,NYK,MIL,Enes Kanter,145,31.6666666666667,32,-0.333333333333332,62,56,6,6,0
21700771,203124,NYK,MIL,Kyle O'Quinn,60,12.4,13,-0.6,21,33,-12,-12,0
21700771,203501,NYK,MIL,Tim Hardaway Jr.,157,34.0833333333333,34,0.0833333333333286,67,57,10,8,2
21700771,203926,NYK,MIL,Doug McDermott,37,7.63333333333333,8,-0.366666666666667,14,23,-9,-7,-2
21700771,204001,NYK,MIL,Kristaps Porzingis,160,35.1833333333333,35,0.183333333333337,65,65,0,0,0
21700771,1628373,NYK,MIL,Frank Ntilikina,79,17.2833333333333,17,0.283333333333331,32,35,-3,-3,0
21700772,200765,NOP,OKC,Rajon Rondo,178,33.95,34,-0.0499999999999972,82,71,11,10,1
21700772,201950,NOP,OKC,Jrue Holiday,181,35.8166666666667,36,-0.183333333333337,90,60,30,32,-2
21700772,201967,NOP,OKC,Dante Cunningham,185,34.9333333333333,35,-0.06666666666667,88,74,14,14,0
21700772,202734,NOP,OKC,E'Twaun Moore,161,31.5666666666667,32,-0.433333333333337,82,59,23,22,1
21700772,203076,NOP,OKC,Anthony Davis,192,37.5333333333333,38,-0.466666666666669,90,77,13,12,1
21700772,203121,NOP,OKC,Darius Miller,123,25.7333333333333,26,-0.266666666666666,56,69,-13,-14,1
21700772,203546,NOP,OKC,Ian Clark,91,19.05,19,0.0499999999999972,37,49,-12,-9,-3
21700772,1627767,NOP,OKC,Cheick Diallo,72,15.6666666666667,16,-0.333333333333332,34,33,1,2,-1
21700772,1628455,NOP,OKC,Mike James,22,4.5,4,0.5,11,8,3,1,2
21700772,2546,OKC,NOP,Carmelo Anthony,171,32.5166666666667,33,-0.483333333333334,70,79,-9,-9,0
21700772,101109,OKC,NOP,Raymond Felton,69,15.4833333333333,16,-0.516666666666666,29,36,-7,-8,1
21700772,201566,OKC,NOP,Russell Westbrook,189,35.9166666666667,36,-0.0833333333333286,76,86,-10,-9,-1
21700772,202331,OKC,NOP,Paul George,198,37.4833333333333,38,-0.516666666666666,81,92,-11,-11,0
21700772,202335,OKC,NOP,Patrick Patterson,60,13.25,13,0.25,25,30,-5,-5,0
21700772,203500,OKC,NOP,Steven Adams,192,36.6833333333333,37,-0.316666666666663,80,85,-5,-5,0
21700772,203518,OKC,NOP,Alex Abrines,112,23.8166666666667,24,-0.183333333333334,57,54,3,5,-2
21700772,203924,OKC,NOP,Jerami Grant,115,23,23,0,42,59,-17,-19,2
21700772,203962,OKC,NOP,Josh Huestis,42,10,10,0,19,21,-2,-2,0
21700772,1628390,OKC,NOP,Terrance Ferguson,57,10.6,11,-0.4,21,28,-7,-7,0
21700773,2199,PHX,UTA,Tyson Chandler,84,17.6666666666667,18,-0.333333333333332,28,56,-28,-28,0
21700773,201162,PHX,UTA,Jared Dudley,115,25.0166666666667,25,0.0166666666666657,52,65,-13,-13,0
21700773,203584,PHX,UTA,Troy Daniels,87,19.2666666666667,19,0.266666666666666,32,50,-18,-18,0
21700773,203933,PHX,UTA,T.J. Warren,122,25.25,25,0.25,43,91,-48,-48,0
21700773,1626164,PHX,UTA,Devin Booker,153,32.2166666666667,32,0.216666666666669,65,95,-30,-30,0
21700773,1627733,PHX,UTA,Dragan Bender,130,28.1666666666667,28,0.166666666666668,62,71,-9,-11,2
21700773,1627737,PHX,UTA,Marquese Chriss,65,13.8666666666667,14,-0.133333333333333,20,40,-20,-20,0
21700773,1627755,PHX,UTA,Tyler Ulis,89,20.2666666666667,20,0.266666666666666,44,35,9,9,0
21700773,1627863,PHX,UTA,Danuel House Jr.,38,8.58333333333333,8,0.583333333333334,22,13,9,11,-2
21700773,1627982,PHX,UTA,Josh Gray,42,8.65,9,-0.350000000000001,20,24,-4,-4,0
21700773,1628367,PHX,UTA,Josh Jackson,140,29.0666666666667,29,0.0666666666666664,65,79,-14,-14,0
21700773,1628409,PHX,UTA,Alec Peters,30,5.93333333333333,6,-0.0666666666666664,18,15,3,3,0
21700773,1628432,PHX,UTA,Davon Reed,25,4.88333333333333,5,-0.116666666666667,14,11,3,3,0
21700773,2207,UTA,PHX,Joe Johnson,99,22.05,22,0.0500000000000007,48,49,-1,0,-1
21700773,201937,UTA,PHX,Ricky Rubio,122,26.15,26,0.149999999999999,79,40,39,39,0
21700773,201973,UTA,PHX,Jonas Jerebko,48,10.2166666666667,11,-0.783333333333335,26,27,-1,-1,0
21700773,202324,UTA,PHX,Derrick Favors,117,24.3833333333333,24,0.383333333333333,73,46,27,26,1
21700773,202327,UTA,PHX,Ekpe Udoh,34,6.9,7,-0.100000000000001,17,20,-3,-1,-2
21700773,202692,UTA,PHX,Alec Burks,98,21.1166666666667,21,0.116666666666667,51,55,-4,-2,-2
21700773,203497,UTA,PHX,Rudy Gobert,150,31.9833333333333,32,-0.0166666666666657,94,52,42,40,2
21700773,203526,UTA,PHX,Raul Neto,47,10.0333333333333,10,0.0333333333333332,23,28,-5,-5,0
21700773,204060,UTA,PHX,Joe Ingles,130,26.45,27,-0.550000000000001,82,51,31,33,-2
21700773,1626220,UTA,PHX,Royce O'Neale,120,26.8333333333333,27,-0.166666666666664,58,61,-3,-5,2
21700773,1628378,UTA,PHX,Donovan Mitchell,155,32.7166666666667,33,-0.283333333333331,94,56,38,36,2
21700774,2585,GSW,SAC,Zaza Pachulia,107,21.5666666666667,22,-0.433333333333334,54,51,3,3,0
21700774,201142,GSW,SAC,Kevin Durant,175,36.65,37,-0.350000000000001,91,87,4,4,0
21700774,201156,GSW,SAC,Nick Young,78,15.85,16,-0.149999999999999,48,33,15,15,0
21700774,201580,GSW,SAC,JaVale McGee,46,10.7166666666667,11,-0.283333333333335,19,17,2,2,0
21700774,201939,GSW,SAC,Stephen Curry,174,35.95,36,-0.0499999999999972,92,78,14,14,0
21700774,201956,GSW,SAC,Omri Casspi,48,9.86666666666667,10,-0.133333333333333,19,19,0,0,0
21700774,202691,GSW,SAC,Klay Thompson,169,35.6166666666667,35,0.61666666666666,95,78,17,15,2
21700774,203110,GSW,SAC,Draymond Green,160,33.9833333333333,34,-0.0166666666666657,86,79,7,7,0
21700774,1626172,GSW,SAC,Kevon Looney,47,9.5,10,-0.5,24,18,6,6,0
21700774,1626188,GSW,SAC,Quinn Cook,5,1.15,1,0.15,2,2,0,0,0
21700774,1627745,GSW,SAC,Damian Jones,5,1.15,1,0.15,2,2,0,0,0
21700774,1627775,GSW,SAC,Patrick McCaw,131,26.5833333333333,28,-1.41666666666667,63,56,7,9,-2
21700774,1713,SAC,GSW,Vince Carter,94,19.6333333333333,20,-0.366666666666667,38,41,-3,-3,0
21700774,2216,SAC,GSW,Zach Randolph,136,28.65,28,0.649999999999999,67,71,-4,-4,0
21700774,201585,SAC,GSW,Kosta Koufos,24,4.96666666666667,5,-0.0333333333333332,9,10,-1,-3,2
21700774,201588,SAC,GSW,George Hill,100,21.75,22,-0.25,42,45,-3,-3,0
21700774,202066,SAC,GSW,Garrett Temple,46,9.53333333333333,10,-0.466666666666667,14,28,-14,-14,0
21700774,203960,SAC,GSW,JaKarr Sampson,18,3.75,4,-0.25,8,13,-5,-3,-2
21700774,203992,SAC,GSW,Bogdan Bogdanovic,138,28.25,29,-0.75,66,74,-8,-10,2
21700774,1626161,SAC,GSW,Willie Cauley-Stein,169,35.0833333333333,35,0.0833333333333286,76,92,-16,-14,-2
21700774,1627741,SAC,GSW,Buddy Hield,100,21.3333333333333,22,-0.666666666666668,45,58,-13,-13,0
21700774,1627834,SAC,GSW,Georgios Papagiannis,5,1.15,1,0.15,2,2,0,0,0
21700774,1628368,SAC,GSW,De'Aaron Fox,150,30.6833333333333,31,-0.316666666666666,72,78,-6,-6,0
21700774,1628382,SAC,GSW,Justin Jackson,165,33.8,34,-0.200000000000003,81,83,-2,-2,0
21700775,201577,CHI,LAC,Robin Lopez,175,35.65,36,-0.350000000000001,84,78,6,5,1
21700775,203200,CHI,LAC,Justin Holiday,188,37.9666666666667,38,-0.0333333333333314,88,78,10,9,1
21700775,203897,CHI,LAC,Zach LaVine,152,30.4666666666667,31,-0.533333333333331,74,68,6,5,1
21700775,1626170,CHI,LAC,Jerian Grant,177,35.9166666666667,37,-1.08333333333333,84,78,6,7,-1
21700775,1626171,CHI,LAC,Bobby Portis,123,24.85,25,-0.149999999999999,55,65,-10,-10,0
21700775,1626245,CHI,LAC,Cristiano Felicio,42,8.73333333333333,9,-0.266666666666668,12,22,-10,-13,3
21700775,1627756,CHI,LAC,Denzel Valentine,94,18.95,19,-0.0500000000000007,34,57,-23,-21,-2
21700775,1627835,CHI,LAC,Paul Zipser,130,25.8333333333333,26,-0.166666666666664,55,59,-4,-2,-2
21700775,1627853,CHI,LAC,Ryan Arcidiacono,29,6.36666666666667,6,0.366666666666667,8,13,-5,-9,4
21700775,1628021,CHI,LAC,David Nwaba,65,12.9333333333333,13,-0.0666666666666664,21,42,-21,-21,0
21700775,101150,LAC,CHI,Lou Williams,165,32.9666666666667,33,-0.0333333333333314,83,76,7,8,-1
21700775,201568,LAC,CHI,Danilo Gallinari,146,29.1833333333333,30,-0.816666666666666,78,57,21,25,-4
21700775,201599,LAC,CHI,DeAndre Jordan,144,29.1833333333333,29,0.183333333333334,66,65,1,-3,4
21700775,202325,LAC,CHI,Wesley Johnson,73,14.85,15,-0.149999999999999,40,32,8,9,-1
21700775,202340,LAC,CHI,Avery Bradley,153,31.75,32,-0.25,64,74,-10,-8,-2
21700775,202699,LAC,CHI,Tobias Harris,165,33.3166666666667,34,-0.683333333333337,71,75,-4,-6,2
21700775,1626149,LAC,CHI,Montrezl Harrell,91,18.35,19,-0.649999999999999,46,38,8,13,-5
21700775,1627820,LAC,CHI,Tyrone Wallace,121,24.65,25,-0.350000000000001,48,55,-7,-7,0
21700775,1628462,LAC,CHI,Milos Teodosic,117,23.4166666666667,23,0.416666666666664,64,43,21,19,2
21700776,201609,MIA,DET,Goran Dragic,157,35.45,35,0.450000000000003,76,80,-4,-3,-1
21700776,201949,MIA,DET,James Johnson,134,28.9333333333333,29,-0.06666666666667,67,71,-4,-5,1
21700776,201961,MIA,DET,Wayne Ellington,137,30.1833333333333,30,0.183333333333334,71,68,3,2,1
21700776,203482,MIA,DET,Kelly Olynyk,180,40.1666666666667,40,0.166666666666664,96,86,10,10,0
21700776,204020,MIA,DET,Tyler Johnson,106,21.8166666666667,22,-0.183333333333334,53,57,-4,-5,1
21700776,1626159,MIA,DET,Justise Winslow,112,24.1833333333333,24,0.183333333333334,46,54,-8,-6,-2
21700776,1626196,MIA,DET,Josh Richardson,164,35.8833333333333,36,-0.116666666666667,83,84,-1,-2,1
21700776,1628389,MIA,DET,Bam Adebayo,110,23.3833333333333,24,-0.616666666666667,43,55,-12,-11,-1
21700776,201229,DET,MIA,Anthony Tolliver,131,28.2,28,0.199999999999999,67,65,2,3,-1
21700776,201933,DET,MIA,Blake Griffin,161,36.4333333333333,36,0.433333333333337,84,79,5,2,3
21700776,202397,DET,MIA,Ish Smith,176,39.6833333333333,40,-0.316666666666663,99,87,12,8,4
21700776,203083,DET,MIA,Andre Drummond,162,34.8833333333333,36,-1.11666666666667,88,73,15,16,-1
21700776,203186,DET,MIA,Willie Reed,7,1.71666666666667,1,0.716666666666667,3,4,-1,-1,0
21700776,203493,DET,MIA,Reggie Bullock,166,35.6666666666667,36,-0.333333333333336,77,81,-4,-2,-2
21700776,204038,DET,MIA,Langston Galloway,99,20.7,21,-0.299999999999997,45,52,-7,-4,-3
21700776,1626169,DET,MIA,Stanley Johnson,154,34.4833333333333,34,0.483333333333334,78,69,9,9,0
21700776,1627740,DET,MIA,Henry Ellenson,44,8.23333333333333,8,0.233333333333334,14,25,-11,-11,0
21700777,2744,IND,PHI,Al Jefferson,63,13.4166666666667,14,-0.583333333333332,37,23,14,13,1
21700777,201152,IND,PHI,Thaddeus Young,158,33.6833333333333,33,0.68333333333333,61,69,-8,-7,-1
21700777,201954,IND,PHI,Darren Collison,156,31.9833333333333,33,-1.01666666666667,65,56,9,8,1
21700777,202362,IND,PHI,Lance Stephenson,110,23.4,23,0.399999999999999,53,41,12,14,-2
21700777,202709,IND,PHI,Cory Joseph,119,25.85,26,-0.149999999999999,55,48,7,8,-1
21700777,202711,IND,PHI,Bojan Bogdanovic,123,25.15,26,-0.850000000000001,51,53,-2,-3,1
21700777,203506,IND,PHI,Victor Oladipo,160,33.25,34,-0.75,70,69,1,1,0
21700777,1626167,IND,PHI,Myles Turner,71,14.5666666666667,15,-0.433333333333334,19,27,-8,-10,2
21700777,1626202,IND,PHI,Joe Young,25,5.06666666666667,5,0.0666666666666664,12,11,1,1,0
21700777,1627734,IND,PHI,Domantas Sabonis,150,32.3833333333333,32,0.383333333333333,77,63,14,15,-1
21700777,101161,PHI,IND,Amir Johnson,60,13.15,14,-0.850000000000001,33,20,13,14,-1
21700777,200755,PHI,IND,JJ Redick,138,27.8166666666667,28,-0.183333333333337,50,59,-9,-13,4
21700777,201573,PHI,IND,Jerryd Bayless,105,22.5333333333333,23,-0.466666666666669,50,43,7,11,-4
21700777,202344,PHI,IND,Trevor Booker,70,15.8666666666667,16,-0.133333333333335,26,38,-12,-13,1
21700777,203496,PHI,IND,Robert Covington,164,34.8,35,-0.200000000000003,74,68,6,7,-1
21700777,203954,PHI,IND,Joel Embiid,163,34.05,34,0.0499999999999972,56,78,-22,-20,-2
21700777,203967,PHI,IND,Dario Saric,141,29.2833333333333,30,-0.716666666666669,58,60,-2,-1,-1
21700777,204456,PHI,IND,T.J. McConnell,61,13.1666666666667,13,0.166666666666666,24,35,-11,-12,1
21700777,1626147,PHI,IND,Justin Anderson,63,12.95,13,-0.0500000000000007,18,32,-14,-15,1
21700777,1627732,PHI,IND,Ben Simmons,170,35.1333333333333,35,0.133333333333333,71,67,4,2,2
21700778,201571,ORL,WAS,D.J. Augustin,112,25.2166666666667,25,0.216666666666669,55,53,2,-2,4
21700778,201578,ORL,WAS,Marreese Speights,83,16.9833333333333,18,-1.01666666666667,29,40,-11,-12,1
21700778,202687,ORL,WAS,Bismack Biyombo,78,18.2166666666667,18,0.216666666666669,31,45,-14,-16,2
21700778,202714,ORL,WAS,Shelvin Mack,98,22.0333333333333,23,-0.966666666666669,49,45,4,4,0
21700778,203095,ORL,WAS,Evan Fournier,135,28.9833333333333,29,-0.0166666666666657,52,81,-29,-27,-2
21700778,203613,ORL,WAS,Jonathon Simmons,119,25.5666666666667,26,-0.433333333333334,49,67,-18,-20,2
21700778,203901,ORL,WAS,Elfrid Payton,111,23.6666666666667,24,-0.333333333333336,44,66,-22,-22,0
21700778,203920,ORL,WAS,Khem Birch,124,27.35,28,-0.649999999999999,69,58,11,13,-2
21700778,1626209,ORL,WAS,Mario Hezonja,128,29.2,29,0.199999999999999,67,70,-3,0,-3
21700778,1628411,ORL,WAS,Wes Iwundu,97,21.2833333333333,21,0.283333333333331,45,50,-5,-3,-2
21700778,101133,WAS,ORL,Ian Mahinmi,80,18.3833333333333,19,-0.616666666666667,40,42,-2,-2,0
21700778,101162,WAS,ORL,Marcin Gortat,114,24.7,25,-0.300000000000001,67,41,26,24,2
21700778,201160,WAS,ORL,Jason Smith,65,14.1166666666667,15,-0.883333333333333,25,38,-13,-11,-2
21700778,201975,WAS,ORL,Jodie Meeks,73,15.5166666666667,16,-0.483333333333333,35,39,-4,-4,0
21700778,202693,WAS,ORL,Markieff Morris,134,29.3166666666667,29,0.316666666666666,77,54,23,23,0
21700778,203078,WAS,ORL,Bradley Beal,140,30.7333333333333,31,-0.266666666666666,78,57,21,21,0
21700778,203107,WAS,ORL,Tomas Satoransky,116,24.9666666666667,25,-0.0333333333333314,66,42,24,24,0
21700778,203490,WAS,ORL,Otto Porter Jr.,146,32.8333333333333,33,-0.166666666666664,86,58,28,30,-2
21700778,204025,WAS,ORL,Tim Frazier,87,19.5833333333333,20,-0.416666666666664,43,46,-3,-3,0
21700778,1626162,WAS,ORL,Kelly Oubre Jr.,117,25.7333333333333,26,-0.266666666666666,54,66,-12,-14,2
21700778,1626191,WAS,ORL,Chris McCullough,13,2.61666666666667,3,-0.383333333333333,4,7,-3,-3,0
21700779,2544,CLE,HOU,LeBron James,140,31.3333333333333,31,0.333333333333332,64,81,-17,-17,0
21700779,2548,CLE,HOU,Dwyane Wade,93,20.0666666666667,20,0.0666666666666664,32,53,-21,-22,1
21700779,2594,CLE,HOU,Kyle Korver,65,13.8666666666667,14,-0.133333333333333,20,40,-20,-20,0
21700779,2747,CLE,HOU,JR Smith,124,27.5,28,-0.5,56,71,-15,-15,0
21700779,101112,CLE,HOU,Channing Frye,81,16.8833333333333,18,-1.11666666666667,31,38,-7,-7,0
21700779,101181,CLE,HOU,Jose Calderon,16,2.98333333333333,3,-0.0166666666666666,6,5,1,0,1
21700779,201145,CLE,HOU,Jeff Green,96,20.8666666666667,21,-0.133333333333333,35,51,-16,-18,2
21700779,201565,CLE,HOU,Derrick Rose,99,20.8333333333333,21,-0.166666666666664,36,50,-14,-14,0
21700779,202684,CLE,HOU,Tristan Thompson,115,25.45,25,0.449999999999999,53,67,-14,-14,0
21700779,202738,CLE,HOU,Isaiah Thomas,123,26.4833333333333,26,0.483333333333334,49,71,-22,-20,-2
21700779,203109,CLE,HOU,Jae Crowder,109,24.6333333333333,25,-0.366666666666667,46,64,-18,-16,-2
21700779,1626224,CLE,HOU,Cedi Osman,29,6.01666666666667,7,-0.983333333333333,12,9,3,3,0
21700779,2403,HOU,CLE,Nene,81,17.55,17,0.549999999999997,52,35,17,21,-4
21700779,101108,HOU,CLE,Chris Paul,121,27.2333333333333,27,0.233333333333334,86,39,47,47,0
21700779,101123,HOU,CLE,Gerald Green,141,29.3833333333333,30,-0.616666666666667,64,61,3,1,2
21700779,200782,HOU,CLE,PJ Tucker,161,34.4333333333333,35,-0.56666666666667,81,67,14,14,0
21700779,201583,HOU,CLE,Ryan Anderson,153,33.25,33,0.25,95,57,38,39,-1
21700779,201601,HOU,CLE,Luc Mbah a Moute,132,29.3166666666667,30,-0.683333333333337,72,56,16,17,-1
21700779,201935,HOU,CLE,James Harden,141,31.1333333333333,31,0.133333333333333,73,62,11,11,0
21700779,203900,HOU,CLE,Markel Brown,23,4.78333333333333,5,-0.216666666666667,9,10,-1,-1,0
21700779,203991,HOU,CLE,Clint Capela,114,25.05,25,0.0500000000000007,59,43,16,12,4
21700779,204028,HOU,CLE,Tarik Black,23,4.78333333333333,5,-0.216666666666667,9,10,-1,-1,0
21700780,200765,NOP,MIN,Rajon Rondo,101,20.5,21,-0.5,38,53,-15,-15,0
21700780,201950,NOP,MIN,Jrue Holiday,183,37.1833333333333,37,0.183333333333337,75,93,-18,-17,-1
21700780,201967,NOP,MIN,Dante Cunningham,101,19.8,20,-0.199999999999999,38,56,-18,-18,0
21700780,202703,NOP,MIN,Nikola Mirotic,177,35.5833333333333,35,0.583333333333329,88,81,7,6,1
21700780,202734,NOP,MIN,E'Twaun Moore,62,12.3333333333333,12,0.333333333333332,20,39,-19,-19,0
21700780,203076,NOP,MIN,Anthony Davis,182,36.4166666666667,36,0.416666666666671,85,90,-5,-4,-1
21700780,203121,NOP,MIN,Darius Miller,111,22.4,22,0.399999999999999,57,51,6,6,0
21700780,203546,NOP,MIN,Ian Clark,158,31.5,32,-0.5,76,70,6,5,1
21700780,1627767,NOP,MIN,Cheick Diallo,75,14.8,15,-0.199999999999999,31,33,-2,-2,0
21700780,1628429,NOP,MIN,Charles Cooke,11,1.8,2,-0.2,6,4,2,2,0
21700780,1628455,NOP,MIN,Mike James,39,7.68333333333333,7,0.683333333333334,21,20,1,1,0
21700780,2037,MIN,NOP,Jamal Crawford,104,20.4666666666667,21,-0.533333333333331,47,51,-4,-3,-1
21700780,201166,MIN,NOP,Aaron Brooks,5,0.883333333333333,1,-0.116666666666667,2,4,-2,-2,0
21700780,201952,MIN,NOP,Jeff Teague,137,26.7833333333333,27,-0.216666666666669,70,49,21,23,-2
21700780,201959,MIN,NOP,Taj Gibson,169,33.2166666666667,33,0.216666666666669,82,72,10,9,1
21700780,202357,MIN,NOP,Nemanja Bjelica,71,14.7833333333333,15,-0.216666666666667,36,35,1,2,-1
21700780,202710,MIN,NOP,Jimmy Butler,181,37.2166666666667,37,0.216666666666669,94,81,13,12,1
21700780,203476,MIN,NOP,Gorgui Dieng,72,15.2,15,0.200000000000001,36,38,-2,-3,1
21700780,203952,MIN,NOP,Andrew Wiggins,190,37.4333333333333,38,-0.566666666666663,93,78,15,15,0
21700780,1626145,MIN,NOP,Tyus Jones,98,20.3333333333333,20,0.333333333333332,46,54,-8,-10,2
21700780,1626157,MIN,NOP,Karl-Anthony Towns,168,32.8,33,-0.200000000000003,82,69,13,14,-1
21700780,1627875,MIN,NOP,Marcus Georges-Hunt,5,0.883333333333333,1,-0.116666666666667,2,4,-2,-2,0
21700781,1938,SAS,UTA,Manu Ginobili,116,24.5666666666667,25,-0.433333333333334,60,63,-3,-5,2
21700781,2200,SAS,UTA,Pau Gasol,93,20.65,20,0.649999999999999,51,55,-4,-2,-2
21700781,2225,SAS,UTA,Tony Parker,108,23.2166666666667,23,0.216666666666669,58,56,2,2,0
21700781,200746,SAS,UTA,LaMarcus Aldridge,157,34.1166666666667,35,-0.883333333333333,73,86,-13,-15,2
21700781,201980,SAS,UTA,Danny Green,148,32.9666666666667,33,-0.0333333333333314,79,74,5,-3,8
21700781,201988,SAS,UTA,Patty Mills,105,22.8833333333333,23,-0.116666666666667,59,64,-5,-5,0
21700781,202722,SAS,UTA,Davis Bertans,84,18.6166666666667,19,-0.383333333333333,40,39,1,1,0
21700781,203530,SAS,UTA,Joffrey Lauvergne,3,0.2,1,-0.8,2,2,0,2,-2
21700781,203937,SAS,UTA,Kyle Anderson,92,20.0666666666667,20,0.0666666666666664,36,50,-14,-12,-2
21700781,1626199,SAS,UTA,Darrun Hilliard,25,4.65,5,-0.35,12,14,-2,2,-4
21700781,1627749,SAS,UTA,Dejounte Murray,97,21.85,22,-0.149999999999999,47,56,-9,-7,-2
21700781,1627854,SAS,UTA,Bryn Forbes,67,14.1333333333333,15,-0.866666666666667,38,41,-3,-3,0
21700781,201937,UTA,SAS,Ricky Rubio,157,34.2166666666667,35,-0.783333333333331,89,74,15,15,0
21700781,201973,UTA,SAS,Jonas Jerebko,57,12.2333333333333,12,0.233333333333334,28,33,-5,-5,0
21700781,202324,UTA,SAS,Derrick Favors,127,27.8333333333333,28,-0.166666666666668,68,55,13,11,2
21700781,202327,UTA,SAS,Ekpe Udoh,51,10.85,10,0.85,25,26,-1,-1,0
21700781,202692,UTA,SAS,Alec Burks,110,24.5833333333333,25,-0.416666666666668,54,55,-1,-1,0
21700781,203497,UTA,SAS,Rudy Gobert,141,31.05,32,-0.949999999999999,82,69,13,13,0
21700781,203526,UTA,SAS,Raul Neto,96,19.9,20,-0.100000000000001,52,55,-3,1,-4
21700781,203918,UTA,SAS,Rodney Hood,70,16.1166666666667,16,0.116666666666667,42,42,0,-2,2
21700781,204060,UTA,SAS,Joe Ingles,134,29.05,30,-0.949999999999999,76,67,9,9,0
21700781,1626220,UTA,SAS,Royce O'Neale,152,32.0833333333333,32,0.0833333333333357,84,79,5,5,0
21700782,201163,DEN,GSW,Wilson Chandler,114,23.5333333333333,24,-0.466666666666669,67,50,17,16,1
21700782,201589,DEN,GSW,Darrell Arthur,74,14.4833333333333,14,0.483333333333334,38,32,6,8,-2
21700782,203115,DEN,GSW,Will Barton,176,35.25,35,0.25,86,85,1,1,0
21700782,203914,DEN,GSW,Gary Harris,188,38.3,39,-0.700000000000003,90,90,0,3,-3
21700782,203999,DEN,GSW,Nikola Jokic,156,32.7333333333333,33,-0.266666666666666,72,73,-1,0,-1
21700782,1626144,DEN,GSW,Emmanuel Mudiay,103,20.5,21,-0.5,52,47,5,7,-2
21700782,1626168,DEN,GSW,Trey Lyles,128,25.5,25,0.5,58,54,4,8,-4
21700782,1627736,DEN,GSW,Malik Beasley,2,0.116666666666667,0,0.116666666666667,2,3,-1,-3,2
21700782,1627750,DEN,GSW,Jamal Murray,135,27.7666666666667,28,-0.233333333333334,62,61,1,0,1
21700782,1628470,DEN,GSW,Torrey Craig,99,20.4833333333333,21,-0.516666666666666,43,45,-2,-5,3
21700782,2585,GSW,DEN,Zaza Pachulia,89,19.0166666666667,19,0.0166666666666657,52,43,9,12,-3
21700782,2733,GSW,DEN,Shaun Livingston,72,14.3833333333333,14,0.383333333333333,28,43,-15,-15,0
21700782,2738,GSW,DEN,Andre Iguodala,103,21.4666666666667,21,0.466666666666669,41,47,-6,-7,1
21700782,201142,GSW,DEN,Kevin Durant,200,40.7333333333333,42,-1.26666666666667,102,98,4,1,3
21700782,201156,GSW,DEN,Nick Young,87,16.85,17,-0.149999999999999,30,44,-14,-11,-3
21700782,201580,GSW,DEN,JaVale McGee,33,6.28333333333333,6,0.283333333333333,13,11,2,-2,4
21700782,201939,GSW,DEN,Stephen Curry,173,35.4666666666667,36,-0.533333333333331,80,82,-2,4,-6
21700782,202691,GSW,DEN,Klay Thompson,176,35.5833333333333,36,-0.416666666666671,87,87,0,-7,7
21700782,203110,GSW,DEN,Draymond Green,178,35.2166666666667,36,-0.783333333333331,77,88,-11,-11,0
21700782,1626172,GSW,DEN,Kevon Looney,38,8.65,8,0.649999999999999,16,16,0,0,0
21700782,1627745,GSW,DEN,Damian Jones,22,4.5,4,0.5,12,11,1,1,0
21700782,1627775,GSW,DEN,Patrick McCaw,4,0.516666666666667,0,0.516666666666667,2,0,2,0,2
21700783,1717,DAL,SAC,Dirk Nowitzki,107,25.5,26,-0.5,57,52,5,6,-1
21700783,2734,DAL,SAC,Devin Harris,70,16.4166666666667,17,-0.583333333333336,41,28,13,15,-2
21700783,200826,DAL,SAC,J.J. Barea,103,24.0833333333333,24,0.0833333333333322,66,47,19,17,2
21700783,202083,DAL,SAC,Wesley Matthews,133,31.15,31,0.149999999999999,63,71,-8,-8,0
21700783,203084,DAL,SAC,Harrison Barnes,143,33.7833333333333,34,-0.216666666666669,68,73,-5,-5,0
21700783,203939,DAL,SAC,Dwight Powell,129,30.7166666666667,31,-0.283333333333331,63,64,-1,-2,1
21700783,1626257,DAL,SAC,Salah Mejri,64,14.8,14,0.800000000000001,33,31,2,2,0
21700783,1627812,DAL,SAC,Yogi Ferrell,139,30.2333333333333,30,0.233333333333334,69,60,9,9,0
21700783,1628372,DAL,SAC,Dennis Smith Jr.,137,32.25,32,0.25,64,66,-2,-2,0
21700783,1628467,DAL,SAC,Maxi Kleber,5,1.06666666666667,1,0.0666666666666667,6,3,3,3,0
21700783,1713,SAC,DAL,Vince Carter,65,14.4333333333333,15,-0.566666666666666,33,41,-8,-8,0
21700783,2216,SAC,DAL,Zach Randolph,90,21.2666666666667,21,0.266666666666666,42,51,-9,-9,0
21700783,201585,SAC,DAL,Kosta Koufos,55,13.3166666666667,14,-0.683333333333334,36,30,6,6,0
21700783,201588,SAC,DAL,George Hill,61,15.0333333333333,15,0.0333333333333332,28,40,-12,-10,-2
21700783,202066,SAC,DAL,Garrett Temple,143,31.6333333333333,31,0.633333333333333,64,69,-5,-5,0
21700783,203960,SAC,DAL,JaKarr Sampson,35,7.86666666666667,8,-0.133333333333334,13,16,-3,-3,0
21700783,203992,SAC,DAL,Bogdan Bogdanovic,111,26.0166666666667,26,0.0166666666666657,60,53,7,5,2
21700783,1626161,SAC,DAL,Willie Cauley-Stein,128,30.9166666666667,31,-0.0833333333333357,60,62,-2,-2,0
21700783,1627741,SAC,DAL,Buddy Hield,92,20.8166666666667,21,-0.183333333333334,37,50,-13,-13,0
21700783,1628368,SAC,DAL,De'Aaron Fox,153,35,35,0,76,70,6,6,0
21700783,1628382,SAC,DAL,Justin Jackson,97,23.7,24,-0.300000000000001,46,48,-2,-2,0
21700784,201143,BOS,POR,Al Horford,158,36.2166666666667,36,0.216666666666669,64,68,-4,-2,-2
21700784,203382,BOS,POR,Aron Baynes,91,21.0666666666667,21,0.0666666666666664,39,43,-4,-4,0
21700784,1626179,BOS,POR,Terry Rozier,161,36.25,36,0.25,84,77,7,7,0
21700784,1627759,BOS,POR,Jaylen Brown,152,34.4833333333333,34,0.483333333333334,70,68,2,4,-2
21700784,1627824,BOS,POR,Guerschon Yabusele,30,7.4,8,-0.6,24,18,6,6,0
21700784,1627846,BOS,POR,Abdel Nader,85,19.8,20,-0.200000000000003,33,38,-5,-4,-1
21700784,1628369,BOS,POR,Jayson Tatum,157,36.05,36,0.0499999999999972,76,75,1,2,-1
21700784,1628400,BOS,POR,Semi Ojeleye,127,28.1166666666667,28,0.116666666666667,50,52,-2,-5,3
21700784,1628443,BOS,POR,Kadeem Allen,3,0.433333333333333,0,0.433333333333333,1,0,1,1,0
21700784,1628464,BOS,POR,Daniel Theis,91,20.1,20,0.100000000000001,44,41,3,1,2
21700784,202323,POR,BOS,Evan Turner,100,23.1333333333333,23,0.133333333333333,42,36,6,5,1
21700784,202329,POR,BOS,Al-Farouq Aminu,145,34.1333333333333,34,0.133333333333333,62,68,-6,-6,0
21700784,202334,POR,BOS,Ed Davis,91,19.75,20,-0.25,50,44,6,7,-1
21700784,203081,POR,BOS,Damian Lillard,170,37.1666666666667,37,0.166666666666664,76,76,0,0,0
21700784,203090,POR,BOS,Maurice Harkless,138,31.5333333333333,31,0.533333333333331,69,65,4,5,-1
21700784,203468,POR,BOS,CJ McCollum,154,35.45,36,-0.549999999999997,64,79,-15,-16,1
21700784,203994,POR,BOS,Jusuf Nurkic,120,28.2333333333333,28,0.233333333333334,46,53,-7,-8,1
21700784,1626192,POR,BOS,Pat Connaughton,83,18.6666666666667,19,-0.333333333333336,41,39,2,4,-2
21700784,1628380,POR,BOS,Zach Collins,54,11.85,12,-0.149999999999999,30,25,5,4,1
21700785,1891,MIL,BKN,Jason Terry,7,1.36666666666667,2,-0.633333333333333,0,3,-3,-3,0
21700785,202339,MIL,BKN,Eric Bledsoe,146,31.9166666666667,32,-0.0833333333333357,84,66,18,20,-2
21700785,203089,MIL,BKN,John Henson,136,30.1333333333333,30,0.133333333333333,84,62,22,22,0
21700785,203114,MIL,BKN,Khris Middleton,143,31.35,31,0.350000000000001,81,64,17,17,0
21700785,203503,MIL,BKN,Tony Snell,132,30.7333333333333,31,-0.266666666666666,77,60,17,19,-2
21700785,203507,MIL,BKN,Giannis Antetokounmpo,120,27.75,28,-0.25,63,46,17,16,1
21700785,203521,MIL,BKN,Matthew Dellavedova,61,14.0333333333333,14,0.0333333333333332,23,25,-2,-2,0
21700785,203930,MIL,BKN,Sean Kilpatrick,34,8.21666666666667,8,0.216666666666667,15,13,2,2,0
21700785,203953,MIL,BKN,Jabari Parker,90,17.35,17,0.350000000000001,37,43,-6,-5,-1
21700785,1626173,MIL,BKN,Rashad Vaughn,7,1.36666666666667,2,-0.633333333333333,0,3,-3,-3,0
21700785,1627748,MIL,BKN,Thon Maker,80,17.65,18,-0.350000000000001,27,32,-5,-7,2
21700785,1628425,MIL,BKN,Sterling Brown,119,25.8833333333333,26,-0.116666666666667,54,53,1,-1,2
21700785,201960,BKN,MIL,DeMarre Carroll,146,32.0833333333333,32,0.0833333333333286,70,82,-12,-14,2
21700785,203112,BKN,MIL,Quincy Acy,95,20.9333333333333,21,-0.0666666666666664,46,49,-3,-4,1
21700785,203459,BKN,MIL,Allen Crabbe,125,28.2833333333333,29,-0.716666666666669,59,74,-15,-15,0
21700785,203915,BKN,MIL,Spencer Dinwiddie,115,28.0833333333333,29,-0.916666666666664,43,63,-20,-20,0
21700785,203917,BKN,MIL,Nik Stauskas,43,9.08333333333333,9,0.0833333333333339,23,13,10,10,0
21700785,203925,BKN,MIL,Joe Harris,117,25.85,26,-0.149999999999999,41,53,-12,-11,-1
21700785,1626143,BKN,MIL,Jahlil Okafor,52,9.85,11,-1.15,17,23,-6,-5,-1
21700785,1626156,BKN,MIL,D'Angelo Russell,96,18.2333333333333,18,0.233333333333334,49,46,3,3,0
21700785,1627747,BKN,MIL,Caris LeVert,108,23.45,23,0.449999999999999,50,47,3,3,0
21700785,1627821,BKN,MIL,James Webb III,64,14.3333333333333,15,-0.666666666666668,22,25,-3,-1,-2
21700785,1628386,BKN,MIL,Jarrett Allen,114,27.5666666666667,27,0.566666666666666,50,70,-20,-21,1
21700786,201158,ATL,NYK,Marco Belinelli,98,20.4833333333333,20,0.483333333333334,40,38,2,2,0
21700786,203101,ATL,NYK,Miles Plumlee,94,20.7,21,-0.300000000000001,46,47,-1,-3,2
21700786,203145,ATL,NYK,Kent Bazemore,143,29.4666666666667,30,-0.533333333333331,64,60,4,6,-2
21700786,203471,ATL,NYK,Dennis Schroder,153,31.25,31,0.25,63,55,8,8,0
21700786,203473,ATL,NYK,Dewayne Dedmon,142,29.3333333333333,29,0.333333333333336,62,58,4,4,0
21700786,203488,ATL,NYK,Mike Muscala,117,23.35,23,0.350000000000001,50,47,3,5,-2
21700786,1627098,ATL,NYK,Malcolm Delaney,83,16.7666666666667,17,-0.233333333333334,36,41,-5,-5,0
21700786,1627752,ATL,NYK,Taurean Prince,158,32.2666666666667,32,0.266666666666666,64,66,-2,-4,2
21700786,1628381,ATL,NYK,John Collins,113,22.55,22,0.550000000000001,40,40,0,0,0
21700786,1628416,ATL,NYK,Tyler Dorsey,69,13.75,14,-0.25,30,28,2,2,0
21700786,101127,NYK,ATL,Jarrett Jack,126,26.7166666666667,27,-0.283333333333331,53,51,2,0,2
21700786,201563,NYK,ATL,Michael Beasley,77,15.7333333333333,16,-0.266666666666666,29,29,0,0,0
21700786,201584,NYK,ATL,Courtney Lee,130,27.15,27,0.149999999999999,53,54,-1,-1,0
21700786,202498,NYK,ATL,Lance Thomas,13,2.51666666666667,3,-0.483333333333333,3,5,-2,-2,0
21700786,202683,NYK,ATL,Enes Kanter,122,26.2,26,0.199999999999999,50,48,2,2,0
21700786,203124,NYK,ATL,Kyle O'Quinn,110,21.75,22,-0.25,46,51,-5,-5,0
21700786,203501,NYK,ATL,Tim Hardaway Jr.,164,33.85,34,-0.150000000000006,67,70,-3,-3,0
21700786,203504,NYK,ATL,Trey Burke,103,20.2,20,0.200000000000003,43,46,-3,-1,-2
21700786,203926,NYK,ATL,Doug McDermott,136,26.9333333333333,27,-0.0666666666666664,54,58,-4,-4,0
21700786,204001,NYK,ATL,Kristaps Porzingis,157,32.25,32,0.25,67,70,-3,-3,0
21700786,1628373,NYK,ATL,Frank Ntilikina,32,6.61666666666667,7,-0.383333333333334,15,13,2,2,0
21700787,101139,TOR,MEM,CJ Miles,60,13.95,14,-0.0500000000000007,29,14,15,17,-2
21700787,200768,TOR,MEM,Kyle Lowry,124,25.7333333333333,26,-0.266666666666666,53,61,-8,-11,3
21700787,201586,TOR,MEM,Serge Ibaka,108,22.4166666666667,23,-0.583333333333336,45,51,-6,-11,5
21700787,201942,TOR,MEM,DeMar DeRozan,129,26.75,27,-0.25,52,63,-11,-14,3
21700787,202685,TOR,MEM,Jonas Valanciunas,117,24.1333333333333,24,0.133333333333333,47,57,-10,-11,1
21700787,1626153,TOR,MEM,Delon Wright,111,24.6166666666667,25,-0.383333333333333,60,26,34,36,-2
21700787,1626181,TOR,MEM,Norman Powell,27,5.13333333333333,5,0.133333333333333,14,8,6,6,0
21700787,1627751,TOR,MEM,Jakob Poeltl,106,23.4666666666667,24,-0.533333333333331,54,28,26,26,0
21700787,1627783,TOR,MEM,Pascal Siakam,115,25.1833333333333,25,0.183333333333334,56,34,22,26,-4
21700787,1627832,TOR,MEM,Fred VanVleet,127,27.9166666666667,28,-0.0833333333333357,64,39,25,25,0
21700787,1628384,TOR,MEM,OG Anunoby,91,18.7,19,-0.299999999999997,31,44,-13,-14,1
21700787,201188,MEM,TOR,Marc Gasol,173,36.6166666666667,37,-0.38333333333334,75,76,-1,2,-3
21700787,201596,MEM,TOR,Mario Chalmers,87,18.25,18,0.25,32,45,-13,-10,-3
21700787,203210,MEM,TOR,JaMychal Green,117,25.4166666666667,26,-0.583333333333332,48,48,0,1,-1
21700787,203463,MEM,TOR,Ben McLemore,19,3.35,4,-0.65,4,12,-8,-6,-2
21700787,203516,MEM,TOR,James Ennis III,108,21.0666666666667,21,0.0666666666666664,38,43,-5,-5,0
21700787,1626150,MEM,TOR,Andrew Harrison,139,30.1666666666667,31,-0.833333333333336,53,56,-3,-5,2
21700787,1626185,MEM,TOR,Jarell Martin,74,17.2333333333333,18,-0.766666666666666,28,35,-7,-8,1
21700787,1627738,MEM,TOR,Deyonta Davis,90,19.25,19,0.25,28,50,-22,-22,0
21700787,1627782,MEM,TOR,Wayne Selden,160,34.9,35,-0.100000000000001,64,66,-2,-7,5
21700787,1628397,MEM,TOR,Ivan Rabb,27,5,5,0,6,15,-9,-6,-3
21700787,1628415,MEM,TOR,Dillon Brooks,121,26.75,27,-0.25,49,59,-10,-9,-1
21700788,201147,LAL,OKC,Corey Brewer,39,8,8,0,13,15,-2,-3,1
21700788,201572,LAL,OKC,Brook Lopez,172,34.3333333333333,35,-0.666666666666671,87,75,12,11,1
21700788,203484,LAL,OKC,Kentavious Caldwell-Pope,144,29.0333333333333,29,0.0333333333333314,70,59,11,10,1
21700788,203903,LAL,OKC,Jordan Clarkson,121,23.2166666666667,23,0.216666666666669,51,57,-6,-4,-2
21700788,203944,LAL,OKC,Julius Randle,163,33.3666666666667,33,0.366666666666667,78,72,6,7,-1
21700788,1626204,LAL,OKC,Larry Nance Jr.,59,11.9333333333333,12,-0.0666666666666664,20,24,-4,-3,-1
21700788,1627742,LAL,OKC,Brandon Ingram,174,35.7,36,-0.299999999999997,83,77,6,5,1
21700788,1627936,LAL,OKC,Alex Caruso,45,8.93333333333333,9,-0.0666666666666664,12,17,-5,-3,-2
21700788,1628398,LAL,OKC,Kyle Kuzma,80,15.8166666666667,16,-0.183333333333334,30,37,-7,-7,0
21700788,1628404,LAL,OKC,Josh Hart,193,38.9166666666667,39,-0.0833333333333286,96,87,9,7,2
21700788,2546,OKC,LAL,Carmelo Anthony,167,33.8833333333333,34,-0.116666666666667,75,78,-3,-6,3
21700788,101109,OKC,LAL,Raymond Felton,67,13.6833333333333,14,-0.316666666666666,28,25,3,2,1
21700788,201566,OKC,LAL,Russell Westbrook,196,39.5833333333333,40,-0.416666666666671,86,98,-12,-10,-2
21700788,202331,OKC,LAL,Paul George,195,39.6333333333333,40,-0.366666666666667,92,89,3,3,0
21700788,202335,OKC,LAL,Patrick Patterson,58,11.8833333333333,12,-0.116666666666667,23,22,1,4,-3
21700788,203500,OKC,LAL,Steven Adams,190,37.5666666666667,38,-0.433333333333337,88,92,-4,-4,0
21700788,203518,OKC,LAL,Alex Abrines,131,26.3833333333333,26,0.383333333333333,69,54,15,15,0
21700788,203924,OKC,LAL,Jerami Grant,87,17.05,17,0.0499999999999972,31,37,-6,-7,1
21700788,203962,OKC,LAL,Josh Huestis,43,8.21666666666667,8,0.216666666666667,12,19,-7,-7,0
21700788,1628390,OKC,LAL,Terrance Ferguson,56,11.3666666666667,11,0.366666666666667,16,26,-10,-10,0
21700789,2199,PHX,CHA,Tyson Chandler,159,33.4833333333333,34,-0.516666666666666,76,80,-4,-3,-1
21700789,201162,PHX,CHA,Jared Dudley,99,21.5833333333333,22,-0.416666666666664,37,54,-17,-19,2
21700789,203458,PHX,CHA,Alex Len,53,11.4666666666667,11,0.466666666666667,25,32,-7,-8,1
21700789,203584,PHX,CHA,Troy Daniels,113,25.2833333333333,25,0.283333333333331,50,63,-13,-13,0
21700789,203933,PHX,CHA,T.J. Warren,177,36.6,37,-0.399999999999999,93,79,14,14,0
21700789,1626164,PHX,CHA,Devin Booker,151,31.3,31,0.300000000000001,78,79,-1,1,-2
21700789,1627733,PHX,CHA,Dragan Bender,127,26.4,27,-0.600000000000001,73,61,12,14,-2
21700789,1627755,PHX,CHA,Tyler Ulis,75,16.6833333333333,17,-0.316666666666666,32,36,-4,-6,2
21700789,1627863,PHX,CHA,Danuel House Jr.,48,11.1833333333333,11,0.183333333333334,17,36,-19,-19,0
21700789,1628367,PHX,CHA,Josh Jackson,128,25.9333333333333,26,-0.0666666666666664,69,55,14,14,0
21700789,2730,CHA,PHX,Dwight Howard,183,37.5833333333333,38,-0.416666666666671,79,95,-16,-16,0
21700789,201587,CHA,PHX,Nicolas Batum,159,33.9,34,-0.100000000000001,79,92,-13,-13,0
21700789,202689,CHA,PHX,Kemba Walker,168,34.25,34,0.25,76,88,-12,-12,0
21700789,203077,CHA,PHX,Michael Kidd-Gilchrist,158,34.0166666666667,34,0.0166666666666657,84,79,5,8,-3
21700789,203087,CHA,PHX,Jeremy Lamb,108,23.3333333333333,23,0.333333333333336,58,32,26,25,1
21700789,203469,CHA,PHX,Cody Zeller,63,14.2333333333333,14,0.233333333333334,43,20,23,22,1
21700789,203487,CHA,PHX,Michael Carter-Williams,85,18.45,18,0.449999999999999,48,39,9,7,2
21700789,1626163,CHA,PHX,Frank Kaminsky,98,20.8666666666667,21,-0.133333333333333,43,55,-12,-11,-1
21700789,1626203,CHA,PHX,Treveon Graham,108,23.2833333333333,23,0.283333333333331,65,50,15,15,0
21700790,202329,POR,DET,Al-Farouq Aminu,133,29.1666666666667,29,0.166666666666664,49,69,-20,-20,0
21700790,202334,POR,DET,Ed Davis,81,17.25,17,0.25,34,40,-6,-6,0
21700790,203081,POR,DET,Damian Lillard,179,38.3,38,0.299999999999997,71,83,-12,-12,0
21700790,203086,POR,DET,Meyers Leonard,19,3.96666666666667,4,-0.0333333333333337,10,10,0,0,0
21700790,203090,POR,DET,Maurice Harkless,107,23.4,24,-0.600000000000001,40,49,-9,-9,0
21700790,203468,POR,DET,CJ McCollum,133,29.4333333333333,30,-0.566666666666666,53,81,-28,-28,0
21700790,203894,POR,DET,Shabazz Napier,121,26.05,26,0.0499999999999972,52,57,-5,-5,0
21700790,203943,POR,DET,Noah Vonleh,19,3.96666666666667,4,-0.0333333333333337,10,10,0,0,0
21700790,203994,POR,DET,Jusuf Nurkic,118,25.6,26,-0.399999999999999,47,56,-9,-9,0
21700790,1626192,POR,DET,Pat Connaughton,88,18.2833333333333,18,0.283333333333331,37,43,-6,-6,0
21700790,1627774,POR,DET,Jake Layman,19,3.96666666666667,4,-0.0333333333333337,10,10,0,0,0
21700790,1628380,POR,DET,Zach Collins,74,15.65,15,0.65,32,37,-5,-5,0
21700790,1628403,POR,DET,Caleb Swanigan,19,3.96666666666667,4,-0.0333333333333337,10,10,0,0,0
21700790,201229,DET,POR,Anthony Tolliver,120,26.7833333333333,27,-0.216666666666669,67,49,18,16,2
21700790,201933,DET,POR,Blake Griffin,135,30,30,0,69,53,16,18,-2
21700790,202397,DET,POR,Ish Smith,131,28.6666666666667,28,0.666666666666664,67,51,16,14,2
21700790,203083,DET,POR,Andre Drummond,163,33.75,34,-0.25,76,64,12,12,0
21700790,203186,DET,POR,Willie Reed,13,2.53333333333333,3,-0.466666666666667,5,8,-3,-3,0
21700790,203493,DET,POR,Reggie Bullock,160,34.3333333333333,34,0.333333333333336,79,59,20,22,-2
21700790,203687,DET,POR,Reggie Hearn,13,2.53333333333333,3,-0.466666666666667,5,8,-3,-3,0
21700790,204038,DET,POR,Langston Galloway,88,18.2,19,-0.800000000000001,41,40,1,3,-2
21700790,1626169,DET,POR,Stanley Johnson,155,33.3166666666667,34,-0.683333333333337,78,62,16,16,0
21700790,1627740,DET,POR,Henry Ellenson,13,2.53333333333333,3,-0.466666666666667,5,8,-3,-3,0
21700790,1627770,DET,POR,Kay Felder,13,2.53333333333333,3,-0.466666666666667,5,8,-3,-3,0
21700790,1628379,DET,POR,Luke Kennard,106,23.8166666666667,24,-0.183333333333334,58,45,13,11,2
21700791,2744,IND,WAS,Al Jefferson,70,16.2833333333333,16,0.283333333333331,45,40,5,4,1
21700791,201152,IND,WAS,Thaddeus Young,143,30.2833333333333,30,0.283333333333331,56,70,-14,-14,0
21700791,202362,IND,WAS,Lance Stephenson,170,37.45,38,-0.549999999999997,78,84,-6,-7,1
21700791,202709,IND,WAS,Cory Joseph,156,34.9333333333333,36,-1.06666666666666,71,77,-6,-14,8
21700791,202711,IND,WAS,Bojan Bogdanovic,172,36.5666666666667,37,-0.433333333333337,80,87,-7,-3,-4
21700791,1626167,IND,WAS,Myles Turner,101,22.3166666666667,23,-0.683333333333334,37,47,-10,-10,0
21700791,1626202,IND,WAS,Joe Young,127,27.8666666666667,28,-0.133333333333333,61,65,-4,-2,-2
21700791,1627734,IND,WAS,Domantas Sabonis,124,26.5833333333333,27,-0.416666666666668,66,63,3,2,1
21700791,1628500,IND,WAS,Ben Moore,32,6.38333333333333,6,0.383333333333333,16,17,-1,-1,0
21700791,101133,WAS,IND,Ian Mahinmi,109,24.05,24,0.0500000000000007,64,55,9,9,0
21700791,101162,WAS,IND,Marcin Gortat,97,20.9166666666667,21,-0.0833333333333357,41,39,2,2,0
21700791,201975,WAS,IND,Jodie Meeks,57,11.7833333333333,12,-0.216666666666667,29,35,-6,-5,-1
21700791,202693,WAS,IND,Markieff Morris,131,29.0666666666667,29,0.06666666666667,60,51,9,9,0
21700791,203078,WAS,IND,Bradley Beal,162,35.95,36,-0.0499999999999972,81,67,14,14,0
21700791,203107,WAS,IND,Tomas Satoransky,103,22.0333333333333,22,0.0333333333333314,46,40,6,7,-1
21700791,203118,WAS,IND,Mike Scott,90,19.0833333333333,19,0.0833333333333357,50,52,-2,-1,-1
21700791,203490,WAS,IND,Otto Porter Jr.,111,24.7666666666667,25,-0.233333333333334,57,41,16,16,0
21700791,204025,WAS,IND,Tim Frazier,88,18.8166666666667,19,-0.183333333333334,50,52,-2,-1,-1
21700791,1626162,WAS,IND,Kelly Oubre Jr.,147,32.2,32,0.200000000000003,72,78,-6,-5,-1
21700792,201609,MIA,ORL,Goran Dragic,176,35.5333333333333,36,-0.466666666666669,86,65,21,17,4
21700792,201949,MIA,ORL,James Johnson,82,18.4333333333333,18,0.433333333333334,37,48,-11,-12,1
21700792,201961,MIA,ORL,Wayne Ellington,143,29.2666666666667,29,0.266666666666666,58,73,-15,-16,1
21700792,202355,MIA,ORL,Hassan Whiteside,117,22.65,23,-0.350000000000001,57,59,-2,-1,-1
21700792,203482,MIA,ORL,Kelly Olynyk,36,6.68333333333333,7,-0.316666666666666,21,13,8,8,0
21700792,204020,MIA,ORL,Tyler Johnson,151,31.8833333333333,32,-0.116666666666667,64,86,-22,-21,-1
21700792,1626159,MIA,ORL,Justise Winslow,138,26.7333333333333,27,-0.266666666666666,65,44,21,22,-1
21700792,1626175,MIA,ORL,Jordan Mickey,28,5.13333333333333,5,0.133333333333333,14,19,-5,-5,0
21700792,1626196,MIA,ORL,Josh Richardson,181,37,37,0,89,86,3,5,-2
21700792,1628389,MIA,ORL,Bam Adebayo,123,26.6,26,0.600000000000001,54,62,-8,-7,-1
21700792,201167,ORL,MIA,Arron Afflalo,77,15.85,16,-0.15,37,30,7,5,2
21700792,201571,ORL,MIA,D.J. Augustin,114,22.8333333333333,23,-0.166666666666668,54,44,10,10,0
21700792,201578,ORL,MIA,Marreese Speights,81,16.9333333333333,17,-0.0666666666666664,38,36,2,3,-1
21700792,202687,ORL,MIA,Bismack Biyombo,115,23.7833333333333,24,-0.216666666666669,55,60,-5,-4,-1
21700792,202714,ORL,MIA,Shelvin Mack,123,26.6666666666667,27,-0.333333333333336,66,62,4,5,-1
21700792,203095,ORL,MIA,Evan Fournier,126,24.9666666666667,25,-0.033333333333335,51,58,-7,-9,2
21700792,203613,ORL,MIA,Jonathon Simmons,136,27.0333333333333,27,0.0333333333333314,58,66,-8,-6,-2
21700792,203901,ORL,MIA,Elfrid Payton,121,25.15,25,0.149999999999999,57,65,-8,-8,0
21700792,203920,ORL,MIA,Khem Birch,39,7.26666666666667,7,0.266666666666666,18,13,5,3,2
21700792,1626209,ORL,MIA,Mario Hezonja,153,31.55,32,-0.449999999999999,74,75,-1,1,-2
21700792,1628411,ORL,MIA,Wes Iwundu,90,17.8833333333333,18,-0.116666666666667,47,36,11,10,1
21700793,2731,NOP,UTA,Emeka Okafor,41,8.6,9,-0.4,20,32,-12,-12,0
21700793,200765,NOP,UTA,Rajon Rondo,145,30.35,30,0.350000000000001,64,83,-19,-19,0
21700793,201950,NOP,UTA,Jrue Holiday,150,32.9666666666667,33,-0.0333333333333314,73,92,-19,-21,2
21700793,202703,NOP,UTA,Nikola Mirotic,151,33.05,33,0.0499999999999972,75,86,-11,-11,0
21700793,202732,NOP,UTA,DeAndre Liggins,66,13.2833333333333,14,-0.716666666666669,28,34,-6,-8,2
21700793,202734,NOP,UTA,E'Twaun Moore,147,30.7666666666667,31,-0.233333333333334,67,86,-19,-17,-2
21700793,203076,NOP,UTA,Anthony Davis,165,34.9333333333333,35,-0.0666666666666629,79,88,-9,-11,2
21700793,203121,NOP,UTA,Darius Miller,96,19.8166666666667,20,-0.183333333333334,54,48,6,4,2
21700793,203546,NOP,UTA,Ian Clark,87,19.0333333333333,19,0.0333333333333314,47,51,-4,-6,2
21700793,1627767,NOP,UTA,Cheick Diallo,68,14.35,15,-0.649999999999999,32,45,-13,-15,2
21700793,1628455,NOP,UTA,Mike James,14,2.6,3,-0.4,6,10,-4,-4,0
21700793,2207,UTA,NOP,Joe Johnson,77,16.2833333333333,16,0.283333333333335,47,41,6,6,0
21700793,201937,UTA,NOP,Ricky Rubio,157,33.2333333333333,33,0.233333333333334,86,71,15,15,0
21700793,201973,UTA,NOP,Jonas Jerebko,46,9.26666666666667,10,-0.733333333333334,18,29,-11,-7,-4
21700793,202324,UTA,NOP,Derrick Favors,129,28.25,28,0.25,88,53,35,33,2
21700793,202327,UTA,NOP,Ekpe Udoh,49,9.28333333333333,9,0.283333333333333,25,24,1,1,0
21700793,203497,UTA,NOP,Rudy Gobert,151,32.8166666666667,33,-0.18333333333333,84,71,13,15,-2
21700793,203526,UTA,NOP,Raul Neto,57,12.3333333333333,13,-0.666666666666668,41,30,11,13,-2
21700793,203918,UTA,NOP,Rodney Hood,127,27.7833333333333,27,0.783333333333331,78,74,4,4,0
21700793,204060,UTA,NOP,Joe Ingles,140,29.75,30,-0.25,81,60,21,21,0
21700793,1626220,UTA,NOP,Royce O'Neale,92,19.9666666666667,20,-0.0333333333333314,54,49,5,9,-4
21700793,1628378,UTA,NOP,Donovan Mitchell,95,18.9666666666667,19,-0.0333333333333314,47,37,10,10,0
21700793,1628571,UTA,NOP,Erik McCree,10,1.81666666666667,2,-0.183333333333333,6,6,0,0,0
21700794,201163,DEN,CHA,Wilson Chandler,88,20.9833333333333,21,-0.0166666666666657,58,48,10,11,-1
21700794,201589,DEN,CHA,Darrell Arthur,58,13.9166666666667,14,-0.0833333333333322,30,30,0,0,0
21700794,203115,DEN,CHA,Will Barton,145,34.0333333333333,34,0.0333333333333314,88,71,17,17,0
21700794,203914,DEN,CHA,Gary Harris,143,33.3,34,-0.700000000000003,93,76,17,17,0
21700794,203999,DEN,CHA,Nikola Jokic,137,32.1166666666667,32,0.116666666666667,89,74,15,15,0
21700794,1626144,DEN,CHA,Emmanuel Mudiay,76,18.1,18,0.100000000000001,40,36,4,4,0
21700794,1626168,DEN,CHA,Trey Lyles,100,24.2833333333333,24,0.283333333333331,53,55,-2,-2,0
21700794,1627736,DEN,CHA,Malik Beasley,6,1.81666666666667,2,-0.183333333333333,2,0,2,2,0
21700794,1627750,DEN,CHA,Jamal Murray,133,32.0166666666667,32,0.0166666666666657,87,74,13,13,0
21700794,1627823,DEN,CHA,Juancho Hernangomez,6,1.81666666666667,2,-0.183333333333333,2,0,2,2,0
21700794,1628470,DEN,CHA,Torrey Craig,113,26.8666666666667,27,-0.133333333333333,63,56,7,6,1
21700794,2730,CHA,DEN,Dwight Howard,115,27.5833333333333,28,-0.416666666666664,62,81,-19,-17,-2
21700794,201587,CHA,DEN,Nicolas Batum,134,31.0333333333333,31,0.0333333333333314,69,91,-22,-22,0
21700794,202689,CHA,DEN,Kemba Walker,140,32.9833333333333,33,-0.0166666666666657,80,94,-14,-14,0
21700794,202933,CHA,DEN,Julyan Stone,11,2.96666666666667,3,-0.0333333333333332,0,2,-2,-2,0
21700794,203077,CHA,DEN,Michael Kidd-Gilchrist,118,28.0666666666667,28,0.0666666666666664,59,80,-21,-21,0
21700794,203087,CHA,DEN,Jeremy Lamb,108,25.6,25,0.600000000000001,64,56,8,8,0
21700794,203469,CHA,DEN,Cody Zeller,75,17.3,17,0.299999999999997,42,38,4,2,2
21700794,203487,CHA,DEN,Michael Carter-Williams,70,16.9666666666667,17,-0.0333333333333314,40,36,4,4,0
21700794,203948,CHA,DEN,Johnny O'Bryant III,11,2.96666666666667,3,-0.0333333333333332,0,2,-2,-2,0
21700794,1626163,CHA,DEN,Frank Kaminsky,93,21.8666666666667,22,-0.133333333333333,47,56,-9,-9,0
21700794,1626203,CHA,DEN,Treveon Graham,108,25.9833333333333,26,-0.0166666666666657,57,65,-8,-8,0
21700794,1628370,CHA,DEN,Malik Monk,11,2.96666666666667,3,-0.0333333333333332,0,2,-2,-2,0
21700794,1628407,CHA,DEN,Dwayne Bacon,11,2.96666666666667,3,-0.0333333333333332,0,2,-2,-2,0
21700795,201577,CHI,SAC,Robin Lopez,59,13.3333333333333,13,0.333333333333332,32,15,17,15,2
21700795,203200,CHI,SAC,Justin Holiday,168,35.7333333333333,36,-0.266666666666666,79,80,-1,-1,0
21700795,203897,CHI,SAC,Zach LaVine,139,31.1666666666667,31,0.166666666666664,61,75,-14,-12,-2
21700795,1626170,CHI,SAC,Jerian Grant,172,36.0833333333333,36,0.0833333333333286,80,84,-4,-6,2
21700795,1626171,CHI,SAC,Bobby Portis,152,32.7,32,0.700000000000003,72,78,-6,-4,-2
21700795,1626245,CHI,SAC,Cristiano Felicio,75,17.4166666666667,18,-0.583333333333336,25,45,-20,-16,-4
21700795,1627756,CHI,SAC,Denzel Valentine,101,22.4166666666667,22,0.416666666666664,47,40,7,7,0
21700795,1627835,CHI,SAC,Paul Zipser,137,32.0666666666667,32,0.0666666666666629,64,66,-2,-5,3
21700795,1627853,CHI,SAC,Ryan Arcidiacono,26,6.56666666666667,7,-0.433333333333334,10,12,-2,-2,0
21700795,1628021,CHI,SAC,David Nwaba,51,12.5166666666667,13,-0.483333333333334,20,25,-5,-6,1
21700795,1713,SAC,CHI,Vince Carter,65,15.5,16,-0.5,24,28,-4,-4,0
21700795,2216,SAC,CHI,Zach Randolph,125,28.3166666666667,29,-0.683333333333334,61,62,-1,2,-3
21700795,201585,SAC,CHI,Kosta Koufos,70,16.6,17,-0.399999999999999,32,27,5,3,2
21700795,201588,SAC,CHI,George Hill,117,25.5,26,-0.5,56,55,1,4,-3
21700795,202066,SAC,CHI,Garrett Temple,123,27.1,27,0.100000000000001,62,52,10,10,0
21700795,203960,SAC,CHI,JaKarr Sampson,83,18.55,18,0.549999999999997,48,45,3,3,0
21700795,203992,SAC,CHI,Bogdan Bogdanovic,139,30.55,31,-0.450000000000003,70,64,6,10,-4
21700795,1626161,SAC,CHI,Willie Cauley-Stein,83,16.8,17,-0.199999999999999,40,32,8,7,1
21700795,1627741,SAC,CHI,Buddy Hield,86,20.9833333333333,21,-0.0166666666666657,40,35,5,3,2
21700795,1628368,SAC,CHI,De'Aaron Fox,78,16.9333333333333,17,-0.0666666666666664,34,37,-3,-6,3
21700795,1628382,SAC,CHI,Justin Jackson,111,23.1666666666667,23,0.166666666666664,53,53,0,-2,2
21700796,1717,DAL,LAC,Dirk Nowitzki,110,24.3,25,-0.700000000000003,63,61,2,1,1
21700796,2734,DAL,LAC,Devin Harris,95,20,20,0,53,49,4,4,0
21700796,200826,DAL,LAC,J.J. Barea,106,22.2166666666667,23,-0.783333333333331,61,51,10,12,-2
21700796,202083,DAL,LAC,Wesley Matthews,154,34.7833333333333,34,0.783333333333331,69,68,1,2,-1
21700796,203939,DAL,LAC,Dwight Powell,127,28.9166666666667,29,-0.0833333333333357,72,66,6,5,1
21700796,1626257,DAL,LAC,Salah Mejri,104,22.45,22,0.449999999999999,39,40,-1,-1,0
21700796,1627812,DAL,LAC,Yogi Ferrell,141,32.35,32,0.350000000000001,62,67,-5,-5,0
21700796,1628372,DAL,LAC,Dennis Smith Jr.,155,35.0666666666667,35,0.0666666666666629,57,77,-20,-22,2
21700796,1628467,DAL,LAC,Maxi Kleber,93,19.9166666666667,19,0.916666666666664,29,41,-12,-11,-1
21700796,101150,LAC,DAL,Lou Williams,154,33.2666666666667,34,-0.733333333333334,70,71,-1,1,-2
21700796,201568,LAC,DAL,Danilo Gallinari,147,34.05,34,0.0499999999999972,70,70,0,0,0
21700796,201599,LAC,DAL,DeAndre Jordan,150,33.65,33,0.649999999999999,68,66,2,1,1
21700796,202325,LAC,DAL,Wesley Johnson,81,16.7666666666667,17,-0.233333333333334,40,41,-1,-1,0
21700796,202340,LAC,DAL,Avery Bradley,126,28.35,27,1.35,65,48,17,13,4
21700796,202699,LAC,DAL,Tobias Harris,155,35.15,35,0.149999999999999,70,69,1,-2,3
21700796,1626149,LAC,DAL,Montrezl Harrell,67,14.35,15,-0.649999999999999,36,35,1,2,-1
21700796,1626155,LAC,DAL,Sam Dekker,49,9.5,9,0.5,28,19,9,12,-3
21700796,1627820,LAC,DAL,Tyrone Wallace,63,13.2,14,-0.800000000000001,28,28,0,0,0
21700796,1628462,LAC,DAL,Milos Teodosic,93,21.7166666666667,22,-0.283333333333331,45,58,-13,-11,-2
21700797,2544,CLE,ORL,LeBron James,153,32.8166666666667,33,-0.183333333333337,62,76,-14,-14,0
21700797,2548,CLE,ORL,Dwyane Wade,105,22.35,22,0.350000000000001,44,47,-3,-1,-2
21700797,2594,CLE,ORL,Kyle Korver,106,22.9833333333333,23,-0.0166666666666657,43,49,-6,-5,-1
21700797,2747,CLE,ORL,JR Smith,120,25.6666666666667,26,-0.333333333333336,54,73,-19,-20,1
21700797,101112,CLE,ORL,Channing Frye,45,9.88333333333333,10,-0.116666666666667,20,23,-3,-1,-2
21700797,101181,CLE,ORL,Jose Calderon,9,2.33333333333333,3,-0.666666666666667,5,5,0,0,0
21700797,201145,CLE,ORL,Jeff Green,107,23.6833333333333,24,-0.31666666666667,45,48,-3,-4,1
21700797,201565,CLE,ORL,Derrick Rose,63,14.55,15,-0.450000000000001,28,26,2,1,1
21700797,202684,CLE,ORL,Tristan Thompson,126,26.7333333333333,27,-0.266666666666666,60,77,-17,-19,2
21700797,202738,CLE,ORL,Isaiah Thomas,142,29.6833333333333,30,-0.316666666666666,68,82,-14,-16,2
21700797,203109,CLE,ORL,Jae Crowder,125,25.7333333333333,26,-0.266666666666666,56,69,-13,-11,-2
21700797,1626224,CLE,ORL,Cedi Osman,9,2.33333333333333,3,-0.666666666666667,5,5,0,0,0
21700797,201167,ORL,CLE,Arron Afflalo,25,5.43333333333333,6,-0.566666666666666,7,12,-5,-7,2
21700797,201571,ORL,CLE,D.J. Augustin,108,24.1666666666667,25,-0.833333333333336,56,40,16,14,2
21700797,201578,ORL,CLE,Marreese Speights,36,7.16666666666667,7,0.166666666666666,17,19,-2,-2,0
21700797,202687,ORL,CLE,Bismack Biyombo,110,22.5833333333333,22,0.583333333333336,60,54,6,5,1
21700797,202714,ORL,CLE,Shelvin Mack,116,25.7,26,-0.299999999999997,58,42,16,14,2
21700797,203095,ORL,CLE,Evan Fournier,176,37.2333333333333,37,0.233333333333334,101,83,18,20,-2
21700797,203613,ORL,CLE,Jonathon Simmons,165,35.65,36,-0.350000000000001,91,75,16,18,-2
21700797,203901,ORL,CLE,Elfrid Payton,114,23.5833333333333,23,0.583333333333332,60,58,2,4,-2
21700797,203920,ORL,CLE,Khem Birch,76,18,18,0,39,25,14,15,-1
21700797,1626209,ORL,CLE,Mario Hezonja,121,25.9666666666667,26,-0.0333333333333314,64,56,8,10,-2
21700797,1628411,ORL,CLE,Wes Iwundu,63,13.2666666666667,13,0.266666666666666,27,26,1,-1,2
21700798,201143,BOS,TOR,Al Horford,111,24.5,24,0.5,38,55,-17,-15,-2
21700798,202681,BOS,TOR,Kyrie Irving,99,21.6666666666667,22,-0.333333333333332,36,56,-20,-22,2
21700798,202694,BOS,TOR,Marcus Morris,130,29.8166666666667,30,-0.183333333333334,49,67,-18,-20,2
21700798,203382,BOS,TOR,Aron Baynes,96,19.75,20,-0.25,42,50,-8,-6,-2
21700798,1626179,BOS,TOR,Terry Rozier,105,24.3,24,0.299999999999997,44,54,-10,-8,-2
21700798,1627759,BOS,TOR,Jaylen Brown,120,27.1666666666667,27,0.166666666666664,42,58,-16,-14,-2
21700798,1627824,BOS,TOR,Guerschon Yabusele,54,10.5,11,-0.5,31,25,6,6,0
21700798,1627846,BOS,TOR,Abdel Nader,70,14,14,0,38,32,6,6,0
21700798,1628369,BOS,TOR,Jayson Tatum,90,20.4666666666667,21,-0.533333333333331,31,47,-16,-16,0
21700798,1628400,BOS,TOR,Semi Ojeleye,90,19.9833333333333,20,-0.0166666666666657,37,53,-16,-18,2
21700798,1628443,BOS,TOR,Kadeem Allen,25,4.93333333333333,5,-0.0666666666666664,17,10,7,7,0
21700798,1628464,BOS,TOR,Daniel Theis,95,21.6666666666667,22,-0.333333333333336,50,48,2,0,2
21700798,101139,TOR,BOS,CJ Miles,70,15.3,15,0.299999999999999,44,30,14,16,-2
21700798,200768,TOR,BOS,Kyle Lowry,115,25.15,25,0.149999999999999,54,40,14,12,2
21700798,201586,TOR,BOS,Serge Ibaka,98,22.2,22,0.199999999999999,44,35,9,7,2
21700798,201942,TOR,BOS,DeMar DeRozan,131,29.4166666666667,29,0.416666666666664,62,49,13,11,2
21700798,202685,TOR,BOS,Jonas Valanciunas,90,20.15,21,-0.850000000000001,43,30,13,11,2
21700798,203512,TOR,BOS,Lucas Nogueira,17,3.46666666666667,4,-0.533333333333333,5,12,-7,-7,0
21700798,1626153,TOR,BOS,Delon Wright,110,24.6666666666667,25,-0.333333333333336,59,56,3,5,-2
21700798,1626181,TOR,BOS,Norman Powell,17,3.46666666666667,4,-0.533333333333333,5,12,-7,-7,0
21700798,1627751,TOR,BOS,Jakob Poeltl,110,24.1333333333333,24,0.133333333333333,63,49,14,16,-2
21700798,1627783,TOR,BOS,Pascal Siakam,118,25.1166666666667,25,0.116666666666667,67,56,11,13,-2
21700798,1627832,TOR,BOS,Fred VanVleet,142,31.0166666666667,31,0.0166666666666657,81,64,17,17,0
21700798,1628384,TOR,BOS,OG Anunoby,67,14.6666666666667,15,-0.333333333333332,28,22,6,6,0
21700799,101141,ATL,MEM,Ersan Ilyasova,90,19.1333333333333,19,0.133333333333333,45,24,21,21,0
21700799,202337,ATL,MEM,Luke Babbitt,52,11.8166666666667,12,-0.183333333333334,29,28,1,1,0
21700799,203101,ATL,MEM,Miles Plumlee,87,19.2333333333333,19,0.233333333333334,36,34,2,4,-2
21700799,203145,ATL,MEM,Kent Bazemore,93,19.85,20,-0.149999999999999,45,24,21,20,1
21700799,203471,ATL,MEM,Dennis Schroder,114,24.4166666666667,25,-0.583333333333336,57,27,30,27,3
21700799,203473,ATL,MEM,Dewayne Dedmon,89,19.2833333333333,19,0.283333333333331,46,32,14,14,0
21700799,203488,ATL,MEM,Mike Muscala,58,12.1666666666667,13,-0.833333333333332,32,22,10,8,2
21700799,1627098,ATL,MEM,Malcolm Delaney,72,14.9666666666667,15,-0.0333333333333332,31,33,-2,1,-3
21700799,1627752,ATL,MEM,Taurean Prince,126,26.4166666666667,26,0.416666666666668,50,40,10,11,-1
21700799,1627819,ATL,MEM,Isaiah Taylor,80,17.6333333333333,18,-0.366666666666667,44,39,5,5,0
21700799,1628381,ATL,MEM,John Collins,120,25.8166666666667,26,-0.18333333333333,57,52,5,5,0
21700799,1628416,ATL,MEM,Tyler Dorsey,129,28.35,29,-0.649999999999999,68,55,13,13,0
21700799,201148,MEM,ATL,Brandan Wright,62,14.1833333333333,15,-0.816666666666666,30,29,1,2,-1
21700799,201188,MEM,ATL,Marc Gasol,93,19.6333333333333,19,0.633333333333333,25,38,-13,-16,3
21700799,201596,MEM,ATL,Mario Chalmers,76,15.3833333333333,16,-0.616666666666667,25,40,-15,-14,-1
21700799,203210,MEM,ATL,JaMychal Green,107,22.8666666666667,23,-0.133333333333333,31,47,-16,-18,2
21700799,203463,MEM,ATL,Ben McLemore,101,22.4666666666667,22,0.466666666666669,41,47,-6,-9,3
21700799,203516,MEM,ATL,James Ennis III,108,24.0333333333333,24,0.0333333333333314,38,59,-21,-19,-2
21700799,1626150,MEM,ATL,Andrew Harrison,107,23.5666666666667,24,-0.433333333333334,47,52,-5,-5,0
21700799,1626185,MEM,ATL,Jarell Martin,84,18.4,19,-0.600000000000001,21,47,-26,-28,2
21700799,1627782,MEM,ATL,Wayne Selden,121,25.1833333333333,25,0.183333333333334,53,56,-3,-2,-1
21700799,1628397,MEM,ATL,Ivan Rabb,98,21.0166666666667,21,0.0166666666666657,48,49,-1,2,-3
21700799,1628415,MEM,ATL,Dillon Brooks,153,32.35,33,-0.649999999999999,51,76,-25,-23,-2
21700800,2403,HOU,BKN,Nene,61,14.35,15,-0.65,44,27,17,17,0
21700800,101108,HOU,BKN,Chris Paul,142,33.6166666666667,34,-0.38333333333334,92,77,15,13,2
21700800,101123,HOU,BKN,Gerald Green,81,17.85,18,-0.149999999999999,55,39,16,18,-2
21700800,200782,HOU,BKN,PJ Tucker,145,33.55,34,-0.450000000000003,81,81,0,0,0
21700800,201569,HOU,BKN,Eric Gordon,123,27.7333333333333,28,-0.266666666666666,70,65,5,7,-2
21700800,201583,HOU,BKN,Ryan Anderson,41,8.43333333333333,9,-0.566666666666666,22,22,0,0,0
21700800,201601,HOU,BKN,Luc Mbah a Moute,156,37.0833333333333,37,0.0833333333333286,93,87,6,4,2
21700800,201935,HOU,BKN,James Harden,146,34.1166666666667,34,0.116666666666667,81,88,-7,-7,0
21700800,203991,HOU,BKN,Clint Capela,140,31.35,32,-0.649999999999999,77,79,-2,-2,0
21700800,201960,BKN,HOU,DeMarre Carroll,127,29.8166666666667,30,-0.183333333333334,72,71,1,0,1
21700800,203459,BKN,HOU,Allen Crabbe,132,30.6,31,-0.399999999999999,77,73,4,4,0
21700800,203915,BKN,HOU,Spencer Dinwiddie,110,25.4333333333333,25,0.433333333333334,65,58,7,6,1
21700800,203917,BKN,HOU,Nik Stauskas,72,17.8,18,-0.200000000000003,39,52,-13,-13,0
21700800,203925,BKN,HOU,Joe Harris,125,28.3166666666667,28,0.316666666666666,68,66,2,2,0
21700800,1626143,BKN,HOU,Jahlil Okafor,103,24.25,25,-0.75,51,69,-18,-18,0
21700800,1626156,BKN,HOU,D'Angelo Russell,89,19.3833333333333,19,0.383333333333333,38,64,-26,-26,0
21700800,1626173,BKN,HOU,Rashad Vaughn,16,3.81666666666667,4,-0.183333333333334,12,8,4,4,0
21700800,1627747,BKN,HOU,Caris LeVert,56,12.2166666666667,12,0.216666666666667,26,38,-12,-11,-1
21700800,1627785,BKN,HOU,Isaiah Whitehead,21,5.28333333333333,6,-0.716666666666667,14,10,4,4,0
21700800,1627821,BKN,HOU,James Webb III,80,17.8,18,-0.199999999999999,41,52,-11,-10,-1
21700800,1628386,BKN,HOU,Jarrett Allen,104,23.3666666666667,23,0.366666666666667,62,54,8,8,0
21700801,1891,MIL,NYK,Jason Terry,91,18.8666666666667,20,-1.13333333333333,29,46,-17,-17,0
21700801,202339,MIL,NYK,Eric Bledsoe,135,29.0833333333333,29,0.0833333333333322,73,43,30,31,-1
21700801,203092,MIL,NYK,Tyler Zeller,28,5.73333333333333,6,-0.266666666666667,8,16,-8,-8,0
21700801,203114,MIL,NYK,Khris Middleton,160,34.35,34,0.350000000000001,84,58,26,27,-1
21700801,203503,MIL,NYK,Tony Snell,86,18.4,18,0.399999999999999,40,35,5,5,0
21700801,203507,MIL,NYK,Giannis Antetokounmpo,165,34.6666666666667,35,-0.333333333333336,72,62,10,11,-1
21700801,203930,MIL,NYK,Sean Kilpatrick,79,16.4833333333333,17,-0.516666666666666,32,39,-7,-7,0
21700801,203953,MIL,NYK,Jabari Parker,96,20.3833333333333,20,0.383333333333333,42,31,11,11,0
21700801,204098,MIL,NYK,Xavier Munford,8,1.48333333333333,2,-0.516666666666667,3,7,-4,-4,0
21700801,1627748,MIL,NYK,Thon Maker,105,22.0833333333333,22,0.0833333333333357,59,33,26,26,0
21700801,1627850,MIL,NYK,Marshall Plumlee,92,19.8333333333333,20,-0.166666666666664,35,40,-5,-4,-1
21700801,1628425,MIL,NYK,Sterling Brown,80,16.8833333333333,17,-0.116666666666667,33,35,-2,-1,-1
21700801,101127,NYK,MIL,Jarrett Jack,83,17.05,17,0.0500000000000007,28,44,-16,-14,-2
21700801,201563,NYK,MIL,Michael Beasley,116,24.5,24,0.5,38,50,-12,-12,0
21700801,201584,NYK,MIL,Courtney Lee,166,35.55,36,-0.450000000000003,60,79,-19,-20,1
21700801,202498,NYK,MIL,Lance Thomas,75,16.4166666666667,17,-0.583333333333336,28,40,-12,-13,1
21700801,202683,NYK,MIL,Enes Kanter,152,31.8833333333333,32,-0.116666666666667,53,80,-27,-25,-2
21700801,203124,NYK,MIL,Kyle O'Quinn,59,12.8666666666667,13,-0.133333333333333,33,17,16,13,3
21700801,203501,NYK,MIL,Tim Hardaway Jr.,127,26.2333333333333,26,0.233333333333334,50,57,-7,-9,2
21700801,203504,NYK,MIL,Trey Burke,104,22.4666666666667,23,-0.533333333333331,43,44,-1,-2,1
21700801,203926,NYK,MIL,Doug McDermott,68,14.6166666666667,15,-0.383333333333333,32,33,-1,-3,2
21700801,204001,NYK,MIL,Kristaps Porzingis,55,11.35,11,0.350000000000001,24,19,5,5,0
21700801,1626195,NYK,MIL,Willy Hernangomez,8,1.48333333333333,2,-0.516666666666667,7,3,4,4,0
21700801,1628373,NYK,MIL,Frank Ntilikina,48,9.81666666666667,10,-0.183333333333334,20,21,-1,-2,1
21700801,1628422,NYK,MIL,Damyean Dotson,64,14.0166666666667,14,0.0166666666666657,29,23,6,8,-2
21700802,101161,PHI,WAS,Amir Johnson,74,15.4333333333333,15,0.433333333333334,26,33,-7,-4,-3
21700802,200755,PHI,WAS,JJ Redick,150,33.1666666666667,33,0.166666666666671,87,76,11,7,4
21700802,201573,PHI,WAS,Jerryd Bayless,58,11.15,11,0.15,20,35,-15,-15,0
21700802,202344,PHI,WAS,Trevor Booker,43,8.68333333333333,9,-0.316666666666666,21,19,2,2,0
21700802,203496,PHI,WAS,Robert Covington,147,32.6166666666667,33,-0.383333333333333,78,61,17,18,-1
21700802,203954,PHI,WAS,Joel Embiid,146,31.9666666666667,32,-0.033333333333335,88,69,19,16,3
21700802,203967,PHI,WAS,Dario Saric,179,39.1833333333333,39,0.183333333333337,94,83,11,11,0
21700802,204456,PHI,WAS,T.J. McConnell,112,23.8,24,-0.199999999999999,58,43,15,17,-2
21700802,1626147,PHI,WAS,Justin Anderson,37,7.75,8,-0.25,21,16,5,4,1
21700802,1627732,PHI,WAS,Ben Simmons,164,35.5833333333333,36,-0.416666666666671,82,75,7,9,-2
21700802,101133,WAS,PHI,Ian Mahinmi,109,23.35,23,0.350000000000001,47,53,-6,-6,0
21700802,101162,WAS,PHI,Marcin Gortat,79,17.3833333333333,17,0.383333333333333,34,49,-15,-14,-1
21700802,201975,WAS,PHI,Jodie Meeks,22,4.65,5,-0.35,12,13,-1,-1,0
21700802,202693,WAS,PHI,Markieff Morris,108,23.7833333333333,24,-0.216666666666669,48,63,-15,-16,1
21700802,203078,WAS,PHI,Bradley Beal,187,40.4833333333333,41,-0.516666666666666,83,99,-16,-14,-2
21700802,203107,WAS,PHI,Tomas Satoransky,98,22.1,22,0.100000000000001,47,58,-11,-11,0
21700802,203118,WAS,PHI,Mike Scott,117,24.5,25,-0.5,53,51,2,2,0
21700802,203490,WAS,PHI,Otto Porter Jr.,157,34.2,34,0.200000000000003,73,91,-18,-15,-3
21700802,204025,WAS,PHI,Tim Frazier,73,15.3666666666667,15,0.366666666666667,33,26,7,4,3
21700802,1626162,WAS,PHI,Kelly Oubre Jr.,155,32.4833333333333,33,-0.516666666666666,77,71,6,6,0
21700802,1626191,WAS,PHI,Chris McCullough,5,1.03333333333333,1,0.0333333333333332,3,1,2,0,2
21700803,2561,GSW,OKC,David West,69,14.3,14,0.300000000000001,28,33,-5,-7,2
21700803,2585,GSW,OKC,Zaza Pachulia,68,13.35,13,0.350000000000001,28,39,-11,-12,1
21700803,2733,GSW,OKC,Shaun Livingston,69,14.3,14,0.300000000000001,28,33,-5,-7,2
21700803,2738,GSW,OKC,Andre Iguodala,120,21.9833333333333,22,-0.0166666666666657,47,54,-7,-7,0
21700803,201142,GSW,OKC,Kevin Durant,164,30.65,30,0.649999999999999,70,94,-24,-17,-7
21700803,201156,GSW,OKC,Nick Young,64,13.3166666666667,13,0.316666666666666,23,28,-5,2,-7
21700803,201580,GSW,OKC,JaVale McGee,31,6.5,6,0.5,14,11,3,1,2
21700803,201939,GSW,OKC,Stephen Curry,171,31.7833333333333,32,-0.216666666666669,74,94,-20,-14,-6
21700803,201956,GSW,OKC,Omri Casspi,37,8.2,8,0.199999999999999,20,21,-1,0,-1
21700803,202691,GSW,OKC,Klay Thompson,164,30.8833333333333,31,-0.116666666666667,58,80,-22,-17,-5
21700803,203110,GSW,OKC,Draymond Green,161,30.25,31,-0.75,58,74,-16,-13,-3
21700803,1626172,GSW,OKC,Kevon Looney,69,13.9833333333333,14,-0.0166666666666657,28,38,-10,-8,-2
21700803,1627775,GSW,OKC,Patrick McCaw,48,9.66666666666667,10,-0.333333333333332,24,26,-2,-1,-1
21700803,2546,OKC,GSW,Carmelo Anthony,34,6.01666666666667,6,0.0166666666666666,19,14,5,5,0
21700803,101109,OKC,GSW,Raymond Felton,66,13.6,14,-0.4,24,22,2,-2,4
21700803,201566,OKC,GSW,Russell Westbrook,191,36.1833333333333,36,0.183333333333337,108,82,26,21,5
21700803,202331,OKC,GSW,Paul George,190,35.85,36,-0.150000000000006,98,77,21,22,-1
21700803,202335,OKC,GSW,Patrick Patterson,154,29.5,30,-0.5,75,60,15,12,3
21700803,202713,OKC,GSW,Kyle Singler,10,2.38333333333333,3,-0.616666666666667,2,4,-2,-2,0
21700803,203500,OKC,GSW,Steven Adams,128,25.9833333333333,26,-0.0166666666666657,65,48,17,16,1
21700803,203518,OKC,GSW,Alex Abrines,123,24.65,24,0.649999999999999,60,50,10,7,3
21700803,203924,OKC,GSW,Jerami Grant,187,35.5666666666667,35,0.566666666666663,100,80,20,16,4
21700803,203962,OKC,GSW,Josh Huestis,132,24.6666666666667,24,0.666666666666664,70,55,15,9,6
21700803,1626177,OKC,GSW,Dakari Johnson,10,2.38333333333333,3,-0.616666666666667,2,4,-2,-2,0
21700803,1628390,OKC,GSW,Terrance Ferguson,10,2.38333333333333,3,-0.616666666666667,2,4,-2,-2,0
21700804,201147,LAL,PHX,Corey Brewer,50,9.26666666666667,9,0.266666666666668,20,23,-3,-3,0
21700804,201572,LAL,PHX,Brook Lopez,107,23.15,23,0.149999999999999,61,50,11,13,-2
21700804,203484,LAL,PHX,Kentavious Caldwell-Pope,129,27.6333333333333,28,-0.366666666666667,66,56,10,9,1
21700804,203898,LAL,PHX,Tyler Ennis,5,1.11666666666667,1,0.116666666666667,0,0,0,0,0
21700804,203903,LAL,PHX,Jordan Clarkson,133,26.7833333333333,27,-0.216666666666669,64,50,14,17,-3
21700804,203944,LAL,PHX,Julius Randle,126,27.3166666666667,27,0.316666666666666,68,53,15,12,3
21700804,1626204,LAL,PHX,Larry Nance Jr.,84,16.7,17,-0.300000000000001,36,35,1,1,0
21700804,1627742,LAL,PHX,Brandon Ingram,157,33.55,34,-0.450000000000003,85,65,20,20,0
21700804,1627826,LAL,PHX,Ivica Zubac,5,1.11666666666667,1,0.116666666666667,0,0,0,0,0
21700804,1627936,LAL,PHX,Alex Caruso,70,14.1333333333333,14,0.133333333333333,27,28,-1,-1,0
21700804,1628398,LAL,PHX,Kyle Kuzma,132,27.0833333333333,27,0.0833333333333357,59,48,11,12,-1
21700804,1628404,LAL,PHX,Josh Hart,137,30.5666666666667,31,-0.43333333333333,74,57,17,15,2
21700804,2199,PHX,LAL,Tyson Chandler,138,30.15,30,0.149999999999999,56,63,-7,-5,-2
21700804,203458,PHX,LAL,Alex Len,30,6.65,7,-0.35,17,20,-3,-7,4
21700804,203584,PHX,LAL,Troy Daniels,120,24.2833333333333,24,0.283333333333331,46,66,-20,-20,0
21700804,203933,PHX,LAL,T.J. Warren,161,35.6833333333333,36,-0.316666666666663,69,83,-14,-16,2
21700804,1627733,PHX,LAL,Dragan Bender,182,37.6,38,-0.399999999999999,73,83,-10,-10,0
21700804,1627737,PHX,LAL,Marquese Chriss,99,19.85,19,0.850000000000001,40,58,-18,-16,-2
21700804,1627755,PHX,LAL,Tyler Ulis,142,29.0833333333333,30,-0.916666666666668,63,63,0,-2,2
21700804,1627982,PHX,LAL,Josh Gray,78,16.8833333333333,17,-0.116666666666667,30,45,-15,-15,0
21700804,1628367,PHX,LAL,Josh Jackson,175,36,36,0,71,79,-8,-4,-4
21700804,1628409,PHX,LAL,Alec Peters,5,1.11666666666667,1,0.116666666666667,0,0,0,0,0
21700804,1628432,PHX,LAL,Davon Reed,5,1.11666666666667,1,0.116666666666667,0,0,0,0,0
21700805,201960,BKN,DET,DeMarre Carroll,162,33.2833333333333,33,0.283333333333331,82,80,2,-2,4
21700805,202389,BKN,DET,Timofey Mozgov,29,7.18333333333333,7,0.183333333333334,15,17,-2,0,-2
21700805,203459,BKN,DET,Allen Crabbe,176,35.75,36,-0.25,89,89,0,-2,2
21700805,203915,BKN,DET,Spencer Dinwiddie,168,35.5333333333333,36,-0.466666666666669,77,91,-14,-14,0
21700805,203917,BKN,DET,Nik Stauskas,53,11.9,12,-0.100000000000001,21,23,-2,-2,0
21700805,203925,BKN,DET,Joe Harris,175,35.4,36,-0.600000000000001,89,90,-1,1,-2
21700805,1626143,BKN,DET,Jahlil Okafor,41,8.96666666666667,9,-0.0333333333333332,8,22,-14,-18,4
21700805,1626156,BKN,DET,D'Angelo Russell,80,17,17,0,34,34,0,0,0
21700805,1627785,BKN,DET,Isaiah Whitehead,32,7.86666666666667,8,-0.133333333333333,8,18,-10,-10,0
21700805,1627821,BKN,DET,James Webb III,66,14.5333333333333,15,-0.466666666666667,24,35,-11,-7,-4
21700805,1628386,BKN,DET,Jarrett Allen,158,31.6666666666667,32,-0.333333333333336,83,76,7,9,-2
21700805,201229,DET,BKN,Anthony Tolliver,118,26.9166666666667,27,-0.0833333333333357,62,59,3,5,-2
21700805,201933,DET,BKN,Blake Griffin,161,33.3833333333333,34,-0.616666666666667,84,80,4,4,0
21700805,202397,DET,BKN,Ish Smith,147,29.7,30,-0.300000000000001,71,72,-1,-2,1
21700805,203083,DET,BKN,Andre Drummond,177,35.3333333333333,36,-0.666666666666671,84,73,11,9,2
21700805,203493,DET,BKN,Reggie Bullock,170,34.5666666666667,34,0.566666666666663,79,78,1,3,-2
21700805,204038,DET,BKN,Langston Galloway,81,18.1166666666667,18,0.116666666666667,44,34,10,11,-1
21700805,1626169,DET,BKN,Stanley Johnson,184,38.2333333333333,39,-0.766666666666666,98,86,12,8,4
21700805,1628379,DET,BKN,Luke Kennard,102,22.8333333333333,23,-0.166666666666668,53,48,5,7,-2
21700806,2403,HOU,MIA,Nene,79,18.9166666666667,19,-0.0833333333333322,41,37,4,4,0
21700806,101108,HOU,MIA,Chris Paul,152,36.5,36,0.5,84,85,-1,-1,0
21700806,101123,HOU,MIA,Gerald Green,111,25.4,26,-0.600000000000001,53,52,1,0,1
21700806,200782,HOU,MIA,PJ Tucker,176,41.1833333333333,41,0.183333333333337,98,83,15,16,-1
21700806,201601,HOU,MIA,Luc Mbah a Moute,155,36.55,37,-0.450000000000003,87,78,9,9,0
21700806,201935,HOU,MIA,James Harden,157,36.4,36,0.399999999999999,83,75,8,9,-1
21700806,203900,HOU,MIA,Markel Brown,69,15.6333333333333,16,-0.366666666666667,31,31,0,-1,1
21700806,203991,HOU,MIA,Clint Capela,126,29,29,0,68,64,4,4,0
21700806,201609,MIA,HOU,Goran Dragic,156,37.7333333333333,38,-0.266666666666666,86,77,9,7,2
21700806,201949,MIA,HOU,James Johnson,155,36.5166666666667,36,0.516666666666666,72,82,-10,-10,0
21700806,202355,MIA,HOU,Hassan Whiteside,137,32.6166666666667,33,-0.383333333333333,74,69,5,3,2
21700806,204020,MIA,HOU,Tyler Johnson,147,34.4166666666667,34,0.416666666666671,65,78,-13,-12,-1
21700806,1626159,MIA,HOU,Justise Winslow,113,25.3833333333333,25,0.383333333333333,53,68,-15,-13,-2
21700806,1626196,MIA,HOU,Josh Richardson,165,39.0666666666667,39,0.0666666666666629,86,89,-3,-1,-2
21700806,1627884,MIA,HOU,Derrick Jones Jr.,84,18.55,19,-0.449999999999999,42,42,0,-3,3
21700806,1628389,MIA,HOU,Bam Adebayo,68,15.3,15,0.300000000000001,27,40,-13,-11,-2
21700807,2544,CLE,MIN,LeBron James,204,48.2,48,0.200000000000003,127,130,-3,-1,-2
21700807,2594,CLE,MIN,Kyle Korver,78,18.6166666666667,19,-0.383333333333333,46,41,5,7,-2
21700807,2747,CLE,MIN,JR Smith,153,36,36,0,96,96,0,0,0
21700807,101112,CLE,MIN,Channing Frye,82,19.95,20,-0.0500000000000007,40,42,-2,0,-2
21700807,201145,CLE,MIN,Jeff Green,126,29.6333333333333,29,0.633333333333333,75,66,9,6,3
21700807,201565,CLE,MIN,Derrick Rose,36,7.53333333333333,7,0.533333333333333,24,20,4,3,1
21700807,202684,CLE,MIN,Tristan Thompson,126,29.0166666666667,29,0.0166666666666657,85,87,-2,-4,2
21700807,202738,CLE,MIN,Isaiah Thomas,129,30.6,31,-0.399999999999999,83,88,-5,-6,1
21700807,203109,CLE,MIN,Jae Crowder,104,23.4333333333333,24,-0.566666666666666,68,70,-2,-2,0
21700807,1626224,CLE,MIN,Cedi Osman,97,22.0166666666667,21,1.01666666666667,56,50,6,7,-1
21700807,2037,MIN,CLE,Jamal Crawford,89,19.8333333333333,20,-0.166666666666664,44,55,-11,-12,1
21700807,201952,MIN,CLE,Jeff Teague,164,38.6666666666667,39,-0.333333333333336,104,104,0,2,-2
21700807,201959,MIN,CLE,Taj Gibson,150,34.85,35,-0.149999999999999,100,98,2,4,-2
21700807,202357,MIN,CLE,Nemanja Bjelica,76,17.7666666666667,17,0.766666666666666,38,42,-4,-6,2
21700807,202710,MIN,CLE,Jimmy Butler,198,46.7666666666667,46,0.766666666666666,125,124,1,1,0
21700807,203476,MIN,CLE,Gorgui Dieng,71,15.8333333333333,16,-0.166666666666668,39,41,-2,-3,1
21700807,203952,MIN,CLE,Andrew Wiggins,168,39.7833333333333,40,-0.216666666666669,107,101,6,7,-1
21700807,1626145,MIN,CLE,Tyus Jones,63,14.3333333333333,14,0.333333333333332,34,36,-2,-4,2
21700807,1626157,MIN,CLE,Karl-Anthony Towns,156,37.1666666666667,37,0.166666666666664,99,99,0,1,-1
21700808,2207,UTA,MEM,Joe Johnson,104,23.7,23,0.699999999999999,42,43,-1,-1,0
21700808,201937,UTA,MEM,Ricky Rubio,131,28.4833333333333,29,-0.516666666666666,57,58,-1,-3,2
21700808,201973,UTA,MEM,Jonas Jerebko,12,2.58333333333333,3,-0.416666666666667,2,2,0,0,0
21700808,202324,UTA,MEM,Derrick Favors,138,31.85,33,-1.15,66,56,10,10,0
21700808,203497,UTA,MEM,Rudy Gobert,174,37.8666666666667,38,-0.133333333333333,74,75,-1,-1,0
21700808,203526,UTA,MEM,Raul Neto,74,17.4333333333333,17,0.433333333333334,33,28,5,7,-2
21700808,203918,UTA,MEM,Rodney Hood,99,23.0833333333333,23,0.0833333333333322,42,37,5,4,1
21700808,204060,UTA,MEM,Joe Ingles,129,28.35,28,0.350000000000001,59,60,-1,-1,0
21700808,1626220,UTA,MEM,Royce O'Neale,66,15.45,15,0.449999999999999,28,19,9,9,0
21700808,1628378,UTA,MEM,Donovan Mitchell,143,31.2,31,0.199999999999996,57,62,-5,-4,-1
21700808,201188,MEM,UTA,Marc Gasol,166,36.7166666666667,37,-0.283333333333331,70,74,-4,-4,0
21700808,201596,MEM,UTA,Mario Chalmers,103,22.6833333333333,23,-0.316666666666666,37,41,-4,-4,0
21700808,203210,MEM,UTA,JaMychal Green,139,29.8333333333333,30,-0.166666666666664,68,62,6,6,0
21700808,203516,MEM,UTA,James Ennis III,108,24.95,25,-0.0500000000000007,41,40,1,1,0
21700808,1626150,MEM,UTA,Andrew Harrison,152,35.0333333333333,35,0.0333333333333314,66,75,-9,-10,1
21700808,1626185,MEM,UTA,Jarell Martin,131,30.7833333333333,31,-0.216666666666669,44,61,-17,-13,-4
21700808,1627782,MEM,UTA,Wayne Selden,80,16.8833333333333,17,-0.116666666666667,31,27,4,-2,6
21700808,1628397,MEM,UTA,Ivan Rabb,48,11.2833333333333,11,0.283333333333333,18,18,0,0,0
21700808,1628415,MEM,UTA,Dillon Brooks,143,31.8333333333333,31,0.833333333333332,65,62,3,6,-3
21700809,2731,NOP,IND,Emeka Okafor,39,8.91666666666667,9,-0.0833333333333339,14,16,-2,-4,2
21700809,200765,NOP,IND,Rajon Rondo,140,28.4,29,-0.600000000000001,60,55,5,5,0
21700809,201950,NOP,IND,Jrue Holiday,160,33.05,33,0.0499999999999972,65,66,-1,-1,0
21700809,202703,NOP,IND,Nikola Mirotic,141,28.25,28,0.25,55,60,-5,-4,-1
21700809,202734,NOP,IND,E'Twaun Moore,173,34.1166666666667,34,0.116666666666667,73,64,9,9,0
21700809,203076,NOP,IND,Anthony Davis,165,34.7833333333333,35,-0.216666666666669,72,68,4,9,-5
21700809,203121,NOP,IND,Darius Miller,92,20.75,21,-0.25,37,36,1,-1,2
21700809,203546,NOP,IND,Ian Clark,108,24.2333333333333,24,0.233333333333334,42,43,-1,1,-2
21700809,203580,NOP,IND,Larry Drew II,32,7.48333333333333,7,0.483333333333333,18,16,2,2,0
21700809,1627767,NOP,IND,Cheick Diallo,100,20.0166666666667,20,0.0166666666666657,44,36,8,4,4
21700809,2744,IND,NOP,Al Jefferson,48,9.36666666666667,9,0.366666666666667,12,20,-8,-6,-2
21700809,201152,IND,NOP,Thaddeus Young,146,31.1333333333333,31,0.133333333333333,62,56,6,7,-1
21700809,201954,IND,NOP,Darren Collison,145,30.9,31,-0.100000000000001,60,62,-2,-4,2
21700809,202344,IND,NOP,Trevor Booker,83,17.45,17,0.449999999999999,34,34,0,-1,1
21700809,202362,IND,NOP,Lance Stephenson,69,13.8833333333333,13,0.883333333333333,26,28,-2,-3,1
21700809,202709,IND,NOP,Cory Joseph,120,23.5666666666667,23,0.566666666666666,44,59,-15,-11,-4
21700809,202711,IND,NOP,Bojan Bogdanovic,159,33.3166666666667,34,-0.683333333333337,64,70,-6,-9,3
21700809,203506,IND,NOP,Victor Oladipo,159,35.1833333333333,35,0.18333333333333,74,64,10,10,0
21700809,203922,IND,NOP,Glenn Robinson III,59,10.65,11,-0.350000000000001,16,22,-6,-6,0
21700809,1626167,IND,NOP,Myles Turner,162,34.55,35,-0.450000000000003,68,65,3,3,0
21700810,201162,PHX,SAS,Jared Dudley,28,5.8,6,-0.2,16,17,-1,-1,0
21700810,203458,PHX,SAS,Alex Len,97,18.2,18,0.199999999999999,33,40,-7,-8,1
21700810,203584,PHX,SAS,Troy Daniels,53,9.98333333333333,10,-0.0166666666666657,14,26,-12,-13,1
21700810,203933,PHX,SAS,T.J. Warren,139,28.95,29,-0.0499999999999972,40,76,-36,-36,0
21700810,1627733,PHX,SAS,Dragan Bender,150,31.2,32,-0.800000000000001,47,89,-42,-41,-1
21700810,1627737,PHX,SAS,Marquese Chriss,140,28.7166666666667,29,-0.283333333333335,40,86,-46,-46,0
21700810,1627755,PHX,SAS,Tyler Ulis,40,9.13333333333333,9,0.133333333333333,8,23,-15,-14,-1
21700810,1627863,PHX,SAS,Danuel House Jr.,76,14.7333333333333,15,-0.266666666666668,32,38,-6,-6,0
21700810,1627982,PHX,SAS,Josh Gray,161,31.45,31,0.449999999999999,65,83,-18,-19,1
21700810,1628367,PHX,SAS,Josh Jackson,162,32.6666666666667,33,-0.333333333333329,47,95,-48,-47,-1
21700810,1628409,PHX,SAS,Alec Peters,67,11.8833333333333,12,-0.116666666666667,26,26,0,0,0
21700810,1628432,PHX,SAS,Davon Reed,92,16.7833333333333,17,-0.216666666666669,37,46,-9,-9,0
21700810,1938,SAS,PHX,Manu Ginobili,82,15.4833333333333,15,0.483333333333333,49,22,27,29,-2
21700810,2200,SAS,PHX,Pau Gasol,117,22.8166666666667,23,-0.183333333333334,63,35,28,29,-1
21700810,2225,SAS,PHX,Tony Parker,86,17.4833333333333,17,0.483333333333334,44,26,18,18,0
21700810,200746,SAS,PHX,LaMarcus Aldridge,134,27.65,28,-0.350000000000001,71,38,33,33,0
21700810,201980,SAS,PHX,Danny Green,100,22.2,22,0.199999999999999,53,31,22,21,1
21700810,201988,SAS,PHX,Patty Mills,90,16.9,17,-0.100000000000001,51,22,29,30,-1
21700810,202722,SAS,PHX,Davis Bertans,128,26.1666666666667,26,0.166666666666664,69,48,21,20,1
21700810,203464,SAS,PHX,Brandon Paul,61,10.9166666666667,11,-0.0833333333333339,26,26,0,0,0
21700810,203530,SAS,PHX,Joffrey Lauvergne,78,14.3166666666667,14,0.316666666666666,41,33,8,8,0
21700810,203937,SAS,PHX,Kyle Anderson,85,18.7666666666667,19,-0.233333333333334,47,26,21,22,-1
21700810,1627749,SAS,PHX,Dejounte Murray,57,12.8,13,-0.199999999999999,39,17,22,21,1
21700810,1627854,SAS,PHX,Bryn Forbes,121,22.1,22,0.100000000000001,60,50,10,8,2
21700810,1628401,SAS,PHX,Derrick White,66,11.9,12,-0.100000000000001,32,31,1,1,0
21700811,101141,ATL,ORL,Ersan Ilyasova,72,15.0166666666667,15,0.0166666666666675,27,32,-5,-7,2
21700811,203101,ATL,ORL,Miles Plumlee,81,17.8166666666667,18,-0.18333333333333,34,43,-9,-11,2
21700811,203145,ATL,ORL,Kent Bazemore,112,23.8666666666667,24,-0.133333333333333,47,46,1,-1,2
21700811,203471,ATL,ORL,Dennis Schroder,144,31.1333333333333,31,0.133333333333333,68,67,1,1,0
21700811,203473,ATL,ORL,Dewayne Dedmon,109,24.1166666666667,24,0.116666666666667,53,46,7,9,-2
21700811,203488,ATL,ORL,Mike Muscala,64,13.15,13,0.15,23,25,-2,-2,0
21700811,1627098,ATL,ORL,Malcolm Delaney,89,19.8666666666667,20,-0.133333333333333,41,41,0,2,-2
21700811,1627752,ATL,ORL,Taurean Prince,142,30.9666666666667,31,-0.0333333333333314,66,73,-7,-7,0
21700811,1627819,ATL,ORL,Isaiah Taylor,65,13.2166666666667,13,0.216666666666667,20,23,-3,-3,0
21700811,1628381,ATL,ORL,John Collins,120,25.9,26,-0.100000000000001,59,54,5,7,-2
21700811,1628416,ATL,ORL,Tyler Dorsey,117,24.95,25,-0.0500000000000007,52,50,2,2,0
21700811,201167,ORL,ATL,Arron Afflalo,30,6.3,6,0.300000000000001,8,9,-1,1,-2
21700811,201571,ORL,ATL,D.J. Augustin,166,35.15,35,0.150000000000006,77,74,3,3,0
21700811,201578,ORL,ATL,Marreese Speights,80,17.2,17,0.199999999999999,33,32,1,1,0
21700811,202687,ORL,ATL,Bismack Biyombo,126,27.75,28,-0.25,65,61,4,6,-2
21700811,202714,ORL,ATL,Shelvin Mack,101,21.9166666666667,22,-0.0833333333333357,38,39,-1,0,-1
21700811,203095,ORL,ATL,Evan Fournier,148,32.3833333333333,32,0.383333333333333,69,71,-2,-2,0
21700811,203613,ORL,ATL,Jonathon Simmons,159,33.9,34,-0.100000000000001,75,73,2,0,2
21700811,203920,ORL,ATL,Khem Birch,96,20.25,20,0.25,35,37,-2,-4,2
21700811,1626209,ORL,ATL,Mario Hezonja,132,28.7166666666667,29,-0.283333333333331,67,62,5,5,0
21700811,1628411,ORL,ATL,Wes Iwundu,77,16.4333333333333,16,0.433333333333334,33,32,1,0,1
21700812,101127,NYK,TOR,Jarrett Jack,103,22.8666666666667,23,-0.133333333333333,43,47,-4,-6,2
21700812,201563,NYK,TOR,Michael Beasley,148,30.7,31,-0.299999999999997,58,69,-11,-10,-1
21700812,201584,NYK,TOR,Courtney Lee,132,27.9,28,-0.100000000000001,50,63,-13,-15,2
21700812,202498,NYK,TOR,Lance Thomas,106,22.1333333333333,22,0.133333333333333,40,58,-18,-15,-3
21700812,203124,NYK,TOR,Kyle O'Quinn,122,25.9666666666667,26,-0.033333333333335,42,57,-15,-15,0
21700812,203501,NYK,TOR,Tim Hardaway Jr.,139,29.8333333333333,30,-0.166666666666664,54,64,-10,-11,1
21700812,203504,NYK,TOR,Trey Burke,60,13.05,13,0.0500000000000007,26,41,-15,-14,-1
21700812,1628373,NYK,TOR,Frank Ntilikina,95,20.6833333333333,21,-0.316666666666666,36,52,-16,-15,-1
21700812,1628422,NYK,TOR,Damyean Dotson,28,6.78333333333333,7,-0.216666666666667,15,14,1,1,0
21700812,1628436,NYK,TOR,Luke Kornet,99,21.7833333333333,22,-0.216666666666669,46,56,-10,-10,0
21700812,1628439,NYK,TOR,Isaiah Hicks,73,17.05,17,0.0500000000000007,30,44,-14,-15,1
21700812,101139,TOR,NYK,CJ Miles,91,20.2833333333333,20,0.283333333333331,62,40,22,23,-1
21700812,200768,TOR,NYK,Kyle Lowry,116,24.7666666666667,25,-0.233333333333334,50,46,4,5,-1
21700812,201586,TOR,NYK,Serge Ibaka,116,24.7666666666667,25,-0.233333333333334,50,46,4,5,-1
21700812,201942,TOR,NYK,DeMar DeRozan,134,28.9166666666667,29,-0.0833333333333357,58,52,6,8,-2
21700812,202685,TOR,NYK,Jonas Valanciunas,114,24.1333333333333,24,0.133333333333333,50,44,6,7,-1
21700812,203512,TOR,NYK,Lucas Nogueira,17,3.53333333333333,4,-0.466666666666667,4,8,-4,-4,0
21700812,1626153,TOR,NYK,Delon Wright,99,21.6666666666667,22,-0.333333333333332,61,41,20,18,2
21700812,1626181,TOR,NYK,Norman Powell,17,3.53333333333333,4,-0.466666666666667,4,8,-4,-4,0
21700812,1627751,TOR,NYK,Jakob Poeltl,90,20.0833333333333,20,0.0833333333333357,59,36,23,22,1
21700812,1627783,TOR,NYK,Pascal Siakam,105,22.9833333333333,23,-0.0166666666666657,63,42,21,20,1
21700812,1627832,TOR,NYK,Fred VanVleet,107,23.6166666666667,24,-0.383333333333333,63,44,19,18,1
21700812,1628384,TOR,NYK,OG Anunoby,99,20.4666666666667,21,-0.533333333333331,41,33,8,7,1
21700813,201143,BOS,WAS,Al Horford,158,34.5333333333333,35,-0.466666666666669,71,71,0,0,0
21700813,202328,BOS,WAS,Greg Monroe,94,19.5,20,-0.5,41,35,6,9,-3
21700813,202681,BOS,WAS,Kyrie Irving,153,33.2,33,0.200000000000003,69,67,2,-2,4
21700813,202694,BOS,WAS,Marcus Morris,147,31.9,31,0.899999999999999,63,67,-4,-4,0
21700813,203382,BOS,WAS,Aron Baynes,65,13.9833333333333,14,-0.0166666666666657,33,29,4,6,-2
21700813,1626179,BOS,WAS,Terry Rozier,141,30.7166666666667,30,0.716666666666665,62,64,-2,-4,2
21700813,1627759,BOS,WAS,Jaylen Brown,178,37.3333333333333,38,-0.666666666666671,86,78,8,6,2
21700813,1628369,BOS,WAS,Jayson Tatum,172,36.4833333333333,36,0.483333333333334,72,61,11,13,-2
21700813,1628464,BOS,WAS,Daniel Theis,137,27.35,28,-0.649999999999999,53,48,5,6,-1
21700813,101133,WAS,BOS,Ian Mahinmi,79,15.8,16,-0.199999999999999,27,33,-6,-8,2
21700813,101162,WAS,BOS,Marcin Gortat,142,30.5833333333333,31,-0.416666666666668,57,68,-11,-6,-5
21700813,201975,WAS,BOS,Jodie Meeks,44,8.58333333333333,9,-0.416666666666666,14,21,-7,-6,-1
21700813,202693,WAS,BOS,Markieff Morris,126,28.2666666666667,29,-0.733333333333334,64,57,7,6,1
21700813,203078,WAS,BOS,Bradley Beal,205,44.4166666666667,44,0.416666666666664,90,89,1,0,1
21700813,203107,WAS,BOS,Tomas Satoransky,159,34.4833333333333,34,0.483333333333334,72,72,0,5,-5
21700813,203118,WAS,BOS,Mike Scott,77,15.5,15,0.5,28,33,-5,-5,0
21700813,203490,WAS,BOS,Otto Porter Jr.,182,40.0833333333333,40,0.0833333333333286,82,82,0,0,0
21700813,204025,WAS,BOS,Tim Frazier,73,14.1833333333333,14,0.183333333333334,24,31,-7,-7,0
21700813,1626162,WAS,BOS,Kelly Oubre Jr.,158,33.1,33,0.100000000000001,62,64,-2,-9,7
21700814,202323,POR,CHA,Evan Turner,87,19.6166666666667,20,-0.383333333333333,38,41,-3,4,-7
21700814,202329,POR,CHA,Al-Farouq Aminu,166,36.15,36,0.149999999999999,77,67,10,8,2
21700814,202334,POR,CHA,Ed Davis,78,18.3166666666667,18,0.316666666666666,31,43,-12,-7,-5
21700814,203081,POR,CHA,Damian Lillard,190,42.0333333333333,42,0.0333333333333314,85,84,1,4,-3
21700814,203086,POR,CHA,Meyers Leonard,10,2.13333333333333,2,0.133333333333333,5,8,-3,-1,-2
21700814,203090,POR,CHA,Maurice Harkless,147,31.9166666666667,32,-0.0833333333333357,66,59,7,7,0
21700814,203468,POR,CHA,CJ McCollum,186,40.8333333333333,41,-0.166666666666664,85,75,10,14,-4
21700814,203894,POR,CHA,Shabazz Napier,71,15.8,16,-0.200000000000001,28,34,-6,-8,2
21700814,203994,POR,CHA,Jusuf Nurkic,151,32.55,33,-0.450000000000003,70,54,16,14,2
21700814,1626192,POR,CHA,Pat Connaughton,36,8.8,9,-0.199999999999999,16,22,-6,-3,-3
21700814,1628380,POR,CHA,Zach Collins,73,16.85,17,-0.149999999999999,29,38,-9,-2,-7
21700814,2730,CHA,POR,Dwight Howard,179,39.0166666666667,39,0.0166666666666657,77,81,-4,-9,5
21700814,101107,CHA,POR,Marvin Williams,107,23.4333333333333,23,0.433333333333334,42,56,-14,-15,1
21700814,201587,CHA,POR,Nicolas Batum,179,39.0166666666667,39,0.0166666666666657,77,81,-4,-9,5
21700814,202689,CHA,POR,Kemba Walker,179,40.05,39,1.05,77,83,-6,-3,-3
21700814,203077,CHA,POR,Michael Kidd-Gilchrist,126,28.8666666666667,29,-0.133333333333333,51,61,-10,-16,6
21700814,203087,CHA,POR,Jeremy Lamb,96,20.7666666666667,21,-0.233333333333334,46,40,6,5,1
21700814,203469,CHA,POR,Cody Zeller,60,13.9833333333333,14,-0.0166666666666675,28,25,3,3,0
21700814,203487,CHA,POR,Michael Carter-Williams,60,12.95,14,-1.05,28,23,5,-3,8
21700814,1626163,CHA,POR,Frank Kaminsky,132,29.5666666666667,30,-0.433333333333337,63,50,13,9,4
21700814,1626203,CHA,POR,Treveon Graham,77,17.35,17,0.350000000000001,36,30,6,8,-2
21700815,1717,DAL,GSW,Dirk Nowitzki,136,27.6166666666667,28,-0.383333333333333,71,62,9,11,-2
21700815,200826,DAL,GSW,J.J. Barea,138,27.8833333333333,28,-0.116666666666667,73,62,11,9,2
21700815,202083,DAL,GSW,Wesley Matthews,138,28.7166666666667,29,-0.283333333333331,66,69,-3,-4,1
21700815,203939,DAL,GSW,Dwight Powell,149,30.9166666666667,31,-0.0833333333333357,78,74,4,6,-2
21700815,1626257,DAL,GSW,Salah Mejri,79,16.9666666666667,17,-0.0333333333333314,25,47,-22,-24,2
21700815,1627812,DAL,GSW,Yogi Ferrell,139,30.8833333333333,31,-0.116666666666667,53,82,-29,-25,-4
21700815,1627858,DAL,GSW,Kyle Collinsworth,90,19.1666666666667,19,0.166666666666668,37,52,-15,-14,-1
21700815,1627883,DAL,GSW,Jalen Jones,30,7.15,7,0.15,13,14,-1,-1,0
21700815,1628372,DAL,GSW,Dennis Smith Jr.,149,29.85,30,-0.149999999999999,67,84,-17,-19,2
21700815,1628467,DAL,GSW,Maxi Kleber,92,20.2666666666667,20,0.266666666666666,32,59,-27,-29,2
21700815,2561,GSW,DAL,David West,74,16.6333333333333,17,-0.366666666666667,46,25,21,19,2
21700815,2585,GSW,DAL,Zaza Pachulia,65,11.9666666666667,12,-0.0333333333333332,24,34,-10,-10,0
21700815,2733,GSW,DAL,Shaun Livingston,55,12.8333333333333,13,-0.166666666666668,34,18,16,18,-2
21700815,2738,GSW,DAL,Andre Iguodala,112,25.85,26,-0.149999999999999,69,45,24,26,-2
21700815,201142,GSW,DAL,Kevin Durant,149,29.6666666666667,30,-0.333333333333336,77,72,5,3,2
21700815,201156,GSW,DAL,Nick Young,47,10.1333333333333,9,1.13333333333333,18,27,-9,-9,0
21700815,201580,GSW,DAL,JaVale McGee,19,3.78333333333333,4,-0.216666666666667,10,11,-1,-1,0
21700815,201939,GSW,DAL,Stephen Curry,149,29.6666666666667,30,-0.333333333333336,77,72,5,3,2
21700815,201956,GSW,DAL,Omri Casspi,19,3.78333333333333,4,-0.216666666666667,10,11,-1,-1,0
21700815,202691,GSW,DAL,Klay Thompson,157,34.1333333333333,34,0.133333333333333,81,69,12,18,-6
21700815,203110,GSW,DAL,Draymond Green,154,32.0833333333333,32,0.0833333333333286,79,68,11,11,0
21700815,1626172,GSW,DAL,Kevon Looney,74,15.8,16,-0.199999999999999,42,35,7,7,0
21700815,1627775,GSW,DAL,Patrick McCaw,66,13.0833333333333,13,0.0833333333333322,38,28,10,6,4
21700816,201147,LAL,OKC,Corey Brewer,94,18.9,19,-0.100000000000001,45,22,23,23,0
21700816,201572,LAL,OKC,Brook Lopez,114,24,24,0,56,49,7,10,-3
21700816,203484,LAL,OKC,Kentavious Caldwell-Pope,142,30.7833333333333,31,-0.216666666666669,71,54,17,19,-2
21700816,203898,LAL,OKC,Tyler Ennis,18,4.03333333333333,4,0.0333333333333332,7,8,-1,-1,0
21700816,203944,LAL,OKC,Julius Randle,138,28.7833333333333,28,0.783333333333331,70,58,12,10,2
21700816,1627742,LAL,OKC,Brandon Ingram,153,32.8833333333333,33,-0.116666666666667,78,60,18,19,-1
21700816,1627780,LAL,OKC,Gary Payton II,15,3.1,3,0.1,7,5,2,2,0
21700816,1627826,LAL,OKC,Ivica Zubac,75,17.0166666666667,17,0.0166666666666657,32,21,11,10,1
21700816,1627936,LAL,OKC,Alex Caruso,86,18.2666666666667,18,0.266666666666666,34,24,10,7,3
21700816,1628398,LAL,OKC,Kyle Kuzma,116,24.0166666666667,24,0.0166666666666657,50,31,19,19,0
21700816,1628404,LAL,OKC,Josh Hart,156,32.85,33,-0.150000000000006,73,65,8,8,0
21700816,1628418,LAL,OKC,Thomas Bryant,18,4.03333333333333,4,0.0333333333333332,7,8,-1,-1,0
21700816,2555,OKC,LAL,Nick Collison,38,8.05,8,0.0499999999999989,9,17,-8,-8,0
21700816,101109,OKC,LAL,Raymond Felton,146,31.1,31,0.100000000000001,58,74,-16,-17,1
21700816,202331,OKC,LAL,Paul George,163,34.1,34,0.0999999999999943,65,80,-15,-16,1
21700816,202335,OKC,LAL,Patrick Patterson,121,25.9,26,-0.100000000000001,50,60,-10,-12,2
21700816,202713,OKC,LAL,Kyle Singler,24,5.38333333333333,6,-0.616666666666667,8,9,-1,-1,0
21700816,203500,OKC,LAL,Steven Adams,152,32.6666666666667,33,-0.333333333333329,60,71,-11,-13,2
21700816,203518,OKC,LAL,Alex Abrines,118,24.5,24,0.5,29,55,-26,-28,2
21700816,203924,OKC,LAL,Jerami Grant,112,23.1666666666667,23,0.166666666666668,35,50,-15,-11,-4
21700816,203962,OKC,LAL,Josh Huestis,78,16.4833333333333,17,-0.516666666666666,37,36,1,2,-1
21700816,1626177,OKC,LAL,Dakari Johnson,35,7.01666666666667,7,0.0166666666666666,12,18,-6,-4,-2
21700816,1627772,OKC,LAL,Daniel Hamilton,69,15.4666666666667,16,-0.533333333333335,22,30,-8,-8,0
21700816,1628390,OKC,LAL,Terrance Ferguson,60,12.9,13,-0.0999999999999996,16,25,-9,-8,-1
21700816,1628408,OKC,LAL,PJ Dozier,9,1.93333333333333,2,-0.0666666666666667,4,5,-1,-1,0
21700817,101150,LAC,DET,Lou Williams,139,30.7,31,-0.300000000000001,76,60,16,16,0
21700817,201568,LAC,DET,Danilo Gallinari,128,27.9333333333333,28,-0.06666666666667,55,52,3,1,2
21700817,201599,LAC,DET,DeAndre Jordan,123,29,29,0,65,56,9,10,-1
21700817,202325,LAC,DET,Wesley Johnson,82,17.2333333333333,17,0.233333333333334,44,36,8,8,0
21700817,202340,LAC,DET,Avery Bradley,118,27.6666666666667,28,-0.333333333333336,55,52,3,3,0
21700817,202699,LAC,DET,Tobias Harris,139,31.55,31,0.549999999999997,69,67,2,0,2
21700817,203085,LAC,DET,Austin Rivers,135,32,32,0,64,58,6,7,-1
21700817,1626149,LAC,DET,Montrezl Harrell,93,18.9166666666667,19,-0.0833333333333357,43,39,4,3,1
21700817,1626155,LAC,DET,Sam Dekker,42,8.66666666666667,9,-0.333333333333332,25,18,7,11,-4
21700817,1627820,LAC,DET,Tyrone Wallace,81,15.9166666666667,16,-0.0833333333333339,44,37,7,6,1
21700817,201229,DET,LAC,Anthony Tolliver,114,23.8666666666667,23,0.866666666666667,51,61,-10,-5,-5
21700817,201933,DET,LAC,Blake Griffin,154,34.9333333333333,35,-0.0666666666666629,73,77,-4,-4,0
21700817,202397,DET,LAC,Ish Smith,133,30.9,31,-0.100000000000001,61,68,-7,-7,0
21700817,203083,DET,LAC,Andre Drummond,164,37.0333333333333,38,-0.966666666666669,66,78,-12,-17,5
21700817,203493,DET,LAC,Reggie Bullock,175,39.7666666666667,40,-0.233333333333334,83,84,-1,-2,1
21700817,204038,DET,LAC,Langston Galloway,83,17.0166666666667,17,0.0166666666666657,34,40,-6,-6,0
21700817,1626169,DET,LAC,Stanley Johnson,144,32.0833333333333,32,0.0833333333333286,59,65,-6,-9,3
21700817,1628379,DET,LAC,Luke Kennard,113,23.9833333333333,24,-0.0166666666666657,48,67,-19,-15,-4
21700818,2731,NOP,PHI,Emeka Okafor,96,19.7833333333333,20,-0.216666666666669,45,34,11,11,0
21700818,200765,NOP,PHI,Rajon Rondo,124,25.05,25,0.0500000000000007,50,53,-3,-1,-2
21700818,201950,NOP,PHI,Jrue Holiday,111,23.15,23,0.149999999999999,35,50,-15,-15,0
21700818,202703,NOP,PHI,Nikola Mirotic,134,28.4,28,0.399999999999999,42,66,-24,-24,0
21700818,202732,NOP,PHI,DeAndre Liggins,90,18.85,19,-0.149999999999999,30,42,-12,-14,2
21700818,202734,NOP,PHI,E'Twaun Moore,115,23.9833333333333,24,-0.0166666666666657,31,61,-30,-28,-2
21700818,203076,NOP,PHI,Anthony Davis,135,27.8166666666667,28,-0.183333333333334,37,66,-29,-29,0
21700818,203121,NOP,PHI,Darius Miller,156,31.95,32,-0.0500000000000043,63,62,1,-1,2
21700818,203546,NOP,PHI,Ian Clark,107,21.8833333333333,22,-0.116666666666667,45,39,6,6,0
21700818,1627767,NOP,PHI,Cheick Diallo,87,17.1333333333333,17,0.133333333333333,32,27,5,5,0
21700818,101161,PHI,NOP,Amir Johnson,88,18.4833333333333,18,0.483333333333334,36,42,-6,-8,2
21700818,200755,PHI,NOP,JJ Redick,111,23.0833333333333,24,-0.916666666666664,49,25,24,26,-2
21700818,201573,PHI,NOP,Jerryd Bayless,39,7.93333333333333,8,-0.0666666666666673,11,22,-11,-11,0
21700818,202344,PHI,NOP,Trevor Booker,91,18.2333333333333,19,-0.766666666666666,23,37,-14,-14,0
21700818,203496,PHI,NOP,Robert Covington,120,25.2833333333333,25,0.283333333333331,66,42,24,24,0
21700818,203954,PHI,NOP,Joel Embiid,114,23.5166666666667,24,-0.483333333333334,56,25,31,33,-2
21700818,203967,PHI,NOP,Dario Saric,140,29.3666666666667,29,0.366666666666667,77,45,32,32,0
21700818,204456,PHI,NOP,T.J. McConnell,119,23.8166666666667,24,-0.183333333333334,53,42,11,9,2
21700818,1626147,PHI,NOP,Justin Anderson,80,17.2166666666667,17,0.216666666666669,30,30,0,0,0
21700818,1626158,PHI,NOP,Richaun Holmes,29,5.6,6,-0.4,8,15,-7,-7,0
21700818,1627732,PHI,NOP,Ben Simmons,121,25.2,25,0.199999999999999,57,37,20,20,0
21700818,1627789,PHI,NOP,Timothe Luwawu-Cabarrot,103,20.2666666666667,20,0.266666666666666,34,48,-14,-14,0
21700819,101141,ATL,CLE,Ersan Ilyasova,118,25.9,26,-0.100000000000001,73,61,12,13,-1
21700819,203101,ATL,CLE,Miles Plumlee,55,12.65,13,-0.35,32,32,0,-1,1
21700819,203145,ATL,CLE,Kent Bazemore,112,25.5,26,-0.5,69,58,11,6,5
21700819,203471,ATL,CLE,Dennis Schroder,119,26.45,26,0.449999999999999,64,69,-5,-7,2
21700819,203473,ATL,CLE,Dewayne Dedmon,105,23.2,23,0.200000000000003,42,63,-21,-19,-2
21700819,203488,ATL,CLE,Mike Muscala,62,13.1,13,0.100000000000001,34,34,0,0,0
21700819,1627098,ATL,CLE,Malcolm Delaney,99,21.65,22,-0.350000000000001,43,62,-19,-15,-4
21700819,1627752,ATL,CLE,Taurean Prince,113,25.6666666666667,25,0.666666666666664,46,75,-29,-21,-8
21700819,1627819,ATL,CLE,Isaiah Taylor,94,20.6,21,-0.400000000000002,50,49,1,1,0
21700819,1628381,ATL,CLE,John Collins,92,20.5166666666667,20,0.516666666666666,33,56,-23,-25,2
21700819,1628416,ATL,CLE,Tyler Dorsey,111,23.1833333333333,23,0.18333333333333,49,56,-7,-12,5
21700819,2544,CLE,ATL,LeBron James,185,40.6666666666667,41,-0.333333333333329,107,91,16,12,4
21700819,2594,CLE,ATL,Kyle Korver,149,32.5,32,0.5,83,65,18,18,0
21700819,2747,CLE,ATL,JR Smith,129,28.45,29,-0.550000000000001,70,71,-1,4,-5
21700819,101181,CLE,ATL,Jose Calderon,90,20.1333333333333,20,0.133333333333333,54,51,3,2,1
21700819,201145,CLE,ATL,Jeff Green,146,32.55,32,0.549999999999997,83,64,19,21,-2
21700819,202684,CLE,ATL,Tristan Thompson,137,30.7,31,-0.300000000000001,85,64,21,21,0
21700819,204066,CLE,ATL,John Holland,59,13.6666666666667,14,-0.333333333333332,32,27,5,5,0
21700819,1626224,CLE,ATL,Cedi Osman,175,38.05,39,-0.950000000000003,97,90,7,5,2
21700819,1627790,CLE,ATL,Ante Zizic,5,0.85,1,-0.15,2,6,-4,-4,0
21700819,1628506,CLE,ATL,London Perrantes,5,0.85,1,-0.15,2,6,-4,-4,0
21700820,201143,BOS,IND,Al Horford,126,28.3166666666667,29,-0.683333333333334,57,66,-9,-9,0
21700820,202328,BOS,IND,Greg Monroe,56,10.55,11,-0.449999999999999,18,23,-5,-3,-2
21700820,202681,BOS,IND,Kyrie Irving,144,31.3,31,0.299999999999997,64,67,-3,-1,-2
21700820,202694,BOS,IND,Marcus Morris,119,24.3,25,-0.700000000000003,40,47,-7,-4,-3
21700820,203382,BOS,IND,Aron Baynes,91,21.55,21,0.550000000000001,40,43,-3,-2,-1
21700820,1626179,BOS,IND,Terry Rozier,132,26.35,26,0.350000000000001,54,50,4,2,2
21700820,1627759,BOS,IND,Jaylen Brown,132,28.3333333333333,28,0.333333333333336,61,56,5,4,1
21700820,1627846,BOS,IND,Abdel Nader,15,3.33333333333333,3,0.333333333333333,6,6,0,0,0
21700820,1628369,BOS,IND,Jayson Tatum,161,34.9,36,-1.09999999999999,65,72,-7,-6,-1
21700820,1628400,BOS,IND,Semi Ojeleye,52,11.5,11,0.5,23,22,1,-1,2
21700820,1628464,BOS,IND,Daniel Theis,87,18.0666666666667,18,0.0666666666666664,27,33,-6,-10,4
21700820,2744,IND,BOS,Al Jefferson,44,9.16666666666667,9,0.166666666666668,18,16,2,1,1
21700820,201152,IND,BOS,Thaddeus Young,156,33.7333333333333,34,-0.266666666666666,69,73,-4,0,-4
21700820,202362,IND,BOS,Lance Stephenson,128,26.7833333333333,27,-0.216666666666669,47,46,1,-3,4
21700820,202709,IND,BOS,Cory Joseph,153,33.9166666666667,34,-0.0833333333333357,68,63,5,6,-1
21700820,202711,IND,BOS,Bojan Bogdanovic,149,31.9166666666667,32,-0.0833333333333322,74,65,9,11,-2
21700820,203506,IND,BOS,Victor Oladipo,167,36.3666666666667,37,-0.63333333333334,72,71,1,3,-2
21700820,1626167,IND,BOS,Myles Turner,152,32.7333333333333,33,-0.266666666666666,71,65,6,6,0
21700820,1626202,IND,BOS,Joe Young,72,14.1166666666667,14,0.116666666666667,30,28,2,1,1
21700820,1627734,IND,BOS,Domantas Sabonis,94,19.7666666666667,20,-0.233333333333334,36,28,8,5,3
21700821,2548,MIA,MIL,Dwyane Wade,100,22.3333333333333,22,0.333333333333332,47,46,1,-3,4
21700821,201609,MIA,MIL,Goran Dragic,129,27.4333333333333,27,0.433333333333334,49,44,5,11,-6
21700821,201949,MIA,MIL,James Johnson,89,20.8833333333333,21,-0.116666666666667,45,39,6,4,2
21700821,201961,MIA,MIL,Wayne Ellington,127,29.9166666666667,29,0.916666666666664,58,52,6,6,0
21700821,202355,MIA,MIL,Hassan Whiteside,122,25.0333333333333,26,-0.966666666666669,40,43,-3,-5,2
21700821,204020,MIA,MIL,Tyler Johnson,168,35.45,36,-0.549999999999997,74,54,20,20,0
21700821,1626159,MIA,MIL,Justise Winslow,77,15.7333333333333,16,-0.266666666666666,30,19,11,13,-2
21700821,1626196,MIA,MIL,Josh Richardson,145,30.5,30,0.5,50,64,-14,-12,-2
21700821,1628389,MIA,MIL,Bam Adebayo,143,32.3833333333333,32,0.383333333333333,62,64,-2,-4,2
21700821,1891,MIL,MIA,Jason Terry,62,15.5333333333333,15,0.533333333333333,25,34,-9,-9,0
21700821,202339,MIL,MIA,Eric Bledsoe,171,35.6,36,-0.400000000000006,68,65,3,3,0
21700821,203089,MIL,MIA,John Henson,98,20.2333333333333,21,-0.766666666666666,32,34,-2,2,-4
21700821,203092,MIL,MIA,Tyler Zeller,62,14,14,0,31,25,6,10,-4
21700821,203114,MIL,MIA,Khris Middleton,149,30.8,31,-0.199999999999999,55,57,-2,-3,1
21700821,203503,MIL,MIA,Tony Snell,147,30.1,30,0.100000000000001,55,50,5,5,0
21700821,203507,MIL,MIA,Giannis Antetokounmpo,186,40.1166666666667,40,0.11666666666666,77,71,6,4,2
21700821,203930,MIL,MIA,Sean Kilpatrick,29,6.36666666666667,6,0.366666666666667,14,8,6,7,-1
21700821,203953,MIL,MIA,Jabari Parker,76,18.5833333333333,19,-0.416666666666664,24,46,-22,-20,-2
21700821,1627748,MIL,MIA,Thon Maker,60,13.7,14,-0.300000000000001,22,32,-10,-16,6
21700821,1628425,MIL,MIA,Sterling Brown,60,14.6333333333333,15,-0.366666666666667,22,33,-11,-13,2
21700822,201577,CHI,MIN,Robin Lopez,125,27.3666666666667,28,-0.633333333333333,75,59,16,16,0
21700822,203200,CHI,MIN,Justin Holiday,166,35.8,36,-0.200000000000003,94,78,16,18,-2
21700822,203897,CHI,MIN,Zach LaVine,152,33.4833333333333,33,0.483333333333334,86,82,4,7,-3
21700822,1626170,CHI,MIN,Jerian Grant,170,37.4333333333333,38,-0.566666666666663,92,81,11,15,-4
21700822,1626171,CHI,MIN,Bobby Portis,114,23.0333333333333,23,0.0333333333333314,47,57,-10,-10,0
21700822,1627756,CHI,MIN,Denzel Valentine,88,17.0333333333333,17,0.0333333333333314,32,37,-5,-8,3
21700822,1627835,CHI,MIN,Paul Zipser,54,9.7,10,-0.300000000000001,15,28,-13,-15,2
21700822,1627853,CHI,MIN,Ryan Arcidiacono,45,8.38333333333333,9,-0.616666666666667,15,26,-11,-12,1
21700822,1628021,CHI,MIN,David Nwaba,61,11.9333333333333,12,-0.0666666666666664,23,38,-15,-20,5
21700822,1628374,CHI,MIN,Lauri Markkanen,160,35.8333333333333,36,-0.166666666666671,91,79,12,14,-2
21700822,2037,MIN,CHI,Jamal Crawford,92,18.3666666666667,19,-0.633333333333333,47,37,10,12,-2
21700822,201952,MIN,CHI,Jeff Teague,101,22.65,23,-0.350000000000001,57,61,-4,-5,1
21700822,201959,MIN,CHI,Taj Gibson,124,27.3333333333333,27,0.333333333333336,63,75,-12,-17,5
21700822,202357,MIN,CHI,Nemanja Bjelica,103,20.6666666666667,21,-0.333333333333336,50,39,11,16,-5
21700822,202710,MIN,CHI,Jimmy Butler,190,40.8333333333333,41,-0.166666666666664,101,95,6,6,0
21700822,203476,MIN,CHI,Gorgui Dieng,79,15.6333333333333,15,0.633333333333333,36,41,-5,-6,1
21700822,203952,MIN,CHI,Andrew Wiggins,172,36.8,37,-0.200000000000003,78,96,-18,-20,2
21700822,1626145,MIN,CHI,Tyus Jones,126,25.35,25,0.350000000000001,56,53,3,4,-1
21700822,1626157,MIN,CHI,Karl-Anthony Towns,148,32.3666666666667,33,-0.633333333333333,77,73,4,5,-1
21700823,201163,DEN,HOU,Wilson Chandler,110,23.4333333333333,23,0.433333333333334,42,66,-24,-24,0
21700823,201589,DEN,HOU,Darrell Arthur,27,6.46666666666667,7,-0.533333333333333,8,11,-3,-1,-2
21700823,203115,DEN,HOU,Will Barton,127,27.7,28,-0.300000000000001,46,73,-27,-27,0
21700823,203914,DEN,HOU,Gary Harris,110,23.2333333333333,23,0.233333333333334,44,71,-27,-26,-1
21700823,203999,DEN,HOU,Nikola Jokic,103,21.4,22,-0.600000000000001,41,65,-24,-24,0
21700823,1626168,DEN,HOU,Trey Lyles,127,27.1166666666667,27,0.116666666666667,70,70,0,-1,1
21700823,1627736,DEN,HOU,Malik Beasley,81,16.8666666666667,17,-0.133333333333333,46,44,2,2,0
21700823,1627750,DEN,HOU,Jamal Murray,123,26.0166666666667,26,0.0166666666666657,52,77,-25,-25,0
21700823,1627823,DEN,HOU,Juancho Hernangomez,81,16.8666666666667,17,-0.133333333333333,46,44,2,2,0
21700823,1628420,DEN,HOU,Monte Morris,101,21.75,22,-0.25,52,53,-1,-1,0
21700823,1628470,DEN,HOU,Torrey Craig,130,27.9833333333333,28,-0.0166666666666657,73,76,-3,-5,2
21700823,101108,HOU,DEN,Chris Paul,97,21.5666666666667,22,-0.433333333333334,63,33,30,25,5
21700823,101123,HOU,DEN,Gerald Green,120,25.2833333333333,26,-0.716666666666669,67,62,5,3,2
21700823,200782,HOU,DEN,PJ Tucker,141,29.25,30,-0.75,75,68,7,8,-1
21700823,201569,HOU,DEN,Eric Gordon,124,27.4333333333333,27,0.433333333333334,78,57,21,24,-3
21700823,201583,HOU,DEN,Ryan Anderson,139,30.15,30,0.149999999999999,84,73,11,10,1
21700823,201601,HOU,DEN,Luc Mbah a Moute,111,24.0666666666667,24,0.0666666666666664,65,44,21,21,0
21700823,201935,HOU,DEN,James Harden,130,27.45,27,0.449999999999999,79,60,19,23,-4
21700823,203900,HOU,DEN,Markel Brown,45,8.75,9,-0.25,19,28,-9,-9,0
21700823,203991,HOU,DEN,Clint Capela,135,28.5333333333333,29,-0.466666666666669,78,47,31,31,0
21700823,204028,HOU,DEN,Tarik Black,78,16.35,16,0.349999999999998,42,48,-6,-6,0
21700824,201937,UTA,CHA,Ricky Rubio,97,20.3833333333333,21,-0.616666666666667,54,46,8,10,-2
21700824,201973,UTA,CHA,Jonas Jerebko,92,21.85,22,-0.149999999999999,47,53,-6,-5,-1
21700824,202324,UTA,CHA,Derrick Favors,130,30.2833333333333,30,0.283333333333331,62,52,10,10,0
21700824,202327,UTA,CHA,Ekpe Udoh,44,10.25,10,0.25,23,12,11,12,-1
21700824,202692,UTA,CHA,Alec Burks,42,10.6166666666667,11,-0.383333333333333,19,24,-5,-8,3
21700824,203497,UTA,CHA,Rudy Gobert,147,32.7333333333333,33,-0.266666666666666,77,68,9,8,1
21700824,203526,UTA,CHA,Raul Neto,68,15.6833333333333,16,-0.316666666666666,26,32,-6,-7,1
21700824,204060,UTA,CHA,Joe Ingles,150,33.6833333333333,34,-0.316666666666663,83,55,28,30,-2
21700824,1626220,UTA,CHA,Royce O'Neale,94,23.6333333333333,23,0.633333333333333,42,44,-2,-2,0
21700824,1627777,UTA,CHA,Georges Niang,5,0.85,1,-0.15,3,3,0,-1,1
21700824,1628378,UTA,CHA,Donovan Mitchell,171,39.1,39,0.100000000000001,91,78,13,14,-1
21700824,1628571,UTA,CHA,Erik McCree,5,0.85,1,-0.15,3,3,0,-1,1
21700824,2730,CHA,UTA,Dwight Howard,93,20.4333333333333,21,-0.56666666666667,41,51,-10,-12,2
21700824,101107,CHA,UTA,Marvin Williams,110,23.8833333333333,24,-0.116666666666667,50,63,-13,-13,0
21700824,201587,CHA,UTA,Nicolas Batum,136,30.45,31,-0.550000000000001,58,78,-20,-20,0
21700824,202689,CHA,UTA,Kemba Walker,144,32.2666666666667,33,-0.733333333333334,65,77,-12,-12,0
21700824,202933,CHA,UTA,Julyan Stone,11,3.01666666666667,3,0.0166666666666666,6,5,1,1,0
21700824,203077,CHA,UTA,Michael Kidd-Gilchrist,91,19.2166666666667,19,0.216666666666669,43,50,-7,-7,0
21700824,203087,CHA,UTA,Jeremy Lamb,79,18.6,19,-0.399999999999999,32,34,-2,-2,0
21700824,203469,CHA,UTA,Cody Zeller,99,22.9833333333333,23,-0.0166666666666657,45,44,1,1,0
21700824,203487,CHA,UTA,Michael Carter-Williams,69,15.6666666666667,16,-0.333333333333334,32,29,3,4,-1
21700824,1626163,CHA,UTA,Frank Kaminsky,105,25.65,25,0.649999999999999,46,49,-3,-1,-2
21700824,1626203,CHA,UTA,Treveon Graham,86,21.7166666666667,21,0.716666666666665,40,40,0,-1,1
21700824,1628370,CHA,UTA,Malik Monk,11,3.01666666666667,3,0.0166666666666666,6,5,1,1,0
21700824,1628407,CHA,UTA,Dwayne Bacon,11,3.01666666666667,3,0.0166666666666666,6,5,1,1,0
21700825,202323,POR,SAC,Evan Turner,95,20.35,20,0.350000000000001,46,33,13,13,0
21700825,202329,POR,SAC,Al-Farouq Aminu,114,23.6333333333333,24,-0.366666666666667,65,60,5,7,-2
21700825,202334,POR,SAC,Ed Davis,95,20.2833333333333,20,0.283333333333331,42,31,11,9,2
21700825,203081,POR,SAC,Damian Lillard,142,29.4666666666667,29,0.466666666666669,84,66,18,18,0
21700825,203086,POR,SAC,Meyers Leonard,13,2.28333333333333,2,0.283333333333333,4,6,-2,-1,-1
21700825,203090,POR,SAC,Maurice Harkless,116,25.25,26,-0.75,68,61,7,6,1
21700825,203468,POR,SAC,CJ McCollum,143,30.7833333333333,31,-0.216666666666669,74,65,9,6,3
21700825,203894,POR,SAC,Shabazz Napier,81,19.0833333333333,19,0.0833333333333357,38,36,2,3,-1
21700825,203994,POR,SAC,Jusuf Nurkic,116,25.3166666666667,25,0.316666666666666,72,63,9,10,-1
21700825,1626192,POR,SAC,Pat Connaughton,69,14.15,14,0.149999999999999,36,27,9,10,-1
21700825,1627774,POR,SAC,Jake Layman,13,2.28333333333333,2,0.283333333333333,4,6,-2,-1,-1
21700825,1628380,POR,SAC,Zach Collins,110,24.25,24,0.25,53,40,13,11,2
21700825,1628403,POR,SAC,Caleb Swanigan,13,2.28333333333333,2,0.283333333333333,4,6,-2,-1,-1
21700825,1713,SAC,POR,Vince Carter,106,22.4666666666667,23,-0.533333333333331,39,54,-15,-16,1
21700825,2216,SAC,POR,Zach Randolph,123,26.45,27,-0.550000000000001,63,64,-1,0,-1
21700825,201585,SAC,POR,Kosta Koufos,76,17.6666666666667,17,0.666666666666664,34,38,-4,-2,-2
21700825,202066,SAC,POR,Garrett Temple,121,26.55,27,-0.449999999999999,47,61,-14,-15,1
21700825,203992,SAC,POR,Bogdan Bogdanovic,157,33.55,33,0.549999999999997,75,89,-14,-11,-3
21700825,1626161,SAC,POR,Willie Cauley-Stein,148,30.2166666666667,31,-0.783333333333335,66,80,-14,-16,2
21700825,1627741,SAC,POR,Buddy Hield,98,22.2166666666667,22,0.216666666666665,42,46,-4,-4,0
21700825,1628368,SAC,POR,De'Aaron Fox,157,33.8833333333333,34,-0.116666666666667,70,91,-21,-21,0
21700825,1628382,SAC,POR,Justin Jackson,134,26.4166666666667,27,-0.583333333333336,64,67,-3,-5,2
21700826,200765,NOP,BKN,Rajon Rondo,207,41.25,42,-0.75,107,89,18,18,0
21700826,201950,NOP,BKN,Jrue Holiday,240,48.7166666666667,49,-0.283333333333331,110,106,4,3,1
21700826,202703,NOP,BKN,Nikola Mirotic,241,48.6333333333333,49,-0.366666666666667,115,99,16,16,0
21700826,202732,NOP,BKN,DeAndre Liggins,14,2.88333333333333,3,-0.116666666666667,4,12,-8,-8,0
21700826,202734,NOP,BKN,E'Twaun Moore,215,43.6166666666667,44,-0.383333333333333,101,86,15,15,0
21700826,203076,NOP,BKN,Anthony Davis,250,49.7166666666667,50,-0.283333333333331,120,113,7,9,-2
21700826,203121,NOP,BKN,Darius Miller,114,23.2166666666667,24,-0.783333333333331,58,60,-2,-2,0
21700826,203546,NOP,BKN,Ian Clark,89,18.0166666666667,18,0.0166666666666657,45,52,-7,-6,-1
21700826,1627767,NOP,BKN,Cheick Diallo,55,12.1166666666667,12,0.116666666666667,30,23,7,5,2
21700826,201960,BKN,NOP,DeMarre Carroll,175,36.1166666666667,36,0.116666666666667,70,81,-11,-12,1
21700826,201967,BKN,NOP,Dante Cunningham,104,19.85,20,-0.149999999999999,61,41,20,21,-1
21700826,203112,BKN,NOP,Quincy Acy,195,39.4666666666667,40,-0.533333333333331,87,89,-2,-1,-1
21700826,203459,BKN,NOP,Allen Crabbe,220,44.0666666666667,44,0.0666666666666629,93,104,-11,-10,-1
21700826,203915,BKN,NOP,Spencer Dinwiddie,206,42.8666666666667,43,-0.133333333333333,87,100,-13,-15,2
21700826,203917,BKN,NOP,Nik Stauskas,52,11.5666666666667,12,-0.433333333333334,21,34,-13,-12,-1
21700826,203925,BKN,NOP,Joe Harris,173,34.0666666666667,34,0.0666666666666629,78,71,7,4,3
21700826,1626143,BKN,NOP,Jahlil Okafor,21,4.9,5,-0.0999999999999996,11,17,-6,-7,1
21700826,1626156,BKN,NOP,D'Angelo Russell,163,31.5333333333333,32,-0.466666666666669,81,86,-5,-3,-2
21700826,1627821,BKN,NOP,James Webb III,31,6.73333333333333,7,-0.266666666666667,17,25,-8,-9,1
21700826,1628386,BKN,NOP,Jarrett Allen,85,17,17,0,34,42,-8,-6,-2
21700827,1891,MIL,ORL,Jason Terry,65,14.6333333333333,15,-0.366666666666667,29,24,5,4,1
21700827,202339,MIL,ORL,Eric Bledsoe,149,33.25,33,0.25,82,80,2,3,-1
21700827,203092,MIL,ORL,Tyler Zeller,106,21.95,22,-0.0500000000000007,54,56,-2,-2,0
21700827,203114,MIL,ORL,Khris Middleton,161,35.5666666666667,36,-0.433333333333337,87,84,3,4,-1
21700827,203503,MIL,ORL,Tony Snell,118,26.8833333333333,27,-0.116666666666667,69,65,4,4,0
21700827,203507,MIL,ORL,Giannis Antetokounmpo,167,38.3166666666667,38,0.316666666666663,86,77,9,11,-2
21700827,203930,MIL,ORL,Sean Kilpatrick,108,23.7333333333333,24,-0.266666666666666,53,52,1,-1,2
21700827,1627748,MIL,ORL,Thon Maker,108,25.9333333333333,26,-0.0666666666666664,57,48,9,9,0
21700827,1628425,MIL,ORL,Sterling Brown,88,19.15,19,0.149999999999999,38,34,4,3,1
21700827,201167,ORL,MIL,Arron Afflalo,92,20.3333333333333,20,0.333333333333332,48,40,8,6,2
21700827,201571,ORL,MIL,D.J. Augustin,106,23.4166666666667,23,0.416666666666668,47,55,-8,-7,-1
21700827,201578,ORL,MIL,Marreese Speights,57,11.45,12,-0.550000000000001,24,23,1,0,1
21700827,202687,ORL,MIL,Bismack Biyombo,86,19.95,20,-0.0499999999999972,35,44,-9,-6,-3
21700827,202714,ORL,MIL,Shelvin Mack,126,27.5833333333333,28,-0.416666666666664,69,67,2,-1,3
21700827,203095,ORL,MIL,Evan Fournier,129,29.4833333333333,29,0.483333333333334,66,71,-5,-6,1
21700827,203613,ORL,MIL,Jonathon Simmons,112,25.7666666666667,26,-0.233333333333334,50,61,-11,-13,2
21700827,203920,ORL,MIL,Khem Birch,109,24.1833333333333,24,0.18333333333333,52,54,-2,-5,3
21700827,1626209,ORL,MIL,Mario Hezonja,152,35.25,35,0.25,76,91,-15,-7,-8
21700827,1628411,ORL,MIL,Wes Iwundu,101,22,22,0,53,49,4,4,0
21700828,101150,LAC,PHI,Lou Williams,155,31.8,32,-0.200000000000003,69,92,-23,-22,-1
21700828,201568,LAC,PHI,Danilo Gallinari,190,40.0166666666667,40,0.0166666666666657,77,88,-11,-11,0
21700828,201599,LAC,PHI,DeAndre Jordan,181,37.3,37,0.299999999999997,66,86,-20,-18,-2
21700828,202325,LAC,PHI,Wesley Johnson,15,3.41666666666667,3,0.416666666666667,9,15,-6,-6,0
21700828,202340,LAC,PHI,Avery Bradley,134,27.7666666666667,28,-0.233333333333334,59,55,4,5,-1
21700828,202699,LAC,PHI,Tobias Harris,183,37.9833333333333,38,-0.0166666666666657,74,87,-13,-15,2
21700828,203085,LAC,PHI,Austin Rivers,159,33.7333333333333,34,-0.266666666666666,62,65,-3,-5,2
21700828,1626149,LAC,PHI,Montrezl Harrell,49,10.6,11,-0.4,32,26,6,4,2
21700828,1626155,LAC,PHI,Sam Dekker,13,2.3,2,0.3,6,7,-1,1,-2
21700828,1627820,LAC,PHI,Tyrone Wallace,71,14.5833333333333,15,-0.416666666666666,36,39,-3,-3,0
21700828,101161,PHI,LAC,Amir Johnson,64,13.6,14,-0.4,36,27,9,10,-1
21700828,200755,PHI,LAC,JJ Redick,139,29.0833333333333,29,0.0833333333333357,67,57,10,9,1
21700828,202344,PHI,LAC,Trevor Booker,76,15.6333333333333,16,-0.366666666666667,43,34,9,10,-1
21700828,203496,PHI,LAC,Robert Covington,159,32.8166666666667,33,-0.183333333333337,74,64,10,11,-1
21700828,203954,PHI,LAC,Joel Embiid,164,34.15,34,0.149999999999999,72,72,0,0,0
21700828,203967,PHI,LAC,Dario Saric,154,32.2666666666667,32,0.266666666666666,69,64,5,4,1
21700828,204456,PHI,LAC,T.J. McConnell,124,25.55,26,-0.450000000000003,63,61,2,2,0
21700828,1626147,PHI,LAC,Justin Anderson,99,20.7666666666667,21,-0.233333333333334,57,45,12,11,1
21700828,1627732,PHI,LAC,Ben Simmons,171,35.6333333333333,35,0.633333333333333,79,66,13,13,0
21700829,201577,CHI,WAS,Robin Lopez,125,27.5333333333333,28,-0.466666666666669,49,63,-14,-14,0
21700829,203200,CHI,WAS,Justin Holiday,158,35.6333333333333,36,-0.366666666666667,58,72,-14,-15,1
21700829,1626170,CHI,WAS,Jerian Grant,162,36.45,37,-0.549999999999997,61,74,-13,-14,1
21700829,1626171,CHI,WAS,Bobby Portis,99,22.7333333333333,23,-0.266666666666666,56,50,6,4,2
21700829,1627756,CHI,WAS,Denzel Valentine,147,33.8833333333333,34,-0.116666666666667,58,70,-12,-14,2
21700829,1627835,CHI,WAS,Paul Zipser,55,13.8,14,-0.199999999999999,29,26,3,2,1
21700829,1627853,CHI,WAS,Ryan Arcidiacono,38,9.45,9,0.449999999999999,24,21,3,2,1
21700829,1628021,CHI,WAS,David Nwaba,116,27.2166666666667,27,0.216666666666665,64,58,6,7,-1
21700829,1628374,CHI,WAS,Lauri Markkanen,145,32.4666666666667,33,-0.533333333333331,51,66,-15,-13,-2
21700829,101133,WAS,CHI,Ian Mahinmi,22,5.7,6,-0.3,11,15,-4,-4,0
21700829,101162,WAS,CHI,Marcin Gortat,154,34.6166666666667,35,-0.383333333333333,74,58,16,17,-1
21700829,201160,WAS,CHI,Jason Smith,33,7.51666666666667,8,-0.483333333333333,15,17,-2,-2,0
21700829,201975,WAS,CHI,Jodie Meeks,73,17.9666666666667,18,-0.033333333333335,40,41,-1,2,-3
21700829,203078,WAS,CHI,Bradley Beal,155,34.7,35,-0.299999999999997,65,54,11,9,2
21700829,203107,WAS,CHI,Tomas Satoransky,165,36.9166666666667,37,-0.0833333333333286,81,64,17,15,2
21700829,203118,WAS,CHI,Mike Scott,103,23.9166666666667,24,-0.0833333333333357,53,61,-8,-6,-2
21700829,203490,WAS,CHI,Otto Porter Jr.,133,30.5333333333333,31,-0.466666666666669,56,49,7,6,1
21700829,204025,WAS,CHI,Tim Frazier,24,5.6,6,-0.4,15,18,-3,-1,-2
21700829,1626162,WAS,CHI,Kelly Oubre Jr.,171,38.8,39,-0.200000000000003,86,65,21,23,-2
21700829,1626191,WAS,CHI,Chris McCullough,12,2.9,3,-0.0999999999999996,4,8,-4,-4,0
21700830,1717,DAL,LAL,Dirk Nowitzki,117,24.5333333333333,24,0.533333333333331,66,69,-3,0,-3
21700830,200826,DAL,LAL,J.J. Barea,119,24.5833333333333,24,0.583333333333332,67,69,-2,0,-2
21700830,202083,DAL,LAL,Wesley Matthews,119,26.5666666666667,27,-0.43333333333333,75,68,7,5,2
21700830,203084,DAL,LAL,Harrison Barnes,119,26.5666666666667,27,-0.43333333333333,75,68,7,5,2
21700830,203926,DAL,LAL,Doug McDermott,109,21.3,21,0.299999999999997,55,54,1,2,-1
21700830,203939,DAL,LAL,Dwight Powell,117,23.1333333333333,23,0.133333333333333,59,63,-4,-5,1
21700830,1626257,DAL,LAL,Salah Mejri,37,7.61666666666667,8,-0.383333333333334,20,18,2,2,0
21700830,1627812,DAL,LAL,Yogi Ferrell,131,26.25,27,-0.75,68,69,-1,-2,1
21700830,1627858,DAL,LAL,Kyle Collinsworth,53,11.3166666666667,11,0.316666666666666,34,25,9,9,0
21700830,1628372,DAL,LAL,Dennis Smith Jr.,153,33.5833333333333,34,-0.416666666666664,91,81,10,7,3
21700830,1628467,DAL,LAL,Maxi Kleber,66,13.8833333333333,14,-0.116666666666667,40,26,14,12,2
21700830,201147,LAL,DAL,Corey Brewer,72,13.7333333333333,14,-0.266666666666668,37,38,-1,-3,2
21700830,201572,LAL,DAL,Brook Lopez,119,25.5166666666667,26,-0.483333333333334,76,68,8,7,1
21700830,202738,LAL,DAL,Isaiah Thomas,154,30.6166666666667,31,-0.383333333333333,73,73,0,0,0
21700830,203484,LAL,DAL,Kentavious Caldwell-Pope,157,34.6833333333333,35,-0.316666666666663,92,96,-4,-4,0
21700830,203944,LAL,DAL,Julius Randle,168,36.8833333333333,37,-0.116666666666667,93,99,-6,-8,2
21700830,1627742,LAL,DAL,Brandon Ingram,164,35.6666666666667,36,-0.333333333333336,91,98,-7,-6,-1
21700830,1627826,LAL,DAL,Ivica Zubac,3,0.483333333333333,1,-0.516666666666667,0,4,-4,0,-4
21700830,1627936,LAL,DAL,Alex Caruso,4,0.466666666666667,0,0.466666666666667,2,3,-1,-3,2
21700830,1628398,LAL,DAL,Kyle Kuzma,160,32.1833333333333,32,0.183333333333337,73,85,-12,-10,-2
21700830,1628404,LAL,DAL,Josh Hart,139,29.1,29,0.100000000000001,73,86,-13,-8,-5
21700831,2561,GSW,SAS,David West,78,16.6333333333333,17,-0.366666666666667,39,28,11,11,0
21700831,2585,GSW,SAS,Zaza Pachulia,69,15.0666666666667,15,0.0666666666666664,35,40,-5,-4,-1
21700831,2733,GSW,SAS,Shaun Livingston,67,14.5333333333333,15,-0.466666666666667,35,22,13,13,0
21700831,2738,GSW,SAS,Andre Iguodala,120,26.3666666666667,26,0.366666666666667,71,53,18,16,2
21700831,201142,GSW,SAS,Kevin Durant,136,28.9333333333333,29,-0.06666666666667,70,64,6,6,0
21700831,201156,GSW,SAS,Nick Young,22,4.28333333333333,4,0.283333333333333,13,15,-2,-2,0
21700831,201580,GSW,SAS,JaVale McGee,40,7.13333333333333,7,0.133333333333333,23,11,12,11,1
21700831,201939,GSW,SAS,Stephen Curry,137,28.95,29,-0.0500000000000043,74,68,6,6,0
21700831,201956,GSW,SAS,Omri Casspi,36,6.65,7,-0.35,19,20,-1,-1,0
21700831,202691,GSW,SAS,Klay Thompson,152,33.4166666666667,34,-0.583333333333336,83,71,12,16,-4
21700831,203110,GSW,SAS,Draymond Green,160,34.7333333333333,35,-0.266666666666666,86,73,13,14,-1
21700831,1626172,GSW,SAS,Kevon Looney,39,7.78333333333333,8,-0.216666666666667,23,26,-3,-2,-1
21700831,1627775,GSW,SAS,Patrick McCaw,74,14.35,14,0.350000000000001,39,34,5,1,4
21700831,1938,SAS,GSW,Manu Ginobili,93,19.2833333333333,19,0.283333333333331,42,51,-9,-10,1
21700831,2200,SAS,GSW,Pau Gasol,50,10.35,11,-0.65,13,29,-16,-16,0
21700831,200746,SAS,GSW,LaMarcus Aldridge,136,29.45,29,0.449999999999999,70,71,-1,-1,0
21700831,201980,SAS,GSW,Danny Green,104,22.5333333333333,22,0.533333333333331,36,53,-17,-14,-3
21700831,201988,SAS,GSW,Patty Mills,78,17.1833333333333,18,-0.816666666666666,35,41,-6,-8,2
21700831,202722,SAS,GSW,Davis Bertans,144,30.6833333333333,31,-0.316666666666666,76,82,-6,-8,2
21700831,203464,SAS,GSW,Brandon Paul,40,7.96666666666667,8,-0.0333333333333332,22,22,0,0,0
21700831,203530,SAS,GSW,Joffrey Lauvergne,40,7.96666666666667,8,-0.0333333333333332,22,22,0,0,0
21700831,203937,SAS,GSW,Kyle Anderson,140,30.05,30,0.0500000000000007,74,70,4,2,2
21700831,1626199,SAS,GSW,Darrun Hilliard,72,14.9666666666667,15,-0.0333333333333332,37,41,-4,-4,0
21700831,1627854,SAS,GSW,Bryn Forbes,97,20.3833333333333,20,0.383333333333333,34,55,-21,-19,-2
21700831,1628401,SAS,GSW,Derrick White,136,28.0166666666667,28,0.0166666666666657,64,73,-9,-7,-2
21700832,2734,DEN,PHX,Devin Harris,103,21.3,22,-0.699999999999999,57,43,14,17,-3
21700832,201163,DEN,PHX,Wilson Chandler,187,39.6833333333333,40,-0.316666666666663,109,99,10,10,0
21700832,201589,DEN,PHX,Darrell Arthur,35,7.2,7,0.199999999999999,16,18,-2,-4,2
21700832,203115,DEN,PHX,Will Barton,202,42.4333333333333,42,0.433333333333337,111,101,10,12,-2
21700832,203914,DEN,PHX,Gary Harris,165,35.05,35,0.0499999999999972,93,88,5,6,-1
21700832,203999,DEN,PHX,Nikola Jokic,129,26.7666666666667,27,-0.233333333333334,71,68,3,5,-2
21700832,1626168,DEN,PHX,Trey Lyles,99,21.2,21,0.199999999999999,51,39,12,12,0
21700832,1627736,DEN,PHX,Malik Beasley,10,1.63333333333333,2,-0.366666666666667,5,6,-1,-3,2
21700832,1627750,DEN,PHX,Jamal Murray,129,27.15,27,0.149999999999999,69,74,-5,-8,3
21700832,1628470,DEN,PHX,Torrey Craig,76,16.4166666666667,16,0.416666666666668,33,29,4,3,1
21700832,201162,PHX,DEN,Jared Dudley,56,11.3166666666667,11,0.316666666666666,23,37,-14,-13,-1
21700832,203458,PHX,DEN,Alex Len,57,11.3166666666667,11,0.316666666666666,23,31,-8,-6,-2
21700832,203584,PHX,DEN,Troy Daniels,135,28.3166666666667,29,-0.683333333333334,75,75,0,0,0
21700832,203901,PHX,DEN,Elfrid Payton,166,35.05,35,0.0499999999999972,93,95,-2,-3,1
21700832,203933,PHX,DEN,T.J. Warren,200,41.8666666666667,42,-0.13333333333334,108,105,3,1,2
21700832,1627733,PHX,DEN,Dragan Bender,155,32.6666666666667,33,-0.333333333333336,90,80,10,10,0
21700832,1627737,PHX,DEN,Marquese Chriss,81,16.9333333333333,17,-0.0666666666666664,37,39,-2,-1,-1
21700832,1627982,PHX,DEN,Josh Gray,61,12.7166666666667,13,-0.283333333333335,20,28,-8,-7,-1
21700832,1628367,PHX,DEN,Josh Jackson,179,38.7833333333333,39,-0.216666666666669,86,93,-7,-8,1
21700832,1628432,PHX,DEN,Davon Reed,45,9.86666666666667,10,-0.133333333333333,10,32,-22,-23,1
21700833,101139,TOR,CHA,CJ Miles,85,17.3833333333333,18,-0.616666666666667,60,30,30,28,2
21700833,200768,TOR,CHA,Kyle Lowry,125,27.0166666666667,27,0.0166666666666657,63,59,4,4,0
21700833,201586,TOR,CHA,Serge Ibaka,120,25.7,26,-0.300000000000001,63,55,8,8,0
21700833,201942,TOR,CHA,DeMar DeRozan,138,29.7666666666667,29,0.766666666666666,71,62,9,9,0
21700833,202685,TOR,CHA,Jonas Valanciunas,113,24.0666666666667,24,0.0666666666666664,59,50,9,9,0
21700833,203512,TOR,CHA,Lucas Nogueira,24,5.88333333333333,6,-0.116666666666667,8,24,-16,-14,-2
21700833,1626153,TOR,CHA,Delon Wright,93,20.05,20,0.0499999999999972,56,46,10,10,0
21700833,1626181,TOR,CHA,Norman Powell,70,16.3,16,0.300000000000001,33,40,-7,-5,-2
21700833,1627751,TOR,CHA,Jakob Poeltl,83,17.6166666666667,18,-0.383333333333333,56,29,27,25,2
21700833,1627781,TOR,CHA,Malachi Richardson,19,4.38333333333333,5,-0.616666666666667,6,18,-12,-12,0
21700833,1627783,TOR,CHA,Pascal Siakam,100,21.8666666666667,22,-0.133333333333333,60,48,12,12,0
21700833,1627832,TOR,CHA,Fred VanVleet,79,16.8666666666667,17,-0.133333333333333,54,28,26,26,0
21700833,1628384,TOR,CHA,OG Anunoby,51,10.9333333333333,11,-0.0666666666666664,26,26,0,0,0
21700833,2730,CHA,TOR,Dwight Howard,132,28.6,29,-0.399999999999999,62,66,-4,-4,0
21700833,101107,CHA,TOR,Marvin Williams,109,23.5166666666667,24,-0.483333333333334,46,56,-10,-9,-1
21700833,201587,CHA,TOR,Nicolas Batum,116,25.15,26,-0.850000000000001,51,60,-9,-8,-1
21700833,202689,CHA,TOR,Kemba Walker,142,30.5,31,-0.5,65,75,-10,-10,0
21700833,202933,CHA,TOR,Julyan Stone,8,1.96666666666667,2,-0.0333333333333332,7,4,3,3,0
21700833,203077,CHA,TOR,Michael Kidd-Gilchrist,108,23.5333333333333,23,0.533333333333331,50,53,-3,-3,0
21700833,203087,CHA,TOR,Jeremy Lamb,91,19.4166666666667,19,0.416666666666664,36,57,-21,-22,1
21700833,203469,CHA,TOR,Cody Zeller,88,18.9666666666667,19,-0.0333333333333314,41,57,-16,-16,0
21700833,203487,CHA,TOR,Michael Carter-Williams,80,17,17,0,34,53,-19,-19,0
21700833,1626163,CHA,TOR,Frank Kaminsky,103,22.0833333333333,22,0.0833333333333322,50,63,-13,-14,1
21700833,1626203,CHA,TOR,Treveon Graham,76,15.5,16,-0.5,28,47,-19,-19,0
21700833,1628370,CHA,TOR,Malik Monk,31,7.9,8,-0.0999999999999996,27,18,9,9,0
21700833,1628407,CHA,TOR,Dwayne Bacon,16,3.7,4,-0.3,18,6,12,12,0
21700834,101141,ATL,DET,Ersan Ilyasova,135,28.1,28,0.100000000000001,78,54,24,18,6
21700834,203145,ATL,DET,Kent Bazemore,133,27.6333333333333,28,-0.366666666666667,73,54,19,17,2
21700834,203471,ATL,DET,Dennis Schroder,160,33.6,34,-0.400000000000006,83,74,9,7,2
21700834,203473,ATL,DET,Dewayne Dedmon,155,31.2,31,0.199999999999999,76,71,5,6,-1
21700834,203488,ATL,DET,Mike Muscala,88,18.6333333333333,19,-0.366666666666667,41,57,-16,-13,-3
21700834,1627098,ATL,DET,Malcolm Delaney,111,23.75,24,-0.25,53,65,-12,-13,1
21700834,1627752,ATL,DET,Taurean Prince,106,21.5333333333333,22,-0.466666666666669,49,59,-10,-8,-2
21700834,1627819,ATL,DET,Isaiah Taylor,49,10.5833333333333,11,-0.416666666666668,25,29,-4,-4,0
21700834,1628381,ATL,DET,John Collins,80,18.0666666666667,18,0.0666666666666664,43,44,-1,-5,4
21700834,1628416,ATL,DET,Tyler Dorsey,128,26.9,26,0.899999999999999,74,58,16,10,6
21700834,2749,DET,ATL,Jameer Nelson,92,18.8333333333333,19,-0.166666666666668,52,47,5,8,-3
21700834,201229,DET,ATL,Anthony Tolliver,101,21.4666666666667,22,-0.533333333333331,62,52,10,12,-2
21700834,201933,DET,ATL,Blake Griffin,167,33.95,34,-0.0499999999999972,69,89,-20,-21,1
21700834,202397,DET,ATL,Ish Smith,135,29,29,0,61,68,-7,-7,0
21700834,203083,DET,ATL,Andre Drummond,177,37.15,37,0.150000000000006,86,91,-5,0,-5
21700834,203493,DET,ATL,Reggie Bullock,169,33.9333333333333,34,-0.0666666666666629,80,81,-1,-4,3
21700834,203516,DET,ATL,James Ennis III,113,22.9,23,-0.100000000000001,57,62,-5,-5,0
21700834,203961,DET,ATL,Eric Moreland,16,3.58333333333333,4,-0.416666666666667,12,8,4,4,0
21700834,1626169,DET,ATL,Stanley Johnson,93,20.2166666666667,20,0.216666666666669,36,50,-14,-13,-1
21700834,1628379,DET,ATL,Luke Kennard,82,18.9666666666667,19,-0.0333333333333314,50,47,3,11,-8
21700835,201143,BOS,CLE,Al Horford,112,24.05,24,0.0500000000000007,48,59,-11,-12,1
21700835,202328,BOS,CLE,Greg Monroe,59,11.6666666666667,12,-0.333333333333332,29,32,-3,-5,2
21700835,202681,BOS,CLE,Kyrie Irving,123,26.3,26,0.299999999999997,50,69,-19,-19,0
21700835,202694,BOS,CLE,Marcus Morris,117,24.7666666666667,25,-0.233333333333334,46,64,-18,-18,0
21700835,203382,BOS,CLE,Aron Baynes,57,12.9,13,-0.100000000000001,23,32,-9,-7,-2
21700835,1626179,BOS,CLE,Terry Rozier,155,33.4666666666667,34,-0.533333333333331,70,83,-13,-12,-1
21700835,1627759,BOS,CLE,Jaylen Brown,144,32.2833333333333,32,0.283333333333331,68,84,-16,-15,-1
21700835,1627846,BOS,CLE,Abdel Nader,49,10.2333333333333,11,-0.766666666666666,25,22,3,3,0
21700835,1628369,BOS,CLE,Jayson Tatum,124,27.4,27,0.399999999999999,56,73,-17,-18,1
21700835,1628400,BOS,CLE,Semi Ojeleye,109,23.9666666666667,24,-0.0333333333333314,49,62,-13,-15,2
21700835,1628464,BOS,CLE,Daniel Theis,56,11.4666666666667,11,0.466666666666667,31,25,6,8,-2
21700835,2544,CLE,BOS,LeBron James,127,27.9,28,-0.100000000000001,75,52,23,23,0
21700835,2594,CLE,BOS,Kyle Korver,71,15.5833333333333,16,-0.416666666666668,39,29,10,8,2
21700835,2747,CLE,BOS,JR Smith,133,28.7666666666667,29,-0.233333333333334,74,57,17,17,0
21700835,101181,CLE,BOS,Jose Calderon,17,3.35,4,-0.65,8,13,-5,-3,-2
21700835,201145,CLE,BOS,Jeff Green,79,16.75,17,-0.25,38,36,2,2,0
21700835,201588,CLE,BOS,George Hill,95,21.0333333333333,21,0.0333333333333314,56,38,18,17,1
21700835,202684,CLE,BOS,Tristan Thompson,127,26.9666666666667,27,-0.033333333333335,68,50,18,18,0
21700835,203903,CLE,BOS,Jordan Clarkson,109,23.3166666666667,23,0.316666666666666,57,48,9,8,1
21700835,203918,CLE,BOS,Rodney Hood,79,18.45,19,-0.550000000000001,49,33,16,14,2
21700835,204066,CLE,BOS,John Holland,17,3.35,4,-0.65,8,13,-5,-3,-2
21700835,1626204,CLE,BOS,Larry Nance Jr.,94,20.7333333333333,21,-0.266666666666666,53,49,4,4,0
21700835,1626224,CLE,BOS,Cedi Osman,142,29.25,29,0.25,72,66,6,8,-2
21700835,1627790,CLE,BOS,Ante Zizic,15,3.05,3,0.0499999999999998,8,11,-3,-3,0
21700836,101127,NYK,IND,Jarrett Jack,44,8,8,0,15,22,-7,-8,1
21700836,201563,NYK,IND,Michael Beasley,146,28.0666666666667,29,-0.933333333333334,67,57,10,8,2
21700836,201584,NYK,IND,Courtney Lee,110,20.7166666666667,21,-0.283333333333335,51,62,-11,-12,1
21700836,202498,NYK,IND,Lance Thomas,67,14.2,14,0.199999999999999,31,42,-11,-8,-3
21700836,202683,NYK,IND,Enes Kanter,140,26.6166666666667,27,-0.383333333333333,67,73,-6,-3,-3
21700836,203124,NYK,IND,Kyle O'Quinn,99,20.7833333333333,21,-0.216666666666669,46,47,-1,-4,3
21700836,203501,NYK,IND,Tim Hardaway Jr.,147,28.3833333333333,29,-0.616666666666667,67,75,-8,-9,1
21700836,203504,NYK,IND,Trey Burke,38,7.81666666666667,8,-0.183333333333334,19,20,-1,-1,0
21700836,1626144,NYK,IND,Emmanuel Mudiay,140,28.95,29,-0.0499999999999972,72,71,1,2,-1
21700836,1628373,NYK,IND,Frank Ntilikina,152,30.2833333333333,31,-0.716666666666669,77,71,6,8,-2
21700836,1628422,NYK,IND,Damyean Dotson,58,10.5833333333333,11,-0.416666666666666,26,23,3,1,2
21700836,1628436,NYK,IND,Luke Kornet,64,13.5166666666667,13,0.516666666666666,27,42,-15,-14,-1
21700836,2744,IND,NYK,Al Jefferson,50,11.2833333333333,12,-0.716666666666667,26,21,5,5,0
21700836,201152,IND,NYK,Thaddeus Young,168,32.05,32,0.0499999999999972,81,78,3,1,2
21700836,202362,IND,NYK,Lance Stephenson,110,21.15,21,0.149999999999999,55,59,-4,2,-6
21700836,202709,IND,NYK,Cory Joseph,105,20.9333333333333,21,-0.0666666666666664,55,36,19,14,5
21700836,202711,IND,NYK,Bojan Bogdanovic,157,31.5,32,-0.5,76,68,8,2,6
21700836,203506,IND,NYK,Victor Oladipo,199,38.6,39,-0.400000000000006,99,95,4,4,0
21700836,1626167,IND,NYK,Myles Turner,135,26.5,27,-0.5,69,66,3,4,-1
21700836,1626202,IND,NYK,Joe Young,153,30.65,31,-0.350000000000001,79,81,-2,3,-5
21700836,1627734,IND,NYK,Domantas Sabonis,128,25.25,25,0.25,65,61,4,5,-1
21700837,203084,DAL,HOU,Harrison Barnes,145,30.7666666666667,31,-0.233333333333334,59,75,-16,-14,-2
21700837,203926,DAL,HOU,Doug McDermott,149,33.4333333333333,34,-0.566666666666663,70,72,-2,-2,0
21700837,203939,DAL,HOU,Dwight Powell,128,28.3666666666667,29,-0.633333333333333,54,68,-14,-14,0
21700837,1627812,DAL,HOU,Yogi Ferrell,154,33.3666666666667,34,-0.63333333333334,66,75,-9,-8,-1
21700837,1627858,DAL,HOU,Kyle Collinsworth,145,30.6333333333333,31,-0.366666666666667,65,56,9,6,3
21700837,1627883,DAL,HOU,Jalen Jones,108,22.6166666666667,23,-0.383333333333333,51,43,8,7,1
21700837,1628372,DAL,HOU,Dennis Smith Jr.,159,34.7333333333333,35,-0.266666666666666,68,84,-16,-14,-2
21700837,1628405,DAL,HOU,Johnathan Motley,15,4.08333333333333,4,0.0833333333333339,11,6,5,7,-2
21700837,1628467,DAL,HOU,Maxi Kleber,102,20.3333333333333,20,0.333333333333332,41,41,0,-3,3
21700837,2403,HOU,DAL,Nene,82,17.0833333333333,17,0.0833333333333357,33,28,5,2,3
21700837,101108,HOU,DAL,Chris Paul,160,35.0833333333333,35,0.0833333333333357,89,65,24,22,2
21700837,101123,HOU,DAL,Gerald Green,92,18.7666666666667,19,-0.233333333333334,38,45,-7,-6,-1
21700837,200782,HOU,DAL,PJ Tucker,115,25.7833333333333,26,-0.216666666666669,61,55,6,4,2
21700837,201569,HOU,DAL,Eric Gordon,118,24.3333333333333,24,0.333333333333336,46,48,-2,-1,-1
21700837,201583,HOU,DAL,Ryan Anderson,106,21.8833333333333,22,-0.116666666666667,43,42,1,3,-2
21700837,201601,HOU,DAL,Luc Mbah a Moute,133,29.7666666666667,30,-0.233333333333334,66,58,8,7,1
21700837,201935,HOU,DAL,James Harden,156,34.1833333333333,34,0.183333333333337,73,69,4,5,-1
21700837,203900,HOU,DAL,Markel Brown,4,0.866666666666667,1,-0.133333333333333,0,6,-6,-6,0
21700837,203991,HOU,DAL,Clint Capela,139,30.5833333333333,31,-0.416666666666668,71,69,2,5,-3
21700838,2037,MIN,SAC,Jamal Crawford,97,21.3166666666667,22,-0.683333333333334,53,48,5,5,0
21700838,201952,MIN,SAC,Jeff Teague,151,32.7333333333333,32,0.733333333333334,78,76,2,0,2
21700838,201959,MIN,SAC,Taj Gibson,150,32.7,32,0.699999999999996,76,76,0,-2,2
21700838,202357,MIN,SAC,Nemanja Bjelica,75,15.3,16,-0.700000000000001,35,30,5,5,0
21700838,202710,MIN,SAC,Jimmy Butler,186,38.9,39,-0.0999999999999943,93,84,9,11,-2
21700838,203476,MIN,SAC,Gorgui Dieng,56,11.7666666666667,11,0.766666666666666,16,25,-9,-7,-2
21700838,203952,MIN,SAC,Andrew Wiggins,167,35.7833333333333,35,0.783333333333331,76,80,-4,-4,0
21700838,1626145,MIN,SAC,Tyus Jones,74,15.2666666666667,16,-0.733333333333334,33,30,3,5,-2
21700838,1626157,MIN,SAC,Karl-Anthony Towns,169,36.2333333333333,37,-0.766666666666666,95,81,14,12,2
21700838,1713,SAC,MIN,Vince Carter,63,13.3166666666667,13,0.316666666666666,31,17,14,14,0
21700838,2216,SAC,MIN,Zach Randolph,133,29.0666666666667,29,0.0666666666666664,66,73,-7,-3,-4
21700838,201585,SAC,MIN,Kosta Koufos,111,23.8833333333333,24,-0.116666666666667,50,50,0,-1,1
21700838,202066,SAC,MIN,Garrett Temple,107,23.5666666666667,24,-0.433333333333334,50,55,-5,-3,-2
21700838,203960,SAC,MIN,JaKarr Sampson,81,16.6,17,-0.399999999999999,34,30,4,0,4
21700838,203992,SAC,MIN,Bogdan Bogdanovic,145,30.8166666666667,31,-0.183333333333337,68,81,-13,-13,0
21700838,1626161,SAC,MIN,Willie Cauley-Stein,125,26.45,26,0.449999999999999,62,69,-7,-6,-1
21700838,1627741,SAC,MIN,Buddy Hield,91,18.6833333333333,19,-0.316666666666666,42,57,-15,-13,-2
21700838,1628368,SAC,MIN,De'Aaron Fox,163,34.7833333333333,35,-0.216666666666669,77,80,-3,-3,0
21700838,1628382,SAC,MIN,Justin Jackson,106,22.8333333333333,23,-0.166666666666668,50,43,7,3,4
21700839,101109,OKC,MEM,Raymond Felton,155,33.0833333333333,34,-0.916666666666671,86,67,19,21,-2
21700839,202331,OKC,MEM,Paul George,169,35.5833333333333,35,0.583333333333329,87,78,9,10,-1
21700839,202335,OKC,MEM,Patrick Patterson,165,35.2166666666667,35,0.216666666666669,73,73,0,5,-5
21700839,202713,OKC,MEM,Kyle Singler,6,1.15,1,0.15,0,2,-2,-2,0
21700839,203500,OKC,MEM,Steven Adams,141,29.8166666666667,30,-0.183333333333334,79,64,15,15,0
21700839,203518,OKC,MEM,Alex Abrines,174,36.8,37,-0.200000000000003,84,79,5,7,-2
21700839,203924,OKC,MEM,Jerami Grant,111,24.75,25,-0.25,63,40,23,20,3
21700839,203962,OKC,MEM,Josh Huestis,90,20.7666666666667,21,-0.233333333333334,45,28,17,16,1
21700839,1626177,OKC,MEM,Dakari Johnson,21,4.76666666666667,5,-0.233333333333333,3,5,-2,-2,0
21700839,1627772,OKC,MEM,Daniel Hamilton,6,1.15,1,0.15,0,2,-2,-2,0
21700839,1628390,OKC,MEM,Terrance Ferguson,66,15.0166666666667,15,0.0166666666666657,25,20,5,4,1
21700839,1628408,OKC,MEM,PJ Dozier,6,1.15,1,0.15,0,2,-2,-2,0
21700839,201188,MEM,OKC,Marc Gasol,155,33.4666666666667,33,0.466666666666669,74,87,-13,-13,0
21700839,201596,MEM,OKC,Mario Chalmers,142,29.9333333333333,30,-0.06666666666667,65,75,-10,-11,1
21700839,201936,MEM,OKC,Tyreke Evans,126,26.2333333333333,26,0.233333333333334,52,64,-12,-10,-2
21700839,203210,MEM,OKC,JaMychal Green,146,30.1833333333333,30,0.18333333333333,59,66,-7,-9,2
21700839,203463,MEM,OKC,Ben McLemore,131,28.2833333333333,28,0.283333333333331,54,66,-12,-14,2
21700839,1626150,MEM,OKC,Andrew Harrison,49,10.9166666666667,11,-0.0833333333333322,14,20,-6,-10,4
21700839,1626185,MEM,OKC,Jarell Martin,112,24.6666666666667,25,-0.333333333333336,46,52,-6,-4,-2
21700839,1627988,MEM,OKC,Myke Henry,66,14.5333333333333,15,-0.466666666666667,25,36,-11,-10,-1
21700839,1628397,MEM,OKC,Ivan Rabb,77,17.6333333333333,18,-0.366666666666667,29,28,1,1,0
21700839,1628415,MEM,OKC,Dillon Brooks,106,23.4,24,-0.600000000000001,42,51,-9,-10,1
21700840,202323,POR,UTA,Evan Turner,63,15.2833333333333,16,-0.716666666666667,31,31,0,-4,4
21700840,202329,POR,UTA,Al-Farouq Aminu,107,22.65,23,-0.350000000000001,38,55,-17,-18,1
21700840,202334,POR,UTA,Ed Davis,125,28.35,28,0.350000000000001,61,63,-2,-5,3
21700840,203081,POR,UTA,Damian Lillard,184,38.7666666666667,39,-0.233333333333334,83,93,-10,-10,0
21700840,203086,POR,UTA,Meyers Leonard,30,5.73333333333333,6,-0.266666666666668,15,22,-7,-4,-3
21700840,203090,POR,UTA,Maurice Harkless,147,30.1166666666667,30,0.116666666666667,63,72,-9,-8,-1
21700840,203468,POR,UTA,CJ McCollum,174,36.1833333333333,37,-0.816666666666663,72,93,-21,-19,-2
21700840,203894,POR,UTA,Shabazz Napier,76,16.7833333333333,17,-0.216666666666669,30,42,-12,-14,2
21700840,203994,POR,UTA,Jusuf Nurkic,66,13.5333333333333,14,-0.466666666666667,20,30,-10,-10,0
21700840,1626192,POR,UTA,Pat Connaughton,74,16.0166666666667,16,0.0166666666666657,42,38,4,7,-3
21700840,1627774,POR,UTA,Jake Layman,5,0.783333333333333,1,-0.216666666666667,0,5,-5,-5,0
21700840,1628380,POR,UTA,Zach Collins,59,14.1333333333333,14,0.133333333333333,25,31,-6,-5,-1
21700840,201973,UTA,POR,Jonas Jerebko,86,19.6333333333333,20,-0.366666666666667,43,35,8,9,-1
21700840,202324,UTA,POR,Derrick Favors,146,30.7,31,-0.299999999999997,79,56,23,23,0
21700840,202327,UTA,POR,Ekpe Udoh,15,4.48333333333333,4,0.483333333333333,7,7,0,0,0
21700840,202692,UTA,POR,Alec Burks,29,7.86666666666667,8,-0.133333333333334,11,12,-1,-1,0
21700840,203109,UTA,POR,Jae Crowder,130,28.25,29,-0.75,72,67,5,4,1
21700840,203497,UTA,POR,Rudy Gobert,161,34.0166666666667,34,0.0166666666666657,76,72,4,4,0
21700840,203526,UTA,POR,Raul Neto,66,15,15,0,38,23,15,12,3
21700840,204060,UTA,POR,Joe Ingles,142,28.7333333333333,30,-1.26666666666667,75,64,11,8,3
21700840,1626220,UTA,POR,Royce O'Neale,163,33.7,33,0.700000000000003,87,62,25,28,-3
21700840,1628378,UTA,POR,Donovan Mitchell,172,35.95,37,-1.05,87,82,5,8,-3
21700841,2731,NOP,DET,Emeka Okafor,73,13.6333333333333,14,-0.366666666666667,25,30,-5,-5,0
21700841,200765,NOP,DET,Rajon Rondo,155,29.8833333333333,30,-0.116666666666667,57,66,-9,-7,-2
21700841,201950,NOP,DET,Jrue Holiday,187,34.6166666666667,35,-0.383333333333333,93,72,21,22,-1
21700841,202703,NOP,DET,Nikola Mirotic,149,28.5833333333333,29,-0.416666666666668,77,66,11,11,0
21700841,202732,NOP,DET,DeAndre Liggins,27,5.55,6,-0.449999999999999,16,7,9,9,0
21700841,202734,NOP,DET,E'Twaun Moore,75,13.7333333333333,14,-0.266666666666666,30,32,-2,-4,2
21700841,203076,NOP,DET,Anthony Davis,194,36.6666666666667,37,-0.333333333333329,100,82,18,18,0
21700841,203121,NOP,DET,Darius Miller,149,29.65,30,-0.350000000000001,78,66,12,9,3
21700841,203546,NOP,DET,Ian Clark,149,28.7166666666667,29,-0.283333333333335,80,66,14,16,-2
21700841,1627767,NOP,DET,Cheick Diallo,82,16.65,17,-0.350000000000001,34,28,6,6,0
21700841,1628429,NOP,DET,Charles Cooke,5,1.15,1,0.15,0,0,0,0,0
21700841,2749,DET,NOP,Jameer Nelson,104,20.3,20,0.300000000000001,45,57,-12,-9,-3
21700841,201229,DET,NOP,Anthony Tolliver,91,17.2166666666667,18,-0.783333333333335,37,47,-10,-13,3
21700841,201933,DET,NOP,Blake Griffin,165,31.6,32,-0.400000000000002,69,77,-8,-8,0
21700841,202397,DET,NOP,Ish Smith,129,24.1833333333333,24,0.183333333333334,52,58,-6,-9,3
21700841,202779,DET,NOP,Dwight Buycks,16,3.28333333333333,3,0.283333333333333,6,3,3,3,0
21700841,203083,DET,NOP,Andre Drummond,186,35.0833333333333,35,0.0833333333333286,79,92,-13,-12,-1
21700841,203493,DET,NOP,Reggie Bullock,157,29.9,30,-0.100000000000001,66,82,-16,-16,0
21700841,203516,DET,NOP,James Ennis III,62,11.8666666666667,12,-0.133333333333333,19,31,-12,-10,-2
21700841,203961,DET,NOP,Eric Moreland,38,7.81666666666667,8,-0.183333333333334,15,15,0,0,0
21700841,204038,DET,NOP,Langston Galloway,68,13.6833333333333,13,0.683333333333334,29,29,0,-1,1
21700841,1626169,DET,NOP,Stanley Johnson,150,28.2166666666667,28,0.216666666666665,65,65,0,1,-1
21700841,1627740,DET,NOP,Henry Ellenson,18,3.81666666666667,4,-0.183333333333334,6,5,1,3,-2
21700841,1628379,DET,NOP,Luke Kennard,61,11.8666666666667,12,-0.133333333333333,27,29,-2,-4,2
21700842,101127,NYK,PHI,Jarrett Jack,77,17.2,18,-0.800000000000001,32,39,-7,-7,0
21700842,201563,NYK,PHI,Michael Beasley,177,39.1833333333333,39,0.183333333333337,70,89,-19,-19,0
21700842,201584,NYK,PHI,Courtney Lee,144,29.7333333333333,30,-0.266666666666666,61,72,-11,-11,0
21700842,202498,NYK,PHI,Lance Thomas,64,14.05,14,0.0500000000000007,27,34,-7,-8,1
21700842,202683,NYK,PHI,Enes Kanter,152,33.05,33,0.0499999999999972,72,82,-10,-10,0
21700842,203124,NYK,PHI,Kyle O'Quinn,62,11.95,12,-0.0500000000000007,18,24,-6,-8,2
21700842,203501,NYK,PHI,Tim Hardaway Jr.,162,34.6833333333333,34,0.683333333333337,67,78,-11,-10,-1
21700842,203504,NYK,PHI,Trey Burke,18,4.4,4,0.4,6,4,2,2,0
21700842,1626144,NYK,PHI,Emmanuel Mudiay,94,19.55,19,0.549999999999997,36,54,-18,-18,0
21700842,1628373,NYK,PHI,Frank Ntilikina,86,20.8333333333333,21,-0.166666666666664,41,39,2,4,-2
21700842,1628422,NYK,PHI,Damyean Dotson,15,3.36666666666667,3,0.366666666666667,4,4,0,0,0
21700842,1628436,NYK,PHI,Luke Kornet,18,4.4,4,0.4,6,4,2,2,0
21700842,1628439,NYK,PHI,Isaiah Hicks,36,7.35,7,0.350000000000001,20,17,3,3,0
21700842,101161,PHI,NYK,Amir Johnson,110,24.6166666666667,24,0.616666666666667,51,49,2,3,-1
21700842,200755,PHI,NYK,JJ Redick,124,25.9833333333333,26,-0.0166666666666657,67,53,14,13,1
21700842,202344,PHI,NYK,Trevor Booker,79,15.5833333333333,16,-0.416666666666668,36,27,9,9,0
21700842,203496,PHI,NYK,Robert Covington,166,35.6333333333333,36,-0.366666666666667,79,73,6,8,-2
21700842,203954,PHI,NYK,Joel Embiid,111,23.3333333333333,24,-0.666666666666664,57,43,14,13,1
21700842,203967,PHI,NYK,Dario Saric,142,32.3666666666667,32,0.366666666666667,72,65,7,7,0
21700842,204456,PHI,NYK,T.J. McConnell,170,36.8333333333333,37,-0.166666666666671,83,72,11,11,0
21700842,1626147,PHI,NYK,Justin Anderson,23,5.65,5,0.65,13,10,3,1,2
21700842,1627732,PHI,NYK,Ben Simmons,144,32.7833333333333,33,-0.216666666666669,70,61,9,10,-1
21700842,1627789,PHI,NYK,Timothe Luwawu-Cabarrot,36,6.96666666666667,7,-0.0333333333333332,12,7,5,5,0
21700843,101150,LAC,BKN,Lou Williams,141,30.1666666666667,30,0.166666666666664,74,72,2,4,-2
21700843,201568,LAC,BKN,Danilo Gallinari,155,34.9333333333333,35,-0.06666666666667,76,83,-7,-7,0
21700843,201599,LAC,BKN,DeAndre Jordan,156,35.35,36,-0.650000000000006,85,63,22,22,0
21700843,202325,LAC,BKN,Wesley Johnson,53,10.4333333333333,10,0.433333333333334,30,19,11,10,1
21700843,202340,LAC,BKN,Avery Bradley,126,27.45,28,-0.550000000000001,64,60,4,3,1
21700843,202699,LAC,BKN,Tobias Harris,141,32.3666666666667,33,-0.633333333333333,79,55,24,24,0
21700843,203085,LAC,BKN,Austin Rivers,150,34.7666666666667,35,-0.233333333333334,76,71,5,6,-1
21700843,1626149,LAC,BKN,Montrezl Harrell,61,12,12,0,29,37,-8,-9,1
21700843,1626155,LAC,BKN,Sam Dekker,24,4.3,5,-0.7,11,8,3,2,1
21700843,1627820,LAC,BKN,Tyrone Wallace,2,0.45,0,0.45,,1,,-1,
21700843,1628414,LAC,BKN,Sindarius Thornwell,2,0.7,1,-0.3,,3,,-3,
21700843,1628462,LAC,BKN,Milos Teodosic,79,15.9166666666667,16,-0.0833333333333322,46,33,13,14,-1
21700843,201960,BKN,LAC,DeMarre Carroll,160,35.1,35,0.0999999999999943,80,79,1,1,0
21700843,201967,BKN,LAC,Dante Cunningham,60,12.2,12,0.199999999999999,25,35,-10,-11,1
21700843,203112,BKN,LAC,Quincy Acy,143,31.6,31,0.600000000000001,71,74,-3,-3,0
21700843,203459,BKN,LAC,Allen Crabbe,147,32.25,33,-0.75,75,85,-10,-9,-1
21700843,203915,BKN,LAC,Spencer Dinwiddie,167,36.2166666666667,36,0.216666666666669,83,83,0,2,-2
21700843,203917,BKN,LAC,Nik Stauskas,19,5.08333333333333,5,0.0833333333333339,4,11,-7,-7,0
21700843,203925,BKN,LAC,Joe Harris,120,26.0333333333333,26,0.0333333333333314,50,60,-10,-13,3
21700843,1626143,BKN,LAC,Jahlil Okafor,58,12.8333333333333,13,-0.166666666666668,18,36,-18,-18,0
21700843,1626156,BKN,LAC,D'Angelo Russell,120,25.0833333333333,25,0.0833333333333322,60,58,2,0,2
21700843,1627785,BKN,LAC,Isaiah Whitehead,8,2.53333333333333,3,-0.466666666666667,4,4,0,0,0
21700843,1627821,BKN,LAC,James Webb III,8,2.53333333333333,3,-0.466666666666667,4,4,0,0,0
21700843,1628386,BKN,LAC,Jarrett Allen,80,17.3666666666667,18,-0.633333333333333,31,41,-10,-7,-3
21700844,201577,CHI,ORL,Robin Lopez,113,26.15,26,0.149999999999999,52,53,-1,-2,1
21700844,203200,CHI,ORL,Justin Holiday,152,34.5833333333333,35,-0.416666666666671,74,69,5,7,-2
21700844,203897,CHI,ORL,Zach LaVine,147,33.15,33,0.149999999999999,78,62,16,16,0
21700844,1626170,CHI,ORL,Jerian Grant,160,37.3333333333333,37,0.333333333333336,73,82,-9,-7,-2
21700844,1626171,CHI,ORL,Bobby Portis,119,26.4666666666667,26,0.466666666666669,62,62,0,1,-1
21700844,1627756,CHI,ORL,Denzel Valentine,83,18.35,18,0.350000000000001,41,43,-2,-2,0
21700844,1627835,CHI,ORL,Paul Zipser,60,12.8,13,-0.199999999999999,37,25,12,10,2
21700844,1627853,CHI,ORL,Ryan Arcidiacono,31,6.88333333333333,7,-0.116666666666667,14,15,-1,-3,2
21700844,1628021,CHI,ORL,David Nwaba,66,13.7,14,-0.300000000000001,35,32,3,1,2
21700844,1628374,CHI,ORL,Lauri Markkanen,134,30.5833333333333,31,-0.416666666666664,59,62,-3,-1,-2
21700844,201167,ORL,CHI,Arron Afflalo,75,16.85,17,-0.149999999999999,39,37,2,3,-1
21700844,201571,ORL,CHI,D.J. Augustin,97,21.9833333333333,22,-0.0166666666666657,41,47,-6,-8,2
21700844,201578,ORL,CHI,Marreese Speights,58,12.6,13,-0.4,26,39,-13,-11,-2
21700844,202687,ORL,CHI,Bismack Biyombo,91,20.6,21,-0.399999999999999,39,43,-4,-3,-1
21700844,202714,ORL,CHI,Shelvin Mack,116,26.0166666666667,26,0.0166666666666657,60,58,2,4,-2
21700844,203095,ORL,CHI,Evan Fournier,147,33.05,33,0.0499999999999972,73,69,4,5,-1
21700844,203613,ORL,CHI,Jonathon Simmons,146,32.8333333333333,33,-0.166666666666671,62,67,-5,-7,2
21700844,203920,ORL,CHI,Khem Birch,113,26.1666666666667,26,0.166666666666668,55,42,13,11,2
21700844,1626209,ORL,CHI,Mario Hezonja,133,29.75,30,-0.25,70,74,-4,-5,1
21700844,1628411,ORL,CHI,Wes Iwundu,89,20.15,20,0.149999999999999,40,49,-9,-9,0
21700845,1938,SAS,UTA,Manu Ginobili,111,22.7666666666667,22,0.766666666666666,49,49,0,2,-2
21700845,2200,SAS,UTA,Pau Gasol,155,32.7166666666667,33,-0.283333333333331,62,67,-5,-4,-1
21700845,2225,SAS,UTA,Tony Parker,76,16.3666666666667,16,0.366666666666667,37,31,6,6,0
21700845,201980,SAS,UTA,Danny Green,139,29.8,30,-0.199999999999999,67,57,10,9,1
21700845,201988,SAS,UTA,Patty Mills,101,21.6,22,-0.399999999999999,49,52,-3,1,-4
21700845,202722,SAS,UTA,Davis Bertans,128,28.3833333333333,29,-0.616666666666667,55,57,-2,-4,2
21700845,203530,SAS,UTA,Joffrey Lauvergne,69,15.2833333333333,15,0.283333333333335,37,34,3,2,1
21700845,203937,SAS,UTA,Kyle Anderson,167,35.1166666666667,35,0.116666666666667,65,76,-11,-14,3
21700845,1627749,SAS,UTA,Dejounte Murray,131,28.5666666666667,29,-0.433333333333334,54,58,-4,-4,0
21700845,1627854,SAS,UTA,Bryn Forbes,43,9.4,9,0.4,20,24,-4,-4,0
21700845,201973,UTA,SAS,Jonas Jerebko,39,8.11666666666667,8,0.116666666666667,14,21,-7,-7,0
21700845,202324,UTA,SAS,Derrick Favors,125,25.6166666666667,25,0.616666666666667,55,62,-7,-8,1
21700845,202327,UTA,SAS,Ekpe Udoh,8,1.86666666666667,2,-0.133333333333333,5,5,0,1,-1
21700845,202692,UTA,SAS,Alec Burks,37,7.98333333333333,8,-0.0166666666666675,18,18,0,-2,2
21700845,203109,UTA,SAS,Jae Crowder,156,33.3666666666667,33,0.366666666666667,74,71,3,4,-1
21700845,203497,UTA,SAS,Rudy Gobert,138,30.7333333333333,31,-0.266666666666666,57,53,4,4,0
21700845,203526,UTA,SAS,Raul Neto,82,17.7333333333333,18,-0.266666666666666,37,40,-3,-4,1
21700845,204060,UTA,SAS,Joe Ingles,178,38.3,39,-0.700000000000003,81,72,9,8,1
21700845,1626220,UTA,SAS,Royce O'Neale,180,38.4333333333333,38,0.433333333333337,87,80,7,8,-1
21700845,1628378,UTA,SAS,Donovan Mitchell,177,37.85,38,-0.149999999999999,77,73,4,6,-2
21700846,2561,GSW,PHX,David West,68,14.9666666666667,16,-1.03333333333333,45,22,23,23,0
21700846,2585,GSW,PHX,Zaza Pachulia,79,16.6,17,-0.399999999999999,36,30,6,6,0
21700846,2733,GSW,PHX,Shaun Livingston,68,14.9666666666667,16,-1.03333333333333,45,22,23,23,0
21700846,2738,GSW,PHX,Andre Iguodala,120,24.15,24,0.149999999999999,64,44,20,20,0
21700846,201142,GSW,PHX,Kevin Durant,156,29.8666666666667,30,-0.133333333333333,80,59,21,21,0
21700846,201156,GSW,PHX,Nick Young,116,23.4833333333333,24,-0.516666666666666,68,33,35,34,1
21700846,201580,GSW,PHX,JaVale McGee,71,13.8,14,-0.199999999999999,37,24,13,13,0
21700846,201939,GSW,PHX,Stephen Curry,156,29.8666666666667,30,-0.133333333333333,80,59,21,21,0
21700846,201956,GSW,PHX,Omri Casspi,128,26.35,27,-0.649999999999999,69,41,28,28,0
21700846,202691,GSW,PHX,Klay Thompson,110,22.6666666666667,23,-0.333333333333336,58,46,12,12,0
21700846,1626172,GSW,PHX,Kevon Looney,71,13.9833333333333,14,-0.0166666666666657,41,19,22,22,0
21700846,1627775,GSW,PHX,Patrick McCaw,37,7.63333333333333,8,-0.366666666666666,22,16,6,7,-1
21700846,2199,PHX,GSW,Tyson Chandler,90,17.5666666666667,18,-0.433333333333334,35,51,-16,-16,0
21700846,201162,PHX,GSW,Jared Dudley,45,9.91666666666667,10,-0.0833333333333339,10,20,-10,-10,0
21700846,203458,PHX,GSW,Alex Len,101,20.1833333333333,20,0.183333333333334,38,58,-20,-20,0
21700846,203584,PHX,GSW,Troy Daniels,103,20.7,21,-0.300000000000001,43,57,-14,-14,0
21700846,203901,PHX,GSW,Elfrid Payton,150,30.6,31,-0.399999999999999,60,82,-22,-22,0
21700846,203933,PHX,GSW,T.J. Warren,164,32.9666666666667,33,-0.0333333333333314,62,92,-30,-25,-5
21700846,1627733,PHX,GSW,Dragan Bender,146,29.7333333333333,30,-0.266666666666666,51,73,-22,-22,0
21700846,1627737,PHX,GSW,Marquese Chriss,90,17.9333333333333,18,-0.0666666666666664,32,56,-24,-24,0
21700846,1627982,PHX,GSW,Josh Gray,86,17.0666666666667,17,0.0666666666666664,23,47,-24,-24,0
21700846,1628367,PHX,GSW,Josh Jackson,160,31.75,32,-0.25,51,89,-38,-43,5
21700846,1628432,PHX,GSW,Davon Reed,45,9.91666666666667,10,-0.0833333333333339,10,20,-10,-10,0
21700847,2548,MIA,TOR,Dwyane Wade,106,21.7333333333333,21,0.733333333333334,46,57,-11,-11,0
21700847,201609,MIA,TOR,Goran Dragic,151,31.05,31,0.0499999999999972,74,68,6,6,0
21700847,201949,MIA,TOR,James Johnson,134,28.85,29,-0.149999999999999,61,77,-16,-14,-2
21700847,201961,MIA,TOR,Wayne Ellington,149,31.3,31,0.300000000000001,71,73,-2,-4,2
21700847,202355,MIA,TOR,Hassan Whiteside,108,22.6166666666667,23,-0.383333333333333,51,59,-8,-10,2
21700847,204020,MIA,TOR,Tyler Johnson,103,22.0166666666667,22,0.0166666666666657,56,46,10,12,-2
21700847,1626159,MIA,TOR,Justise Winslow,96,20.8666666666667,21,-0.133333333333333,49,50,-1,-2,1
21700847,1626196,MIA,TOR,Josh Richardson,177,36.1833333333333,37,-0.816666666666663,91,89,2,1,1
21700847,1628389,MIA,TOR,Bam Adebayo,121,25.3833333333333,25,0.383333333333333,61,56,5,7,-2
21700847,101139,TOR,MIA,CJ Miles,66,15.2166666666667,15,0.216666666666667,32,35,-3,-3,0
21700847,200768,TOR,MIA,Kyle Lowry,157,32.8333333333333,33,-0.166666666666671,75,77,-2,0,-2
21700847,201586,TOR,MIA,Serge Ibaka,120,25.4666666666667,26,-0.533333333333335,65,55,10,8,2
21700847,201942,TOR,MIA,DeMar DeRozan,174,35.1833333333333,35,0.183333333333337,93,81,12,10,2
21700847,202685,TOR,MIA,Jonas Valanciunas,145,30.05,30,0.0500000000000007,68,73,-5,-1,-4
21700847,1626153,TOR,MIA,Delon Wright,98,20.9666666666667,21,-0.0333333333333314,42,50,-8,-8,0
21700847,1626181,TOR,MIA,Norman Powell,33,6.85,7,-0.15,20,15,5,5,0
21700847,1627751,TOR,MIA,Jakob Poeltl,84,17.95,18,-0.0500000000000007,47,39,8,4,4
21700847,1627783,TOR,MIA,Pascal Siakam,95,19.7666666666667,19,0.766666666666666,48,50,-2,0,-2
21700847,1627832,TOR,MIA,Fred VanVleet,113,23.3,23,0.299999999999997,56,52,4,4,0
21700847,1628384,TOR,MIA,OG Anunoby,60,12.4166666666667,13,-0.583333333333334,29,33,-4,-4,0
21700848,101141,ATL,MIL,Ersan Ilyasova,125,27.8833333333333,28,-0.116666666666667,55,58,-3,-4,1
21700848,203145,ATL,MIL,Kent Bazemore,133,29.3,29,0.300000000000001,58,58,0,-3,3
21700848,203471,ATL,MIL,Dennis Schroder,143,31.2333333333333,31,0.233333333333331,64,68,-4,-6,2
21700848,203473,ATL,MIL,Dewayne Dedmon,126,27.3333333333333,28,-0.666666666666668,57,56,1,-1,2
21700848,203488,ATL,MIL,Mike Muscala,77,17.35,17,0.350000000000001,32,34,-2,0,-2
21700848,1627098,ATL,MIL,Malcolm Delaney,72,15.4,15,0.399999999999999,26,36,-10,-9,-1
21700848,1627752,ATL,MIL,Taurean Prince,136,29.7666666666667,30,-0.233333333333334,58,58,0,0,0
21700848,1627761,ATL,MIL,DeAndre' Bembry,56,12.2666666666667,12,0.266666666666666,27,23,4,5,-1
21700848,1627819,ATL,MIL,Isaiah Taylor,59,13.8833333333333,14,-0.116666666666667,27,19,8,8,0
21700848,1628381,ATL,MIL,John Collins,103,22.6,23,-0.399999999999999,38,44,-6,-5,-1
21700848,1628416,ATL,MIL,Tyler Dorsey,55,12.3166666666667,13,-0.683333333333334,18,31,-13,-10,-3
21700848,1891,MIL,ATL,Jason Terry,63,13.5166666666667,13,0.516666666666666,23,27,-4,-5,1
21700848,202339,MIL,ATL,Eric Bledsoe,154,34.35,35,-0.650000000000006,74,65,9,10,-1
21700848,203092,MIL,ATL,Tyler Zeller,104,23.25,23,0.25,41,48,-7,-8,1
21700848,203114,MIL,ATL,Khris Middleton,154,34.35,35,-0.650000000000006,74,65,9,10,-1
21700848,203503,MIL,ATL,Tony Snell,143,31.1666666666667,31,0.166666666666664,68,60,8,8,0
21700848,203507,MIL,ATL,Giannis Antetokounmpo,159,34.2666666666667,34,0.266666666666666,68,64,4,4,0
21700848,203930,MIL,ATL,Sean Kilpatrick,42,9.58333333333333,9,0.583333333333332,14,21,-7,-6,-1
21700848,203953,MIL,ATL,Jabari Parker,79,17.65,18,-0.350000000000001,38,37,1,0,1
21700848,1627748,MIL,ATL,Thon Maker,113,24.6166666666667,25,-0.383333333333333,56,44,12,13,-1
21700848,1628425,MIL,ATL,Sterling Brown,74,16.5833333333333,17,-0.416666666666664,29,29,0,-1,1
21700849,2403,HOU,MIN,Nene,66,13.5333333333333,14,-0.466666666666667,34,28,6,8,-2
21700849,101108,HOU,MIN,Chris Paul,146,33.5666666666667,34,-0.433333333333337,83,63,20,22,-2
21700849,101123,HOU,MIN,Gerald Green,89,17.4166666666667,18,-0.583333333333336,47,42,5,6,-1
21700849,200782,HOU,MIN,PJ Tucker,118,28.2333333333333,28,0.233333333333334,76,60,16,14,2
21700849,201569,HOU,MIN,Eric Gordon,137,30.4666666666667,30,0.466666666666665,82,77,5,5,0
21700849,201583,HOU,MIN,Ryan Anderson,120,25.6333333333333,26,-0.366666666666667,74,60,14,12,2
21700849,201601,HOU,MIN,Luc Mbah a Moute,121,28.6166666666667,29,-0.383333333333333,79,63,16,15,1
21700849,201935,HOU,MIN,James Harden,159,35.6,36,-0.400000000000006,97,86,11,11,0
21700849,203991,HOU,MIN,Clint Capela,114,25.85,26,-0.149999999999999,58,61,-3,-3,0
21700849,2037,MIN,HOU,Jamal Crawford,94,19.7333333333333,20,-0.266666666666666,45,58,-13,-12,-1
21700849,201166,MIN,HOU,Aaron Brooks,6,1.13333333333333,1,0.133333333333333,3,5,-2,-2,0
21700849,201952,MIN,HOU,Jeff Teague,170,38.2166666666667,38,0.216666666666669,96,99,-3,-3,0
21700849,201959,MIN,HOU,Taj Gibson,152,33.55,34,-0.450000000000003,90,84,6,4,2
21700849,202332,MIN,HOU,Cole Aldrich,2,0.516666666666667,1,-0.483333333333333,0,2,-2,-2,0
21700849,202357,MIN,HOU,Nemanja Bjelica,54,12.1166666666667,12,0.116666666666667,18,30,-12,-10,-2
21700849,202710,MIN,HOU,Jimmy Butler,161,36.3666666666667,36,0.366666666666667,87,94,-7,-9,2
21700849,203476,MIN,HOU,Gorgui Dieng,53,12.1333333333333,12,0.133333333333333,22,32,-10,-12,2
21700849,203952,MIN,HOU,Andrew Wiggins,175,40.45,41,-0.549999999999997,81,107,-26,-25,-1
21700849,1626145,MIN,HOU,Tyus Jones,44,9.56666666666667,10,-0.433333333333334,12,27,-15,-15,0
21700849,1626157,MIN,HOU,Karl-Anthony Towns,159,35.1333333333333,35,0.133333333333333,86,92,-6,-4,-2
21700850,2544,CLE,OKC,LeBron James,187,40.2333333333333,40,0.233333333333334,98,100,-2,-1,-1
21700850,2594,CLE,OKC,Kyle Korver,37,7.75,8,-0.25,22,12,10,9,1
21700850,2747,CLE,OKC,JR Smith,145,30.8,31,-0.200000000000003,80,83,-3,-5,2
21700850,201145,CLE,OKC,Jeff Green,127,26.65,27,-0.350000000000001,68,54,14,14,0
21700850,201588,CLE,OKC,George Hill,107,23.4833333333333,24,-0.516666666666666,58,61,-3,-5,2
21700850,202684,CLE,OKC,Tristan Thompson,100,22.8,23,-0.200000000000003,58,61,-3,-6,3
21700850,203903,CLE,OKC,Jordan Clarkson,107,23.7,24,-0.299999999999997,57,45,12,16,-4
21700850,203918,CLE,OKC,Rodney Hood,119,24.7666666666667,24,0.766666666666666,58,50,8,8,0
21700850,1626204,CLE,OKC,Larry Nance Jr.,124,25.1833333333333,25,0.18333333333333,62,51,11,14,-3
21700850,1626224,CLE,OKC,Cedi Osman,67,14.55,15,-0.450000000000001,39,43,-4,-4,0
21700850,2546,OKC,CLE,Carmelo Anthony,169,36.4166666666667,36,0.416666666666664,95,92,3,3,0
21700850,101109,OKC,CLE,Raymond Felton,65,13.9,14,-0.0999999999999996,23,32,-9,-11,2
21700850,201566,OKC,CLE,Russell Westbrook,183,39.4333333333333,39,0.433333333333337,98,103,-5,-3,-2
21700850,202331,OKC,CLE,Paul George,185,38.9833333333333,40,-1.01666666666667,97,99,-2,-4,2
21700850,202335,OKC,CLE,Patrick Patterson,46,9.91666666666667,10,-0.0833333333333339,19,21,-2,-4,2
21700850,203500,OKC,CLE,Steven Adams,193,41.5833333333333,42,-0.416666666666664,103,106,-3,-1,-2
21700850,203518,OKC,CLE,Alex Abrines,113,23.1,23,0.100000000000001,58,55,3,1,2
21700850,203924,OKC,CLE,Jerami Grant,98,21.4166666666667,21,0.416666666666664,36,55,-19,-19,0
21700850,203962,OKC,CLE,Josh Huestis,68,15.1666666666667,15,0.166666666666668,31,37,-6,-2,-4
21700851,1717,DAL,SAC,Dirk Nowitzki,133,31.4333333333333,32,-0.566666666666666,76,68,8,8,0
21700851,200826,DAL,SAC,J.J. Barea,133,31.4333333333333,32,-0.566666666666666,76,68,8,8,0
21700851,202083,DAL,SAC,Wesley Matthews,129,29.0833333333333,29,0.0833333333333322,56,68,-12,-12,0
21700851,203084,DAL,SAC,Harrison Barnes,136,30.45,30,0.449999999999999,58,72,-14,-14,0
21700851,203926,DAL,SAC,Doug McDermott,79,18.8166666666667,19,-0.183333333333334,53,46,7,7,0
21700851,203939,DAL,SAC,Dwight Powell,110,25.9333333333333,26,-0.0666666666666664,66,64,2,2,0
21700851,1626257,DAL,SAC,Salah Mejri,27,5.51666666666667,6,-0.483333333333333,15,17,-2,-2,0
21700851,1627812,DAL,SAC,Yogi Ferrell,68,15.0333333333333,15,0.0333333333333332,28,41,-13,-11,-2
21700851,1627858,DAL,SAC,Kyle Collinsworth,79,18.8833333333333,19,-0.116666666666667,56,47,9,7,2
21700851,1627883,DAL,SAC,Jalen Jones,1,0.0333333333333333,0,0.0333333333333333,,1,,-1,
21700851,1628372,DAL,SAC,Dennis Smith Jr.,135,30.4166666666667,30,0.416666666666664,58,71,-13,-13,0
21700851,1628467,DAL,SAC,Maxi Kleber,10,2.46666666666667,2,0.466666666666667,3,7,-4,-4,0
21700851,1713,SAC,DAL,Vince Carter,114,27.0333333333333,27,0.0333333333333314,66,60,6,6,0
21700851,2216,SAC,DAL,Zach Randolph,113,25.6166666666667,26,-0.383333333333333,57,48,9,9,0
21700851,201585,SAC,DAL,Kosta Koufos,95,22.2833333333333,22,0.283333333333331,57,61,-4,-4,0
21700851,202066,SAC,DAL,Garrett Temple,81,19.05,19,0.0499999999999972,50,42,8,8,0
21700851,203960,SAC,DAL,JaKarr Sampson,20,4.78333333333333,5,-0.216666666666667,14,17,-3,-3,0
21700851,203992,SAC,DAL,Bogdan Bogdanovic,147,33.9833333333333,34,-0.0166666666666657,76,79,-3,-3,0
21700851,1626161,SAC,DAL,Willie Cauley-Stein,122,27.7,28,-0.300000000000001,64,56,8,8,0
21700851,1627741,SAC,DAL,Buddy Hield,75,17.2,17,0.200000000000003,50,38,12,13,-1
21700851,1628368,SAC,DAL,De'Aaron Fox,137,31.25,31,0.25,68,72,-4,-5,1
21700851,1628382,SAC,DAL,Justin Jackson,136,30.6,31,-0.399999999999999,68,72,-4,-4,0
21700852,2734,DEN,SAS,Devin Harris,99,20.6,20,0.600000000000001,47,49,-2,-2,0
21700852,201163,DEN,SAS,Wilson Chandler,165,33.9166666666667,34,-0.0833333333333286,81,72,9,10,-1
21700852,201589,DEN,SAS,Darrell Arthur,27,6.05,6,0.0499999999999998,9,17,-8,-8,0
21700852,203115,DEN,SAS,Will Barton,202,42.4833333333333,43,-0.516666666666666,111,96,15,15,0
21700852,203914,DEN,SAS,Gary Harris,166,35.0833333333333,35,0.0833333333333286,83,76,7,6,1
21700852,203999,DEN,SAS,Nikola Jokic,154,32.85,33,-0.150000000000006,81,70,11,11,0
21700852,1626168,DEN,SAS,Trey Lyles,82,17.0333333333333,17,0.0333333333333314,42,46,-4,-5,1
21700852,1627736,DEN,SAS,Malik Beasley,63,13.1666666666667,13,0.166666666666668,33,36,-3,-4,1
21700852,1627750,DEN,SAS,Jamal Murray,175,37.5166666666667,38,-0.483333333333334,98,81,17,19,-2
21700852,1628420,DEN,SAS,Monte Morris,2,0.466666666666667,1,-0.533333333333333,0,2,-2,-2,0
21700852,1938,SAS,DEN,Manu Ginobili,69,14.15,14,0.15,32,32,0,0,0
21700852,2200,SAS,DEN,Pau Gasol,97,20.4,21,-0.600000000000001,42,63,-21,-21,0
21700852,2225,SAS,DEN,Tony Parker,99,21.95,22,-0.0500000000000007,47,51,-4,-2,-2
21700852,201980,SAS,DEN,Danny Green,150,31.6833333333333,32,-0.316666666666666,79,79,0,0,0
21700852,201988,SAS,DEN,Patty Mills,128,26.3666666666667,26,0.366666666666667,53,55,-2,-2,0
21700852,202722,SAS,DEN,Davis Bertans,120,26.4666666666667,27,-0.533333333333331,59,62,-3,-5,2
21700852,203464,SAS,DEN,Brandon Paul,2,0.466666666666667,1,-0.533333333333333,2,0,2,2,0
21700852,203530,SAS,DEN,Joffrey Lauvergne,111,24.1,24,0.100000000000001,59,45,14,18,-4
21700852,203937,SAS,DEN,Kyle Anderson,104,21.8,21,0.800000000000001,43,67,-24,-24,0
21700852,1626199,SAS,DEN,Darrun Hilliard,14,2.68333333333333,3,-0.316666666666667,8,9,-1,-3,2
21700852,1627749,SAS,DEN,Dejounte Murray,134,27.4,27,0.399999999999999,64,72,-8,-8,0
21700852,1627854,SAS,DEN,Bryn Forbes,96,19.55,20,-0.450000000000003,49,44,5,7,-2
21700852,1628401,SAS,DEN,Derrick White,11,2.15,2,0.15,8,6,2,-2,4
21700853,203101,ATL,DET,Miles Plumlee,58,13.95,14,-0.0500000000000007,31,38,-7,-7,0
21700853,203473,ATL,DET,Dewayne Dedmon,115,25.1,25,0.100000000000001,46,55,-9,-9,0
21700853,203488,ATL,DET,Mike Muscala,118,25.4166666666667,25,0.416666666666664,55,58,-3,1,-4
21700853,1627098,ATL,DET,Malcolm Delaney,136,27.4333333333333,27,0.43333333333333,53,71,-18,-18,0
21700853,1627752,ATL,DET,Taurean Prince,143,28.45,29,-0.550000000000001,62,64,-2,-4,2
21700853,1627761,ATL,DET,DeAndre' Bembry,65,14.9833333333333,15,-0.0166666666666657,31,37,-6,-8,2
21700853,1627819,ATL,DET,Isaiah Taylor,115,25.2166666666667,25,0.216666666666665,64,48,16,14,2
21700853,1628381,ATL,DET,John Collins,151,31.3,31,0.299999999999997,56,54,2,4,-2
21700853,1628416,ATL,DET,Tyler Dorsey,147,31.2833333333333,31,0.283333333333331,58,64,-6,-6,0
21700853,1628510,ATL,DET,Andrew White III,72,16.7833333333333,17,-0.216666666666669,34,31,3,3,0
21700853,2749,DET,ATL,Jameer Nelson,63,14.5166666666667,15,-0.483333333333334,18,25,-7,-7,0
21700853,201229,DET,ATL,Anthony Tolliver,104,24.5333333333333,25,-0.466666666666669,46,47,-1,-1,0
21700853,201933,DET,ATL,Blake Griffin,172,36.2,36,0.200000000000003,85,74,11,11,0
21700853,202397,DET,ATL,Ish Smith,161,33.4666666666667,33,0.466666666666669,86,73,13,13,0
21700853,203083,DET,ATL,Andre Drummond,168,35.0666666666667,35,0.0666666666666629,73,73,0,2,-2
21700853,203493,DET,ATL,Reggie Bullock,146,29.6666666666667,30,-0.333333333333336,78,57,21,21,0
21700853,203516,DET,ATL,James Ennis III,82,18.5,19,-0.5,37,41,-4,-6,2
21700853,1626169,DET,ATL,Stanley Johnson,146,29.65,29,0.649999999999999,71,59,12,12,0
21700853,1628379,DET,ATL,Luke Kennard,78,18.3166666666667,18,0.316666666666666,26,41,-15,-15,0
21700854,201167,ORL,CHA,Arron Afflalo,68,15.45,15,0.449999999999999,34,31,3,3,0
21700854,201571,ORL,CHA,D.J. Augustin,148,30.5666666666667,31,-0.43333333333333,64,69,-5,-3,-2
21700854,201578,ORL,CHA,Marreese Speights,89,19.0166666666667,19,0.0166666666666657,44,37,7,9,-2
21700854,202687,ORL,CHA,Bismack Biyombo,122,25.1333333333333,25,0.133333333333333,53,58,-5,-5,0
21700854,202714,ORL,CHA,Shelvin Mack,110,23.6666666666667,24,-0.333333333333336,48,40,8,6,2
21700854,203095,ORL,CHA,Evan Fournier,148,29.8666666666667,30,-0.133333333333333,62,69,-7,-5,-2
21700854,203613,ORL,CHA,Jonathon Simmons,121,24.5333333333333,25,-0.466666666666669,55,66,-11,-9,-2
21700854,203920,ORL,CHA,Khem Birch,73,16.5333333333333,17,-0.466666666666669,34,31,3,3,0
21700854,1626209,ORL,CHA,Mario Hezonja,174,35.3166666666667,35,0.316666666666663,73,82,-9,-9,0
21700854,1628411,ORL,CHA,Wes Iwundu,92,19.9166666666667,20,-0.0833333333333357,43,37,6,0,6
21700854,2730,CHA,ORL,Dwight Howard,158,32.4,32,0.399999999999999,76,63,13,13,0
21700854,101107,CHA,ORL,Marvin Williams,155,31.9333333333333,32,-0.06666666666667,74,61,13,13,0
21700854,201587,CHA,ORL,Nicolas Batum,158,32.1166666666667,32,0.116666666666667,77,66,11,12,-1
21700854,202689,CHA,ORL,Kemba Walker,201,41.55,42,-0.450000000000003,88,87,1,1,0
21700854,203077,CHA,ORL,Michael Kidd-Gilchrist,110,23.2666666666667,23,0.266666666666666,48,54,-6,-10,4
21700854,203087,CHA,ORL,Jeremy Lamb,125,25.7,26,-0.300000000000001,59,51,8,9,-1
21700854,203469,CHA,ORL,Cody Zeller,69,15.5333333333333,16,-0.466666666666667,26,36,-10,-10,0
21700854,203487,CHA,ORL,Michael Carter-Williams,61,13.9,14,-0.0999999999999996,26,34,-8,-8,0
21700854,1626163,CHA,ORL,Frank Kaminsky,47,9.65,10,-0.35,24,24,0,4,-4
21700854,1626203,CHA,ORL,Treveon Graham,61,13.95,14,-0.0500000000000007,22,34,-12,-14,2
21700855,2548,MIA,PHI,Dwyane Wade,110,22.9833333333333,23,-0.0166666666666657,42,47,-5,-3,-2
21700855,201609,MIA,PHI,Goran Dragic,156,32.55,33,-0.450000000000003,74,68,6,2,4
21700855,201949,MIA,PHI,James Johnson,101,21.3833333333333,21,0.383333333333333,42,47,-5,-2,-3
21700855,201961,MIA,PHI,Wayne Ellington,157,31.8666666666667,31,0.866666666666667,71,60,11,14,-3
21700855,202337,MIA,PHI,Luke Babbitt,42,8.76666666666667,9,-0.233333333333334,17,27,-10,-9,-1
21700855,202355,MIA,PHI,Hassan Whiteside,134,28.7833333333333,29,-0.216666666666669,64,60,4,5,-1
21700855,204020,MIA,PHI,Tyler Johnson,133,28.15,29,-0.850000000000001,66,59,7,6,1
21700855,1626159,MIA,PHI,Justise Winslow,113,23.7666666666667,24,-0.233333333333334,52,52,0,-3,3
21700855,1626196,MIA,PHI,Josh Richardson,105,22.3166666666667,23,-0.683333333333334,43,52,-9,-8,-1
21700855,1628389,MIA,PHI,Bam Adebayo,94,19.4333333333333,19,0.433333333333334,34,48,-14,-12,-2
21700855,101161,PHI,MIA,Amir Johnson,90,19.6,20,-0.399999999999999,45,47,-2,-2,0
21700855,200755,PHI,MIA,JJ Redick,165,34.5666666666667,34,0.566666666666663,74,72,2,3,-1
21700855,201158,PHI,MIA,Marco Belinelli,132,27.8,28,-0.200000000000003,53,51,2,3,-1
21700855,202344,PHI,MIA,Trevor Booker,68,15.15,15,0.15,30,25,5,4,1
21700855,203496,PHI,MIA,Robert Covington,126,25.9666666666667,26,-0.0333333333333314,65,61,4,1,3
21700855,203967,PHI,MIA,Dario Saric,158,32.6333333333333,33,-0.366666666666667,74,73,1,1,0
21700855,204456,PHI,MIA,T.J. McConnell,90,19.75,20,-0.25,35,42,-7,-8,1
21700855,1626158,PHI,MIA,Richaun Holmes,139,28.4,28,0.399999999999999,59,54,5,4,1
21700855,1627732,PHI,MIA,Ben Simmons,177,36.1333333333333,36,0.133333333333333,85,80,5,4,1
21700856,201960,BKN,IND,DeMarre Carroll,169,34.7666666666667,35,-0.233333333333334,77,73,4,6,-2
21700856,201967,BKN,IND,Dante Cunningham,131,28.15,28,0.149999999999999,56,64,-8,-13,5
21700856,202389,BKN,IND,Timofey Mozgov,14,3.83333333333333,4,-0.166666666666667,8,9,-1,-1,0
21700856,203112,BKN,IND,Quincy Acy,152,31.5333333333333,32,-0.466666666666669,60,75,-15,-11,-4
21700856,203459,BKN,IND,Allen Crabbe,173,36.1333333333333,36,0.133333333333333,74,74,0,-2,2
21700856,203915,BKN,IND,Spencer Dinwiddie,157,32.7333333333333,33,-0.266666666666666,71,77,-6,-4,-2
21700856,203925,BKN,IND,Joe Harris,105,23.4666666666667,23,0.466666666666669,59,53,6,6,0
21700856,1626156,BKN,IND,D'Angelo Russell,137,28.5666666666667,29,-0.433333333333334,63,74,-11,-10,-1
21700856,1628386,BKN,IND,Jarrett Allen,97,20.4833333333333,20,0.483333333333334,47,41,6,4,2
21700856,2744,IND,BKN,Al Jefferson,37,8.03333333333333,8,0.0333333333333332,19,26,-7,-5,-2
21700856,201152,IND,BKN,Thaddeus Young,174,36.0166666666667,36,0.0166666666666657,86,69,17,14,3
21700856,202362,IND,BKN,Lance Stephenson,88,19.3333333333333,19,0.333333333333336,44,47,-3,-3,0
21700856,202709,IND,BKN,Cory Joseph,177,36.4166666666667,36,0.416666666666671,80,73,7,7,0
21700856,202711,IND,BKN,Bojan Bogdanovic,176,36.8666666666667,37,-0.133333333333333,90,70,20,20,0
21700856,203506,IND,BKN,Victor Oladipo,179,36.7833333333333,37,-0.216666666666669,79,81,-2,-2,0
21700856,1626167,IND,BKN,Myles Turner,142,29.2333333333333,29,0.233333333333334,64,58,6,8,-2
21700856,1626202,IND,BKN,Joe Young,61,14.4,14,0.4,31,38,-7,-6,-1
21700856,1627734,IND,BKN,Domantas Sabonis,101,22.5833333333333,23,-0.416666666666664,47,53,-6,-8,2
21700857,101127,NYK,WAS,Jarrett Jack,132,27.4,28,-0.600000000000001,70,70,0,-1,1
21700857,201563,NYK,WAS,Michael Beasley,192,40.0666666666667,40,0.0666666666666629,98,98,0,0,0
21700857,201584,NYK,WAS,Courtney Lee,159,33.3833333333333,34,-0.616666666666667,83,84,-1,1,-2
21700857,202498,NYK,WAS,Lance Thomas,90,18.9666666666667,19,-0.0333333333333314,39,44,-5,-4,-1
21700857,202683,NYK,WAS,Enes Kanter,165,34.1666666666667,34,0.166666666666671,88,85,3,1,2
21700857,203124,NYK,WAS,Kyle O'Quinn,63,13.65,14,-0.350000000000001,25,33,-8,-6,-2
21700857,203501,NYK,WAS,Tim Hardaway Jr.,193,39.75,40,-0.25,98,102,-4,-4,0
21700857,1626144,NYK,WAS,Emmanuel Mudiay,96,20.4166666666667,20,0.416666666666664,43,48,-5,-4,-1
21700857,1628373,NYK,WAS,Frank Ntilikina,50,11.2833333333333,11,0.283333333333333,21,26,-5,-8,3
21700857,101133,WAS,NYK,Ian Mahinmi,126,25.55,26,-0.449999999999999,58,58,0,0,0
21700857,101162,WAS,NYK,Marcin Gortat,101,22.15,22,0.149999999999999,60,55,5,5,0
21700857,201975,WAS,NYK,Jodie Meeks,66,13.2666666666667,13,0.266666666666666,33,33,0,-3,3
21700857,202693,WAS,NYK,Markieff Morris,112,24.8166666666667,25,-0.183333333333334,63,56,7,7,0
21700857,203078,WAS,NYK,Bradley Beal,204,42.6666666666667,43,-0.333333333333329,107,103,4,6,-2
21700857,203107,WAS,NYK,Tomas Satoransky,153,32.7166666666667,33,-0.283333333333331,82,71,11,9,2
21700857,203118,WAS,NYK,Mike Scott,63,12.65,12,0.65,28,33,-5,-4,-1
21700857,203490,WAS,NYK,Otto Porter Jr.,182,38.2,38,0.200000000000003,96,90,6,6,0
21700857,1626162,WAS,NYK,Kelly Oubre Jr.,133,27.0666666666667,27,0.0666666666666664,63,66,-3,-1,-2
21700858,201143,BOS,LAC,Al Horford,162,34.85,35,-0.150000000000006,77,88,-11,-13,2
21700858,202328,BOS,LAC,Greg Monroe,50,9.35,10,-0.65,29,30,-1,-5,4
21700858,202681,BOS,LAC,Kyrie Irving,183,37.95,38,-0.0499999999999972,93,106,-13,-14,1
21700858,202694,BOS,LAC,Marcus Morris,176,34.8666666666667,35,-0.133333333333333,97,99,-2,2,-4
21700858,203382,BOS,LAC,Aron Baynes,68,14.6833333333333,15,-0.316666666666666,28,34,-6,-8,2
21700858,1626179,BOS,LAC,Terry Rozier,142,28.3,29,-0.699999999999999,68,84,-16,-15,-1
21700858,1627759,BOS,LAC,Jaylen Brown,168,35.6,36,-0.399999999999999,93,90,3,4,-1
21700858,1628369,BOS,LAC,Jayson Tatum,149,31.1,32,-0.899999999999999,80,82,-2,-1,-1
21700858,1628464,BOS,LAC,Daniel Theis,57,11.1333333333333,11,0.133333333333333,30,32,-2,0,-2
21700858,101150,LAC,BOS,Lou Williams,157,31.5,32,-0.5,91,75,16,16,0
21700858,201568,LAC,BOS,Danilo Gallinari,189,39.9666666666667,40,-0.0333333333333314,101,88,13,13,0
21700858,201599,LAC,BOS,DeAndre Jordan,152,31.45,32,-0.550000000000001,90,75,15,12,3
21700858,202325,LAC,BOS,Wesley Johnson,19,2.81666666666667,3,-0.183333333333333,11,13,-2,-2,0
21700858,202340,LAC,BOS,Avery Bradley,101,21.75,22,-0.25,45,60,-15,-13,-2
21700858,202699,LAC,BOS,Tobias Harris,191,39.2,40,-0.799999999999997,116,97,19,19,0
21700858,203085,LAC,BOS,Austin Rivers,168,35.0666666666667,36,-0.933333333333337,97,78,19,16,3
21700858,1626149,LAC,BOS,Montrezl Harrell,79,16.1166666666667,16,0.116666666666667,39,44,-5,-2,-3
21700858,1626155,LAC,BOS,Sam Dekker,14,2.78333333333333,3,-0.216666666666667,9,11,-2,-4,2
21700858,1628462,LAC,BOS,Milos Teodosic,85,17.1833333333333,17,0.183333333333334,46,54,-8,-5,-3
21700859,201577,CHI,TOR,Robin Lopez,106,22.5666666666667,23,-0.433333333333334,49,60,-11,-11,0
21700859,203200,CHI,TOR,Justin Holiday,126,27.25,27,0.25,60,69,-9,-8,-1
21700859,203897,CHI,TOR,Zach LaVine,122,26.8333333333333,27,-0.166666666666664,51,80,-29,-30,1
21700859,203943,CHI,TOR,Noah Vonleh,27,5.5,6,-0.5,12,10,2,2,0
21700859,1626170,CHI,TOR,Jerian Grant,102,23.25,23,0.25,48,55,-7,-4,-3
21700859,1626171,CHI,TOR,Bobby Portis,94,22.0166666666667,22,0.0166666666666657,46,56,-10,-10,0
21700859,1626245,CHI,TOR,Cristiano Felicio,27,5.5,6,-0.5,12,10,2,2,0
21700859,1627739,CHI,TOR,Kris Dunn,93,19.7166666666667,20,-0.283333333333331,38,57,-19,-21,2
21700859,1627756,CHI,TOR,Denzel Valentine,91,20.6833333333333,21,-0.316666666666666,44,47,-3,-3,0
21700859,1627835,CHI,TOR,Paul Zipser,65,14.7666666666667,15,-0.233333333333334,27,43,-16,-14,-2
21700859,1627853,CHI,TOR,Ryan Arcidiacono,23,4.63333333333333,5,-0.366666666666667,12,10,2,1,1
21700859,1628021,CHI,TOR,David Nwaba,97,20.4333333333333,21,-0.566666666666666,41,48,-7,-7,0
21700859,1628374,CHI,TOR,Lauri Markkanen,117,24.85,25,-0.149999999999999,50,65,-15,-17,2
21700859,101139,TOR,CHI,CJ Miles,86,19.8,20,-0.199999999999999,53,38,15,13,2
21700859,200768,TOR,CHI,Kyle Lowry,126,26.65,27,-0.350000000000001,67,55,12,11,1
21700859,201586,TOR,CHI,Serge Ibaka,122,25.8166666666667,26,-0.183333333333334,66,53,13,13,0
21700859,201942,TOR,CHI,DeMar DeRozan,130,27.8833333333333,28,-0.116666666666667,70,62,8,8,0
21700859,202685,TOR,CHI,Jonas Valanciunas,109,23.1666666666667,23,0.166666666666664,59,48,11,12,-1
21700859,203512,TOR,CHI,Lucas Nogueira,17,3.2,3,0.2,7,9,-2,-2,0
21700859,1626153,TOR,CHI,Delon Wright,88,19.7166666666667,20,-0.283333333333331,52,36,16,16,0
21700859,1626181,TOR,CHI,Norman Powell,46,9.53333333333333,10,-0.466666666666667,21,16,5,6,-1
21700859,1627751,TOR,CHI,Jakob Poeltl,92,21.2333333333333,21,0.233333333333334,56,41,15,14,1
21700859,1627783,TOR,CHI,Pascal Siakam,96,21.7833333333333,22,-0.216666666666669,56,45,11,11,0
21700859,1627832,TOR,CHI,Fred VanVleet,73,17.15,17,0.149999999999999,46,33,13,12,1
21700859,1628035,TOR,CHI,Alfonzo McKinnie,23,4.63333333333333,5,-0.366666666666667,10,12,-2,-1,-1
21700859,1628384,TOR,CHI,OG Anunoby,82,17.4333333333333,18,-0.566666666666666,47,42,5,7,-2
21700860,2207,HOU,SAC,Joe Johnson,142,31.5833333333333,31,0.583333333333336,71,69,2,1,1
21700860,101108,HOU,SAC,Chris Paul,136,30.3333333333333,31,-0.666666666666668,57,61,-4,-6,2
21700860,101123,HOU,SAC,Gerald Green,97,21.8,22,-0.199999999999999,44,40,4,4,0
21700860,200782,HOU,SAC,PJ Tucker,139,31.65,32,-0.350000000000001,66,57,9,9,0
21700860,201583,HOU,SAC,Ryan Anderson,94,20.3833333333333,21,-0.616666666666667,42,44,-2,0,-2
21700860,201601,HOU,SAC,Luc Mbah a Moute,117,25.0166666666667,25,0.0166666666666657,53,42,11,14,-3
21700860,201935,HOU,SAC,James Harden,162,35.1666666666667,35,0.166666666666671,75,61,14,14,0
21700860,203991,HOU,SAC,Clint Capela,153,32.6,33,-0.399999999999999,76,60,16,14,2
21700860,204028,HOU,SAC,Tarik Black,50,11.3,11,0.300000000000001,16,21,-5,-5,0
21700860,1713,SAC,HOU,Vince Carter,106,24.5166666666667,24,0.516666666666666,50,47,3,6,-3
21700860,201585,SAC,HOU,Kosta Koufos,86,19.7166666666667,20,-0.283333333333331,38,36,2,3,-1
21700860,202066,SAC,HOU,Garrett Temple,133,30.4666666666667,30,0.466666666666669,67,62,5,4,1
21700860,203960,SAC,HOU,JaKarr Sampson,114,24.5166666666667,24,0.516666666666666,38,52,-14,-15,1
21700860,203992,SAC,HOU,Bogdan Bogdanovic,137,30.0333333333333,30,0.0333333333333314,51,67,-16,-17,1
21700860,1626161,SAC,HOU,Willie Cauley-Stein,132,28.25,28,0.25,53,64,-11,-12,1
21700860,1627741,SAC,HOU,Buddy Hield,103,22.65,22,0.649999999999999,49,48,1,1,0
21700860,1628368,SAC,HOU,De'Aaron Fox,118,25.45,26,-0.550000000000001,38,55,-17,-17,0
21700860,1628382,SAC,HOU,Justin Jackson,161,34.2333333333333,34,0.233333333333334,71,69,2,2,0
21700861,2546,OKC,MEM,Carmelo Anthony,153,33.0666666666667,33,0.0666666666666629,86,81,5,6,-1
21700861,101109,OKC,MEM,Raymond Felton,107,23.1333333333333,23,0.133333333333333,65,53,12,13,-1
21700861,201566,OKC,MEM,Russell Westbrook,169,37.0666666666667,37,0.0666666666666629,96,81,15,14,1
21700861,202331,OKC,MEM,Paul George,173,37.4,38,-0.599999999999994,100,92,8,8,0
21700861,202335,OKC,MEM,Patrick Patterson,100,21.5833333333333,21,0.583333333333336,57,51,6,6,0
21700861,203500,OKC,MEM,Steven Adams,139,30.95,31,-0.0500000000000007,84,70,14,14,0
21700861,203518,OKC,MEM,Alex Abrines,53,11.7833333333333,12,-0.216666666666667,22,31,-9,-10,1
21700861,203924,OKC,MEM,Jerami Grant,99,21.3166666666667,21,0.316666666666666,47,54,-7,-6,-1
21700861,203962,OKC,MEM,Josh Huestis,47,10.15,10,0.15,20,25,-5,-6,1
21700861,1626177,OKC,MEM,Dakari Johnson,16,3.13333333333333,3,0.133333333333334,3,7,-4,-4,0
21700861,1628390,OKC,MEM,Terrance Ferguson,44,10,10,0,25,25,0,0,0
21700861,201188,MEM,OKC,Marc Gasol,139,29.9666666666667,30,-0.0333333333333314,71,76,-5,-5,0
21700861,201596,MEM,OKC,Mario Chalmers,78,15.9333333333333,16,-0.0666666666666664,36,51,-15,-10,-5
21700861,201936,MEM,OKC,Tyreke Evans,141,30.6166666666667,31,-0.383333333333333,67,69,-2,0,-2
21700861,202718,MEM,OKC,Chandler Parsons,54,11.6666666666667,12,-0.333333333333332,25,46,-21,-21,0
21700861,203210,MEM,OKC,JaMychal Green,83,18.0666666666667,19,-0.933333333333334,40,49,-9,-10,1
21700861,203463,MEM,OKC,Ben McLemore,53,12.3333333333333,12,0.333333333333332,34,26,8,8,0
21700861,1626150,MEM,OKC,Andrew Harrison,150,33.2666666666667,33,0.266666666666666,83,79,4,-3,7
21700861,1626185,MEM,OKC,Jarell Martin,143,31.3333333333333,31,0.333333333333336,78,80,-2,-1,-1
21700861,1627738,MEM,OKC,Deyonta Davis,81,17.95,18,-0.0500000000000007,43,45,-2,-2,0
21700861,1628415,MEM,OKC,Dillon Brooks,178,38.45,39,-0.549999999999997,93,84,9,9,0
21700862,2731,NOP,LAL,Emeka Okafor,105,21,20,1,63,46,17,17,0
21700862,200765,NOP,LAL,Rajon Rondo,51,8.2,8,0.199999999999999,32,21,11,9,2
21700862,201950,NOP,LAL,Jrue Holiday,169,32.8333333333333,33,-0.166666666666671,101,79,22,22,0
21700862,202703,NOP,LAL,Nikola Mirotic,155,29.3666666666667,30,-0.633333333333333,90,79,11,11,0
21700862,202732,NOP,LAL,DeAndre Liggins,66,14.1833333333333,14,0.183333333333334,39,37,2,4,-2
21700862,202734,NOP,LAL,E'Twaun Moore,159,31.2333333333333,31,0.233333333333334,88,70,18,18,0
21700862,203076,NOP,LAL,Anthony Davis,161,32.9,33,-0.100000000000001,94,72,22,22,0
21700862,203121,NOP,LAL,Darius Miller,156,30.8833333333333,31,-0.116666666666667,94,81,13,13,0
21700862,203546,NOP,LAL,Ian Clark,121,24.0666666666667,24,0.0666666666666664,58,61,-3,-3,0
21700862,1627767,NOP,LAL,Cheick Diallo,64,11.6166666666667,12,-0.383333333333333,31,35,-4,-4,0
21700862,1628429,NOP,LAL,Charles Cooke,13,2.63333333333333,3,-0.366666666666667,5,4,1,1,0
21700862,101112,LAL,NOP,Channing Frye,60,11.25,11,0.25,39,33,6,6,0
21700862,201147,LAL,NOP,Corey Brewer,103,19.8666666666667,20,-0.133333333333333,58,63,-5,-4,-1
21700862,201572,LAL,NOP,Brook Lopez,92,18.6666666666667,18,0.666666666666664,42,44,-2,-3,1
21700862,202738,LAL,NOP,Isaiah Thomas,29,4.78333333333333,5,-0.216666666666667,17,21,-4,-2,-2
21700862,203484,LAL,NOP,Kentavious Caldwell-Pope,164,32.9833333333333,33,-0.0166666666666657,75,93,-18,-18,0
21700862,203898,LAL,NOP,Tyler Ennis,24,4.31666666666667,5,-0.683333333333334,10,10,0,-2,2
21700862,203944,LAL,NOP,Julius Randle,157,31.65,31,0.650000000000002,68,92,-24,-24,0
21700862,1627742,LAL,NOP,Brandon Ingram,157,30.6666666666667,31,-0.333333333333336,79,82,-3,-5,2
21700862,1627780,LAL,NOP,Gary Payton II,82,15.9666666666667,17,-1.03333333333333,34,50,-16,-16,0
21700862,1627826,LAL,NOP,Ivica Zubac,31,5.48333333333333,6,-0.516666666666668,14,14,0,-2,2
21700862,1628398,LAL,NOP,Kyle Kuzma,136,26.8333333333333,27,-0.166666666666664,73,86,-13,-14,1
21700862,1628404,LAL,NOP,Josh Hart,156,31.2333333333333,31,0.233333333333334,66,91,-25,-22,-3
21700862,1628418,LAL,NOP,Thomas Bryant,29,5.21666666666667,5,0.216666666666667,10,16,-6,-4,-2
21700863,201162,PHX,UTA,Jared Dudley,24,6.03333333333333,6,0.0333333333333332,5,15,-10,-7,-3
21700863,203458,PHX,UTA,Alex Len,172,37.3166666666667,38,-0.683333333333337,73,88,-15,-12,-3
21700863,203584,PHX,UTA,Troy Daniels,56,11.6666666666667,11,0.666666666666666,27,27,0,-2,2
21700863,203901,PHX,UTA,Elfrid Payton,172,38.25,39,-0.75,77,87,-10,-8,-2
21700863,203933,PHX,UTA,T.J. Warren,94,21.25,22,-0.75,43,44,-1,-5,4
21700863,1626164,PHX,UTA,Devin Booker,158,35.7333333333333,36,-0.266666666666666,68,80,-12,-10,-2
21700863,1627733,PHX,UTA,Dragan Bender,104,24.2833333333333,25,-0.716666666666669,56,50,6,1,5
21700863,1627737,PHX,UTA,Marquese Chriss,89,19.0833333333333,19,0.0833333333333322,40,41,-1,0,-1
21700863,1627755,PHX,UTA,Tyler Ulis,44,9.4,9,0.399999999999999,20,20,0,-2,2
21700863,1628367,PHX,UTA,Josh Jackson,167,35.2333333333333,36,-0.766666666666666,76,83,-7,-5,-2
21700863,201973,UTA,PHX,Jonas Jerebko,58,12.6,12,0.6,23,27,-4,-6,2
21700863,202324,UTA,PHX,Derrick Favors,142,31.8,33,-1.2,66,69,-3,-3,0
21700863,202692,UTA,PHX,Alec Burks,43,9.08333333333333,9,0.0833333333333339,15,23,-8,-8,0
21700863,203109,UTA,PHX,Jae Crowder,114,24.75,25,-0.25,57,50,7,9,-2
21700863,203497,UTA,PHX,Rudy Gobert,168,37.1333333333333,37,0.133333333333333,88,73,15,17,-2
21700863,203526,UTA,PHX,Raul Neto,55,12.6,13,-0.4,24,27,-3,1,-4
21700863,204060,UTA,PHX,Joe Ingles,167,36.9333333333333,37,-0.0666666666666629,89,74,15,17,-2
21700863,1626220,UTA,PHX,Royce O'Neale,160,35.05,36,-0.950000000000003,85,71,14,9,5
21700863,1628378,UTA,PHX,Donovan Mitchell,173,38.3,38,0.299999999999997,88,71,17,14,3
21700864,2561,GSW,POR,David West,62,13.55,14,-0.449999999999999,25,26,-1,1,-2
21700864,2585,GSW,POR,Zaza Pachulia,34,5.73333333333333,6,-0.266666666666667,11,21,-10,-10,0
21700864,2733,GSW,POR,Shaun Livingston,73,16.55,17,-0.450000000000003,31,27,4,-4,8
21700864,2738,GSW,POR,Andre Iguodala,136,29.2,29,0.199999999999999,68,61,7,9,-2
21700864,201142,GSW,POR,Kevin Durant,192,37.25,37,0.25,97,103,-6,-6,0
21700864,201156,GSW,POR,Nick Young,78,15.1333333333333,15,0.133333333333333,40,43,-3,-3,0
21700864,201580,GSW,POR,JaVale McGee,36,6.16666666666667,6,0.166666666666667,12,19,-7,-7,0
21700864,201939,GSW,POR,Stephen Curry,180,34.4166666666667,34,0.416666666666671,92,99,-7,-7,0
21700864,201956,GSW,POR,Omri Casspi,12,2.36666666666667,2,0.366666666666667,2,6,-4,-4,0
21700864,202691,GSW,POR,Klay Thompson,192,37.8333333333333,38,-0.166666666666671,101,103,-2,-2,0
21700864,203110,GSW,POR,Draymond Green,195,38.6333333333333,39,-0.366666666666667,101,101,0,4,-4
21700864,1626172,GSW,POR,Kevon Looney,10,2.91666666666667,3,-0.0833333333333335,5,6,-1,-1,0
21700864,202323,POR,GSW,Evan Turner,94,18.4166666666667,18,0.416666666666668,37,43,-6,-6,0
21700864,202329,POR,GSW,Al-Farouq Aminu,187,36.3166666666667,36,0.316666666666663,100,92,8,8,0
21700864,202334,POR,GSW,Ed Davis,61,12.8333333333333,13,-0.166666666666668,25,27,-2,-2,0
21700864,203081,POR,GSW,Damian Lillard,198,39.5333333333333,40,-0.466666666666669,112,95,17,17,0
21700864,203090,POR,GSW,Maurice Harkless,140,26.5166666666667,27,-0.483333333333334,77,75,2,2,0
21700864,203468,POR,GSW,CJ McCollum,199,39.8,40,-0.200000000000003,106,99,7,7,0
21700864,203894,POR,GSW,Shabazz Napier,89,19.8333333333333,20,-0.166666666666664,43,49,-6,-5,-1
21700864,203994,POR,GSW,Jusuf Nurkic,151,30.2166666666667,30,0.216666666666665,80,74,6,5,1
21700864,1626192,POR,GSW,Pat Connaughton,54,9.96666666666667,10,-0.0333333333333332,22,20,2,2,0
21700864,1628380,POR,GSW,Zach Collins,27,6.31666666666667,6,0.316666666666666,13,11,2,2,0
21700865,2734,DEN,MIL,Devin Harris,97,19.3833333333333,19,0.383333333333333,47,43,4,4,0
21700865,201163,DEN,MIL,Wilson Chandler,181,37.45,38,-0.549999999999997,99,99,0,-2,2
21700865,201589,DEN,MIL,Darrell Arthur,59,11.75,12,-0.25,31,23,8,5,3
21700865,203115,DEN,MIL,Will Barton,195,39.2,39,0.200000000000003,113,103,10,11,-1
21700865,203914,DEN,MIL,Gary Harris,194,38.75,39,-0.25,112,99,13,13,0
21700865,203999,DEN,MIL,Nikola Jokic,169,33.75,34,-0.25,100,93,7,11,-4
21700865,1626168,DEN,MIL,Trey Lyles,78,16.45,17,-0.550000000000001,40,38,2,1,1
21700865,1627736,DEN,MIL,Malik Beasley,28,5.36666666666667,5,0.366666666666667,10,12,-2,-6,4
21700865,1627750,DEN,MIL,Jamal Murray,175,35.3166666666667,36,-0.683333333333337,111,93,18,18,0
21700865,1627823,DEN,MIL,Juancho Hernangomez,9,0.833333333333333,1,-0.166666666666667,2,2,0,0,0
21700865,1891,MIL,DEN,Jason Terry,45,9.28333333333333,9,0.283333333333333,20,28,-8,-7,-1
21700865,202339,MIL,DEN,Eric Bledsoe,186,36.7666666666667,37,-0.233333333333334,98,97,1,-1,2
21700865,203092,MIL,DEN,Tyler Zeller,148,30.3833333333333,30,0.383333333333333,81,75,6,9,-3
21700865,203114,MIL,DEN,Khris Middleton,193,37.8666666666667,38,-0.133333333333333,99,103,-4,-8,4
21700865,203503,MIL,DEN,Tony Snell,170,33.7666666666667,34,-0.233333333333334,94,97,-3,-5,2
21700865,203507,MIL,DEN,Giannis Antetokounmpo,194,38.9333333333333,39,-0.0666666666666629,105,109,-4,-3,-1
21700865,203930,MIL,DEN,Sean Kilpatrick,17,3.88333333333333,4,-0.116666666666667,7,16,-9,-6,-3
21700865,203953,MIL,DEN,Jabari Parker,77,16.3833333333333,17,-0.616666666666667,36,44,-8,-7,-1
21700865,204098,MIL,DEN,Xavier Munford,2,0.383333333333333,1,-0.616666666666667,0,2,-2,0,-2
21700865,1627748,MIL,DEN,Thon Maker,87,16.8833333333333,17,-0.116666666666667,40,56,-16,-20,4
21700865,1627850,MIL,DEN,Marshall Plumlee,2,0.383333333333333,1,-0.616666666666667,0,2,-2,0,-2
21700865,1628391,MIL,DEN,D.J. Wilson,2,0.383333333333333,1,-0.616666666666667,0,2,-2,0,-2
21700865,1628425,MIL,DEN,Sterling Brown,62,12.95,13,-0.0500000000000007,25,34,-9,-7,-2
21700866,201147,LAL,MIN,Corey Brewer,74,13.1833333333333,13,0.183333333333334,45,31,14,14,0
21700866,201572,LAL,MIN,Brook Lopez,120,25.95,26,-0.0500000000000007,55,57,-2,-3,1
21700866,202738,LAL,MIN,Isaiah Thomas,135,24.7166666666667,25,-0.283333333333331,59,67,-8,-8,0
21700866,203484,LAL,MIN,Kentavious Caldwell-Pope,195,40.0666666666667,41,-0.933333333333337,92,89,3,2,1
21700866,203944,LAL,MIN,Julius Randle,148,31.6166666666667,31,0.616666666666667,65,80,-15,-17,2
21700866,1627742,LAL,MIN,Brandon Ingram,164,33.55,34,-0.450000000000003,68,90,-22,-22,0
21700866,1627826,LAL,MIN,Ivica Zubac,102,19.3,20,-0.699999999999999,53,48,5,5,0
21700866,1628398,LAL,MIN,Kyle Kuzma,107,18.3166666666667,19,-0.683333333333334,49,51,-2,-1,-1
21700866,1628404,LAL,MIN,Josh Hart,150,31.3833333333333,31,0.383333333333333,69,82,-13,-10,-3
21700866,2037,MIN,LAL,Jamal Crawford,116,21.5833333333333,22,-0.416666666666664,58,57,1,1,0
21700866,201952,MIN,LAL,Jeff Teague,171,34.8833333333333,35,-0.116666666666667,86,76,10,7,3
21700866,201959,MIN,LAL,Taj Gibson,188,38.7166666666667,39,-0.283333333333331,96,82,14,13,1
21700866,202357,MIN,LAL,Nemanja Bjelica,51,8.9,9,-0.0999999999999996,23,29,-6,-5,-1
21700866,202710,MIN,LAL,Jimmy Butler,200,41,41,0,100,90,10,12,-2
21700866,203476,MIN,LAL,Gorgui Dieng,84,15.4166666666667,16,-0.583333333333334,40,38,2,1,1
21700866,203952,MIN,LAL,Andrew Wiggins,162,32.65,33,-0.350000000000001,80,75,5,3,2
21700866,1626145,MIN,LAL,Tyus Jones,68,12.7333333333333,13,-0.266666666666666,33,35,-2,1,-3
21700866,1626157,MIN,LAL,Karl-Anthony Towns,155,32.2,32,0.200000000000003,79,73,6,7,-1
21700867,201960,BKN,CHA,DeMarre Carroll,151,32.35,32,0.349999999999994,60,71,-11,-15,4
21700867,201967,BKN,CHA,Dante Cunningham,117,26.3666666666667,27,-0.633333333333333,57,56,1,3,-2
21700867,203112,BKN,CHA,Quincy Acy,111,24.2,24,0.199999999999999,51,54,-3,-1,-2
21700867,203459,BKN,CHA,Allen Crabbe,148,30.7166666666667,31,-0.283333333333331,59,79,-20,-20,0
21700867,203915,BKN,CHA,Spencer Dinwiddie,158,33.35,34,-0.649999999999999,65,89,-24,-23,-1
21700867,203917,BKN,CHA,Nik Stauskas,11,1.9,2,-0.1,6,4,2,2,0
21700867,203925,BKN,CHA,Joe Harris,129,29,29,0,62,67,-5,-3,-2
21700867,1626156,BKN,CHA,D'Angelo Russell,153,32.5666666666667,32,0.56666666666667,62,66,-4,-8,4
21700867,1627785,BKN,CHA,Isaiah Whitehead,11,1.9,2,-0.1,6,4,2,2,0
21700867,1628386,BKN,CHA,Jarrett Allen,126,26.5666666666667,26,0.566666666666666,52,65,-13,-12,-1
21700867,2730,CHA,BKN,Dwight Howard,144,29.5166666666667,30,-0.483333333333334,73,60,13,12,1
21700867,101107,CHA,BKN,Marvin Williams,126,25.6666666666667,26,-0.333333333333336,61,48,13,13,0
21700867,201587,CHA,BKN,Nicolas Batum,153,31.6166666666667,32,-0.383333333333333,76,62,14,13,1
21700867,202689,CHA,BKN,Kemba Walker,164,34.6,35,-0.400000000000006,91,71,20,18,2
21700867,203077,CHA,BKN,Michael Kidd-Gilchrist,115,23.2,24,-0.800000000000001,58,44,14,14,0
21700867,203087,CHA,BKN,Jeremy Lamb,100,23.1666666666667,23,0.166666666666664,51,49,2,1,1
21700867,203469,CHA,BKN,Cody Zeller,71,16.85,17,-0.149999999999999,36,33,3,3,0
21700867,203487,CHA,BKN,Michael Carter-Williams,68,16.25,16,0.25,33,33,0,0,0
21700867,1626163,CHA,BKN,Frank Kaminsky,97,22.1166666666667,22,0.116666666666667,50,48,2,2,0
21700867,1626195,CHA,BKN,Willy Hernangomez,8,1.41666666666667,1,0.416666666666667,2,3,-1,0,-1
21700867,1626203,CHA,BKN,Treveon Graham,53,11.6833333333333,12,-0.316666666666666,20,23,-3,-1,-2
21700867,1628370,CHA,BKN,Malik Monk,8,1.41666666666667,1,0.416666666666667,2,3,-1,0,-1
21700867,1628407,CHA,BKN,Dwayne Bacon,8,1.41666666666667,1,0.416666666666667,2,3,-1,0,-1
21700868,201563,NYK,ORL,Michael Beasley,110,22.5666666666667,23,-0.433333333333334,61,52,9,9,0
21700868,201584,NYK,ORL,Courtney Lee,69,13.9333333333333,14,-0.0666666666666664,36,36,0,0,0
21700868,202498,NYK,ORL,Lance Thomas,116,25.3833333333333,25,0.383333333333333,59,61,-2,-2,0
21700868,202683,NYK,ORL,Enes Kanter,98,20.9833333333333,21,-0.0166666666666657,51,54,-3,-5,2
21700868,203124,NYK,ORL,Kyle O'Quinn,88,19.0833333333333,19,0.0833333333333322,47,40,7,9,-2
21700868,203501,NYK,ORL,Tim Hardaway Jr.,166,34.6166666666667,35,-0.38333333333334,88,88,0,2,-2
21700868,203504,NYK,ORL,Trey Burke,138,29.8,30,-0.199999999999999,75,62,13,15,-2
21700868,1626144,NYK,ORL,Emmanuel Mudiay,112,22.8,23,-0.199999999999999,56,62,-6,-8,2
21700868,1627786,NYK,ORL,Troy Williams,25,6.1,6,0.0999999999999996,14,10,4,4,0
21700868,1628373,NYK,ORL,Frank Ntilikina,136,29.5833333333333,30,-0.416666666666664,75,66,9,9,0
21700868,1628422,NYK,ORL,Damyean Dotson,35,7.23333333333333,7,0.233333333333333,18,15,3,1,2
21700868,1628436,NYK,ORL,Luke Kornet,37,7.66666666666667,8,-0.333333333333334,20,19,1,1,0
21700868,201167,ORL,NYK,Arron Afflalo,34,7.23333333333333,7,0.233333333333333,17,19,-2,-2,0
21700868,201571,ORL,NYK,D.J. Augustin,130,27.3166666666667,27,0.316666666666666,69,71,-2,-2,0
21700868,202687,ORL,NYK,Bismack Biyombo,90,19.8166666666667,20,-0.183333333333334,43,46,-3,-3,0
21700868,202696,ORL,NYK,Nikola Vucevic,114,24.5166666666667,24,0.516666666666666,59,60,-1,-1,0
21700868,202714,ORL,NYK,Shelvin Mack,96,20.6333333333333,21,-0.366666666666667,44,49,-5,-5,0
21700868,203095,ORL,NYK,Evan Fournier,165,35.1666666666667,35,0.166666666666671,85,84,1,1,0
21700868,203613,ORL,NYK,Jonathon Simmons,143,29.7833333333333,30,-0.216666666666669,72,75,-3,-3,0
21700868,203920,ORL,NYK,Khem Birch,22,3.61666666666667,4,-0.383333333333333,11,14,-3,-3,0
21700868,203932,ORL,NYK,Aaron Gordon,116,24.7833333333333,25,-0.216666666666669,59,61,-2,0,-2
21700868,1626173,ORL,NYK,Rashad Vaughn,6,0.383333333333333,0,0.383333333333333,3,3,0,0,0
21700868,1626209,ORL,NYK,Mario Hezonja,122,26.9,27,-0.100000000000001,57,68,-11,-13,2
21700868,1628411,ORL,NYK,Wes Iwundu,92,19.6,20,-0.399999999999999,46,50,-4,-4,0
21700869,2544,CLE,WAS,LeBron James,170,36.55,37,-0.450000000000003,75,84,-9,-10,1
21700869,2594,CLE,WAS,Kyle Korver,85,18.75,19,-0.25,39,41,-2,2,-4
21700869,2747,CLE,WAS,JR Smith,148,32.1333333333333,33,-0.866666666666667,71,75,-4,-4,0
21700869,201145,CLE,WAS,Jeff Green,80,16.5,16,0.5,37,38,-1,1,-2
21700869,201588,CLE,WAS,George Hill,141,31.2,31,0.199999999999999,71,71,0,0,0
21700869,202684,CLE,WAS,Tristan Thompson,121,27.25,28,-0.75,59,64,-5,-10,5
21700869,203903,CLE,WAS,Jordan Clarkson,77,16.6833333333333,17,-0.316666666666666,32,39,-7,-7,0
21700869,203918,CLE,WAS,Rodney Hood,124,27.3833333333333,27,0.383333333333333,60,72,-12,-12,0
21700869,1626204,CLE,WAS,Larry Nance Jr.,75,16.15,16,0.149999999999999,32,37,-5,-5,0
21700869,1626224,CLE,WAS,Cedi Osman,79,16.9833333333333,17,-0.0166666666666657,39,29,10,10,0
21700869,101133,WAS,CLE,Ian Mahinmi,91,20.25,20,0.25,49,41,8,5,3
21700869,101162,WAS,CLE,Marcin Gortat,79,17.3666666666667,18,-0.633333333333333,29,42,-13,-13,0
21700869,201975,WAS,CLE,Jodie Meeks,79,17.7666666666667,17,0.766666666666666,40,37,3,0,3
21700869,202693,WAS,CLE,Markieff Morris,131,28.2,28,0.199999999999999,63,62,1,4,-3
21700869,203078,WAS,CLE,Bradley Beal,161,35.1833333333333,36,-0.816666666666663,82,76,6,9,-3
21700869,203107,WAS,CLE,Tomas Satoransky,144,31.3666666666667,31,0.366666666666667,75,69,6,7,-1
21700869,203118,WAS,CLE,Mike Scott,80,16.15,16,0.149999999999999,38,38,0,-1,1
21700869,203490,WAS,CLE,Otto Porter Jr.,128,29.4166666666667,29,0.416666666666668,70,60,10,11,-1
21700869,204025,WAS,CLE,Tim Frazier,56,11.5166666666667,12,-0.483333333333334,23,24,-1,-2,1
21700869,1626162,WAS,CLE,Kelly Oubre Jr.,151,32.3666666666667,32,0.366666666666667,81,66,15,15,0
21700870,203897,CHI,PHI,Zach LaVine,156,31.0166666666667,31,0.0166666666666657,67,85,-18,-17,-1
21700870,203943,CHI,PHI,Noah Vonleh,75,17.25,17,0.25,51,39,12,14,-2
21700870,1626166,CHI,PHI,Cameron Payne,87,19.9166666666667,20,-0.0833333333333357,57,39,18,17,1
21700870,1626171,CHI,PHI,Bobby Portis,166,34.2833333333333,34,0.283333333333331,87,76,11,13,-2
21700870,1626245,CHI,PHI,Cristiano Felicio,53,11.4666666666667,12,-0.533333333333335,17,33,-16,-20,4
21700870,1627739,CHI,PHI,Kris Dunn,143,28.0833333333333,28,0.0833333333333357,58,77,-19,-18,-1
21700870,1627756,CHI,PHI,Denzel Valentine,118,25.45,26,-0.550000000000001,66,53,13,12,1
21700870,1627835,CHI,PHI,Paul Zipser,31,6.93333333333333,7,-0.0666666666666664,18,15,3,4,-1
21700870,1628021,CHI,PHI,David Nwaba,158,33.2166666666667,33,0.216666666666669,81,79,2,1,1
21700870,1628374,CHI,PHI,Lauri Markkanen,163,32.3833333333333,33,-0.616666666666667,73,84,-11,-11,0
21700870,101161,PHI,CHI,Amir Johnson,70,13.5833333333333,13,0.583333333333332,30,35,-5,-5,0
21700870,200755,PHI,CHI,JJ Redick,146,31.0833333333333,31,0.0833333333333322,76,74,2,1,1
21700870,201158,PHI,CHI,Marco Belinelli,119,25.1166666666667,25,0.116666666666667,55,70,-15,-14,-1
21700870,202344,PHI,CHI,Trevor Booker,67,15.7833333333333,16,-0.216666666666667,32,39,-7,-8,1
21700870,203496,PHI,CHI,Robert Covington,146,29.45,30,-0.550000000000001,76,63,13,13,0
21700870,203954,PHI,CHI,Joel Embiid,160,34.4166666666667,35,-0.583333333333329,86,80,6,6,0
21700870,203967,PHI,CHI,Dario Saric,159,32.0833333333333,32,0.0833333333333286,82,76,6,7,-1
21700870,204456,PHI,CHI,T.J. McConnell,111,24.25,24,0.25,52,61,-9,-10,1
21700870,1627732,PHI,CHI,Ben Simmons,172,34.2333333333333,34,0.233333333333334,91,77,14,15,-1
21700871,1713,SAC,OKC,Vince Carter,134,29.4833333333333,29,0.483333333333334,76,60,16,14,2
21700871,2216,SAC,OKC,Zach Randolph,178,39.6166666666667,40,-0.383333333333333,88,90,-2,-4,2
21700871,202066,SAC,OKC,Garrett Temple,160,34.1166666666667,34,0.116666666666667,75,81,-6,-4,-2
21700871,203992,SAC,OKC,Bogdan Bogdanovic,86,18.2333333333333,19,-0.766666666666666,37,52,-15,-13,-2
21700871,1626161,SAC,OKC,Willie Cauley-Stein,105,21.8,22,-0.200000000000003,38,64,-26,-24,-2
21700871,1627741,SAC,OKC,Buddy Hield,133,29.6,29,0.600000000000001,70,59,11,15,-4
21700871,1627746,SAC,OKC,Skal Labissiere,118,26.95,26,0.950000000000003,70,48,22,20,2
21700871,1628382,SAC,OKC,Justin Jackson,126,26.3166666666667,27,-0.683333333333334,49,67,-18,-20,2
21700871,1628412,SAC,OKC,Frank Mason,60,13.8833333333333,14,-0.116666666666667,32,29,3,1,2
21700871,2546,OKC,SAC,Carmelo Anthony,161,34.4,34,0.399999999999999,83,73,10,6,4
21700871,101109,OKC,SAC,Raymond Felton,76,17.3333333333333,17,0.333333333333336,31,49,-18,-16,-2
21700871,201566,OKC,SAC,Russell Westbrook,178,38.45,38,0.450000000000003,89,85,4,4,0
21700871,202331,OKC,SAC,Paul George,174,37.3166666666667,37,0.316666666666663,98,70,28,26,2
21700871,202335,OKC,SAC,Patrick Patterson,59,13.6,14,-0.399999999999999,27,34,-7,-3,-4
21700871,203500,OKC,SAC,Steven Adams,179,38.8333333333333,39,-0.166666666666671,98,79,19,19,0
21700871,203518,OKC,SAC,Alex Abrines,33,6.98333333333333,7,-0.0166666666666675,21,19,2,2,0
21700871,203924,OKC,SAC,Jerami Grant,115,25.8666666666667,25,0.866666666666667,46,58,-12,-10,-2
21700871,203962,OKC,SAC,Josh Huestis,68,13.8666666666667,15,-1.13333333333333,41,24,17,17,0
21700871,1628390,OKC,SAC,Terrance Ferguson,57,13.35,13,0.35,16,44,-28,-30,2
21700872,2561,GSW,LAC,David West,70,14.5666666666667,15,-0.433333333333334,35,38,-3,3,-6
21700872,2585,GSW,LAC,Zaza Pachulia,36,7.18333333333333,7,0.183333333333334,18,24,-6,-4,-2
21700872,2733,GSW,LAC,Shaun Livingston,75,15.4166666666667,15,0.416666666666666,43,43,0,-4,4
21700872,2738,GSW,LAC,Andre Iguodala,123,25.6666666666667,26,-0.333333333333336,76,80,-4,-1,-3
21700872,201142,GSW,LAC,Kevin Durant,180,37.5666666666667,38,-0.433333333333337,102,98,4,7,-3
21700872,201156,GSW,LAC,Nick Young,71,14.45,14,0.449999999999999,36,42,-6,-6,0
21700872,201580,GSW,LAC,JaVale McGee,63,13.6833333333333,14,-0.316666666666666,37,26,11,9,2
21700872,201939,GSW,LAC,Stephen Curry,175,37.05,37,0.0499999999999972,107,98,9,8,1
21700872,202691,GSW,LAC,Klay Thompson,172,35.8,36,-0.200000000000003,103,92,11,14,-3
21700872,203110,GSW,LAC,Draymond Green,175,37.5333333333333,37,0.533333333333331,108,94,14,9,5
21700872,101150,LAC,GSW,Lou Williams,162,33.4666666666667,34,-0.533333333333331,94,88,6,7,-1
21700872,201568,LAC,GSW,Danilo Gallinari,154,32.2166666666667,32,0.216666666666669,78,83,-5,-5,0
21700872,201599,LAC,GSW,DeAndre Jordan,145,31.0166666666667,32,-0.983333333333334,81,89,-8,-11,3
21700872,202325,LAC,GSW,Wesley Johnson,6,1.06666666666667,1,0.0666666666666667,4,6,-2,-3,1
21700872,202699,LAC,GSW,Tobias Harris,172,35.9,36,-0.0999999999999943,98,102,-4,-9,5
21700872,203085,LAC,GSW,Austin Rivers,181,38.1,38,0.0999999999999943,106,111,-5,-4,-1
21700872,1626149,LAC,GSW,Montrezl Harrell,81,16.4,16,0.399999999999999,46,43,3,4,-1
21700872,1626155,LAC,GSW,Sam Dekker,15,3,3,0,5,12,-7,-9,2
21700872,1626246,LAC,GSW,Boban Marjanovic,6,1.43333333333333,1,0.433333333333333,5,4,1,1,0
21700872,1627820,LAC,GSW,Tyrone Wallace,90,18.6,19,-0.399999999999999,45,51,-6,-8,2
21700872,1628462,LAC,GSW,Milos Teodosic,128,27.7166666666667,28,-0.283333333333335,73,76,-3,2,-5
21700873,201143,BOS,DET,Al Horford,114,26.0166666666667,27,-0.983333333333334,63,48,15,12,3
21700873,202328,BOS,DET,Greg Monroe,91,20.2,19,1.2,38,52,-14,-12,-2
21700873,202681,BOS,DET,Kyrie Irving,134,28.7,29,-0.300000000000001,70,65,5,4,1
21700873,202694,BOS,DET,Marcus Morris,107,24.7166666666667,25,-0.283333333333331,55,43,12,15,-3
21700873,203382,BOS,DET,Aron Baynes,9,2.31666666666667,3,-0.683333333333334,6,6,0,0,0
21700873,203935,BOS,DET,Marcus Smart,114,26.2666666666667,26,0.266666666666666,57,45,12,15,-3
21700873,1626179,BOS,DET,Terry Rozier,102,23.75,24,-0.25,54,39,15,15,0
21700873,1627759,BOS,DET,Jaylen Brown,112,24.0833333333333,24,0.0833333333333322,57,54,3,2,1
21700873,1627846,BOS,DET,Abdel Nader,10,1.95,2,-0.05,5,9,-4,-3,-1
21700873,1628369,BOS,DET,Jayson Tatum,96,20.65,21,-0.350000000000001,50,49,1,-2,3
21700873,1628400,BOS,DET,Semi Ojeleye,83,19.7,20,-0.300000000000001,45,36,9,8,1
21700873,1628464,BOS,DET,Daniel Theis,103,20.9,21,-0.100000000000001,50,44,6,6,0
21700873,2749,DET,BOS,Jameer Nelson,53,12.8166666666667,13,-0.183333333333334,15,29,-14,-14,0
21700873,201229,DET,BOS,Anthony Tolliver,118,26.65,27,-0.350000000000001,50,64,-14,-15,1
21700873,201933,DET,BOS,Blake Griffin,155,35.15,35,0.150000000000006,65,75,-10,-9,-1
21700873,202397,DET,BOS,Ish Smith,152,33.0833333333333,33,0.0833333333333286,74,76,-2,-1,-1
21700873,202779,DET,BOS,Dwight Buycks,10,1.95,2,-0.05,9,5,4,3,1
21700873,203083,DET,BOS,Andre Drummond,143,31.1,31,0.100000000000001,70,74,-4,-4,0
21700873,203493,DET,BOS,Reggie Bullock,145,31.5166666666667,31,0.516666666666666,72,73,-1,0,-1
21700873,203516,DET,BOS,James Ennis III,83,19.15,19,0.149999999999999,36,45,-9,-9,0
21700873,203961,DET,BOS,Eric Moreland,14,2.8,3,-0.2,11,7,4,4,0
21700873,1626169,DET,BOS,Stanley Johnson,132,28.7,29,-0.300000000000001,62,65,-3,-3,0
21700873,1628379,DET,BOS,Luke Kennard,70,16.3333333333333,17,-0.666666666666668,26,37,-11,-12,1
21700874,203101,ATL,IND,Miles Plumlee,99,19.2833333333333,19,0.283333333333331,37,37,0,0,0
21700874,203145,ATL,IND,Kent Bazemore,145,27.9833333333333,28,-0.0166666666666657,59,72,-13,-14,1
21700874,203471,ATL,IND,Dennis Schroder,145,27.3333333333333,27,0.333333333333336,49,69,-20,-21,1
21700874,203473,ATL,IND,Dewayne Dedmon,58,11.6,12,-0.399999999999999,23,27,-4,-4,0
21700874,203488,ATL,IND,Mike Muscala,120,24.1833333333333,24,0.18333333333333,42,54,-12,-12,0
21700874,1627752,ATL,IND,Taurean Prince,140,27.2333333333333,27,0.233333333333334,53,73,-20,-20,0
21700874,1627761,ATL,IND,DeAndre' Bembry,128,25.7166666666667,26,-0.283333333333335,49,62,-13,-13,0
21700874,1627819,ATL,IND,Isaiah Taylor,105,22.3333333333333,23,-0.666666666666664,46,51,-5,-4,-1
21700874,1628381,ATL,IND,John Collins,153,29.9,30,-0.100000000000001,59,79,-20,-20,0
21700874,1628416,ATL,IND,Tyler Dorsey,111,22.2333333333333,22,0.233333333333334,44,52,-8,-7,-1
21700874,1628510,ATL,IND,Andrew White III,6,1.2,1,0.2,4,4,0,0,0
21700874,201152,IND,ATL,Thaddeus Young,162,32.0666666666667,32,0.0666666666666629,78,58,20,21,-1
21700874,202362,IND,ATL,Lance Stephenson,125,25.8833333333333,26,-0.116666666666667,67,53,14,15,-1
21700874,202709,IND,ATL,Cory Joseph,136,25.8166666666667,26,-0.183333333333334,64,48,16,16,0
21700874,202711,IND,ATL,Bojan Bogdanovic,155,31.25,31,0.25,76,62,14,15,-1
21700874,203506,IND,ATL,Victor Oladipo,150,27.95,28,-0.0499999999999972,66,47,19,18,1
21700874,203590,IND,ATL,Trey McKinney-Jones,6,1.2,1,0.2,4,4,0,0,0
21700874,203922,IND,ATL,Glenn Robinson III,91,18.4833333333333,19,-0.516666666666666,43,43,0,0,0
21700874,1626167,IND,ATL,Myles Turner,120,22.1666666666667,22,0.166666666666664,49,39,10,8,2
21700874,1626202,IND,ATL,Joe Young,106,21.9833333333333,22,-0.0166666666666657,52,45,7,7,0
21700874,1627734,IND,ATL,Domantas Sabonis,147,29.8,30,-0.199999999999999,73,58,15,15,0
21700874,1627816,IND,ATL,Alex Poythress,6,1.2,1,0.2,4,4,0,0,0
21700874,1628388,IND,ATL,TJ Leaf,6,1.2,1,0.2,4,4,0,0,0
21700875,101133,WAS,CHA,Ian Mahinmi,44,10.1,10,0.0999999999999996,19,29,-10,-11,1
21700875,101162,WAS,CHA,Marcin Gortat,125,26.2333333333333,27,-0.766666666666666,61,65,-4,-6,2
21700875,201975,WAS,CHA,Jodie Meeks,35,7.7,8,-0.300000000000001,15,22,-7,-7,0
21700875,202693,WAS,CHA,Markieff Morris,124,27.3666666666667,27,0.366666666666667,60,72,-12,-11,-1
21700875,203078,WAS,CHA,Bradley Beal,183,40.0166666666667,40,0.0166666666666657,90,98,-8,-10,2
21700875,203107,WAS,CHA,Tomas Satoransky,159,34.25,34,0.25,76,83,-7,-9,2
21700875,203118,WAS,CHA,Mike Scott,67,14.6833333333333,15,-0.316666666666666,29,42,-13,-13,0
21700875,203490,WAS,CHA,Otto Porter Jr.,153,33.2333333333333,33,0.233333333333334,74,79,-5,-7,2
21700875,204025,WAS,CHA,Tim Frazier,49,11.05,11,0.0500000000000007,24,31,-7,-7,0
21700875,1626162,WAS,CHA,Kelly Oubre Jr.,136,30.7,31,-0.300000000000004,70,74,-4,-6,2
21700875,1626191,WAS,CHA,Chris McCullough,15,3.25,4,-0.75,7,5,2,2,0
21700875,2730,CHA,WAS,Dwight Howard,113,23.6333333333333,24,-0.366666666666667,60,55,5,7,-2
21700875,101107,CHA,WAS,Marvin Williams,103,21.15,21,0.149999999999999,49,53,-4,-2,-2
21700875,201587,CHA,WAS,Nicolas Batum,126,26.3666666666667,27,-0.633333333333333,71,57,14,14,0
21700875,202689,CHA,WAS,Kemba Walker,152,32.65,33,-0.350000000000001,82,72,10,14,-4
21700875,203077,CHA,WAS,Michael Kidd-Gilchrist,118,24.6833333333333,25,-0.316666666666666,59,58,1,4,-3
21700875,203087,CHA,WAS,Jeremy Lamb,98,22.9,23,-0.100000000000001,63,45,18,18,0
21700875,203469,CHA,WAS,Cody Zeller,105,24.0833333333333,24,0.0833333333333357,60,50,10,10,0
21700875,203487,CHA,WAS,Michael Carter-Williams,81,18.7666666666667,18,0.766666666666666,50,40,10,9,1
21700875,1626163,CHA,WAS,Frank Kaminsky,106,24.7833333333333,25,-0.216666666666669,71,47,24,24,0
21700875,1626195,CHA,WAS,Willy Hernangomez,9,1.78333333333333,2,-0.216666666666667,0,5,-5,-5,0
21700875,1626203,CHA,WAS,Treveon Graham,61,14.2166666666667,14,0.216666666666667,35,33,2,2,0
21700875,1628370,CHA,WAS,Malik Monk,9,1.78333333333333,2,-0.216666666666667,0,5,-5,-5,0
21700875,1628407,CHA,WAS,Dwayne Bacon,9,1.78333333333333,2,-0.216666666666667,0,5,-5,-5,0
21700876,1891,MIL,TOR,Jason Terry,117,26.5833333333333,26,0.583333333333332,59,56,3,5,-2
21700876,202339,MIL,TOR,Eric Bledsoe,173,36.4666666666667,37,-0.533333333333331,93,89,4,2,2
21700876,203089,MIL,TOR,John Henson,162,35.0833333333333,35,0.0833333333333286,81,81,0,-1,1
21700876,203114,MIL,TOR,Khris Middleton,162,35.0166666666667,35,0.0166666666666657,87,77,10,6,4
21700876,203503,MIL,TOR,Tony Snell,81,16.5166666666667,17,-0.483333333333334,44,52,-8,-12,4
21700876,203507,MIL,TOR,Giannis Antetokounmpo,205,45.55,45,0.549999999999997,100,94,6,10,-4
21700876,203930,MIL,TOR,Sean Kilpatrick,23,5.18333333333333,5,0.183333333333334,8,11,-3,-3,0
21700876,203953,MIL,TOR,Jabari Parker,102,20.95,21,-0.0499999999999972,46,43,3,6,-3
21700876,1627748,MIL,TOR,Thon Maker,80,17.7,18,-0.299999999999997,39,36,3,4,-1
21700876,1628425,MIL,TOR,Sterling Brown,120,25.95,26,-0.0500000000000007,53,56,-3,-2,-1
21700876,101139,TOR,MIL,CJ Miles,106,22.1833333333333,22,0.183333333333334,54,51,3,5,-2
21700876,200768,TOR,MIL,Kyle Lowry,181,38.1,38,0.0999999999999943,92,93,-1,-3,2
21700876,201586,TOR,MIL,Serge Ibaka,157,33.4666666666667,34,-0.533333333333331,80,89,-9,-6,-3
21700876,201942,TOR,MIL,DeMar DeRozan,189,40.5833333333333,41,-0.416666666666664,96,97,-1,1,-2
21700876,202685,TOR,MIL,Jonas Valanciunas,148,30.95,31,-0.0500000000000007,78,84,-6,-3,-3
21700876,1626153,TOR,MIL,Delon Wright,84,18.2,19,-0.800000000000001,38,42,-4,-3,-1
21700876,1627751,TOR,MIL,Jakob Poeltl,88,19.5333333333333,19,0.533333333333331,39,33,6,3,3
21700876,1627783,TOR,MIL,Pascal Siakam,97,22.05,22,0.0499999999999972,41,38,3,-2,5
21700876,1627832,TOR,MIL,Fred VanVleet,112,26.3833333333333,26,0.383333333333333,46,48,-2,-3,1
21700876,1628384,TOR,MIL,OG Anunoby,63,13.55,13,0.550000000000001,31,35,-4,-4,0
21700877,2207,HOU,MIN,Joe Johnson,97,21.4333333333333,22,-0.566666666666666,49,44,5,9,-4
21700877,2403,HOU,MIN,Nene,74,16.1666666666667,16,0.166666666666664,40,24,16,14,2
21700877,2772,HOU,MIN,Trevor Ariza,122,25.85,26,-0.149999999999999,68,60,8,7,1
21700877,101108,HOU,MIN,Chris Paul,156,32.7666666666667,33,-0.233333333333334,80,68,12,9,3
21700877,101123,HOU,MIN,Gerald Green,27,5.53333333333333,6,-0.466666666666667,14,6,8,6,2
21700877,200782,HOU,MIN,PJ Tucker,136,28.25,28,0.25,75,70,5,5,0
21700877,201583,HOU,MIN,Ryan Anderson,90,19.55,20,-0.450000000000003,45,32,13,13,0
21700877,201601,HOU,MIN,Luc Mbah a Moute,113,23.5333333333333,24,-0.466666666666669,56,47,9,11,-2
21700877,201935,HOU,MIN,James Harden,163,34.2833333333333,34,0.283333333333331,93,81,12,12,0
21700877,203991,HOU,MIN,Clint Capela,152,31.6333333333333,32,-0.366666666666667,80,78,2,4,-2
21700877,2037,MIN,HOU,Jamal Crawford,108,23.6666666666667,24,-0.333333333333336,41,57,-16,-14,-2
21700877,201952,MIN,HOU,Jeff Teague,170,35.3333333333333,35,0.333333333333329,75,81,-6,-5,-1
21700877,201959,MIN,HOU,Taj Gibson,135,27.5833333333333,27,0.583333333333332,62,70,-8,-8,0
21700877,202357,MIN,HOU,Nemanja Bjelica,91,20.2166666666667,21,-0.783333333333331,40,50,-10,-10,0
21700877,202710,MIN,HOU,Jimmy Butler,121,25.1166666666667,25,0.116666666666667,58,64,-6,-9,3
21700877,203476,MIN,HOU,Gorgui Dieng,75,15.9166666666667,16,-0.0833333333333322,32,46,-14,-12,-2
21700877,203498,MIN,HOU,Shabazz Muhammad,16,3.26666666666667,3,0.266666666666667,10,13,-3,-3,0
21700877,203952,MIN,HOU,Andrew Wiggins,171,36.35,36,0.349999999999994,78,87,-9,-8,-1
21700877,1626145,MIN,HOU,Tyus Jones,76,16.4,17,-0.600000000000001,34,45,-11,-12,1
21700877,1626157,MIN,HOU,Karl-Anthony Towns,151,31.8833333333333,32,-0.116666666666667,70,74,-4,-6,2
21700877,1627875,MIN,HOU,Marcus Georges-Hunt,16,3.26666666666667,3,0.266666666666667,10,13,-3,-3,0
21700878,2544,CLE,MEM,LeBron James,178,37.05,37,0.0499999999999972,88,71,17,18,-1
21700878,2594,CLE,MEM,Kyle Korver,106,20.6666666666667,21,-0.333333333333332,51,39,12,11,1
21700878,2747,CLE,MEM,JR Smith,69,14.8166666666667,15,-0.183333333333334,27,37,-10,-6,-4
21700878,101181,CLE,MEM,Jose Calderon,15,2.95,3,-0.0500000000000003,10,5,5,5,0
21700878,201145,CLE,MEM,Jeff Green,81,15.1166666666667,15,0.116666666666667,34,28,6,3,3
21700878,201588,CLE,MEM,George Hill,165,34.4166666666667,34,0.416666666666664,79,66,13,15,-2
21700878,202684,CLE,MEM,Tristan Thompson,77,16.0833333333333,16,0.0833333333333322,30,35,-5,-4,-1
21700878,203903,CLE,MEM,Jordan Clarkson,103,20.05,20,0.0500000000000007,43,25,18,17,1
21700878,203918,CLE,MEM,Rodney Hood,122,24.65,25,-0.350000000000001,66,42,24,21,3
21700878,204066,CLE,MEM,John Holland,15,2.95,3,-0.0500000000000003,10,5,5,5,0
21700878,1626204,CLE,MEM,Larry Nance Jr.,133,27.0333333333333,27,0.0333333333333314,68,40,28,26,2
21700878,1626224,CLE,MEM,Cedi Osman,98,20.9166666666667,21,-0.0833333333333322,49,48,1,3,-2
21700878,1627790,CLE,MEM,Ante Zizic,8,1.55,2,-0.45,5,4,1,1,0
21700878,201188,MEM,CLE,Marc Gasol,145,30.5333333333333,30,0.533333333333331,64,73,-9,-11,2
21700878,201596,MEM,CLE,Mario Chalmers,126,25.2333333333333,26,-0.766666666666666,47,62,-15,-18,3
21700878,201936,MEM,CLE,Tyreke Evans,150,30.0833333333333,31,-0.916666666666664,67,65,2,-2,4
21700878,203210,MEM,CLE,JaMychal Green,117,23.6833333333333,24,-0.316666666666666,58,44,14,14,0
21700878,203463,MEM,CLE,Ben McLemore,121,24.05,24,0.0500000000000007,32,67,-35,-34,-1
21700878,1626150,MEM,CLE,Andrew Harrison,132,28.4,28,0.399999999999999,46,63,-17,-14,-3
21700878,1626185,MEM,CLE,Jarell Martin,116,22.9166666666667,23,-0.0833333333333357,36,60,-24,-19,-5
21700878,1627738,MEM,CLE,Deyonta Davis,89,17.1166666666667,18,-0.883333333333333,25,39,-14,-12,-2
21700878,1628397,MEM,CLE,Ivan Rabb,21,4.26666666666667,5,-0.733333333333333,7,12,-5,-5,0
21700878,1628415,MEM,CLE,Dillon Brooks,153,31.9666666666667,31,0.966666666666665,63,75,-12,-14,2
21700879,2731,NOP,MIA,Emeka Okafor,94,17.6166666666667,18,-0.383333333333333,43,43,0,1,-1
21700879,200765,NOP,MIA,Rajon Rondo,129,25.5666666666667,26,-0.433333333333334,51,50,1,3,-2
21700879,201950,NOP,MIA,Jrue Holiday,206,38.35,38,0.350000000000001,94,91,3,-2,5
21700879,202703,NOP,MIA,Nikola Mirotic,174,34.85,35,-0.149999999999999,80,77,3,8,-5
21700879,202732,NOP,MIA,DeAndre Liggins,1,0,0,0,,0,,0,
21700879,202734,NOP,MIA,E'Twaun Moore,161,30,30,0,76,78,-2,0,-2
21700879,203076,NOP,MIA,Anthony Davis,218,41.25,41,0.25,103,104,-1,-3,2
21700879,203121,NOP,MIA,Darius Miller,118,24.6833333333333,25,-0.316666666666666,50,52,-2,-2,0
21700879,203546,NOP,MIA,Ian Clark,198,38.55,38,0.549999999999997,95,86,9,7,2
21700879,1627215,NOP,MIA,Walter Lemon Jr.,19,4.11666666666667,4,0.116666666666667,11,15,-4,-4,0
21700879,1627767,NOP,MIA,Cheick Diallo,47,10.0166666666667,10,0.0166666666666657,17,19,-2,-3,1
21700879,2548,MIA,NOP,Dwyane Wade,140,27.0166666666667,26,1.01666666666667,59,62,-3,-1,-2
21700879,201609,MIA,NOP,Goran Dragic,171,32.1333333333333,37,-4.86666666666667,76,75,1,2,-1
21700879,201949,MIA,NOP,James Johnson,184,35.6833333333333,35,0.68333333333333,71,82,-11,-13,2
21700879,201961,MIA,NOP,Wayne Ellington,123,25.5333333333333,26,-0.466666666666669,50,51,-1,-3,2
21700879,202337,MIA,NOP,Luke Babbitt,26,5.76666666666667,6,-0.233333333333333,17,16,1,1,0
21700879,202355,MIA,NOP,Hassan Whiteside,195,37.3,33,4.3,94,88,6,-1,7
21700879,204020,MIA,NOP,Tyler Johnson,143,27.45,28,-0.550000000000001,67,71,-4,2,-6
21700879,1626159,MIA,NOP,Justise Winslow,86,16.0666666666667,16,0.0666666666666664,50,40,10,12,-2
21700879,1626196,MIA,NOP,Josh Richardson,199,38.25,38,0.25,87,91,-4,-6,2
21700879,1628389,MIA,NOP,Bam Adebayo,98,19.8,19,0.799999999999997,44,44,0,2,-2
21700880,2734,DEN,SAS,Devin Harris,92,16.4833333333333,17,-0.516666666666666,45,47,-2,-3,1
21700880,201163,DEN,SAS,Wilson Chandler,188,38.1,38,0.100000000000001,92,94,-2,-4,2
21700880,203115,DEN,SAS,Will Barton,158,31.25,32,-0.75,82,81,1,3,-2
21700880,203486,DEN,SAS,Mason Plumlee,103,21,21,0,51,54,-3,-4,1
21700880,203914,DEN,SAS,Gary Harris,170,36.1333333333333,36,0.133333333333333,88,84,4,4,0
21700880,203999,DEN,SAS,Nikola Jokic,166,34.5666666666667,34,0.566666666666663,84,75,9,9,0
21700880,1626168,DEN,SAS,Trey Lyles,105,20,20,0,61,52,9,11,-2
21700880,1627736,DEN,SAS,Malik Beasley,35,7.4,7,0.4,21,22,-1,-4,3
21700880,1627750,DEN,SAS,Jamal Murray,158,34.9833333333333,35,-0.0166666666666657,86,81,5,3,2
21700880,1938,SAS,DEN,Manu Ginobili,102,21.1166666666667,20,1.11666666666667,45,56,-11,-11,0
21700880,2200,SAS,DEN,Pau Gasol,142,29.8833333333333,30,-0.116666666666667,72,72,0,1,-1
21700880,2225,SAS,DEN,Tony Parker,116,24.1666666666667,24,0.166666666666668,59,64,-5,-5,0
21700880,200746,SAS,DEN,LaMarcus Aldridge,165,35.6666666666667,36,-0.333333333333329,84,86,-2,2,-4
21700880,200752,SAS,DEN,Rudy Gay,97,18.9833333333333,19,-0.0166666666666657,49,52,-3,-1,-2
21700880,201988,SAS,DEN,Patty Mills,159,32.8333333333333,33,-0.166666666666671,88,81,7,8,-1
21700880,202722,SAS,DEN,Davis Bertans,77,14.7666666666667,14,0.766666666666666,39,30,9,8,1
21700880,203464,SAS,DEN,Brandon Paul,2,0.466666666666667,0,0.466666666666667,2,0,2,2,0
21700880,203530,SAS,DEN,Joffrey Lauvergne,31,4.36666666666667,4,0.366666666666667,14,14,0,-1,1
21700880,203937,SAS,DEN,Kyle Anderson,134,28.1333333333333,28,0.133333333333333,72,64,8,8,0
21700880,1627749,SAS,DEN,Dejounte Murray,117,22.7333333333333,23,-0.266666666666666,56,62,-6,-5,-1
21700880,1627854,SAS,DEN,Bryn Forbes,33,6.8,7,-0.2,10,29,-19,-19,0
21700881,101150,LAC,PHX,Lou Williams,179,32.4166666666667,33,-0.583333333333329,91,93,-2,-2,0
21700881,201599,LAC,PHX,DeAndre Jordan,140,26.4666666666667,26,0.466666666666669,73,58,15,15,0
21700881,202325,LAC,PHX,Wesley Johnson,102,20.15,20,0.149999999999999,54,33,21,21,0
21700881,202699,LAC,PHX,Tobias Harris,192,35.8666666666667,36,-0.13333333333334,98,83,15,13,2
21700881,203085,LAC,PHX,Austin Rivers,194,35.8666666666667,36,-0.13333333333334,98,92,6,8,-2
21700881,1626149,LAC,PHX,Montrezl Harrell,112,21,21,0,55,57,-2,-2,0
21700881,1626155,LAC,PHX,Sam Dekker,61,11.6666666666667,12,-0.333333333333332,30,34,-4,-2,-2
21700881,1627820,LAC,PHX,Tyrone Wallace,194,36.3333333333333,37,-0.666666666666671,95,84,11,9,2
21700881,1628414,LAC,PHX,Sindarius Thornwell,1,0.0666666666666667,1,-0.933333333333333,,2,,-2,
21700881,1628462,LAC,PHX,Milos Teodosic,90,17.8333333333333,18,-0.166666666666668,46,49,-3,-3,0
21700881,201162,PHX,LAC,Jared Dudley,58,11.0333333333333,11,0.0333333333333332,29,23,6,8,-2
21700881,203458,PHX,LAC,Alex Len,127,23.6,24,-0.399999999999999,52,66,-14,-12,-2
21700881,203584,PHX,LAC,Troy Daniels,133,23.9333333333333,24,-0.06666666666667,69,71,-2,-3,1
21700881,203901,PHX,LAC,Elfrid Payton,157,28.5833333333333,29,-0.416666666666664,66,82,-16,-14,-2
21700881,203933,PHX,LAC,T.J. Warren,187,34.4333333333333,35,-0.56666666666667,91,95,-4,-6,2
21700881,1626164,PHX,LAC,Devin Booker,199,37.3166666666667,37,0.316666666666663,98,104,-6,-3,-3
21700881,1627733,PHX,LAC,Dragan Bender,151,29.4333333333333,30,-0.566666666666666,66,79,-13,-13,0
21700881,1627737,PHX,LAC,Marquese Chriss,66,12.5833333333333,13,-0.416666666666666,28,30,-2,-4,2
21700881,1627885,PHX,LAC,Shaquille Harrison,71,14.0166666666667,14,0.0166666666666657,33,32,1,1,0
21700881,1628367,PHX,LAC,Josh Jackson,116,22.7333333333333,23,-0.266666666666666,53,58,-5,-9,4
21700882,202323,POR,UTA,Evan Turner,98,22.1333333333333,22,0.133333333333333,36,41,-5,-5,0
21700882,202329,POR,UTA,Al-Farouq Aminu,142,32.6666666666667,33,-0.333333333333336,69,47,22,22,0
21700882,202334,POR,UTA,Ed Davis,91,20.8666666666667,21,-0.133333333333333,35,46,-11,-11,0
21700882,203081,POR,UTA,Damian Lillard,162,36.6666666666667,37,-0.333333333333336,80,65,15,15,0
21700882,203090,POR,UTA,Maurice Harkless,114,25.8333333333333,26,-0.166666666666664,64,40,24,24,0
21700882,203468,POR,UTA,CJ McCollum,158,35.4333333333333,36,-0.56666666666667,76,51,25,25,0
21700882,203894,POR,UTA,Shabazz Napier,86,19.7833333333333,19,0.783333333333331,34,32,2,2,0
21700882,203994,POR,UTA,Jusuf Nurkic,115,25.5333333333333,26,-0.466666666666669,63,35,28,28,0
21700882,1626192,POR,UTA,Pat Connaughton,20,4.63333333333333,5,-0.366666666666667,10,14,-4,-4,0
21700882,1628380,POR,UTA,Zach Collins,74,16.2833333333333,16,0.283333333333331,33,34,-1,-1,0
21700882,201937,UTA,POR,Ricky Rubio,88,19.75,20,-0.25,31,49,-18,-18,0
21700882,201973,UTA,POR,Jonas Jerebko,85,19.7833333333333,20,-0.216666666666669,42,34,8,8,0
21700882,202324,UTA,POR,Derrick Favors,107,24.05,25,-0.950000000000003,40,56,-16,-20,4
21700882,202327,UTA,POR,Ekpe Udoh,25,5.76666666666667,6,-0.233333333333333,7,14,-7,-5,-2
21700882,202692,UTA,POR,Alec Burks,44,10.6166666666667,11,-0.383333333333333,14,16,-2,-2,0
21700882,203109,UTA,POR,Jae Crowder,120,27.25,27,0.25,48,52,-4,-4,0
21700882,203497,UTA,POR,Rudy Gobert,154,34.2833333333333,34,0.283333333333331,60,72,-12,-10,-2
21700882,204060,UTA,POR,Joe Ingles,153,35.0666666666667,35,0.0666666666666629,54,79,-25,-27,2
21700882,1626220,UTA,POR,Royce O'Neale,122,27.0833333333333,27,0.0833333333333357,49,54,-5,-5,0
21700882,1628378,UTA,POR,Donovan Mitchell,162,36.1833333333333,36,0.183333333333337,60,74,-14,-12,-2
21700883,1717,DAL,LAL,Dirk Nowitzki,90,19.6333333333333,20,-0.366666666666667,55,47,8,8,0
21700883,200826,DAL,LAL,J.J. Barea,124,26.65,26,0.649999999999999,65,69,-4,-6,2
21700883,202083,DAL,LAL,Wesley Matthews,134,28.6666666666667,29,-0.333333333333332,54,85,-31,-29,-2
21700883,203084,DAL,LAL,Harrison Barnes,155,32.3,32,0.299999999999997,63,92,-29,-29,0
21700883,203926,DAL,LAL,Doug McDermott,117,23.6166666666667,23,0.616666666666667,59,58,1,1,0
21700883,203939,DAL,LAL,Dwight Powell,131,26.7166666666667,27,-0.283333333333331,59,67,-8,-8,0
21700883,1626257,DAL,LAL,Salah Mejri,13,2.53333333333333,2,0.533333333333333,5,9,-4,-4,0
21700883,1627812,DAL,LAL,Yogi Ferrell,147,29.8833333333333,30,-0.116666666666667,61,64,-3,-7,4
21700883,1627858,DAL,LAL,Kyle Collinsworth,22,4.55,5,-0.45,8,7,1,1,0
21700883,1628372,DAL,LAL,Dennis Smith Jr.,143,30.1833333333333,30,0.18333333333333,59,89,-30,-26,-4
21700883,1628467,DAL,LAL,Maxi Kleber,69,14.5166666666667,14,0.516666666666668,22,33,-11,-11,0
21700883,201572,LAL,DAL,Brook Lopez,97,21.3833333333333,21,0.383333333333333,65,40,25,23,2
21700883,202738,LAL,DAL,Isaiah Thomas,127,25.9,25,0.899999999999999,71,67,4,4,0
21700883,203484,LAL,DAL,Kentavious Caldwell-Pope,144,29.4833333333333,30,-0.516666666666666,82,66,16,18,-2
21700883,203898,LAL,DAL,Tyler Ennis,22,4.55,5,-0.45,7,8,-1,-1,0
21700883,203944,LAL,DAL,Julius Randle,138,29.75,30,-0.25,84,57,27,27,0
21700883,1627742,LAL,DAL,Brandon Ingram,134,29.2833333333333,29,0.283333333333331,74,47,27,27,0
21700883,1627826,LAL,DAL,Ivica Zubac,90,18.6166666666667,18,0.616666666666667,40,40,0,-2,2
21700883,1628366,LAL,DAL,Lonzo Ball,89,17.6166666666667,17,0.616666666666667,46,52,-6,-6,0
21700883,1628398,LAL,DAL,Kyle Kuzma,126,25.0333333333333,25,0.0333333333333314,57,62,-5,-3,-2
21700883,1628404,LAL,DAL,Josh Hart,156,33.0833333333333,34,-0.916666666666671,87,63,24,24,0
21700883,1628418,LAL,DAL,Thomas Bryant,22,4.55,5,-0.45,7,8,-1,-1,0
21700884,201167,ORL,PHI,Arron Afflalo,59,12.8833333333333,13,-0.116666666666667,30,38,-8,-6,-2
21700884,201571,ORL,PHI,D.J. Augustin,103,22.75,23,-0.25,47,46,1,-3,4
21700884,202687,ORL,PHI,Bismack Biyombo,62,14.1833333333333,14,0.183333333333334,31,37,-6,-6,0
21700884,202696,ORL,PHI,Nikola Vucevic,135,29.3833333333333,30,-0.616666666666667,67,64,3,-1,4
21700884,202714,ORL,PHI,Shelvin Mack,78,18.05,18,0.0500000000000007,35,54,-19,-15,-4
21700884,203095,ORL,PHI,Evan Fournier,157,35.0833333333333,35,0.0833333333333357,78,80,-2,-4,2
21700884,203613,ORL,PHI,Jonathon Simmons,150,32.1833333333333,32,0.183333333333337,78,76,2,5,-3
21700884,203920,ORL,PHI,Khem Birch,21,5.46666666666667,6,-0.533333333333333,10,17,-7,-3,-4
21700884,203932,ORL,PHI,Aaron Gordon,141,30.9833333333333,31,-0.0166666666666657,74,65,9,7,2
21700884,1626173,ORL,PHI,Rashad Vaughn,2,0.4,1,-0.6,2,2,0,2,-2
21700884,1626209,ORL,PHI,Mario Hezonja,113,25.6,25,0.600000000000001,53,71,-18,-18,0
21700884,1628411,ORL,PHI,Wes Iwundu,49,11.8666666666667,12,-0.133333333333333,20,30,-10,-13,3
21700884,200755,PHI,ORL,JJ Redick,107,24.5333333333333,24,0.533333333333335,60,50,10,10,0
21700884,201158,PHI,ORL,Marco Belinelli,119,27.3166666666667,27,0.316666666666666,75,58,17,15,2
21700884,202344,PHI,ORL,Trevor Booker,98,22.5166666666667,23,-0.483333333333334,62,53,9,7,2
21700884,203496,PHI,ORL,Robert Covington,123,26.7166666666667,27,-0.283333333333331,63,59,4,4,0
21700884,203954,PHI,ORL,Joel Embiid,119,27.1666666666667,27,0.166666666666664,65,56,9,9,0
21700884,203967,PHI,ORL,Dario Saric,116,25.25,25,0.25,54,52,2,4,-2
21700884,204456,PHI,ORL,T.J. McConnell,134,30.45,31,-0.549999999999997,75,68,7,7,0
21700884,1626158,PHI,ORL,Richaun Holmes,95,20.6,21,-0.399999999999999,51,49,2,2,0
21700884,1627732,PHI,ORL,Ben Simmons,130,28.2666666666667,29,-0.733333333333334,63,59,4,6,-2
21700884,1627789,PHI,ORL,Timothe Luwawu-Cabarrot,29,6.01666666666667,6,0.0166666666666666,12,21,-9,-9,0
21700885,2548,MIA,MEM,Dwyane Wade,81,18.0833333333333,18,0.0833333333333357,55,29,26,26,0
21700885,2617,MIA,MEM,Udonis Haslem,15,3.51666666666667,4,-0.483333333333333,0,5,-5,-5,0
21700885,201609,MIA,MEM,Goran Dragic,122,25.2166666666667,25,0.216666666666669,58,53,5,5,0
21700885,201949,MIA,MEM,James Johnson,89,19.3333333333333,19,0.333333333333336,56,33,23,23,0
21700885,201961,MIA,MEM,Wayne Ellington,128,27.7,28,-0.300000000000001,73,47,26,24,2
21700885,202337,MIA,MEM,Luke Babbitt,45,9.86666666666667,10,-0.133333333333333,10,16,-6,-6,0
21700885,202355,MIA,MEM,Hassan Whiteside,124,25.7833333333333,26,-0.216666666666669,62,55,7,7,0
21700885,204020,MIA,MEM,Tyler Johnson,153,31.2166666666667,32,-0.783333333333331,78,59,19,19,0
21700885,1626159,MIA,MEM,Justise Winslow,134,28.2666666666667,29,-0.733333333333334,59,56,3,3,0
21700885,1626175,MIA,MEM,Jordan Mickey,15,3.51666666666667,4,-0.483333333333333,0,5,-5,-5,0
21700885,1626196,MIA,MEM,Josh Richardson,125,27.2,27,0.199999999999999,71,58,13,15,-2
21700885,1628389,MIA,MEM,Bam Adebayo,84,18.3,18,0.300000000000001,53,29,24,24,0
21700885,201596,MEM,MIA,Mario Chalmers,75,15.4833333333333,15,0.483333333333334,26,46,-20,-16,-4
21700885,203210,MEM,MIA,JaMychal Green,170,35.3833333333333,35,0.383333333333333,71,83,-12,-11,-1
21700885,203463,MEM,MIA,Ben McLemore,71,15.4666666666667,16,-0.533333333333335,24,42,-18,-19,1
21700885,1626150,MEM,MIA,Andrew Harrison,133,28.1833333333333,28,0.183333333333334,59,73,-14,-14,0
21700885,1626185,MEM,MIA,Jarell Martin,142,31.6166666666667,32,-0.383333333333333,59,81,-22,-23,1
21700885,1627738,MEM,MIA,Deyonta Davis,111,23.3666666666667,23,0.366666666666667,45,58,-13,-10,-3
21700885,1627744,MEM,MIA,Brice Johnson,21,4.5,5,-0.5,5,7,-2,-2,0
21700885,1627988,MEM,MIA,Myke Henry,53,12.1,13,-0.9,23,22,1,1,0
21700885,1628397,MEM,MIA,Ivan Rabb,106,23.25,24,-0.75,44,50,-6,-9,3
21700885,1628415,MEM,MIA,Dillon Brooks,132,26.45,26,0.449999999999999,51,62,-11,-12,1
21700885,1628424,MEM,MIA,Kobi Simmons,101,22.2,23,-0.800000000000001,38,51,-13,-15,2
21700886,201143,BOS,NYK,Al Horford,162,31.95,33,-1.05,85,70,15,13,2
21700886,202328,BOS,NYK,Greg Monroe,52,10.8333333333333,11,-0.166666666666668,18,29,-11,-9,-2
21700886,202681,BOS,NYK,Kyrie Irving,177,34.2333333333333,35,-0.766666666666666,95,75,20,22,-2
21700886,202694,BOS,NYK,Marcus Morris,150,30.2333333333333,30,0.233333333333334,78,79,-1,2,-3
21700886,203499,BOS,NYK,Shane Larkin,26,5.28333333333333,5,0.283333333333333,11,15,-4,-4,0
21700886,203935,BOS,NYK,Marcus Smart,136,27.1333333333333,28,-0.866666666666667,66,74,-8,-7,-1
21700886,1626179,BOS,NYK,Terry Rozier,101,20.75,21,-0.25,51,54,-3,-4,1
21700886,1627759,BOS,NYK,Jaylen Brown,150,28.9333333333333,29,-0.0666666666666664,77,63,14,12,2
21700886,1628369,BOS,NYK,Jayson Tatum,134,25.5333333333333,26,-0.466666666666669,70,51,19,21,-2
21700886,1628400,BOS,NYK,Semi Ojeleye,24,4.86666666666667,4,0.866666666666667,6,14,-8,-10,2
21700886,1628464,BOS,NYK,Daniel Theis,98,18.5833333333333,18,0.583333333333332,48,36,12,9,3
21700886,201563,NYK,BOS,Michael Beasley,149,28.55,29,-0.449999999999999,60,79,-19,-19,0
21700886,201584,NYK,BOS,Courtney Lee,87,16.55,16,0.550000000000001,31,42,-11,-9,-2
21700886,202498,NYK,BOS,Lance Thomas,120,24.1833333333333,24,0.18333333333333,68,57,11,9,2
21700886,202683,NYK,BOS,Enes Kanter,119,22.8666666666667,23,-0.133333333333333,48,62,-14,-10,-4
21700886,203124,NYK,BOS,Kyle O'Quinn,96,19.7333333333333,20,-0.266666666666666,48,44,4,2,2
21700886,203501,NYK,BOS,Tim Hardaway Jr.,170,32.85,33,-0.149999999999999,75,93,-18,-18,0
21700886,203504,NYK,BOS,Trey Burke,134,26.1333333333333,26,0.133333333333333,69,71,-2,-4,2
21700886,1626144,NYK,BOS,Emmanuel Mudiay,129,25.6333333333333,25,0.633333333333333,54,63,-9,-7,-2
21700886,1627786,NYK,BOS,Troy Williams,59,11.6666666666667,12,-0.333333333333332,31,33,-2,-2,0
21700886,1628373,NYK,BOS,Frank Ntilikina,115,23.5833333333333,24,-0.416666666666668,58,52,6,4,2
21700886,1628422,NYK,BOS,Damyean Dotson,32,6.58333333333333,7,-0.416666666666667,18,9,9,9,0
21700887,2561,GSW,OKC,David West,57,13.0833333333333,13,0.0833333333333322,23,21,2,2,0
21700887,2585,GSW,OKC,Zaza Pachulia,83,18.2166666666667,18,0.216666666666669,51,24,27,27,0
21700887,2733,GSW,OKC,Shaun Livingston,57,12.6166666666667,13,-0.383333333333333,21,23,-2,-2,0
21700887,2738,GSW,OKC,Andre Iguodala,106,22.4166666666667,23,-0.583333333333332,62,33,29,29,0
21700887,201142,GSW,OKC,Kevin Durant,161,32.2333333333333,32,0.233333333333334,81,57,24,20,4
21700887,201156,GSW,OKC,Nick Young,89,18.1166666666667,18,0.116666666666667,44,21,23,23,0
21700887,201580,GSW,OKC,JaVale McGee,55,10.3666666666667,10,0.366666666666667,13,23,-10,-10,0
21700887,201939,GSW,OKC,Stephen Curry,150,29.6,30,-0.399999999999999,74,52,22,24,-2
21700887,201956,GSW,OKC,Omri Casspi,24,6.06666666666667,6,0.0666666666666664,13,7,6,6,0
21700887,202691,GSW,OKC,Klay Thompson,143,30.7166666666667,31,-0.283333333333331,71,61,10,10,0
21700887,203110,GSW,OKC,Draymond Green,160,33.5,34,-0.5,83,64,19,21,-2
21700887,1626172,GSW,OKC,Kevon Looney,21,5.16666666666667,5,0.166666666666666,11,7,4,4,0
21700887,1626188,GSW,OKC,Quinn Cook,24,6.06666666666667,6,0.0666666666666664,13,7,6,6,0
21700887,2546,OKC,GSW,Carmelo Anthony,154,30.3333333333333,30,0.333333333333332,52,78,-26,-26,0
21700887,2555,OKC,GSW,Nick Collison,24,6.06666666666667,6,0.0666666666666664,7,13,-6,-6,0
21700887,101109,OKC,GSW,Raymond Felton,53,12.8333333333333,13,-0.166666666666666,19,26,-7,-7,0
21700887,201566,OKC,GSW,Russell Westbrook,159,31.4666666666667,31,0.466666666666669,56,75,-19,-19,0
21700887,202331,OKC,GSW,Paul George,155,32.4333333333333,33,-0.566666666666663,64,74,-10,-12,2
21700887,202335,OKC,GSW,Patrick Patterson,95,21.65,22,-0.350000000000001,30,51,-21,-19,-2
21700887,202713,OKC,GSW,Kyle Singler,21,5.16666666666667,5,0.166666666666666,7,11,-4,-4,0
21700887,203500,OKC,GSW,Steven Adams,163,33.45,34,-0.549999999999997,66,72,-6,-6,0
21700887,203518,OKC,GSW,Alex Abrines,92,19.85,20,-0.149999999999999,27,57,-30,-30,0
21700887,203924,OKC,GSW,Jerami Grant,99,21.1666666666667,21,0.166666666666668,28,56,-28,-26,-2
21700887,203962,OKC,GSW,Josh Huestis,98,19.6,20,-0.399999999999999,37,36,1,-1,2
21700887,1628390,OKC,GSW,Terrance Ferguson,17,4.15,4,0.15,7,11,-4,-4,0
21700888,203897,CHI,MIN,Zach LaVine,161,31.7833333333333,32,-0.216666666666669,71,79,-8,-8,0
21700888,203943,CHI,MIN,Noah Vonleh,67,13.9666666666667,14,-0.033333333333335,31,38,-7,-7,0
21700888,1626166,CHI,MIN,Cameron Payne,95,18.9666666666667,19,-0.033333333333335,47,54,-7,-7,0
21700888,1626170,CHI,MIN,Jerian Grant,12,2.53333333333333,3,-0.466666666666667,8,6,2,2,0
21700888,1626171,CHI,MIN,Bobby Portis,95,19.2666666666667,20,-0.733333333333334,47,54,-7,-7,0
21700888,1626245,CHI,MIN,Cristiano Felicio,152,30.4833333333333,31,-0.516666666666666,63,74,-11,-11,0
21700888,1627739,CHI,MIN,Kris Dunn,143,28.9166666666667,29,-0.0833333333333357,57,68,-11,-11,0
21700888,1627756,CHI,MIN,Denzel Valentine,138,27.8,28,-0.200000000000003,63,77,-14,-14,0
21700888,1628021,CHI,MIN,David Nwaba,165,33.65,34,-0.349999999999994,66,82,-16,-16,0
21700888,1628374,CHI,MIN,Lauri Markkanen,162,32.05,32,0.0499999999999972,67,78,-11,-11,0
21700888,2037,MIN,CHI,Jamal Crawford,139,27.5833333333333,28,-0.416666666666668,77,72,5,7,-2
21700888,201166,MIN,CHI,Aaron Brooks,6,1.15,1,0.15,2,6,-4,-4,0
21700888,201952,MIN,CHI,Jeff Teague,171,33.8333333333333,34,-0.166666666666671,83,73,10,10,0
21700888,201959,MIN,CHI,Taj Gibson,184,36.1666666666667,36,0.166666666666671,90,77,13,13,0
21700888,202332,MIN,CHI,Cole Aldrich,6,1.15,1,0.15,2,6,-4,-4,0
21700888,202357,MIN,CHI,Nemanja Bjelica,153,32.2166666666667,33,-0.783333333333331,79,61,18,16,2
21700888,203476,MIN,CHI,Gorgui Dieng,93,19.6666666666667,20,-0.333333333333336,53,45,8,8,0
21700888,203952,MIN,CHI,Andrew Wiggins,178,34.8166666666667,35,-0.183333333333337,86,69,17,17,0
21700888,1626145,MIN,CHI,Tyus Jones,67,14.05,14,0.0500000000000007,39,31,8,8,0
21700888,1626157,MIN,CHI,Karl-Anthony Towns,187,37.6333333333333,38,-0.366666666666667,97,74,23,23,0
21700888,1627875,MIN,CHI,Marcus Georges-Hunt,6,1.15,1,0.15,2,6,-4,-4,0
21700889,201162,PHX,POR,Jared Dudley,32,7.23333333333333,7,0.233333333333333,13,17,-4,-2,-2
21700889,203458,PHX,POR,Alex Len,145,29.3833333333333,29,0.383333333333333,62,67,-5,-3,-2
21700889,203584,PHX,POR,Troy Daniels,114,23.6166666666667,23,0.616666666666667,45,58,-13,-10,-3
21700889,203901,PHX,POR,Elfrid Payton,158,32.4166666666667,33,-0.583333333333336,72,72,0,-2,2
21700889,203933,PHX,POR,T.J. Warren,190,36.8666666666667,37,-0.133333333333333,88,83,5,5,0
21700889,1626164,PHX,POR,Devin Booker,194,39.2166666666667,39,0.216666666666669,82,95,-13,-11,-2
21700889,1627733,PHX,POR,Dragan Bender,114,24.7166666666667,25,-0.283333333333331,57,46,11,13,-2
21700889,1627737,PHX,POR,Marquese Chriss,93,18.3,18,0.300000000000001,39,35,4,2,2
21700889,1627885,PHX,POR,Shaquille Harrison,49,9.11666666666667,9,0.116666666666667,25,21,4,3,1
21700889,1628367,PHX,POR,Josh Jackson,101,19.1333333333333,19,0.133333333333333,37,36,1,-5,6
21700889,202323,POR,PHX,Evan Turner,67,13.75,14,-0.25,30,27,3,2,1
21700889,202329,POR,PHX,Al-Farouq Aminu,174,34.6666666666667,35,-0.333333333333329,76,77,-1,-2,1
21700889,202334,POR,PHX,Ed Davis,93,18.7666666666667,19,-0.233333333333334,31,38,-7,-7,0
21700889,203081,POR,PHX,Damian Lillard,197,38.8166666666667,39,-0.183333333333337,88,82,6,6,0
21700889,203090,POR,PHX,Maurice Harkless,150,30.2333333333333,30,0.233333333333334,73,67,6,6,0
21700889,203468,POR,PHX,CJ McCollum,174,36.6333333333333,36,0.633333333333333,83,85,-2,-2,0
21700889,203894,POR,PHX,Shabazz Napier,102,20.9,21,-0.100000000000001,41,45,-4,-4,0
21700889,203994,POR,PHX,Jusuf Nurkic,143,29.0166666666667,29,0.0166666666666657,73,66,7,7,0
21700889,1626192,POR,PHX,Pat Connaughton,47,8.8,9,-0.199999999999999,16,15,1,1,0
21700889,1628380,POR,PHX,Zach Collins,43,8.41666666666667,9,-0.583333333333332,19,18,1,3,-2
21700890,1717,DAL,UTA,Dirk Nowitzki,143,31.65,32,-0.350000000000001,72,62,10,10,0
21700890,200826,DAL,UTA,J.J. Barea,146,32.55,33,-0.450000000000003,72,64,8,10,-2
21700890,202083,DAL,UTA,Wesley Matthews,142,30.05,30,0.0500000000000007,44,72,-28,-28,0
21700890,203084,DAL,UTA,Harrison Barnes,142,30.05,30,0.0500000000000007,44,72,-28,-28,0
21700890,203926,DAL,UTA,Doug McDermott,92,21.0833333333333,21,0.0833333333333357,46,35,11,11,0
21700890,203939,DAL,UTA,Dwight Powell,109,24.8833333333333,25,-0.116666666666667,49,43,6,8,-2
21700890,1626257,DAL,UTA,Salah Mejri,46,9.53333333333333,10,-0.466666666666667,15,19,-4,-6,2
21700890,1627812,DAL,UTA,Yogi Ferrell,156,35.1666666666667,35,0.166666666666664,69,59,10,10,0
21700890,1627858,DAL,UTA,Kyle Collinsworth,11,2.03333333333333,2,0.0333333333333332,4,3,1,-1,2
21700890,1628372,DAL,UTA,Dennis Smith Jr.,108,23,23,0,35,56,-21,-21,0
21700890,201937,UTA,DAL,Ricky Rubio,132,29.25,29,0.25,61,47,14,14,0
21700890,201973,UTA,DAL,Jonas Jerebko,55,13.5666666666667,13,0.566666666666666,29,25,4,4,0
21700890,202324,UTA,DAL,Derrick Favors,140,31.1666666666667,31,0.166666666666664,62,67,-5,-5,0
21700890,202692,UTA,DAL,Alec Burks,61,13.2166666666667,13,0.216666666666667,19,34,-15,-14,-1
21700890,203109,UTA,DAL,Jae Crowder,128,27.9166666666667,28,-0.0833333333333357,46,48,-2,-2,0
21700890,203497,UTA,DAL,Rudy Gobert,160,34.4166666666667,35,-0.583333333333336,76,60,16,16,0
21700890,204060,UTA,DAL,Joe Ingles,163,34.7166666666667,34,0.716666666666669,77,65,12,11,1
21700890,1626220,UTA,DAL,Royce O'Neale,87,19.1333333333333,19,0.133333333333333,36,41,-5,-5,0
21700890,1628378,UTA,DAL,Donovan Mitchell,169,36.6166666666667,37,-0.383333333333333,79,63,16,16,0
21700891,201147,LAL,SAC,Corey Brewer,54,13.0166666666667,13,0.0166666666666657,24,31,-7,-8,1
21700891,201572,LAL,SAC,Brook Lopez,118,24.4,24,0.399999999999999,65,53,12,11,1
21700891,202738,LAL,SAC,Isaiah Thomas,103,22.9666666666667,23,-0.0333333333333314,49,53,-4,-1,-3
21700891,203484,LAL,SAC,Kentavious Caldwell-Pope,189,38.4,38,0.399999999999999,95,85,10,10,0
21700891,203944,LAL,SAC,Julius Randle,183,37.4666666666667,38,-0.533333333333331,95,75,20,20,0
21700891,1627742,LAL,SAC,Brandon Ingram,189,38.3333333333333,38,0.333333333333329,94,88,6,6,0
21700891,1627826,LAL,SAC,Ivica Zubac,49,11.3333333333333,11,0.333333333333332,22,31,-9,-9,0
21700891,1628398,LAL,SAC,Kyle Kuzma,105,22.5333333333333,23,-0.466666666666669,40,54,-14,-8,-6
21700891,1628404,LAL,SAC,Josh Hart,155,31.55,31,0.550000000000001,81,70,11,4,7
21700891,1713,SAC,LAL,Vince Carter,28,6.26666666666667,6,0.266666666666667,18,16,2,2,0
21700891,2216,SAC,LAL,Zach Randolph,99,19.7333333333333,20,-0.266666666666666,39,54,-15,-15,0
21700891,201585,SAC,LAL,Kosta Koufos,58,13.9166666666667,14,-0.0833333333333322,33,23,10,10,0
21700891,202066,SAC,LAL,Garrett Temple,73,17.35,17,0.350000000000001,40,30,10,10,0
21700891,203992,SAC,LAL,Bogdan Bogdanovic,155,30.1666666666667,30,0.166666666666664,68,81,-13,-11,-2
21700891,1626161,SAC,LAL,Willie Cauley-Stein,182,37.1333333333333,37,0.133333333333333,76,96,-20,-18,-2
21700891,1627741,SAC,LAL,Buddy Hield,145,30.9166666666667,31,-0.0833333333333322,68,65,3,3,0
21700891,1627746,SAC,LAL,Skal Labissiere,119,25.2166666666667,25,0.216666666666669,68,53,15,13,2
21700891,1628368,SAC,LAL,De'Aaron Fox,154,30.3666666666667,30,0.366666666666667,66,79,-13,-13,0
21700891,1628382,SAC,LAL,Justin Jackson,70,14.2166666666667,14,0.216666666666667,30,41,-11,-11,0
21700891,1628412,SAC,LAL,Frank Mason,62,14.7166666666667,15,-0.283333333333333,34,27,7,5,2
21700892,2749,DET,CHA,Jameer Nelson,34,6.41666666666667,6,0.416666666666667,4,20,-16,-17,1
21700892,201229,DET,CHA,Anthony Tolliver,76,15.1166666666667,15,0.116666666666667,26,50,-24,-25,1
21700892,201933,DET,CHA,Blake Griffin,142,30.4333333333333,31,-0.566666666666666,61,73,-12,-9,-3
21700892,202397,DET,CHA,Ish Smith,140,28.2666666666667,28,0.266666666666666,67,74,-7,-6,-1
21700892,202779,DET,CHA,Dwight Buycks,57,12.9666666666667,13,-0.033333333333335,27,20,7,7,0
21700892,203083,DET,CHA,Andre Drummond,161,32.5166666666667,32,0.516666666666666,69,85,-16,-15,-1
21700892,203493,DET,CHA,Reggie Bullock,146,29.5833333333333,30,-0.416666666666668,67,76,-9,-8,-1
21700892,203516,DET,CHA,James Ennis III,98,19.9166666666667,20,-0.0833333333333357,38,59,-21,-22,1
21700892,203961,DET,CHA,Eric Moreland,54,10.8,11,-0.199999999999999,23,16,7,4,3
21700892,204038,DET,CHA,Langston Galloway,58,11.7166666666667,12,-0.283333333333333,19,23,-4,-5,1
21700892,1626169,DET,CHA,Stanley Johnson,134,28.3833333333333,28,0.383333333333333,55,67,-12,-11,-1
21700892,1627740,DET,CHA,Henry Ellenson,29,6.43333333333333,7,-0.566666666666666,17,4,13,13,0
21700892,1628379,DET,CHA,Luke Kennard,26,5.7,6,-0.3,17,3,14,14,0
21700892,2730,CHA,DET,Dwight Howard,113,23.3166666666667,23,0.316666666666666,56,52,4,5,-1
21700892,101107,CHA,DET,Marvin Williams,119,24.45,25,-0.550000000000001,56,58,-2,-2,0
21700892,201587,CHA,DET,Nicolas Batum,142,28.95,29,-0.0500000000000007,70,63,7,9,-2
21700892,202689,CHA,DET,Kemba Walker,137,27.65,28,-0.350000000000001,71,67,4,4,0
21700892,203077,CHA,DET,Michael Kidd-Gilchrist,101,20.55,21,-0.449999999999999,41,45,-4,-4,0
21700892,203087,CHA,DET,Jeremy Lamb,104,21.4,21,0.399999999999999,70,36,34,34,0
21700892,203469,CHA,DET,Cody Zeller,102,20.9833333333333,21,-0.0166666666666657,57,35,22,22,0
21700892,203487,CHA,DET,Michael Carter-Williams,88,18.85,19,-0.149999999999999,48,24,24,24,0
21700892,1626163,CHA,DET,Frank Kaminsky,112,23.2,23,0.199999999999999,58,40,18,18,0
21700892,1626195,CHA,DET,Willy Hernangomez,16,3.35,3,0.35,1,11,-10,-11,1
21700892,1626203,CHA,DET,Treveon Graham,80,16.7333333333333,17,-0.266666666666666,39,31,8,6,2
21700892,1628370,CHA,DET,Malik Monk,26,5.7,6,-0.3,3,17,-14,-14,0
21700892,1628407,CHA,DET,Dwayne Bacon,15,3.11666666666667,3,0.116666666666667,0,11,-11,-11,0
21700893,2731,NOP,MIL,Emeka Okafor,76,15.0666666666667,16,-0.933333333333334,38,34,4,4,0
21700893,200765,NOP,MIL,Rajon Rondo,171,36.1833333333333,36,0.183333333333337,86,80,6,13,-7
21700893,201950,NOP,MIL,Jrue Holiday,193,41.35,42,-0.649999999999999,95,92,3,1,2
21700893,202703,NOP,MIL,Nikola Mirotic,178,37.75,37,0.75,85,87,-2,-2,0
21700893,202732,NOP,MIL,DeAndre Liggins,1,0.183333333333333,0,0.183333333333333,,0,,0,
21700893,202734,NOP,MIL,E'Twaun Moore,166,35.6166666666667,36,-0.383333333333333,87,74,13,13,0
21700893,203076,NOP,MIL,Anthony Davis,207,43.3,43,0.299999999999997,102,98,4,6,-2
21700893,203121,NOP,MIL,Darius Miller,146,28.5166666666667,28,0.516666666666666,65,72,-7,-10,3
21700893,203546,NOP,MIL,Ian Clark,89,17.3333333333333,18,-0.666666666666664,36,45,-9,-11,2
21700893,1627767,NOP,MIL,Cheick Diallo,48,9.7,10,-0.300000000000001,21,23,-2,-4,2
21700893,1891,MIL,NOP,Jason Terry,93,18.4,18,0.399999999999999,45,40,5,5,0
21700893,202339,MIL,NOP,Eric Bledsoe,175,37.4,37,0.399999999999999,84,85,-1,-3,2
21700893,203089,MIL,NOP,John Henson,122,27.2,27,0.199999999999999,53,64,-11,-13,2
21700893,203092,MIL,NOP,Tyler Zeller,57,11.15,11,0.149999999999999,31,27,4,6,-2
21700893,203114,MIL,NOP,Khris Middleton,173,37.9666666666667,38,-0.0333333333333314,84,92,-8,-8,0
21700893,203503,MIL,NOP,Tony Snell,161,34.1166666666667,34,0.116666666666667,77,80,-3,-4,1
21700893,203507,MIL,NOP,Giannis Antetokounmpo,183,39.4833333333333,40,-0.516666666666666,86,93,-7,-3,-4
21700893,203953,MIL,NOP,Jabari Parker,127,24.3333333333333,24,0.333333333333336,61,56,5,3,2
21700893,1627748,MIL,NOP,Thon Maker,75,14.4666666666667,15,-0.533333333333333,37,32,5,5,0
21700893,1628425,MIL,NOP,Sterling Brown,109,20.4833333333333,20,0.483333333333334,47,46,1,2,-1
21700894,2544,CLE,SAS,LeBron James,186,40.1666666666667,40,0.166666666666664,85,92,-7,-8,1
21700894,2594,CLE,SAS,Kyle Korver,125,25.0666666666667,25,0.0666666666666664,50,58,-8,-7,-1
21700894,2747,CLE,SAS,JR Smith,91,20.4,21,-0.600000000000001,38,48,-10,-8,-2
21700894,101181,CLE,SAS,Jose Calderon,4,0.666666666666667,1,-0.333333333333333,0,0,0,0,0
21700894,201145,CLE,SAS,Jeff Green,110,21.1833333333333,21,0.183333333333334,45,56,-11,-10,-1
21700894,201588,CLE,SAS,George Hill,111,25.2333333333333,25,0.233333333333334,48,55,-7,-9,2
21700894,202684,CLE,SAS,Tristan Thompson,98,22.5666666666667,23,-0.433333333333334,41,49,-8,-10,2
21700894,203903,CLE,SAS,Jordan Clarkson,118,23.55,23,0.549999999999997,50,57,-7,-10,3
21700894,203918,CLE,SAS,Rodney Hood,137,28.2166666666667,28,0.216666666666669,58,65,-7,-8,1
21700894,204066,CLE,SAS,John Holland,4,0.666666666666667,1,-0.333333333333333,0,0,0,0,0
21700894,1626204,CLE,SAS,Larry Nance Jr.,76,15.35,15,0.35,33,36,-3,-1,-2
21700894,1626224,CLE,SAS,Cedi Osman,61,14.5166666666667,15,-0.483333333333334,22,29,-7,-9,2
21700894,1627790,CLE,SAS,Ante Zizic,4,0.666666666666667,1,-0.333333333333333,0,0,0,0,0
21700894,2200,SAS,CLE,Pau Gasol,112,25.2333333333333,25,0.233333333333334,64,46,18,16,2
21700894,2225,SAS,CLE,Tony Parker,70,14.25,14,0.25,32,36,-4,-4,0
21700894,200746,SAS,CLE,LaMarcus Aldridge,171,36.8666666666667,37,-0.13333333333334,86,74,12,11,1
21700894,200752,SAS,CLE,Rudy Gay,72,15.4333333333333,16,-0.566666666666666,37,29,8,10,-2
21700894,201980,SAS,CLE,Danny Green,115,23,23,0,58,49,9,12,-3
21700894,201988,SAS,CLE,Patty Mills,166,35.4333333333333,35,0.43333333333333,80,71,9,8,1
21700894,202722,SAS,CLE,Davis Bertans,4,0.666666666666667,1,-0.333333333333333,0,0,0,0,0
21700894,203464,SAS,CLE,Brandon Paul,4,0.666666666666667,1,-0.333333333333333,0,0,0,0,0
21700894,203530,SAS,CLE,Joffrey Lauvergne,24,4.3,5,-0.7,3,9,-6,-4,-2
21700894,203937,SAS,CLE,Kyle Anderson,135,29.4,30,-0.600000000000001,65,56,9,8,1
21700894,1627749,SAS,CLE,Dejounte Murray,154,33.3333333333333,34,-0.666666666666671,74,58,16,17,-1
21700894,1627854,SAS,CLE,Bryn Forbes,98,19.6666666666667,20,-0.333333333333336,46,42,4,6,-2
21700895,101161,PHI,WAS,Amir Johnson,57,12.2333333333333,12,0.233333333333334,24,31,-7,-7,0
21700895,200755,PHI,WAS,JJ Redick,144,30.1,30,0.0999999999999979,59,79,-20,-21,1
21700895,201158,PHI,WAS,Marco Belinelli,128,27.2666666666667,27,0.266666666666666,61,58,3,3,0
21700895,202344,PHI,WAS,Trevor Booker,39,8.36666666666667,9,-0.633333333333333,12,19,-7,-7,0
21700895,203496,PHI,WAS,Robert Covington,137,29.1666666666667,30,-0.833333333333336,51,64,-13,-13,0
21700895,203954,PHI,WAS,Joel Embiid,152,31.6,32,-0.399999999999999,62,71,-9,-9,0
21700895,203967,PHI,WAS,Dario Saric,140,29.55,30,-0.449999999999999,58,71,-13,-11,-2
21700895,204456,PHI,WAS,T.J. McConnell,99,20.6166666666667,21,-0.383333333333333,36,48,-12,-13,1
21700895,1626158,PHI,WAS,Richaun Holmes,50,11.1666666666667,12,-0.833333333333332,28,16,12,12,0
21700895,1627732,PHI,WAS,Ben Simmons,173,36.7,37,-0.299999999999997,77,86,-9,-9,0
21700895,1627789,PHI,WAS,Timothe Luwawu-Cabarrot,6,1.73333333333333,2,-0.266666666666667,2,2,0,0,0
21700895,101133,WAS,PHI,Ian Mahinmi,80,16.35,16,0.350000000000001,35,29,6,6,0
21700895,101162,WAS,PHI,Marcin Gortat,124,27.1666666666667,28,-0.833333333333336,57,55,2,3,-1
21700895,201975,WAS,PHI,Jodie Meeks,53,10.75,11,-0.25,20,20,0,3,-3
21700895,202693,WAS,PHI,Markieff Morris,119,26.15,27,-0.850000000000001,65,51,14,13,1
21700895,203078,WAS,PHI,Bradley Beal,172,36.95,37,-0.0499999999999972,89,74,15,12,3
21700895,203107,WAS,PHI,Tomas Satoransky,151,32.2,32,0.200000000000003,79,65,14,13,1
21700895,203118,WAS,PHI,Mike Scott,72,14.5333333333333,14,0.533333333333333,27,30,-3,-1,-2
21700895,203490,WAS,PHI,Otto Porter Jr.,146,31.7,32,-0.300000000000001,78,60,18,17,1
21700895,204025,WAS,PHI,Tim Frazier,56,11.3666666666667,11,0.366666666666667,25,19,6,6,0
21700895,1626162,WAS,PHI,Kelly Oubre Jr.,152,31.3333333333333,32,-0.666666666666668,70,67,3,3,0
21700896,2734,DEN,HOU,Devin Harris,57,11.85,12,-0.15,31,37,-6,-5,-1
21700896,201163,DEN,HOU,Wilson Chandler,155,32.0333333333333,32,0.0333333333333314,71,76,-5,-4,-1
21700896,203115,DEN,HOU,Will Barton,174,36,36,0,86,82,4,4,0
21700896,203486,DEN,HOU,Mason Plumlee,77,16.9666666666667,17,-0.0333333333333314,43,41,2,4,-2
21700896,203914,DEN,HOU,Gary Harris,158,32.05,32,0.0499999999999972,72,78,-6,-7,1
21700896,203999,DEN,HOU,Nikola Jokic,153,31.0333333333333,31,0.0333333333333314,70,78,-8,-9,1
21700896,1626168,DEN,HOU,Trey Lyles,105,22.8,23,-0.200000000000003,59,58,1,1,0
21700896,1627736,DEN,HOU,Malik Beasley,100,21.15,21,0.149999999999999,51,56,-5,-1,-4
21700896,1627750,DEN,HOU,Jamal Murray,171,36.1166666666667,36,0.11666666666666,82,89,-7,-8,1
21700896,2207,HOU,DEN,Joe Johnson,146,29.0166666666667,29,0.0166666666666657,77,78,-1,1,-2
21700896,2772,HOU,DEN,Trevor Ariza,153,32.5666666666667,33,-0.43333333333333,70,71,-1,-1,0
21700896,101108,HOU,DEN,Chris Paul,147,32.1,32,0.0999999999999943,74,76,-2,-4,2
21700896,200782,HOU,DEN,PJ Tucker,112,24.4333333333333,24,0.43333333333333,55,58,-3,-4,1
21700896,201148,HOU,DEN,Brandan Wright,72,15.1166666666667,15,0.116666666666667,48,38,10,9,1
21700896,201583,HOU,DEN,Ryan Anderson,102,20.1166666666667,20,0.116666666666667,60,49,11,10,1
21700896,201601,HOU,DEN,Luc Mbah a Moute,116,22.9166666666667,23,-0.0833333333333357,66,53,13,12,1
21700896,201935,HOU,DEN,James Harden,183,37.2166666666667,37,0.216666666666669,96,85,11,12,-1
21700896,203991,HOU,DEN,Clint Capela,119,26.5166666666667,26,0.516666666666666,49,57,-8,-10,2
21700897,203101,ATL,LAL,Miles Plumlee,69,13.2333333333333,13,0.233333333333334,28,36,-8,-10,2
21700897,203145,ATL,LAL,Kent Bazemore,133,25.5,26,-0.5,58,64,-6,-4,-2
21700897,203471,ATL,LAL,Dennis Schroder,139,26.8833333333333,27,-0.116666666666667,57,67,-10,-10,0
21700897,203473,ATL,LAL,Dewayne Dedmon,129,25.7333333333333,25,0.733333333333334,54,62,-8,-8,0
21700897,203488,ATL,LAL,Mike Muscala,129,24.05,24,0.0499999999999972,52,64,-12,-14,2
21700897,203705,ATL,LAL,Josh Magette,24,4.61666666666667,5,-0.383333333333333,12,7,5,3,2
21700897,1627752,ATL,LAL,Taurean Prince,163,31.6666666666667,32,-0.333333333333336,72,83,-11,-11,0
21700897,1627819,ATL,LAL,Isaiah Taylor,114,20.4166666666667,21,-0.583333333333336,46,51,-5,-4,-1
21700897,1628381,ATL,LAL,John Collins,127,23.3666666666667,24,-0.633333333333333,53,59,-6,-4,-2
21700897,1628416,ATL,LAL,Tyler Dorsey,133,24.85,25,-0.149999999999999,51,74,-23,-18,-5
21700897,1628510,ATL,LAL,Andrew White III,100,18.4333333333333,19,-0.56666666666667,37,48,-11,-15,4
21700897,201572,LAL,ATL,Brook Lopez,110,21.4333333333333,21,0.43333333333333,52,45,7,11,-4
21700897,202738,LAL,ATL,Isaiah Thomas,143,26.8,27,-0.200000000000003,70,57,13,13,0
21700897,203484,LAL,ATL,Kentavious Caldwell-Pope,173,32.6333333333333,32,0.633333333333333,82,72,10,8,2
21700897,203898,LAL,ATL,Tyler Ennis,25,4.75,5,-0.25,10,12,-2,-2,0
21700897,203944,LAL,ATL,Julius Randle,157,29.6,30,-0.399999999999999,76,61,15,15,0
21700897,1627742,LAL,ATL,Brandon Ingram,148,28.4666666666667,29,-0.533333333333331,71,56,15,19,-4
21700897,1627826,LAL,ATL,Ivica Zubac,85,16.1666666666667,17,-0.833333333333336,41,39,2,0,2
21700897,1628366,LAL,ATL,Lonzo Ball,129,24,24,0,71,53,18,18,0
21700897,1628398,LAL,ATL,Kyle Kuzma,152,28.3,28,0.300000000000001,77,63,14,12,2
21700897,1628404,LAL,ATL,Josh Hart,138,26.6,27,-0.399999999999999,65,62,3,1,2
21700898,201143,BOS,MEM,Al Horford,108,23.4333333333333,24,-0.56666666666667,54,54,0,0,0
21700898,202681,BOS,MEM,Kyrie Irving,112,24.4666666666667,25,-0.533333333333331,61,52,9,7,2
21700898,202694,BOS,MEM,Marcus Morris,151,33.2333333333333,34,-0.766666666666666,79,63,16,19,-3
21700898,203382,BOS,MEM,Aron Baynes,72,16.1,16,0.100000000000001,35,33,2,-2,4
21700898,203499,BOS,MEM,Shane Larkin,38,8.75,9,-0.25,15,23,-8,-9,1
21700898,203935,BOS,MEM,Marcus Smart,104,22.3333333333333,22,0.333333333333332,57,44,13,12,1
21700898,1626179,BOS,MEM,Terry Rozier,89,19.45,19,0.449999999999999,46,36,10,12,-2
21700898,1627759,BOS,MEM,Jaylen Brown,119,25.5833333333333,26,-0.416666666666664,43,52,-9,-5,-4
21700898,1627846,BOS,MEM,Abdel Nader,10,1.95,2,-0.05,5,7,-2,-3,1
21700898,1628369,BOS,MEM,Jayson Tatum,115,25.8166666666667,26,-0.183333333333334,58,62,-4,-3,-1
21700898,1628400,BOS,MEM,Semi Ojeleye,62,13.5166666666667,13,0.516666666666666,37,20,17,16,1
21700898,1628464,BOS,MEM,Daniel Theis,110,24.3666666666667,24,0.366666666666667,55,44,11,11,0
21700898,201188,MEM,BOS,Marc Gasol,145,32.3,33,-0.700000000000003,66,72,-6,-4,-2
21700898,201596,MEM,BOS,Mario Chalmers,96,20.5,20,0.5,43,55,-12,-14,2
21700898,203210,MEM,BOS,JaMychal Green,150,33.25,34,-0.75,66,74,-8,-6,-2
21700898,203463,MEM,BOS,Ben McLemore,62,13.55,13,0.550000000000001,25,33,-8,-9,1
21700898,1626150,MEM,BOS,Andrew Harrison,147,32.5833333333333,33,-0.416666666666664,63,62,1,-1,2
21700898,1626185,MEM,BOS,Jarell Martin,160,34.3,34,0.299999999999997,72,73,-1,-1,0
21700898,1627738,MEM,BOS,Deyonta Davis,63,13.55,13,0.550000000000001,25,32,-7,-10,3
21700898,1627744,MEM,BOS,Brice Johnson,10,1.95,2,-0.05,7,5,2,3,-1
21700898,1627988,MEM,BOS,Myke Henry,76,15.9666666666667,16,-0.033333333333335,33,39,-6,-3,-3
21700898,1628397,MEM,BOS,Ivan Rabb,51,11.7833333333333,12,-0.216666666666667,25,35,-10,-12,2
21700898,1628415,MEM,BOS,Dillon Brooks,130,29.2666666666667,30,-0.733333333333334,65,65,0,2,-2
21700899,203200,CHI,BKN,Justin Holiday,168,34.8333333333333,35,-0.166666666666671,59,76,-17,-19,2
21700899,203943,CHI,BKN,Noah Vonleh,77,15.1333333333333,15,0.133333333333333,25,16,9,9,0
21700899,1626166,CHI,BKN,Cameron Payne,91,17.8166666666667,18,-0.183333333333334,28,22,6,6,0
21700899,1626171,CHI,BKN,Bobby Portis,105,20.9666666666667,21,-0.0333333333333314,40,30,10,8,2
21700899,1626245,CHI,BKN,Cristiano Felicio,142,29.7166666666667,30,-0.283333333333335,50,80,-30,-28,-2
21700899,1627739,CHI,BKN,Kris Dunn,142,30.1833333333333,30,0.18333333333333,59,82,-23,-23,0
21700899,1627756,CHI,BKN,Denzel Valentine,145,29.8666666666667,30,-0.133333333333333,58,55,3,6,-3
21700899,1628021,CHI,BKN,David Nwaba,153,31.3,31,0.300000000000001,57,77,-20,-21,1
21700899,1628374,CHI,BKN,Lauri Markkanen,142,30.1833333333333,30,0.18333333333333,59,82,-23,-23,0
21700899,201960,BKN,CHI,DeMarre Carroll,128,26.7833333333333,27,-0.216666666666669,74,49,25,25,0
21700899,201967,BKN,CHI,Dante Cunningham,114,23.6833333333333,23,0.68333333333333,38,38,0,0,0
21700899,203112,BKN,CHI,Quincy Acy,45,9.31666666666667,9,0.316666666666666,11,22,-11,-12,1
21700899,203459,BKN,CHI,Allen Crabbe,111,22.9666666666667,23,-0.0333333333333314,65,48,17,16,1
21700899,203915,BKN,CHI,Spencer Dinwiddie,135,28.45,29,-0.550000000000001,80,53,27,26,1
21700899,203917,BKN,CHI,Nik Stauskas,16,3.33333333333333,3,0.333333333333333,3,7,-4,-4,0
21700899,203925,BKN,CHI,Joe Harris,143,29.85,30,-0.149999999999999,53,46,7,8,-1
21700899,1626156,BKN,CHI,D'Angelo Russell,144,29.1166666666667,29,0.116666666666667,59,48,11,11,0
21700899,1626178,BKN,CHI,Rondae Hollis-Jefferson,109,21.8333333333333,22,-0.166666666666664,38,48,-10,-10,0
21700899,1627747,BKN,CHI,Caris LeVert,106,21.7,21,0.699999999999999,36,32,4,5,-1
21700899,1628386,BKN,CHI,Jarrett Allen,114,22.9666666666667,23,-0.0333333333333314,63,44,19,20,-1
21700900,2561,GSW,NYK,David West,61,13.5666666666667,14,-0.433333333333334,28,25,3,3,0
21700900,2585,GSW,NYK,Zaza Pachulia,73,14.5,14,0.5,40,41,-1,-1,0
21700900,2733,GSW,NYK,Shaun Livingston,37,8.01666666666667,8,0.0166666666666675,15,14,1,1,0
21700900,2738,GSW,NYK,Andre Iguodala,89,19.2166666666667,19,0.216666666666669,40,45,-5,-6,1
21700900,201142,GSW,NYK,Kevin Durant,133,27.6166666666667,28,-0.383333333333333,89,63,26,27,-1
21700900,201156,GSW,NYK,Nick Young,75,14.7333333333333,15,-0.266666666666666,33,39,-6,-8,2
21700900,201580,GSW,NYK,JaVale McGee,67,14.3833333333333,15,-0.616666666666667,43,30,13,13,0
21700900,201939,GSW,NYK,Stephen Curry,145,30.3,30,0.299999999999997,95,70,25,25,0
21700900,201956,GSW,NYK,Omri Casspi,34,6.61666666666667,7,-0.383333333333333,12,21,-9,-7,-2
21700900,202691,GSW,NYK,Klay Thompson,153,33,33,0,92,72,20,22,-2
21700900,203110,GSW,NYK,Draymond Green,147,31.5666666666667,32,-0.43333333333333,79,68,11,11,0
21700900,1626188,GSW,NYK,Quinn Cook,57,11.7333333333333,12,-0.266666666666668,23,29,-6,-6,0
21700900,1628395,GSW,NYK,Jordan Bell,69,13.4166666666667,13,0.416666666666666,36,38,-2,-4,2
21700900,201563,NYK,GSW,Michael Beasley,117,25.2166666666667,26,-0.783333333333331,58,75,-17,-17,0
21700900,201584,NYK,GSW,Courtney Lee,53,11.2,11,0.199999999999999,23,37,-14,-14,0
21700900,202498,NYK,GSW,Lance Thomas,83,17.4,17,0.399999999999999,35,34,1,1,0
21700900,202683,NYK,GSW,Enes Kanter,80,16.9166666666667,17,-0.0833333333333322,38,53,-15,-15,0
21700900,203124,NYK,GSW,Kyle O'Quinn,101,21.4833333333333,21,0.483333333333334,50,55,-5,-5,0
21700900,203501,NYK,GSW,Tim Hardaway Jr.,134,28.4333333333333,29,-0.56666666666667,70,81,-11,-13,2
21700900,203504,NYK,GSW,Trey Burke,119,24.8333333333333,25,-0.166666666666664,67,63,4,6,-2
21700900,1626144,NYK,GSW,Emmanuel Mudiay,144,30.3666666666667,31,-0.633333333333333,63,83,-20,-22,2
21700900,1627786,NYK,GSW,Troy Williams,69,14.4666666666667,15,-0.533333333333333,33,27,6,6,0
21700900,1628373,NYK,GSW,Frank Ntilikina,133,28.1166666666667,28,0.116666666666667,65,70,-5,-5,0
21700900,1628422,NYK,GSW,Damyean Dotson,44,8.11666666666667,8,0.116666666666667,23,19,4,6,-2
21700900,1628439,NYK,GSW,Isaiah Hicks,63,12.1166666666667,12,0.116666666666667,30,28,2,2,0
21700901,101139,TOR,DET,CJ Miles,73,14.9833333333333,15,-0.0166666666666675,42,26,16,14,2
21700901,200768,TOR,DET,Kyle Lowry,123,24.5333333333333,25,-0.466666666666669,62,54,8,12,-4
21700901,201586,TOR,DET,Serge Ibaka,119,23.9666666666667,24,-0.0333333333333314,62,52,10,14,-4
21700901,201942,TOR,DET,DeMar DeRozan,147,29.2333333333333,29,0.233333333333334,79,65,14,14,0
21700901,202685,TOR,DET,Jonas Valanciunas,108,21.8166666666667,22,-0.183333333333334,57,48,9,14,-5
21700901,203512,TOR,DET,Lucas Nogueira,17,3.75,4,-0.25,9,4,5,5,0
21700901,1626153,TOR,DET,Delon Wright,92,20.25,21,-0.75,51,34,17,17,0
21700901,1626181,TOR,DET,Norman Powell,42,8.85,9,-0.15,22,23,-1,-1,0
21700901,1626259,TOR,DET,Malcolm Miller,38,8.76666666666667,9,-0.233333333333334,21,14,7,7,0
21700901,1627751,TOR,DET,Jakob Poeltl,107,22.2833333333333,22,0.283333333333331,57,42,15,10,5
21700901,1627783,TOR,DET,Pascal Siakam,113,23.8833333333333,24,-0.116666666666667,61,42,19,15,4
21700901,1627832,TOR,DET,Fred VanVleet,89,18.8166666666667,19,-0.183333333333334,47,31,16,14,2
21700901,1628384,TOR,DET,OG Anunoby,92,18.1166666666667,18,0.116666666666667,45,35,10,10,0
21700901,201229,DET,TOR,Anthony Tolliver,89,17.9166666666667,18,-0.0833333333333322,35,49,-14,-14,0
21700901,201933,DET,TOR,Blake Griffin,157,33.15,33,0.149999999999999,61,83,-22,-20,-2
21700901,202397,DET,TOR,Ish Smith,124,25.65,26,-0.350000000000001,51,70,-19,-22,3
21700901,202779,DET,TOR,Dwight Buycks,91,18.45,19,-0.550000000000001,39,44,-5,-2,-3
21700901,203083,DET,TOR,Andre Drummond,173,34.9833333333333,35,-0.0166666666666657,77,91,-14,-16,2
21700901,203493,DET,TOR,Reggie Bullock,159,32.2166666666667,32,0.216666666666669,69,83,-14,-17,3
21700901,203516,DET,TOR,James Ennis III,115,24.45,24,0.449999999999999,45,54,-9,-9,0
21700901,203961,DET,TOR,Eric Moreland,17,3.75,4,-0.25,4,9,-5,-5,0
21700901,204038,DET,TOR,Langston Galloway,17,3.75,4,-0.25,4,9,-5,-5,0
21700901,1626169,DET,TOR,Stanley Johnson,117,23.4,24,-0.600000000000001,49,69,-20,-20,0
21700901,1627740,DET,TOR,Henry Ellenson,28,5.9,6,-0.0999999999999996,11,14,-3,-3,0
21700901,1628379,DET,TOR,Luke Kennard,73,15.6333333333333,16,-0.366666666666667,25,40,-15,-12,-3
21700902,2731,NOP,PHX,Emeka Okafor,100,18.4166666666667,19,-0.583333333333336,55,45,10,8,2
21700902,200765,NOP,PHX,Rajon Rondo,196,35.4,36,-0.600000000000001,97,77,20,18,2
21700902,201950,NOP,PHX,Jrue Holiday,183,33.0833333333333,33,0.0833333333333357,93,81,12,14,-2
21700902,202703,NOP,PHX,Nikola Mirotic,131,24.95,25,-0.0500000000000007,63,53,10,12,-2
21700902,202732,NOP,PHX,DeAndre Liggins,32,7.13333333333333,7,0.133333333333333,11,21,-10,-7,-3
21700902,202734,NOP,PHX,E'Twaun Moore,160,28.8,29,-0.200000000000003,76,74,2,4,-2
21700902,203076,NOP,PHX,Anthony Davis,211,37.8833333333333,39,-1.11666666666667,100,92,8,9,-1
21700902,203121,NOP,PHX,Darius Miller,144,26.2666666666667,26,0.266666666666666,67,63,4,2,2
21700902,203546,NOP,PHX,Ian Clark,115,21.2333333333333,21,0.233333333333334,51,57,-6,-7,1
21700902,1627215,NOP,PHX,Walter Lemon Jr.,23,5.08333333333333,5,0.083333333333333,7,17,-10,-8,-2
21700902,203458,PHX,NOP,Alex Len,113,20.65,21,-0.350000000000001,57,60,-3,3,-6
21700902,203584,PHX,NOP,Troy Daniels,138,25.8833333333333,26,-0.116666666666667,58,65,-7,-11,4
21700902,203901,PHX,NOP,Elfrid Payton,194,35.4666666666667,36,-0.533333333333331,77,99,-22,-22,0
21700902,203933,PHX,NOP,T.J. Warren,231,41.3666666666667,42,-0.633333333333333,102,112,-10,-11,1
21700902,1626164,PHX,NOP,Devin Booker,220,40.3333333333333,41,-0.666666666666671,103,104,-1,-3,2
21700902,1627733,PHX,NOP,Dragan Bender,134,25.0666666666667,25,0.0666666666666664,64,64,0,-3,3
21700902,1627737,PHX,NOP,Marquese Chriss,95,18.2833333333333,18,0.283333333333331,40,42,-2,-3,1
21700902,1627885,PHX,NOP,Shaquille Harrison,10,1.5,2,-0.5,7,2,5,6,-1
21700902,1628367,PHX,NOP,Josh Jackson,160,29.7,30,-0.300000000000001,72,72,0,-1,1
21700903,201571,ORL,OKC,D.J. Augustin,158,33.1833333333333,33,0.183333333333337,80,78,2,1,1
21700903,202687,ORL,OKC,Bismack Biyombo,70,15.3666666666667,15,0.366666666666667,29,41,-12,-13,1
21700903,202696,ORL,OKC,Nikola Vucevic,160,32.6333333333333,33,-0.366666666666667,76,71,5,6,-1
21700903,202714,ORL,OKC,Shelvin Mack,79,16.9333333333333,17,-0.0666666666666664,29,45,-16,-15,-1
21700903,203095,ORL,OKC,Evan Fournier,173,35.1166666666667,35,0.116666666666667,81,79,2,0,2
21700903,203613,ORL,OKC,Jonathon Simmons,176,35.4166666666667,36,-0.583333333333329,83,77,6,5,1
21700903,203932,ORL,OKC,Aaron Gordon,164,33.2833333333333,33,0.283333333333331,79,70,9,9,0
21700903,1626173,ORL,OKC,Rashad Vaughn,47,10.4666666666667,10,0.466666666666667,18,24,-6,-5,-1
21700903,1626209,ORL,OKC,Mario Hezonja,69,15.3666666666667,15,0.366666666666667,26,42,-16,-16,0
21700903,1628411,ORL,OKC,Wes Iwundu,54,12.2333333333333,12,0.233333333333334,24,33,-9,-7,-2
21700903,2546,OKC,ORL,Carmelo Anthony,156,31.7166666666667,32,-0.283333333333335,70,72,-2,-5,3
21700903,101109,OKC,ORL,Raymond Felton,55,12.7,13,-0.300000000000001,34,24,10,12,-2
21700903,201566,OKC,ORL,Russell Westbrook,175,35.3,35,0.299999999999997,78,81,-3,-5,2
21700903,202331,OKC,ORL,Paul George,182,36.8666666666667,37,-0.133333333333333,81,79,2,2,0
21700903,202335,OKC,ORL,Patrick Patterson,75,16.4666666666667,16,0.466666666666669,42,33,9,12,-3
21700903,203500,OKC,ORL,Steven Adams,168,34.0333333333333,34,0.0333333333333314,77,80,-3,-2,-1
21700903,203518,OKC,ORL,Alex Abrines,102,21.55,21,0.550000000000001,54,48,6,8,-2
21700903,203924,OKC,ORL,Jerami Grant,78,17.15,17,0.149999999999999,46,33,13,12,1
21700903,203962,OKC,ORL,Josh Huestis,92,20.5666666666667,21,-0.433333333333334,45,49,-4,-2,-2
21700903,1628390,OKC,ORL,Terrance Ferguson,67,13.65,13,0.649999999999999,33,26,7,3,4
21700904,1717,DAL,IND,Dirk Nowitzki,109,24.75,25,-0.25,65,50,15,20,-5
21700904,200826,DAL,IND,J.J. Barea,114,26.1666666666667,26,0.166666666666664,70,57,13,17,-4
21700904,202083,DAL,IND,Wesley Matthews,149,31.5666666666667,32,-0.43333333333333,58,70,-12,-14,2
21700904,203084,DAL,IND,Harrison Barnes,149,31.5666666666667,32,-0.43333333333333,58,70,-12,-14,2
21700904,203926,DAL,IND,Doug McDermott,72,16.4166666666667,16,0.416666666666664,51,33,18,20,-2
21700904,203939,DAL,IND,Dwight Powell,152,32.7333333333333,33,-0.266666666666666,85,78,7,7,0
21700904,1626257,DAL,IND,Salah Mejri,55,12.5166666666667,13,-0.483333333333334,21,18,3,1,2
21700904,1627812,DAL,IND,Yogi Ferrell,142,30.6833333333333,31,-0.31666666666667,74,63,11,7,4
21700904,1628372,DAL,IND,Dennis Smith Jr.,140,28.8833333333333,29,-0.116666666666667,58,64,-6,-6,0
21700904,1628467,DAL,IND,Maxi Kleber,23,4.63333333333333,5,-0.366666666666667,5,12,-7,-8,1
21700904,201152,IND,DAL,Thaddeus Young,161,35.5833333333333,36,-0.416666666666664,75,65,10,11,-1
21700904,202362,IND,DAL,Lance Stephenson,88,19.6333333333333,20,-0.366666666666667,37,60,-23,-20,-3
21700904,202709,IND,DAL,Cory Joseph,171,36.45,37,-0.549999999999997,79,91,-12,-12,0
21700904,202711,IND,DAL,Bojan Bogdanovic,173,36.2,36,0.200000000000003,84,75,9,6,3
21700904,203506,IND,DAL,Victor Oladipo,108,22.45,23,-0.550000000000001,55,52,3,3,0
21700904,203922,IND,DAL,Glenn Robinson III,95,21.55,21,0.550000000000001,41,47,-6,-6,0
21700904,1626167,IND,DAL,Myles Turner,170,36.2666666666667,36,0.266666666666666,80,75,5,5,0
21700904,1626202,IND,DAL,Joe Young,68,15.5166666666667,15,0.516666666666666,31,28,3,3,0
21700904,1627734,IND,DAL,Domantas Sabonis,71,16.2666666666667,16,0.266666666666666,33,52,-19,-20,1
21700905,2207,HOU,UTA,Joe Johnson,135,29.5,30,-0.5,62,55,7,5,2
21700905,2403,HOU,UTA,Nene,97,19.5166666666667,20,-0.483333333333334,37,24,13,10,3
21700905,2772,HOU,UTA,Trevor Ariza,146,32.8666666666667,33,-0.133333333333333,65,67,-2,0,-2
21700905,101108,HOU,UTA,Chris Paul,144,33.8333333333333,34,-0.166666666666671,73,61,12,15,-3
21700905,101123,HOU,UTA,Gerald Green,69,16.0333333333333,16,0.0333333333333314,27,28,-1,-3,2
21700905,200782,HOU,UTA,PJ Tucker,113,25.2666666666667,25,0.266666666666666,45,43,2,4,-2
21700905,201601,HOU,UTA,Luc Mbah a Moute,131,28.9,29,-0.100000000000001,65,48,17,16,1
21700905,201935,HOU,UTA,James Harden,161,35.1333333333333,35,0.133333333333333,73,58,15,15,0
21700905,204028,HOU,UTA,Tarik Black,74,18.5333333333333,18,0.533333333333331,33,41,-8,-7,-1
21700905,201937,UTA,HOU,Ricky Rubio,119,26.6666666666667,27,-0.333333333333336,52,53,-1,-4,3
21700905,201973,UTA,HOU,Jonas Jerebko,69,16.25,17,-0.75,37,22,15,13,2
21700905,202324,UTA,HOU,Derrick Favors,117,27.6,28,-0.399999999999999,47,57,-10,-10,0
21700905,202692,UTA,HOU,Alec Burks,51,11.9166666666667,12,-0.0833333333333322,21,26,-5,-3,-2
21700905,203109,UTA,HOU,Jae Crowder,140,29.7666666666667,30,-0.233333333333334,53,62,-9,-8,-1
21700905,203497,UTA,HOU,Rudy Gobert,166,36.5666666666667,36,0.566666666666663,66,75,-9,-9,0
21700905,204060,UTA,HOU,Joe Ingles,147,32.3,32,0.299999999999997,52,70,-18,-18,0
21700905,1626220,UTA,HOU,Royce O'Neale,94,21.3833333333333,21,0.383333333333333,31,42,-11,-9,-2
21700905,1628378,UTA,HOU,Donovan Mitchell,167,37.1333333333333,37,0.133333333333333,66,73,-7,-7,0
21700906,2037,MIN,SAC,Jamal Crawford,103,23.9166666666667,24,-0.0833333333333357,55,54,1,1,0
21700906,201166,MIN,SAC,Aaron Brooks,3,0.666666666666667,1,-0.333333333333333,0,2,-2,-2,0
21700906,201952,MIN,SAC,Jeff Teague,150,32.9166666666667,33,-0.0833333333333357,90,70,20,20,0
21700906,201959,MIN,SAC,Taj Gibson,154,34.8833333333333,34,0.883333333333333,85,75,10,14,-4
21700906,202332,MIN,SAC,Cole Aldrich,4,0.85,1,-0.15,0,2,-2,-2,0
21700906,202357,MIN,SAC,Nemanja Bjelica,154,33.3333333333333,34,-0.666666666666664,89,65,24,22,2
21700906,203476,MIN,SAC,Gorgui Dieng,93,21.05,22,-0.949999999999999,51,44,7,3,4
21700906,203952,MIN,SAC,Andrew Wiggins,166,37.25,37,0.25,92,79,13,15,-2
21700906,1626145,MIN,SAC,Tyus Jones,63,14.6666666666667,15,-0.333333333333334,28,30,-2,-2,0
21700906,1626157,MIN,SAC,Karl-Anthony Towns,175,38.3833333333333,39,-0.616666666666667,100,79,21,21,0
21700906,201585,SAC,MIN,Kosta Koufos,92,19.6666666666667,20,-0.333333333333336,42,50,-8,-8,0
21700906,203992,SAC,MIN,Bogdan Bogdanovic,143,32.35,33,-0.649999999999999,70,76,-6,-5,-1
21700906,203998,SAC,MIN,Bruno Caboclo,81,18.3333333333333,19,-0.666666666666664,33,42,-9,-7,-2
21700906,1626161,SAC,MIN,Willie Cauley-Stein,126,29.3833333333333,30,-0.616666666666667,64,68,-4,-6,2
21700906,1627741,SAC,MIN,Buddy Hield,127,27.8833333333333,28,-0.116666666666667,63,66,-3,-2,-1
21700906,1627746,SAC,MIN,Skal Labissiere,142,30.9833333333333,31,-0.0166666666666657,64,84,-20,-20,0
21700906,1628368,SAC,MIN,De'Aaron Fox,123,27.1333333333333,27,0.133333333333333,58,65,-7,-13,6
21700906,1628382,SAC,MIN,Justin Jackson,153,34.65,36,-1.35,70,92,-22,-22,0
21700906,1628412,SAC,MIN,Frank Mason,78,17.5333333333333,18,-0.466666666666669,36,47,-11,-7,-4
21700907,203897,CHI,CHA,Zach LaVine,160,34.7666666666667,35,-0.233333333333334,69,89,-20,-20,0
21700907,203943,CHI,CHA,Noah Vonleh,71,14.05,14,0.0500000000000007,38,32,6,4,2
21700907,1626166,CHI,CHA,Cameron Payne,84,17.6333333333333,18,-0.366666666666667,50,45,5,3,2
21700907,1626171,CHI,CHA,Bobby Portis,114,23.5,23,0.5,57,55,2,2,0
21700907,1626245,CHI,CHA,Cristiano Felicio,112,25.6833333333333,26,-0.316666666666666,48,67,-19,-17,-2
21700907,1627739,CHI,CHA,Kris Dunn,138,30.05,30,0.0499999999999972,53,73,-20,-18,-2
21700907,1627756,CHI,CHA,Denzel Valentine,139,29.3166666666667,29,0.316666666666666,66,74,-8,-11,3
21700907,1628021,CHI,CHA,David Nwaba,145,31.2833333333333,32,-0.716666666666669,71,73,-2,1,-3
21700907,1628374,CHI,CHA,Lauri Markkanen,147,32.1333333333333,32,0.133333333333333,63,82,-19,-19,0
21700907,2730,CHA,CHI,Dwight Howard,130,28.7,29,-0.299999999999997,80,58,22,18,4
21700907,101107,CHA,CHI,Marvin Williams,134,29.65,30,-0.350000000000001,74,56,18,18,0
21700907,201587,CHA,CHI,Nicolas Batum,149,32.7666666666667,33,-0.233333333333334,77,75,2,4,-2
21700907,202689,CHA,CHI,Kemba Walker,153,33.6666666666667,34,-0.333333333333329,84,68,16,14,2
21700907,203077,CHA,CHI,Michael Kidd-Gilchrist,24,6.05,6,0.0499999999999998,16,13,3,3,0
21700907,203087,CHA,CHI,Jeremy Lamb,128,26.7666666666667,27,-0.233333333333334,67,52,15,13,2
21700907,203469,CHA,CHI,Cody Zeller,56,10.9333333333333,11,-0.0666666666666664,22,28,-6,-4,-2
21700907,203487,CHA,CHI,Michael Carter-Williams,68,14.0166666666667,14,0.0166666666666657,35,34,1,3,-2
21700907,1626163,CHA,CHI,Frank Kaminsky,109,22.5666666666667,23,-0.433333333333334,52,56,-4,0,-4
21700907,1626195,CHA,CHI,Willy Hernangomez,15,3.51666666666667,4,-0.483333333333333,8,8,0,-2,2
21700907,1626203,CHA,CHI,Treveon Graham,132,27.4833333333333,28,-0.516666666666666,67,59,8,8,0
21700907,1628370,CHA,CHI,Malik Monk,6,1.15,1,0.15,4,4,0,0,0
21700907,1628407,CHA,CHI,Dwayne Bacon,6,1.15,1,0.15,4,4,0,0,0
21700908,2544,CLE,BKN,LeBron James,188,39.0166666666667,39,0.0166666666666657,103,105,-2,2,-4
21700908,2594,CLE,BKN,Kyle Korver,120,25.3333333333333,25,0.333333333333332,77,63,14,15,-1
21700908,2747,CLE,BKN,JR Smith,106,21.5666666666667,22,-0.433333333333334,56,48,8,6,2
21700908,201588,CLE,BKN,George Hill,180,36.2833333333333,37,-0.716666666666669,97,90,7,5,2
21700908,202684,CLE,BKN,Tristan Thompson,112,21.6666666666667,22,-0.333333333333336,51,57,-6,-4,-2
21700908,203903,CLE,BKN,Jordan Clarkson,100,21.5,21,0.5,54,56,-2,1,-3
21700908,203918,CLE,BKN,Rodney Hood,148,30.8666666666667,31,-0.133333333333333,84,85,-1,0,-1
21700908,204066,CLE,BKN,John Holland,4,0.583333333333333,1,-0.416666666666667,2,4,-2,-2,0
21700908,1626204,CLE,BKN,Larry Nance Jr.,119,25.8,26,-0.200000000000003,73,66,7,4,3
21700908,1626224,CLE,BKN,Cedi Osman,93,17.2166666666667,18,-0.783333333333331,48,41,7,3,4
21700908,201960,BKN,CLE,DeMarre Carroll,164,32.1,32,0.0999999999999943,85,89,-4,-6,2
21700908,201967,BKN,CLE,Dante Cunningham,85,19.6333333333333,20,-0.366666666666667,45,51,-6,-4,-2
21700908,203112,BKN,CLE,Quincy Acy,17,2.86666666666667,3,-0.133333333333333,4,9,-5,-3,-2
21700908,203459,BKN,CLE,Allen Crabbe,159,32,32,0,83,82,1,-1,2
21700908,203915,BKN,CLE,Spencer Dinwiddie,146,30.6666666666667,31,-0.333333333333336,73,79,-6,-9,3
21700908,203925,BKN,CLE,Joe Harris,98,22.0166666666667,22,0.0166666666666657,54,64,-10,-9,-1
21700908,1626156,BKN,CLE,D'Angelo Russell,167,32.0833333333333,32,0.0833333333333357,90,83,7,10,-3
21700908,1626178,BKN,CLE,Rondae Hollis-Jefferson,102,21.3,21,0.299999999999997,58,61,-3,-4,1
21700908,1627747,BKN,CLE,Caris LeVert,87,19.0666666666667,19,0.0666666666666664,47,53,-6,-4,-2
21700908,1628386,BKN,CLE,Jarrett Allen,145,28.1,28,0.100000000000001,76,74,2,0,2
21700909,2548,MIA,PHI,Dwyane Wade,119,25.1666666666667,25,0.166666666666664,44,62,-18,-16,-2
21700909,201609,MIA,PHI,Goran Dragic,162,33.4666666666667,33,0.466666666666669,80,60,20,20,0
21700909,201949,MIA,PHI,James Johnson,82,16.5666666666667,16,0.566666666666666,24,31,-7,-8,1
21700909,201961,MIA,PHI,Wayne Ellington,56,11.3333333333333,11,0.333333333333332,16,22,-6,-4,-2
21700909,202355,MIA,PHI,Hassan Whiteside,160,33.4333333333333,34,-0.56666666666667,81,62,19,19,0
21700909,203482,MIA,PHI,Kelly Olynyk,113,24.8333333333333,25,-0.166666666666668,65,57,8,11,-3
21700909,203585,MIA,PHI,Rodney McGruder,41,9.13333333333333,9,0.133333333333333,20,20,0,1,-1
21700909,204020,MIA,PHI,Tyler Johnson,110,22.4666666666667,22,0.466666666666669,47,45,2,-1,3
21700909,1626159,MIA,PHI,Justise Winslow,96,18.9,19,-0.100000000000001,43,40,3,2,1
21700909,1626196,MIA,PHI,Josh Richardson,178,37.6333333333333,38,-0.366666666666667,82,86,-4,-2,-2
21700909,1628389,MIA,PHI,Bam Adebayo,38,7.06666666666667,7,0.0666666666666664,3,20,-17,-17,0
21700909,101161,PHI,MIA,Amir Johnson,59,11.7333333333333,13,-1.26666666666667,16,27,-11,-11,0
21700909,200755,PHI,MIA,JJ Redick,144,28.8166666666667,28,0.816666666666666,65,68,-3,-2,-1
21700909,201158,PHI,MIA,Marco Belinelli,121,26.5,26,0.5,43,43,0,-1,1
21700909,203496,PHI,MIA,Robert Covington,158,32.4333333333333,32,0.43333333333333,74,73,1,1,0
21700909,203954,PHI,MIA,Joel Embiid,149,30.9166666666667,30,0.916666666666664,72,60,12,12,0
21700909,203967,PHI,MIA,Dario Saric,167,35.1666666666667,36,-0.833333333333329,78,91,-13,-13,0
21700909,204456,PHI,MIA,T.J. McConnell,117,24.1666666666667,24,0.166666666666664,53,39,14,11,3
21700909,1626158,PHI,MIA,Richaun Holmes,83,17.4333333333333,17,0.43333333333333,35,24,11,9,2
21700909,1627732,PHI,MIA,Ben Simmons,157,32.8333333333333,33,-0.166666666666664,69,80,-11,-11,0
21700910,1891,MIL,WAS,Jason Terry,91,18.7666666666667,19,-0.233333333333334,50,43,7,8,-1
21700910,202339,MIL,WAS,Eric Bledsoe,161,35.6,35,0.599999999999994,72,80,-8,-9,1
21700910,203089,MIL,WAS,John Henson,119,25.7666666666667,26,-0.233333333333334,47,56,-9,-14,5
21700910,203092,MIL,WAS,Tyler Zeller,31,7.75,8,-0.25,21,18,3,5,-2
21700910,203114,MIL,WAS,Khris Middleton,150,32.9,33,-0.100000000000001,64,76,-12,-12,0
21700910,203503,MIL,WAS,Tony Snell,102,22.2,22,0.199999999999999,41,46,-5,-7,2
21700910,203507,MIL,WAS,Giannis Antetokounmpo,180,39.2666666666667,39,0.266666666666666,84,85,-1,-1,0
21700910,203930,MIL,WAS,Sean Kilpatrick,12,3.28333333333333,3,0.283333333333333,8,12,-4,-4,0
21700910,203953,MIL,WAS,Jabari Parker,122,26.5666666666667,27,-0.433333333333334,61,56,5,5,0
21700910,1627748,MIL,WAS,Thon Maker,66,13.4333333333333,13,0.433333333333334,32,31,1,6,-5
21700910,1628425,MIL,WAS,Sterling Brown,76,14.4666666666667,14,0.466666666666665,40,32,8,8,0
21700910,101133,WAS,MIL,Ian Mahinmi,87,18.5,18,0.5,40,45,-5,-2,-3
21700910,101162,WAS,MIL,Marcin Gortat,123,26.2833333333333,26,0.283333333333331,58,52,6,5,1
21700910,201975,WAS,MIL,Jodie Meeks,73,16.4166666666667,16,0.416666666666668,36,40,-4,-7,3
21700910,202693,WAS,MIL,Markieff Morris,149,32.45,32,0.450000000000003,73,63,10,8,2
21700910,203078,WAS,MIL,Bradley Beal,161,34.6833333333333,35,-0.316666666666663,76,71,5,6,-1
21700910,203107,WAS,MIL,Tomas Satoransky,90,20.2166666666667,20,0.216666666666669,52,40,12,11,1
21700910,203118,WAS,MIL,Mike Scott,68,14.1333333333333,14,0.133333333333333,34,39,-5,-5,0
21700910,203490,WAS,MIL,Otto Porter Jr.,154,33.8666666666667,34,-0.133333333333333,73,65,8,8,0
21700910,204025,WAS,MIL,Tim Frazier,99,20.4666666666667,20,0.466666666666669,43,48,-5,-2,-3
21700910,1626162,WAS,MIL,Kelly Oubre Jr.,106,22.9833333333333,23,-0.0166666666666657,50,57,-7,-7,0
21700911,202323,POR,SAC,Evan Turner,87,19.4333333333333,19,0.43333333333333,47,41,6,6,0
21700911,202329,POR,SAC,Al-Farouq Aminu,130,27.3666666666667,27,0.366666666666667,67,55,12,14,-2
21700911,202334,POR,SAC,Ed Davis,91,20.4333333333333,20,0.433333333333334,47,41,6,4,2
21700911,203081,POR,SAC,Damian Lillard,156,33.75,34,-0.25,83,69,14,14,0
21700911,203086,POR,SAC,Meyers Leonard,10,2.23333333333333,3,-0.766666666666667,6,5,1,1,0
21700911,203090,POR,SAC,Maurice Harkless,125,25.9833333333333,26,-0.0166666666666657,63,53,10,10,0
21700911,203468,POR,SAC,CJ McCollum,166,33.6166666666667,34,-0.383333333333333,85,70,15,16,-1
21700911,203894,POR,SAC,Shabazz Napier,91,20.7333333333333,21,-0.266666666666666,50,41,9,10,-1
21700911,203994,POR,SAC,Jusuf Nurkic,121,24.9833333333333,25,-0.0166666666666657,63,53,10,12,-2
21700911,1626192,POR,SAC,Pat Connaughton,31,7.2,8,-0.8,14,18,-4,-6,2
21700911,1627774,POR,SAC,Jake Layman,10,2.23333333333333,3,-0.766666666666667,6,5,1,1,0
21700911,1628380,POR,SAC,Zach Collins,82,18.05,18,0.0500000000000007,43,39,4,2,2
21700911,1628403,POR,SAC,Caleb Swanigan,10,2.23333333333333,3,-0.766666666666667,6,5,1,1,0
21700911,1713,SAC,POR,Vince Carter,87,19.3666666666667,19,0.366666666666667,41,47,-6,-5,-1
21700911,2216,SAC,POR,Zach Randolph,135,28.0833333333333,28,0.0833333333333357,60,75,-15,-15,0
21700911,203992,SAC,POR,Bogdan Bogdanovic,153,31.9166666666667,32,-0.0833333333333357,71,78,-7,-7,0
21700911,1626161,SAC,POR,Willie Cauley-Stein,144,30.5,31,-0.5,67,71,-4,-2,-2
21700911,1627741,SAC,POR,Buddy Hield,129,28.6166666666667,29,-0.383333333333333,56,64,-8,-8,0
21700911,1627746,SAC,POR,Skal Labissiere,115,25.85,26,-0.149999999999999,45,60,-15,-17,2
21700911,1628368,SAC,POR,De'Aaron Fox,155,32.85,33,-0.149999999999999,67,79,-12,-9,-3
21700911,1628382,SAC,POR,Justin Jackson,117,24.3166666666667,25,-0.683333333333334,56,64,-8,-9,1
21700911,1628412,SAC,POR,Frank Mason,75,16.75,17,-0.25,32,42,-10,-13,3
21700912,2734,DEN,LAC,Devin Harris,72,12.3166666666667,12,0.316666666666666,29,35,-6,-8,2
21700912,200794,DEN,LAC,Paul Millsap,128,23.7333333333333,23,0.733333333333334,52,58,-6,-8,2
21700912,201163,DEN,LAC,Wilson Chandler,180,36.1,36,0.0999999999999943,91,91,0,-1,1
21700912,203115,DEN,LAC,Will Barton,205,39.5333333333333,40,-0.466666666666669,98,100,-2,-2,0
21700912,203486,DEN,LAC,Mason Plumlee,121,22.4,22,0.399999999999999,48,54,-6,-6,0
21700912,203914,DEN,LAC,Gary Harris,199,38.75,39,-0.25,95,95,0,1,-1
21700912,203999,DEN,LAC,Nikola Jokic,137,27.6,28,-0.399999999999999,75,72,3,6,-3
21700912,1626168,DEN,LAC,Trey Lyles,32,5.3,5,0.3,17,18,-1,-1,0
21700912,1627736,DEN,LAC,Malik Beasley,10,1.28333333333333,1,0.283333333333333,7,4,3,2,1
21700912,1627750,DEN,LAC,Jamal Murray,161,32.9833333333333,33,-0.0166666666666657,88,83,5,7,-2
21700912,101150,LAC,DEN,Lou Williams,190,36.1333333333333,36,0.133333333333333,93,88,5,7,-2
21700912,201599,LAC,DEN,DeAndre Jordan,112,23.0833333333333,23,0.0833333333333322,44,57,-13,-13,0
21700912,202325,LAC,DEN,Wesley Johnson,82,15.65,16,-0.35,33,45,-12,-14,2
21700912,202699,LAC,DEN,Tobias Harris,140,28.5666666666667,29,-0.433333333333334,64,71,-7,-9,2
21700912,203085,LAC,DEN,Austin Rivers,148,29.2166666666667,29,0.216666666666669,63,78,-15,-13,-2
21700912,1626149,LAC,DEN,Montrezl Harrell,136,24.9,25,-0.100000000000001,77,63,14,12,2
21700912,1626155,LAC,DEN,Sam Dekker,53,9.55,9,0.550000000000001,19,29,-10,-8,-2
21700912,1626246,LAC,DEN,Boban Marjanovic,79,15.0166666666667,15,0.0166666666666657,56,29,27,27,0
21700912,1627820,LAC,DEN,Tyrone Wallace,161,30.9833333333333,31,-0.0166666666666657,85,74,11,7,4
21700912,1628462,LAC,DEN,Milos Teodosic,144,26.9,27,-0.100000000000001,76,66,10,14,-4
21700913,1891,MIL,DET,Jason Terry,90,18.8166666666667,19,-0.183333333333334,31,50,-19,-18,-1
21700913,202339,MIL,DET,Eric Bledsoe,133,29.3833333333333,30,-0.616666666666667,52,62,-10,-15,5
21700913,203089,MIL,DET,John Henson,110,25.0833333333333,25,0.0833333333333357,45,52,-7,-8,1
21700913,203092,MIL,DET,Tyler Zeller,48,10.6833333333333,11,-0.316666666666666,18,23,-5,-4,-1
21700913,203114,MIL,DET,Khris Middleton,134,29.6166666666667,30,-0.383333333333333,51,62,-11,-11,0
21700913,203507,MIL,DET,Giannis Antetokounmpo,139,30.15,30,0.149999999999999,58,70,-12,-13,1
21700913,203930,MIL,DET,Sean Kilpatrick,121,26.35,26,0.350000000000001,44,65,-21,-18,-3
21700913,203953,MIL,DET,Jabari Parker,91,18.45,18,0.449999999999999,33,48,-15,-16,1
21700913,204098,MIL,DET,Xavier Munford,30,7.53333333333333,8,-0.466666666666667,14,15,-1,0,-1
21700913,1627748,MIL,DET,Thon Maker,51,10.2333333333333,10,0.233333333333333,23,32,-9,-9,0
21700913,1628391,MIL,DET,D.J. Wilson,30,7.53333333333333,8,-0.466666666666667,14,15,-1,0,-1
21700913,1628425,MIL,DET,Sterling Brown,108,25.5833333333333,26,-0.416666666666668,47,51,-4,-3,-1
21700913,201229,DET,MIL,Anthony Tolliver,88,19.3333333333333,20,-0.666666666666664,52,27,25,25,0
21700913,201933,DET,MIL,Blake Griffin,113,25.1,25,0.100000000000001,50,45,5,6,-1
21700913,202397,DET,MIL,Ish Smith,106,23.65,24,-0.350000000000001,48,43,5,3,2
21700913,202779,DET,MIL,Dwight Buycks,111,24.2333333333333,24,0.233333333333334,61,43,18,20,-2
21700913,203083,DET,MIL,Andre Drummond,118,26.1166666666667,27,-0.883333333333333,57,48,9,10,-1
21700913,203493,DET,MIL,Reggie Bullock,115,25.2333333333333,25,0.233333333333334,58,51,7,10,-3
21700913,203516,DET,MIL,James Ennis III,60,14.2166666666667,15,-0.783333333333335,26,31,-5,-5,0
21700913,203961,DET,MIL,Eric Moreland,99,21.7666666666667,21,0.766666666666666,52,38,14,13,1
21700913,204038,DET,MIL,Langston Galloway,102,22.65,23,-0.350000000000001,51,35,16,13,3
21700913,1626169,DET,MIL,Stanley Johnson,141,30.2166666666667,30,0.216666666666669,76,41,35,36,-1
21700913,1627740,DET,MIL,Henry Ellenson,16,3.45,4,-0.55,7,14,-7,-8,1
21700913,1628379,DET,MIL,Luke Kennard,16,3.45,4,-0.55,7,14,-7,-8,1
21700914,201571,ORL,TOR,D.J. Augustin,135,28.9,29,-0.100000000000001,58,75,-17,-19,2
21700914,202687,ORL,TOR,Bismack Biyombo,80,18.3333333333333,18,0.333333333333336,45,39,6,7,-1
21700914,202696,ORL,TOR,Nikola Vucevic,135,28.9,29,-0.100000000000001,58,75,-17,-19,2
21700914,202714,ORL,TOR,Shelvin Mack,95,20.6166666666667,21,-0.383333333333333,48,46,2,3,-1
21700914,203095,ORL,TOR,Evan Fournier,139,30.8666666666667,31,-0.133333333333333,67,85,-18,-17,-1
21700914,203613,ORL,TOR,Jonathon Simmons,128,28.1833333333333,28,0.183333333333334,62,71,-9,-13,4
21700914,203920,ORL,TOR,Khem Birch,4,0.45,1,-0.55,1,3,-2,-1,-1
21700914,203932,ORL,TOR,Aaron Gordon,141,31.15,31,0.149999999999999,67,78,-11,-12,1
21700914,1626173,ORL,TOR,Rashad Vaughn,60,13.5166666666667,14,-0.483333333333334,29,28,1,1,0
21700914,1626209,ORL,TOR,Mario Hezonja,93,19.05,19,0.0500000000000007,43,40,3,4,-1
21700914,1628411,ORL,TOR,Wes Iwundu,85,18.45,19,-0.550000000000001,42,45,-3,1,-4
21700914,101139,TOR,ORL,CJ Miles,69,15.4666666666667,15,0.466666666666665,35,38,-3,-4,1
21700914,200768,TOR,ORL,Kyle Lowry,154,33.45,33,0.450000000000003,84,70,14,15,-1
21700914,201586,TOR,ORL,Serge Ibaka,105,22.9166666666667,23,-0.0833333333333357,60,52,8,6,2
21700914,201942,TOR,ORL,DeMar DeRozan,155,34.2666666666667,34,0.266666666666666,90,79,11,11,0
21700914,202685,TOR,ORL,Jonas Valanciunas,88,19.8666666666667,20,-0.133333333333333,43,45,-2,0,-2
21700914,1626153,TOR,ORL,Delon Wright,56,12.4,13,-0.600000000000001,23,24,-1,1,-2
21700914,1626181,TOR,ORL,Norman Powell,54,10.8666666666667,11,-0.133333333333333,21,23,-2,-3,1
21700914,1627751,TOR,ORL,Jakob Poeltl,131,27.8166666666667,28,-0.183333333333334,74,59,15,13,2
21700914,1627783,TOR,ORL,Pascal Siakam,114,24.7666666666667,25,-0.233333333333334,57,52,5,7,-2
21700914,1627832,TOR,ORL,Fred VanVleet,125,26.4333333333333,27,-0.56666666666667,62,52,10,9,1
21700914,1628384,TOR,ORL,OG Anunoby,44,10.1666666666667,10,0.166666666666668,36,26,10,10,0
21700915,203101,ATL,IND,Miles Plumlee,71,12.8,13,-0.199999999999999,30,25,5,4,1
21700915,203145,ATL,IND,Kent Bazemore,127,25.75,26,-0.25,62,50,12,9,3
21700915,203471,ATL,IND,Dennis Schroder,166,32.0333333333333,32,0.0333333333333314,71,69,2,4,-2
21700915,203473,ATL,IND,Dewayne Dedmon,147,28.6166666666667,29,-0.383333333333333,54,65,-11,-11,0
21700915,203488,ATL,IND,Mike Muscala,114,20.6,20,0.600000000000001,46,36,10,10,0
21700915,1627098,ATL,IND,Malcolm Delaney,65,11.65,12,-0.350000000000001,23,33,-10,-10,0
21700915,1627752,ATL,IND,Taurean Prince,173,34.3333333333333,35,-0.666666666666671,74,68,6,6,0
21700915,1627819,ATL,IND,Isaiah Taylor,87,15.95,16,-0.0500000000000007,36,32,4,1,3
21700915,1628381,ATL,IND,John Collins,140,27.1333333333333,27,0.133333333333333,69,59,10,9,1
21700915,1628416,ATL,IND,Tyler Dorsey,103,19.0833333333333,19,0.0833333333333322,43,40,3,3,0
21700915,1628537,ATL,IND,Jaylen Morris,72,11.9666666666667,12,-0.033333333333335,27,28,-1,0,-1
21700915,201152,IND,ATL,Thaddeus Young,143,26.9833333333333,27,-0.0166666666666657,49,64,-15,-14,-1
21700915,202362,IND,ATL,Lance Stephenson,158,30.05,30,0.0499999999999972,70,60,10,11,-1
21700915,202709,IND,ATL,Cory Joseph,167,30.95,31,-0.0500000000000007,72,67,5,5,0
21700915,202711,IND,ATL,Bojan Bogdanovic,184,35.2833333333333,35,0.283333333333331,76,82,-6,-6,0
21700915,203506,IND,ATL,Victor Oladipo,201,38.0166666666667,38,0.0166666666666657,80,86,-6,-5,-1
21700915,203922,IND,ATL,Glenn Robinson III,67,12.2333333333333,12,0.233333333333334,26,24,2,2,0
21700915,1626167,IND,ATL,Myles Turner,78,15.2,16,-0.800000000000001,28,33,-5,-6,1
21700915,1626202,IND,ATL,Joe Young,86,17.0333333333333,17,0.0333333333333314,29,40,-11,-10,-1
21700915,1627734,IND,ATL,Domantas Sabonis,181,34.1666666666667,34,0.166666666666664,75,79,-4,-2,-2
21700916,201143,BOS,CHA,Al Horford,98,21.4166666666667,21,0.416666666666664,70,44,26,27,-1
21700916,202328,BOS,CHA,Greg Monroe,95,20.2166666666667,21,-0.783333333333331,53,40,13,13,0
21700916,202681,BOS,CHA,Kyrie Irving,115,24.5833333333333,25,-0.416666666666664,77,58,19,18,1
21700916,202694,BOS,CHA,Marcus Morris,102,21.8,22,-0.200000000000003,58,52,6,3,3
21700916,203382,BOS,CHA,Aron Baynes,101,21.5333333333333,22,-0.466666666666669,70,49,21,21,0
21700916,203499,BOS,CHA,Shane Larkin,39,7.93333333333333,8,-0.0666666666666664,15,19,-4,-4,0
21700916,203935,BOS,CHA,Marcus Smart,99,21.0666666666667,21,0.0666666666666664,58,45,13,13,0
21700916,1626179,BOS,CHA,Terry Rozier,114,24.5666666666667,25,-0.433333333333334,61,57,4,2,2
21700916,1627759,BOS,CHA,Jaylen Brown,105,22.5333333333333,23,-0.466666666666669,71,47,24,28,-4
21700916,1627846,BOS,CHA,Abdel Nader,52,10.85,11,-0.149999999999999,29,24,5,5,0
21700916,1628369,BOS,CHA,Jayson Tatum,91,20.5,21,-0.5,65,47,18,18,0
21700916,1628400,BOS,CHA,Semi Ojeleye,94,20,21,-1,43,48,-5,-4,-1
21700916,2730,CHA,BOS,Dwight Howard,124,26.1333333333333,26,0.133333333333333,64,79,-15,-15,0
21700916,101107,CHA,BOS,Marvin Williams,106,22.1333333333333,22,0.133333333333333,46,61,-15,-17,2
21700916,201587,CHA,BOS,Nicolas Batum,138,29.0666666666667,29,0.0666666666666664,68,89,-21,-21,0
21700916,202689,CHA,BOS,Kemba Walker,113,24.4833333333333,25,-0.516666666666666,57,73,-16,-20,4
21700916,202933,CHA,BOS,Julyan Stone,19,3.9,4,-0.1,6,10,-4,-4,0
21700916,203087,CHA,BOS,Jeremy Lamb,118,25.5833333333333,25,0.583333333333332,61,75,-14,-12,-2
21700916,203487,CHA,BOS,Michael Carter-Williams,89,19.0166666666667,19,0.0166666666666657,43,51,-8,-4,-4
21700916,1626163,CHA,BOS,Frank Kaminsky,109,24.6833333333333,25,-0.316666666666666,61,67,-6,-2,-4
21700916,1626195,CHA,BOS,Willy Hernangomez,42,8.78333333333333,9,-0.216666666666667,14,27,-13,-15,2
21700916,1626203,CHA,BOS,Treveon Graham,136,29.2333333333333,30,-0.766666666666666,59,83,-24,-26,2
21700916,1628370,CHA,BOS,Malik Monk,83,18.3333333333333,19,-0.666666666666664,38,45,-7,-7,0
21700916,1628407,CHA,BOS,Dwayne Bacon,28,5.65,6,-0.35,13,10,3,3,0
21700917,2561,GSW,WAS,David West,64,14.6833333333333,15,-0.316666666666666,22,33,-11,-11,0
21700917,2585,GSW,WAS,Zaza Pachulia,26,5.66666666666667,5,0.666666666666666,16,10,6,6,0
21700917,2733,GSW,WAS,Shaun Livingston,75,16.8333333333333,17,-0.166666666666664,30,33,-3,-8,5
21700917,2738,GSW,WAS,Andre Iguodala,141,30.2333333333333,30,0.233333333333334,63,76,-13,-9,-4
21700917,201142,GSW,WAS,Kevin Durant,174,37.2666666666667,37,0.266666666666666,90,73,17,17,0
21700917,201156,GSW,WAS,Nick Young,30,6.05,6,0.0500000000000007,22,7,15,15,0
21700917,201580,GSW,WAS,JaVale McGee,57,13.2666666666667,14,-0.733333333333334,37,18,19,19,0
21700917,201939,GSW,WAS,Stephen Curry,162,34.8,35,-0.200000000000003,90,71,19,20,-1
21700917,202691,GSW,WAS,Klay Thompson,168,37.5166666666667,37,0.516666666666666,76,86,-10,-10,0
21700917,203110,GSW,WAS,Draymond Green,168,37.1833333333333,37,0.183333333333337,89,82,7,7,0
21700917,1628395,GSW,WAS,Jordan Bell,35,6.33333333333333,7,-0.666666666666666,10,16,-6,-6,0
21700917,101133,WAS,GSW,Ian Mahinmi,72,16.1666666666667,16,0.166666666666664,28,33,-5,-5,0
21700917,101162,WAS,GSW,Marcin Gortat,57,13.2666666666667,14,-0.733333333333334,18,37,-19,-19,0
21700917,201975,WAS,GSW,Jodie Meeks,71,16.6666666666667,16,0.666666666666664,34,26,8,10,-2
21700917,202693,WAS,GSW,Markieff Morris,169,36.1833333333333,36,0.183333333333337,80,91,-11,-11,0
21700917,203078,WAS,GSW,Bradley Beal,167,36.1166666666667,37,-0.883333333333333,76,88,-12,-14,2
21700917,203107,WAS,GSW,Tomas Satoransky,158,32.85,33,-0.149999999999999,69,91,-22,-22,0
21700917,203118,WAS,GSW,Mike Scott,51,11.7833333333333,12,-0.216666666666667,21,18,3,3,0
21700917,203490,WAS,GSW,Otto Porter Jr.,148,31.8,32,-0.199999999999999,73,76,-3,-3,0
21700917,204025,WAS,GSW,Tim Frazier,44,10.3,10,0.300000000000001,23,13,10,10,0
21700917,1626162,WAS,GSW,Kelly Oubre Jr.,163,34.7,34,0.700000000000003,83,72,11,11,0
21700918,201162,PHX,MEM,Jared Dudley,50,9.63333333333333,9,0.633333333333333,19,24,-5,-4,-1
21700918,203458,PHX,MEM,Alex Len,125,24.5166666666667,25,-0.483333333333334,54,44,10,18,-8
21700918,203584,PHX,MEM,Troy Daniels,142,28.4333333333333,28,0.433333333333334,73,66,7,9,-2
21700918,203901,PHX,MEM,Elfrid Payton,198,38.6666666666667,39,-0.333333333333336,91,79,12,10,2
21700918,1626164,PHX,MEM,Devin Booker,198,38.4833333333333,39,-0.516666666666666,90,80,10,10,0
21700918,1627733,PHX,MEM,Dragan Bender,174,34.2333333333333,35,-0.766666666666666,76,76,0,-4,4
21700918,1627737,PHX,MEM,Marquese Chriss,29,6.41666666666667,7,-0.583333333333334,11,15,-4,-8,4
21700918,1627885,PHX,MEM,Shaquille Harrison,86,17.8833333333333,18,-0.116666666666667,43,42,1,3,-2
21700918,1628367,PHX,MEM,Josh Jackson,203,40.0666666666667,40,0.0666666666666629,93,84,9,6,3
21700918,201188,MEM,PHX,Marc Gasol,175,34.5166666666667,35,-0.483333333333334,73,83,-10,-10,0
21700918,201596,MEM,PHX,Mario Chalmers,99,18.4833333333333,18,0.483333333333334,49,39,10,16,-6
21700918,203210,MEM,PHX,JaMychal Green,183,35.8,36,-0.200000000000003,80,81,-1,-3,2
21700918,203463,MEM,PHX,Ben McLemore,50,8.86666666666667,9,-0.133333333333333,12,25,-13,-15,2
21700918,1626150,MEM,PHX,Andrew Harrison,184,37.3166666666667,38,-0.683333333333337,73,92,-19,-19,0
21700918,1626185,MEM,PHX,Jarell Martin,179,36.5,37,-0.5,72,87,-15,-11,-4
21700918,1627988,MEM,PHX,Myke Henry,123,24.4833333333333,24,0.483333333333334,57,54,3,-1,4
21700918,1628397,MEM,PHX,Ivan Rabb,60,12.7333333333333,13,-0.266666666666666,27,28,-1,-1,0
21700918,1628415,MEM,PHX,Dillon Brooks,152,29.6333333333333,30,-0.366666666666667,67,61,6,4,2
21700919,1717,DAL,OKC,Dirk Nowitzki,109,23.8166666666667,24,-0.183333333333334,58,48,10,10,0
21700919,200826,DAL,OKC,J.J. Barea,120,25.95,26,-0.0500000000000007,53,57,-4,-4,0
21700919,202083,DAL,OKC,Wesley Matthews,192,42.2666666666667,42,0.266666666666666,86,92,-6,-6,0
21700919,203084,DAL,OKC,Harrison Barnes,177,38.8166666666667,39,-0.183333333333337,79,85,-6,-6,0
21700919,203457,DAL,OKC,Nerlens Noel,72,15.4,16,-0.6,29,32,-3,-5,2
21700919,203926,DAL,OKC,Doug McDermott,85,17.1666666666667,17,0.166666666666664,37,32,5,5,0
21700919,203939,DAL,OKC,Dwight Powell,172,37.6,37,0.599999999999994,81,79,2,4,-2
21700919,1627812,DAL,OKC,Yogi Ferrell,112,24.5666666666667,25,-0.433333333333334,45,49,-4,-2,-2
21700919,1628372,DAL,OKC,Dennis Smith Jr.,181,39.4166666666667,40,-0.583333333333329,82,81,1,-1,2
21700919,2546,OKC,DAL,Carmelo Anthony,166,36.5833333333333,37,-0.416666666666664,80,80,0,-2,2
21700919,101109,OKC,DAL,Raymond Felton,107,22.9833333333333,23,-0.0166666666666657,42,47,-5,-7,2
21700919,201566,OKC,DAL,Russell Westbrook,192,41.6,42,-0.399999999999999,93,84,9,8,1
21700919,202331,OKC,DAL,Paul George,192,42.2666666666667,42,0.266666666666666,92,86,6,6,0
21700919,202335,OKC,DAL,Patrick Patterson,74,15.5166666666667,16,-0.483333333333334,28,28,0,0,0
21700919,203500,OKC,DAL,Steven Adams,175,38.2666666666667,38,0.266666666666666,86,80,6,4,2
21700919,203518,OKC,DAL,Alex Abrines,95,19.7166666666667,20,-0.283333333333331,38,42,-4,-2,-2
21700919,203924,OKC,DAL,Jerami Grant,73,15.6333333333333,15,0.633333333333333,28,32,-4,0,-4
21700919,203962,OKC,DAL,Josh Huestis,100,21.7666666666667,22,-0.233333333333334,44,50,-6,-5,-1
21700919,1628390,OKC,DAL,Terrance Ferguson,46,10.6666666666667,10,0.666666666666668,24,21,3,3,0
21700920,2731,NOP,SAS,Emeka Okafor,18,3.96666666666667,4,-0.0333333333333332,7,9,-2,-3,1
21700920,200765,NOP,SAS,Rajon Rondo,161,32.55,32,0.549999999999997,81,82,-1,0,-1
21700920,201950,NOP,SAS,Jrue Holiday,179,36.1833333333333,36,0.183333333333337,91,86,5,4,1
21700920,202703,NOP,SAS,Nikola Mirotic,107,20.15,20,0.149999999999999,45,55,-10,-9,-1
21700920,202734,NOP,SAS,E'Twaun Moore,191,37.9833333333333,38,-0.0166666666666657,103,91,12,12,0
21700920,203076,NOP,SAS,Anthony Davis,185,37.1,37,0.100000000000001,92,87,5,5,0
21700920,203121,NOP,SAS,Darius Miller,154,32.8166666666667,33,-0.183333333333337,87,75,12,12,0
21700920,203546,NOP,SAS,Ian Clark,107,21.9166666666667,22,-0.0833333333333322,62,51,11,11,0
21700920,1627215,NOP,SAS,Walter Lemon Jr.,27,5.35,5,0.35,8,13,-5,-5,0
21700920,1627767,NOP,SAS,Cheick Diallo,56,11.9833333333333,12,-0.0166666666666657,29,31,-2,-2,0
21700920,1938,SAS,NOP,Manu Ginobili,97,19.7833333333333,20,-0.216666666666669,43,58,-15,-15,0
21700920,2225,SAS,NOP,Tony Parker,81,17.1333333333333,17,0.133333333333333,42,52,-10,-10,0
21700920,200746,SAS,NOP,LaMarcus Aldridge,64,13.2,13,0.199999999999999,34,26,8,8,0
21700920,200752,SAS,NOP,Rudy Gay,117,23.8833333333333,24,-0.116666666666667,58,54,4,4,0
21700920,201980,SAS,NOP,Danny Green,137,26.9666666666667,27,-0.0333333333333314,67,67,0,-1,1
21700920,201988,SAS,NOP,Patty Mills,179,36.5166666666667,37,-0.483333333333334,89,89,0,0,0
21700920,202722,SAS,NOP,Davis Bertans,85,16.8666666666667,17,-0.133333333333333,42,44,-2,-2,0
21700920,203530,SAS,NOP,Joffrey Lauvergne,98,19.1666666666667,19,0.166666666666664,45,58,-13,-13,0
21700920,203937,SAS,NOP,Kyle Anderson,139,28.1,28,0.100000000000001,66,74,-8,-7,-1
21700920,1627749,SAS,NOP,Dejounte Murray,152,30.5333333333333,31,-0.466666666666669,74,67,7,7,0
21700920,1627854,SAS,NOP,Bryn Forbes,36,7.85,8,-0.15,20,16,4,4,0
21700921,2207,HOU,LAC,Joe Johnson,111,24.1166666666667,24,0.116666666666667,57,52,5,7,-2
21700921,2403,HOU,LAC,Nene,42,9.51666666666667,9,0.516666666666666,22,15,7,7,0
21700921,2772,HOU,LAC,Trevor Ariza,145,32.8166666666667,33,-0.183333333333337,69,58,11,11,0
21700921,101108,HOU,LAC,Chris Paul,130,28.6333333333333,29,-0.366666666666667,70,50,20,21,-1
21700921,101123,HOU,LAC,Gerald Green,11,2.25,3,-0.75,2,7,-5,-5,0
21700921,200782,HOU,LAC,PJ Tucker,110,23.95,24,-0.0500000000000007,52,46,6,5,1
21700921,201569,HOU,LAC,Eric Gordon,129,27.9166666666667,28,-0.0833333333333357,57,54,3,1,2
21700921,201601,HOU,LAC,Luc Mbah a Moute,96,20.2833333333333,21,-0.716666666666669,45,53,-8,-8,0
21700921,201935,HOU,LAC,James Harden,147,33.2166666666667,33,0.216666666666669,76,58,18,17,1
21700921,203991,HOU,LAC,Clint Capela,148,33.1333333333333,33,0.133333333333333,73,60,13,14,-1
21700921,204028,HOU,LAC,Tarik Black,11,2.25,3,-0.75,2,7,-5,-5,0
21700921,101150,LAC,HOU,Lou Williams,159,34.8833333333333,35,-0.116666666666667,67,77,-10,-4,-6
21700921,201599,LAC,HOU,DeAndre Jordan,131,29.4333333333333,30,-0.566666666666666,45,65,-20,-18,-2
21700921,202325,LAC,HOU,Wesley Johnson,28,5.38333333333333,6,-0.616666666666667,5,21,-16,-16,0
21700921,202699,LAC,HOU,Tobias Harris,160,35.5833333333333,36,-0.416666666666664,66,83,-17,-16,-1
21700921,203085,LAC,HOU,Austin Rivers,143,32.8666666666667,33,-0.133333333333333,62,60,2,-3,5
21700921,203710,LAC,HOU,C.J. Williams,92,21.1,21,0.100000000000001,37,44,-7,-6,-1
21700921,1626149,LAC,HOU,Montrezl Harrell,131,28.2666666666667,29,-0.733333333333334,59,61,-2,-3,1
21700921,1626155,LAC,HOU,Sam Dekker,22,5.05,5,0.0500000000000007,11,6,5,5,0
21700921,1626246,LAC,HOU,Boban Marjanovic,16,3.35,3,0.35,9,10,-1,-1,0
21700921,1628414,LAC,HOU,Sindarius Thornwell,65,14.1333333333333,14,0.133333333333333,39,27,12,10,2
21700921,1628462,LAC,HOU,Milos Teodosic,133,28.0333333333333,28,0.0333333333333314,60,71,-11,-13,2
21700922,201572,LAL,MIA,Brook Lopez,100,21.75,22,-0.25,60,60,0,0,0
21700922,202738,LAL,MIA,Isaiah Thomas,136,29.0833333333333,30,-0.916666666666664,80,69,11,13,-2
21700922,203484,LAL,MIA,Kentavious Caldwell-Pope,167,35.9666666666667,36,-0.0333333333333314,99,91,8,10,-2
21700922,203898,LAL,MIA,Tyler Ennis,6,1.61666666666667,1,0.616666666666667,3,2,1,1,0
21700922,203944,LAL,MIA,Julius Randle,151,33.65,34,-0.350000000000001,89,75,14,15,-1
21700922,1627742,LAL,MIA,Brandon Ingram,163,35.2833333333333,35,0.283333333333331,91,99,-8,-10,2
21700922,1627780,LAL,MIA,Gary Payton II,6,1.61666666666667,1,0.616666666666667,3,2,1,1,0
21700922,1627826,LAL,MIA,Ivica Zubac,85,17.3166666666667,18,-0.683333333333334,58,38,20,19,1
21700922,1628366,LAL,MIA,Lonzo Ball,153,33.7666666666667,34,-0.233333333333334,91,65,26,24,2
21700922,1628398,LAL,MIA,Kyle Kuzma,132,28,28,0,78,62,16,16,0
21700922,1628418,LAL,MIA,Thomas Bryant,6,1.61666666666667,1,0.616666666666667,3,2,1,1,0
21700922,2548,MIA,LAL,Dwyane Wade,120,25.5,26,-0.5,59,76,-17,-18,1
21700922,201609,MIA,LAL,Goran Dragic,158,34.4833333333333,35,-0.516666666666666,90,88,2,2,0
21700922,201949,MIA,LAL,James Johnson,118,24.7666666666667,25,-0.233333333333334,67,70,-3,-6,3
21700922,202337,MIA,LAL,Luke Babbitt,6,1.61666666666667,1,0.616666666666667,2,3,-1,-1,0
21700922,202355,MIA,LAL,Hassan Whiteside,88,18.5333333333333,19,-0.466666666666669,41,59,-18,-19,1
21700922,203482,MIA,LAL,Kelly Olynyk,62,12.4333333333333,13,-0.566666666666666,23,47,-24,-19,-5
21700922,203585,MIA,LAL,Rodney McGruder,119,24.5,25,-0.5,63,67,-4,-4,0
21700922,1626159,MIA,LAL,Justise Winslow,138,30.6333333333333,31,-0.366666666666667,73,74,-1,1,-2
21700922,1626175,MIA,LAL,Jordan Mickey,6,1.61666666666667,1,0.616666666666667,2,3,-1,-1,0
21700922,1626196,MIA,LAL,Josh Richardson,157,35.2833333333333,36,-0.716666666666669,69,99,-30,-30,0
21700922,1628389,MIA,LAL,Bam Adebayo,133,30.3,30,0.299999999999997,76,69,7,5,2
21700923,2544,CLE,PHI,LeBron James,184,39.15,39,0.150000000000006,84,96,-12,-8,-4
21700923,2594,CLE,PHI,Kyle Korver,132,28.2166666666667,28,0.216666666666669,58,57,1,-1,2
21700923,201145,CLE,PHI,Jeff Green,98,22.35,22,0.350000000000001,37,30,7,1,6
21700923,201588,CLE,PHI,George Hill,105,22.15,22,0.149999999999999,47,56,-9,-7,-2
21700923,202684,CLE,PHI,Tristan Thompson,101,21.35,22,-0.649999999999999,42,56,-14,-12,-2
21700923,203903,CLE,PHI,Jordan Clarkson,124,26.45,26,0.449999999999999,55,52,3,1,2
21700923,203918,CLE,PHI,Rodney Hood,186,38.6833333333333,39,-0.316666666666663,73,95,-22,-20,-2
21700923,1626204,CLE,PHI,Larry Nance Jr.,125,26.6166666666667,26,0.616666666666667,55,52,3,1,2
21700923,1626224,CLE,PHI,Cedi Osman,74,14.7,15,-0.299999999999999,34,46,-12,-10,-2
21700923,1628506,CLE,PHI,London Perrantes,1,0.166666666666667,0,0.166666666666667,0,,,0,
21700923,101141,PHI,CLE,Ersan Ilyasova,84,18.55,18,0.550000000000001,27,36,-9,-7,-2
21700923,101161,PHI,CLE,Amir Johnson,65,14.2833333333333,14,0.283333333333333,26,30,-4,-5,1
21700923,200755,PHI,CLE,JJ Redick,135,28.7166666666667,29,-0.283333333333331,74,59,15,17,-2
21700923,201158,PHI,CLE,Marco Belinelli,111,23.2666666666667,23,0.266666666666666,39,41,-2,-4,2
21700923,203496,PHI,CLE,Robert Covington,191,41.5166666666667,41,0.516666666666666,91,84,7,9,-2
21700923,203954,PHI,CLE,Joel Embiid,160,33.5166666666667,34,-0.483333333333334,82,67,15,16,-1
21700923,203967,PHI,CLE,Dario Saric,141,29.25,30,-0.75,81,61,20,18,2
21700923,204456,PHI,CLE,T.J. McConnell,92,19.1166666666667,19,0.116666666666667,36,38,-2,0,-2
21700923,1627732,PHI,CLE,Ben Simmons,151,31.6166666666667,32,-0.383333333333333,84,69,15,11,4
21700924,201960,BKN,SAC,DeMarre Carroll,157,33.3833333333333,34,-0.616666666666667,87,71,16,14,2
21700924,201967,BKN,SAC,Dante Cunningham,103,20.95,21,-0.0500000000000007,32,44,-12,-12,0
21700924,203459,BKN,SAC,Allen Crabbe,162,35.25,35,0.25,84,82,2,5,-3
21700924,203915,BKN,SAC,Spencer Dinwiddie,170,36.5166666666667,36,0.516666666666666,91,76,15,13,2
21700924,203925,BKN,SAC,Joe Harris,117,24.7166666666667,25,-0.283333333333335,40,56,-16,-15,-1
21700924,1626156,BKN,SAC,D'Angelo Russell,177,37.7333333333333,38,-0.266666666666666,78,83,-5,-1,-4
21700924,1626178,BKN,SAC,Rondae Hollis-Jefferson,107,21.6666666666667,21,0.666666666666668,37,46,-9,-10,1
21700924,1627747,BKN,SAC,Caris LeVert,99,20.0333333333333,20,0.0333333333333314,27,42,-15,-18,3
21700924,1628386,BKN,SAC,Jarrett Allen,158,34.3333333333333,34,0.333333333333329,79,80,-1,-1,0
21700924,201585,SAC,BKN,Kosta Koufos,96,20.0166666666667,20,0.0166666666666657,46,29,17,17,0
21700924,202066,SAC,BKN,Garrett Temple,133,28.4166666666667,29,-0.583333333333336,61,45,16,14,2
21700924,203992,SAC,BKN,Bogdan Bogdanovic,172,37.55,38,-0.450000000000003,84,87,-3,-5,2
21700924,1626161,SAC,BKN,Willie Cauley-Stein,162,34.6166666666667,35,-0.383333333333333,72,84,-12,-12,0
21700924,1627741,SAC,BKN,Buddy Hield,162,34.2,34,0.200000000000003,79,64,15,17,-2
21700924,1627746,SAC,BKN,Skal Labissiere,145,30.3666666666667,30,0.366666666666667,69,75,-6,-6,0
21700924,1628368,SAC,BKN,De'Aaron Fox,171,35.8166666666667,36,-0.183333333333337,84,80,4,5,-1
21700924,1628382,SAC,BKN,Justin Jackson,117,23.8833333333333,24,-0.116666666666667,49,50,-1,-1,0
21700924,1628412,SAC,BKN,Frank Mason,92,19.7166666666667,19,0.716666666666669,36,41,-5,-4,-1
21700925,2037,MIN,POR,Jamal Crawford,119,24.6166666666667,25,-0.383333333333333,52,57,-5,-5,0
21700925,201952,MIN,POR,Jeff Teague,180,36.1166666666667,36,0.116666666666667,77,83,-6,-8,2
21700925,201959,MIN,POR,Taj Gibson,146,29.55,29,0.550000000000001,62,59,3,5,-2
21700925,202357,MIN,POR,Nemanja Bjelica,172,34.25,34,0.25,75,79,-4,-6,2
21700925,203476,MIN,POR,Gorgui Dieng,105,23.65,24,-0.350000000000001,41,55,-14,-14,0
21700925,203952,MIN,POR,Andrew Wiggins,178,37.5,38,-0.5,76,84,-8,-9,1
21700925,1626145,MIN,POR,Tyus Jones,57,12.4166666666667,13,-0.583333333333334,27,30,-3,0,-3
21700925,1626157,MIN,POR,Karl-Anthony Towns,198,40.9833333333333,41,-0.0166666666666657,85,93,-8,-6,-2
21700925,202323,POR,MIN,Evan Turner,106,21.3,22,-0.699999999999999,52,55,-3,-7,4
21700925,202329,POR,MIN,Al-Farouq Aminu,146,28.75,29,-0.25,68,61,7,5,2
21700925,202334,POR,MIN,Ed Davis,125,27.8166666666667,28,-0.183333333333334,60,53,7,8,-1
21700925,203081,POR,MIN,Damian Lillard,187,37.9666666666667,38,-0.0333333333333314,86,79,7,9,-2
21700925,203090,POR,MIN,Maurice Harkless,38,7.7,8,-0.3,13,14,-1,-1,0
21700925,203468,POR,MIN,CJ McCollum,181,37.45,38,-0.549999999999997,87,83,4,6,-2
21700925,203894,POR,MIN,Shabazz Napier,129,26.9,27,-0.100000000000001,71,50,21,21,0
21700925,203994,POR,MIN,Jusuf Nurkic,96,19.0833333333333,19,0.0833333333333322,39,38,1,0,1
21700925,1626192,POR,MIN,Pat Connaughton,65,13.4666666666667,13,0.466666666666665,24,26,-2,0,-2
21700925,1628380,POR,MIN,Zach Collins,82,18.65,19,-0.350000000000001,40,36,4,4,0
21700926,201571,ORL,DET,D.J. Augustin,187,41.2333333333333,41,0.233333333333334,94,81,13,11,2
21700926,202687,ORL,DET,Bismack Biyombo,58,14.5166666666667,15,-0.483333333333334,28,31,-3,-3,0
21700926,202696,ORL,DET,Nikola Vucevic,176,38.4833333333333,38,0.483333333333334,87,75,12,12,0
21700926,202714,ORL,DET,Shelvin Mack,95,23.15,23,0.149999999999999,40,39,1,2,-1
21700926,203095,ORL,DET,Evan Fournier,162,36.1666666666667,36,0.166666666666664,78,66,12,12,0
21700926,203613,ORL,DET,Jonathon Simmons,138,30.25,30,0.25,70,77,-7,-9,2
21700926,203932,ORL,DET,Aaron Gordon,161,35.4,36,-0.600000000000001,82,67,15,15,0
21700926,1626209,ORL,DET,Mario Hezonja,98,23.1166666666667,23,0.116666666666667,51,47,4,7,-3
21700926,1628371,ORL,DET,Jonathan Isaac,66,15.2166666666667,15,0.216666666666665,31,32,-1,-1,0
21700926,1628411,ORL,DET,Wes Iwundu,29,7.46666666666667,7,0.466666666666667,14,15,-1,-1,0
21700926,201229,DET,ORL,Anthony Tolliver,85,20.7166666666667,21,-0.283333333333331,40,40,0,0,0
21700926,201933,DET,ORL,Blake Griffin,156,33.95,34,-0.0499999999999972,68,77,-9,-9,0
21700926,202397,DET,ORL,Ish Smith,142,31.3833333333333,32,-0.616666666666667,63,71,-8,-7,-1
21700926,202779,DET,ORL,Dwight Buycks,88,21.1666666666667,21,0.166666666666664,43,41,2,1,1
21700926,203083,DET,ORL,Andre Drummond,180,38.7,38,0.700000000000003,77,90,-13,-13,0
21700926,203493,DET,ORL,Reggie Bullock,183,40.5833333333333,41,-0.416666666666664,80,91,-11,-11,0
21700926,203516,DET,ORL,James Ennis III,149,32.7,33,-0.299999999999997,65,74,-9,-4,-5
21700926,203961,DET,ORL,Eric Moreland,49,12.8,13,-0.199999999999999,27,25,2,2,0
21700926,204038,DET,ORL,Langston Galloway,51,12.4166666666667,12,0.416666666666666,26,24,2,2,0
21700926,1626169,DET,ORL,Stanley Johnson,87,20.5833333333333,21,-0.416666666666668,41,42,-1,-6,5
21700927,101141,PHI,CHA,Ersan Ilyasova,105,22.8666666666667,23,-0.133333333333333,52,45,7,7,0
21700927,200755,PHI,CHA,JJ Redick,148,31.7333333333333,32,-0.266666666666669,78,58,20,19,1
21700927,201158,PHI,CHA,Marco Belinelli,70,18.0333333333333,18,0.0333333333333314,37,47,-10,-9,-1
21700927,203496,PHI,CHA,Robert Covington,158,34.6833333333333,35,-0.316666666666663,91,72,19,19,0
21700927,203954,PHI,CHA,Joel Embiid,140,31.7333333333333,32,-0.266666666666666,73,53,20,19,1
21700927,203967,PHI,CHA,Dario Saric,121,28.4833333333333,28,0.483333333333334,68,62,6,7,-1
21700927,204456,PHI,CHA,T.J. McConnell,88,20.8333333333333,21,-0.166666666666668,38,37,1,1,0
21700927,1626158,PHI,CHA,Richaun Holmes,51,11.7666666666667,12,-0.233333333333334,22,36,-14,-14,0
21700927,1627732,PHI,CHA,Ben Simmons,150,33.8833333333333,34,-0.116666666666667,87,77,10,10,0
21700927,1627789,PHI,CHA,Timothe Luwawu-Cabarrot,24,4.98333333333333,5,-0.0166666666666675,4,8,-4,-4,0
21700927,2730,CHA,PHI,Dwight Howard,110,24.8833333333333,25,-0.116666666666667,57,60,-3,-5,2
21700927,101107,CHA,PHI,Marvin Williams,113,25.1,25,0.100000000000001,54,62,-8,-9,1
21700927,201587,CHA,PHI,Nicolas Batum,161,35.9666666666667,36,-0.0333333333333314,71,83,-12,-12,0
21700927,202689,CHA,PHI,Kemba Walker,167,37.9333333333333,38,-0.0666666666666629,85,97,-12,-12,0
21700927,203077,CHA,PHI,Michael Kidd-Gilchrist,135,31.4166666666667,31,0.416666666666664,71,78,-7,-7,0
21700927,203087,CHA,PHI,Jeremy Lamb,89,19.35,20,-0.649999999999999,36,44,-8,-8,0
21700927,203487,CHA,PHI,Michael Carter-Williams,57,13.0333333333333,14,-0.966666666666667,20,21,-1,-1,0
21700927,1626163,CHA,PHI,Frank Kaminsky,115,26.4833333333333,27,-0.516666666666666,51,58,-7,-6,-1
21700927,1626195,CHA,PHI,Willy Hernangomez,74,16.55,16,0.550000000000001,30,35,-5,-4,-1
21700927,1626203,CHA,PHI,Treveon Graham,34,8.28333333333333,8,0.283333333333333,20,12,8,9,-1
21700928,203101,ATL,GSW,Miles Plumlee,38,8.68333333333333,9,-0.316666666666666,17,23,-6,-9,3
21700928,203145,ATL,GSW,Kent Bazemore,154,32.05,32,0.0499999999999972,77,72,5,4,1
21700928,203471,ATL,GSW,Dennis Schroder,176,36.5333333333333,37,-0.466666666666669,92,84,8,5,3
21700928,203473,ATL,GSW,Dewayne Dedmon,148,32.0666666666667,32,0.0666666666666629,77,71,6,8,-2
21700928,203488,ATL,GSW,Mike Muscala,97,21.1,21,0.100000000000001,37,54,-17,-17,0
21700928,1627098,ATL,GSW,Malcolm Delaney,71,15.2166666666667,15,0.216666666666667,30,38,-8,-9,1
21700928,1627752,ATL,GSW,Taurean Prince,150,30.5333333333333,31,-0.466666666666669,78,73,5,9,-4
21700928,1627819,ATL,GSW,Isaiah Taylor,50,11.8166666666667,12,-0.183333333333334,17,27,-10,-12,2
21700928,1628381,ATL,GSW,John Collins,155,31.8333333333333,32,-0.166666666666664,84,72,12,12,0
21700928,1628416,ATL,GSW,Tyler Dorsey,33,7.7,8,-0.300000000000001,13,21,-8,-2,-6
21700928,1628537,ATL,GSW,Jaylen Morris,53,12.3833333333333,12,0.383333333333333,23,35,-12,-14,2
21700928,2561,GSW,ATL,David West,63,14.7,15,-0.300000000000001,32,24,8,9,-1
21700928,2585,GSW,ATL,Zaza Pachulia,40,9.13333333333333,9,0.133333333333333,21,28,-7,-6,-1
21700928,2738,GSW,ATL,Andre Iguodala,123,26.1166666666667,26,0.116666666666667,61,59,2,1,1
21700928,201142,GSW,ATL,Kevin Durant,172,34.8833333333333,35,-0.116666666666667,85,88,-3,-5,2
21700928,201156,GSW,ATL,Nick Young,105,23.3666666666667,23,0.366666666666667,54,52,2,7,-5
21700928,201580,GSW,ATL,JaVale McGee,48,10.2,10,0.199999999999999,28,23,5,3,2
21700928,201939,GSW,ATL,Stephen Curry,109,23.0833333333333,23,0.0833333333333357,57,55,2,2,0
21700928,201956,GSW,ATL,Omri Casspi,24,5.55,6,-0.45,7,11,-4,-3,-1
21700928,202691,GSW,ATL,Klay Thompson,165,35.3333333333333,36,-0.666666666666664,84,79,5,-2,7
21700928,203110,GSW,ATL,Draymond Green,174,37.2666666666667,37,0.266666666666666,89,80,9,10,-1
21700928,1626188,GSW,ATL,Quinn Cook,61,12.9166666666667,13,-0.0833333333333339,33,29,4,4,0
21700928,1628395,GSW,ATL,Jordan Bell,41,7.36666666666667,8,-0.633333333333334,19,17,2,5,-3
21700929,101139,TOR,WAS,CJ Miles,94,20.3833333333333,20,0.383333333333333,50,33,17,18,-1
21700929,200768,TOR,WAS,Kyle Lowry,141,32.8,33,-0.200000000000003,66,69,-3,-2,-1
21700929,201586,TOR,WAS,Serge Ibaka,76,19.0166666666667,19,0.0166666666666657,31,44,-13,-13,0
21700929,201942,TOR,WAS,DeMar DeRozan,151,33.7333333333333,34,-0.266666666666666,72,72,0,-2,2
21700929,202685,TOR,WAS,Jonas Valanciunas,75,18.8166666666667,19,-0.183333333333334,36,44,-8,-11,3
21700929,203512,TOR,WAS,Lucas Nogueira,37,6.95,7,-0.0499999999999998,22,10,12,14,-2
21700929,1626153,TOR,WAS,Delon Wright,43,9.58333333333333,10,-0.416666666666666,21,17,4,4,0
21700929,1626181,TOR,WAS,Norman Powell,66,16.8166666666667,17,-0.183333333333334,25,41,-16,-16,0
21700929,1626259,TOR,WAS,Malcolm Miller,31,6.66666666666667,7,-0.333333333333333,17,11,6,6,0
21700929,1627751,TOR,WAS,Jakob Poeltl,100,22.1333333333333,22,0.133333333333333,44,41,3,4,-1
21700929,1627783,TOR,WAS,Pascal Siakam,110,23.7166666666667,24,-0.283333333333331,55,42,13,13,0
21700929,1627832,TOR,WAS,Fred VanVleet,136,28.8833333333333,29,-0.116666666666667,71,51,20,20,0
21700929,101133,WAS,TOR,Ian Mahinmi,61,13.65,14,-0.350000000000001,21,27,-6,-8,2
21700929,101162,WAS,TOR,Marcin Gortat,103,24.45,24,0.449999999999999,57,46,11,11,0
21700929,201160,WAS,TOR,Jason Smith,16,3.1,3,0.1,4,9,-5,-7,2
21700929,201975,WAS,TOR,Jodie Meeks,28,5.43333333333333,5,0.433333333333334,8,19,-11,-11,0
21700929,202693,WAS,TOR,Markieff Morris,136,31.3166666666667,31,0.316666666666666,69,65,4,7,-3
21700929,203078,WAS,TOR,Bradley Beal,172,39.1666666666667,39,0.166666666666671,83,77,6,6,0
21700929,203107,WAS,TOR,Tomas Satoransky,152,34.65,35,-0.350000000000001,74,75,-1,-2,1
21700929,203118,WAS,TOR,Mike Scott,54,13,13,0,21,28,-7,-8,1
21700929,203490,WAS,TOR,Otto Porter Jr.,177,39.8833333333333,40,-0.116666666666667,82,83,-1,1,-2
21700929,204025,WAS,TOR,Tim Frazier,60,13.25,13,0.25,21,27,-6,-5,-1
21700929,1626162,WAS,TOR,Kelly Oubre Jr.,101,21.6,22,-0.399999999999999,35,54,-19,-19,0
21700930,203897,CHI,DAL,Zach LaVine,156,34.2,34,0.200000000000003,75,72,3,3,0
21700930,203943,CHI,DAL,Noah Vonleh,19,2.93333333333333,3,-0.0666666666666664,9,9,0,0,0
21700930,1626166,CHI,DAL,Cameron Payne,63,13.4333333333333,14,-0.566666666666666,26,29,-3,-1,-2
21700930,1626170,CHI,DAL,Jerian Grant,35,6.41666666666667,6,0.416666666666666,13,16,-3,-3,0
21700930,1626171,CHI,DAL,Bobby Portis,167,33.8833333333333,34,-0.11666666666666,85,64,21,21,0
21700930,1626245,CHI,DAL,Cristiano Felicio,111,24.4333333333333,25,-0.566666666666666,40,59,-19,-17,-2
21700930,1627739,CHI,DAL,Kris Dunn,164,34.3,34,0.299999999999997,82,71,11,9,2
21700930,1627756,CHI,DAL,Denzel Valentine,112,21.9333333333333,22,-0.0666666666666664,51,44,7,6,1
21700930,1628021,CHI,DAL,David Nwaba,151,32.9166666666667,33,-0.0833333333333286,77,68,9,10,-1
21700930,1628374,CHI,DAL,Lauri Markkanen,157,34.2166666666667,34,0.216666666666669,82,68,14,12,2
21700930,1717,DAL,CHI,Dirk Nowitzki,121,26.7666666666667,27,-0.233333333333334,66,59,7,9,-2
21700930,200826,DAL,CHI,J.J. Barea,95,19.75,20,-0.25,34,46,-12,-14,2
21700930,202083,DAL,CHI,Wesley Matthews,146,30.9666666666667,31,-0.0333333333333314,68,67,1,1,0
21700930,203084,DAL,CHI,Harrison Barnes,159,33.75,34,-0.25,72,73,-1,-1,0
21700930,203457,DAL,CHI,Nerlens Noel,75,15.1333333333333,15,0.133333333333333,31,37,-6,-8,2
21700930,203926,DAL,CHI,Doug McDermott,121,23.7666666666667,24,-0.233333333333334,44,62,-18,-18,0
21700930,203939,DAL,CHI,Dwight Powell,120,25.1333333333333,26,-0.866666666666667,48,52,-4,-6,2
21700930,1627812,DAL,CHI,Yogi Ferrell,117,24.4833333333333,25,-0.516666666666666,48,58,-10,-12,2
21700930,1628372,DAL,CHI,Dennis Smith Jr.,158,33.9333333333333,34,-0.0666666666666629,72,75,-3,-1,-2
21700930,1628467,DAL,CHI,Maxi Kleber,23,4.98333333333333,5,-0.0166666666666666,17,11,6,10,-4
21700931,2734,DEN,MEM,Devin Harris,89,17.6833333333333,18,-0.316666666666666,44,44,0,-2,2
21700931,200794,DEN,MEM,Paul Millsap,128,27.2833333333333,27,0.283333333333331,53,51,2,4,-2
21700931,201163,DEN,MEM,Wilson Chandler,143,31.0333333333333,31,0.0333333333333314,70,71,-1,-1,0
21700931,201589,DEN,MEM,Darrell Arthur,1,0.116666666666667,0,0.116666666666667,,0,,0,
21700931,203115,DEN,MEM,Will Barton,164,32.9333333333333,33,-0.0666666666666629,75,72,3,3,0
21700931,203486,DEN,MEM,Mason Plumlee,105,21.1166666666667,21,0.116666666666667,57,51,6,4,2
21700931,203914,DEN,MEM,Gary Harris,170,34.7666666666667,35,-0.233333333333334,77,69,8,10,-2
21700931,203999,DEN,MEM,Nikola Jokic,156,32.7333333333333,33,-0.266666666666666,69,65,4,6,-2
21700931,1626168,DEN,MEM,Trey Lyles,72,14.5166666666667,15,-0.483333333333334,37,37,0,-2,2
21700931,1627750,DEN,MEM,Jamal Murray,127,27.2333333333333,28,-0.766666666666666,58,50,8,8,0
21700931,201188,MEM,DEN,Marc Gasol,170,36.2166666666667,36,0.216666666666669,79,73,6,6,0
21700931,201596,MEM,DEN,Mario Chalmers,158,33.8,34,-0.200000000000003,73,62,11,11,0
21700931,203463,MEM,DEN,Ben McLemore,144,29.6333333333333,30,-0.366666666666667,61,67,-6,-5,-1
21700931,1626185,MEM,DEN,Jarell Martin,129,27.6166666666667,28,-0.383333333333333,59,58,1,-1,2
21700931,1627744,MEM,DEN,Brice Johnson,61,11.6666666666667,12,-0.333333333333334,23,35,-12,-12,0
21700931,1627782,MEM,DEN,Wayne Selden,53,10.4166666666667,10,0.416666666666668,24,22,2,2,0
21700931,1627988,MEM,DEN,Myke Henry,103,21.7166666666667,22,-0.283333333333335,48,52,-4,-1,-3
21700931,1628397,MEM,DEN,Ivan Rabb,106,21.1333333333333,21,0.133333333333333,46,53,-7,-7,0
21700931,1628415,MEM,DEN,Dillon Brooks,158,33.1333333333333,33,0.133333333333333,68,72,-4,-6,2
21700931,1628424,MEM,DEN,Kobi Simmons,73,14.0833333333333,14,0.0833333333333322,29,46,-17,-17,0
21700932,1891,MIL,IND,Jason Terry,173,36.5166666666667,36,0.516666666666666,74,70,4,4,0
21700932,202339,MIL,IND,Eric Bledsoe,160,34.2666666666667,35,-0.733333333333334,74,68,6,8,-2
21700932,203089,MIL,IND,John Henson,144,31.0333333333333,31,0.0333333333333314,62,58,4,7,-3
21700932,203092,MIL,IND,Tyler Zeller,64,12.4166666666667,12,0.416666666666666,25,32,-7,-8,1
21700932,203114,MIL,IND,Khris Middleton,192,40.7833333333333,40,0.783333333333331,84,84,0,0,0
21700932,203507,MIL,IND,Giannis Antetokounmpo,203,43.3333333333333,43,0.333333333333329,87,96,-9,-10,1
21700932,203953,MIL,IND,Jabari Parker,120,24.7666666666667,25,-0.233333333333334,46,63,-17,-16,-1
21700932,1627748,MIL,IND,Thon Maker,20,4.48333333333333,5,-0.516666666666667,9,13,-4,-6,2
21700932,1628425,MIL,IND,Sterling Brown,64,12.0666666666667,12,0.0666666666666664,19,31,-12,-14,2
21700932,201152,IND,MIL,Thaddeus Young,178,37.4,37,0.399999999999999,80,75,5,5,0
21700932,202362,IND,MIL,Lance Stephenson,119,25.65,26,-0.350000000000001,57,54,3,6,-3
21700932,202709,IND,MIL,Cory Joseph,192,41.4833333333333,41,0.483333333333334,89,83,6,5,1
21700932,202711,IND,MIL,Bojan Bogdanovic,140,29.1666666666667,29,0.166666666666664,61,54,7,6,1
21700932,203506,IND,MIL,Victor Oladipo,171,35.85,36,-0.149999999999999,70,71,-1,-2,1
21700932,203922,IND,MIL,Glenn Robinson III,52,10.9666666666667,11,-0.033333333333335,31,25,6,6,0
21700932,1626167,IND,MIL,Myles Turner,145,30.3166666666667,30,0.316666666666666,59,61,-2,2,-4
21700932,1626202,IND,MIL,Joe Young,27,5,5,0,12,10,2,2,0
21700932,1627734,IND,MIL,Domantas Sabonis,93,19.55,20,-0.450000000000003,44,38,6,2,4
21700932,1628388,IND,MIL,TJ Leaf,23,4.28333333333333,4,0.283333333333333,12,9,3,3,0
21700933,201162,PHX,OKC,Jared Dudley,39,8.18333333333333,8,0.183333333333334,15,18,-3,-3,0
21700933,203458,PHX,OKC,Alex Len,121,22.4333333333333,22,0.43333333333333,60,59,1,-1,2
21700933,203584,PHX,OKC,Troy Daniels,68,14.1666666666667,14,0.166666666666666,25,30,-5,-7,2
21700933,203901,PHX,OKC,Elfrid Payton,200,38.8,39,-0.200000000000003,97,104,-7,-7,0
21700933,203933,PHX,OKC,T.J. Warren,213,41.7166666666667,42,-0.283333333333331,98,111,-13,-13,0
21700933,1626164,PHX,OKC,Devin Booker,193,38.55,39,-0.450000000000003,93,94,-1,1,-2
21700933,1627733,PHX,OKC,Dragan Bender,194,36.7,37,-0.299999999999997,99,96,3,3,0
21700933,1627737,PHX,OKC,Marquese Chriss,63,13.2666666666667,13,0.266666666666666,38,37,1,3,-2
21700933,1627885,PHX,OKC,Shaquille Harrison,5,0.7,1,-0.3,2,3,-1,-1,0
21700933,1628367,PHX,OKC,Josh Jackson,129,25.4833333333333,26,-0.516666666666666,53,68,-15,-15,0
21700933,2546,OKC,PHX,Carmelo Anthony,165,31.0166666666667,31,0.0166666666666657,92,80,12,11,1
21700933,101109,OKC,PHX,Raymond Felton,39,9.01666666666667,9,0.0166666666666657,21,18,3,3,0
21700933,201566,OKC,PHX,Russell Westbrook,211,39.95,40,-0.0499999999999972,104,102,2,2,0
21700933,202331,OKC,PHX,Paul George,194,36.65,37,-0.350000000000001,102,93,9,9,0
21700933,202335,OKC,PHX,Patrick Patterson,80,16.9833333333333,17,-0.0166666666666657,32,36,-4,-3,-1
21700933,203500,OKC,PHX,Steven Adams,176,33.0833333333333,33,0.0833333333333286,90,83,7,7,0
21700933,203518,OKC,PHX,Alex Abrines,48,10.55,11,-0.449999999999999,23,19,4,4,0
21700933,203924,OKC,PHX,Jerami Grant,124,25.9833333333333,26,-0.0166666666666657,62,57,5,3,2
21700933,203962,OKC,PHX,Josh Huestis,137,26.9666666666667,27,-0.0333333333333314,63,66,-3,-3,0
21700933,1628390,OKC,PHX,Terrance Ferguson,51,9.8,9,0.800000000000001,31,26,5,7,-2
21700934,2037,MIN,UTA,Jamal Crawford,140,28.65,29,-0.350000000000001,63,71,-8,-8,0
21700934,201952,MIN,UTA,Jeff Teague,118,25.45,26,-0.550000000000001,60,64,-4,-2,-2
21700934,201959,MIN,UTA,Taj Gibson,184,38.9833333333333,39,-0.0166666666666657,95,100,-5,-6,1
21700934,202357,MIN,UTA,Nemanja Bjelica,210,44.75,45,-0.25,99,107,-8,-7,-1
21700934,203476,MIN,UTA,Gorgui Dieng,83,18.7833333333333,19,-0.216666666666669,42,45,-3,-3,0
21700934,203952,MIN,UTA,Andrew Wiggins,158,34.6,35,-0.400000000000006,85,79,6,6,0
21700934,1626145,MIN,UTA,Tyus Jones,115,24.55,25,-0.450000000000003,54,61,-7,-9,2
21700934,1626157,MIN,UTA,Karl-Anthony Towns,94,19.7333333333333,20,-0.266666666666666,37,47,-10,-10,0
21700934,1627875,MIN,UTA,Marcus Georges-Hunt,13,2.91666666666667,3,-0.083333333333333,5,6,-1,-1,0
21700934,201937,UTA,MIN,Ricky Rubio,149,30.8333333333333,31,-0.166666666666668,89,68,21,23,-2
21700934,201973,UTA,MIN,Jonas Jerebko,50,11.2833333333333,11,0.283333333333333,20,28,-8,-8,0
21700934,202324,UTA,MIN,Derrick Favors,117,25.65,26,-0.350000000000001,56,59,-3,1,-4
21700934,202692,UTA,MIN,Alec Burks,49,11.4333333333333,11,0.433333333333334,21,26,-5,-3,-2
21700934,203109,UTA,MIN,Jae Crowder,134,28.3833333333333,29,-0.616666666666667,74,59,15,15,0
21700934,203497,UTA,MIN,Rudy Gobert,168,35.75,36,-0.25,93,79,14,10,4
21700934,203526,UTA,MIN,Raul Neto,27,6.18333333333333,6,0.183333333333334,8,17,-9,-11,2
21700934,204060,UTA,MIN,Joe Ingles,165,34.1166666666667,34,0.116666666666667,92,78,14,12,2
21700934,1626220,UTA,MIN,Royce O'Neale,72,15.6833333333333,16,-0.316666666666666,28,37,-9,-9,0
21700934,1628378,UTA,MIN,Donovan Mitchell,184,39.1,39,0.100000000000001,99,89,10,10,0
21700935,101150,LAC,NYK,Lou Williams,141,29.4,29,0.399999999999999,70,66,4,6,-2
21700935,201599,LAC,NYK,DeAndre Jordan,132,28.2666666666667,28,0.266666666666666,74,57,17,19,-2
21700935,202325,LAC,NYK,Wesley Johnson,64,13.2666666666667,13,0.266666666666666,36,38,-2,-3,1
21700935,202699,LAC,NYK,Tobias Harris,142,30.4,31,-0.600000000000001,79,67,12,14,-2
21700935,203085,LAC,NYK,Austin Rivers,131,27.8,28,-0.200000000000003,78,52,26,28,-2
21700935,203710,LAC,NYK,C.J. Williams,126,25.9166666666667,26,-0.0833333333333357,73,60,13,13,0
21700935,1626149,LAC,NYK,Montrezl Harrell,73,15.6666666666667,16,-0.333333333333332,42,30,12,10,2
21700935,1626155,LAC,NYK,Sam Dekker,80,16.1666666666667,16,0.166666666666664,45,38,7,5,2
21700935,1626246,LAC,NYK,Boban Marjanovic,31,5.26666666666667,5,0.266666666666667,16,18,-2,-2,0
21700935,1628414,LAC,NYK,Sindarius Thornwell,90,18.6166666666667,19,-0.383333333333333,50,47,3,1,2
21700935,1628462,LAC,NYK,Milos Teodosic,135,28.65,29,-0.350000000000001,77,52,25,24,1
21700935,201563,NYK,LAC,Michael Beasley,94,19.7333333333333,20,-0.266666666666666,39,58,-19,-21,2
21700935,201584,NYK,LAC,Courtney Lee,128,26.0666666666667,26,0.0666666666666664,54,76,-22,-23,1
21700935,202498,NYK,LAC,Lance Thomas,83,18.2333333333333,18,0.233333333333334,36,45,-9,-7,-2
21700935,202683,NYK,LAC,Enes Kanter,150,29.8333333333333,30,-0.166666666666668,64,85,-21,-21,0
21700935,203124,NYK,LAC,Kyle O'Quinn,71,16.4,16,0.399999999999999,35,39,-4,-4,0
21700935,203501,NYK,LAC,Tim Hardaway Jr.,164,34.4,34,0.399999999999999,76,90,-14,-13,-1
21700935,203504,NYK,LAC,Trey Burke,85,18.6666666666667,19,-0.333333333333336,44,45,-1,-1,0
21700935,1626144,NYK,LAC,Emmanuel Mudiay,120,25.8833333333333,26,-0.116666666666667,49,73,-24,-24,0
21700935,1627786,NYK,LAC,Troy Williams,80,16.8833333333333,17,-0.116666666666667,39,45,-6,-7,1
21700935,1628373,NYK,LAC,Frank Ntilikina,96,20.2833333333333,20,0.283333333333331,49,48,1,2,-1
21700935,1628422,NYK,LAC,Damyean Dotson,37,6.51666666666667,7,-0.483333333333333,20,18,2,2,0
21700935,1628436,NYK,LAC,Luke Kornet,37,6.51666666666667,7,-0.483333333333333,20,18,2,2,0
21700936,201571,ORL,MEM,D.J. Augustin,134,29.05,29,0.0500000000000007,76,66,10,12,-2
21700936,202687,ORL,MEM,Bismack Biyombo,70,15.2833333333333,15,0.283333333333333,22,26,-4,-2,-2
21700936,202696,ORL,MEM,Nikola Vucevic,127,27.6333333333333,28,-0.366666666666667,70,66,4,4,0
21700936,202714,ORL,MEM,Shelvin Mack,84,18.6666666666667,19,-0.333333333333336,29,34,-5,-5,0
21700936,203095,ORL,MEM,Evan Fournier,136,29.2,30,-0.800000000000001,82,68,14,12,2
21700936,203613,ORL,MEM,Jonathon Simmons,132,27.9166666666667,28,-0.0833333333333357,74,60,14,13,1
21700936,203920,ORL,MEM,Khem Birch,19,3.88333333333333,4,-0.116666666666667,14,8,6,4,2
21700936,203932,ORL,MEM,Aaron Gordon,148,32.2166666666667,33,-0.783333333333331,83,68,15,13,2
21700936,1626173,ORL,MEM,Rashad Vaughn,53,10.85,10,0.85,17,25,-8,-4,-4
21700936,1626209,ORL,MEM,Mario Hezonja,96,21.8,22,-0.199999999999999,36,40,-4,-5,1
21700936,1628371,ORL,MEM,Jonathan Isaac,81,18.0333333333333,18,0.0333333333333314,27,32,-5,-5,0
21700936,1628411,ORL,MEM,Wes Iwundu,20,5.21666666666667,5,0.216666666666667,5,7,-2,-4,2
21700936,201596,MEM,ORL,Mario Chalmers,128,28.2166666666667,28,0.216666666666669,66,61,5,3,2
21700936,202718,MEM,ORL,Chandler Parsons,59,13.0666666666667,13,0.0666666666666664,23,29,-6,-3,-3
21700936,203210,MEM,ORL,JaMychal Green,172,36.55,37,-0.450000000000003,73,82,-9,-8,-1
21700936,203463,MEM,ORL,Ben McLemore,174,38.2333333333333,38,0.233333333333334,89,87,2,3,-1
21700936,1626185,MEM,ORL,Jarell Martin,154,35.2,35,0.200000000000003,81,82,-1,-4,3
21700936,1627744,MEM,ORL,Brice Johnson,47,9.35,9,0.35,16,25,-9,-7,-2
21700936,1627988,MEM,ORL,Myke Henry,35,7.53333333333333,8,-0.466666666666667,14,13,1,0,1
21700936,1628397,MEM,ORL,Ivan Rabb,68,14.85,15,-0.15,30,27,3,3,0
21700936,1628415,MEM,ORL,Dillon Brooks,172,37.0666666666667,37,0.0666666666666629,74,85,-11,-14,3
21700936,1628424,MEM,ORL,Kobi Simmons,91,19.6833333333333,20,-0.31666666666667,34,44,-10,-8,-2
21700937,2544,CLE,DEN,LeBron James,191,42.4333333333333,42,0.433333333333337,102,109,-7,-6,-1
21700937,2594,CLE,DEN,Kyle Korver,37,7.23333333333333,7,0.233333333333333,22,21,1,1,0
21700937,2747,CLE,DEN,JR Smith,155,34.3,35,-0.700000000000003,75,89,-14,-13,-1
21700937,201588,CLE,DEN,George Hill,152,33.8833333333333,34,-0.116666666666667,79,93,-14,-13,-1
21700937,202684,CLE,DEN,Tristan Thompson,128,27.85,28,-0.149999999999999,66,85,-19,-18,-1
21700937,203903,CLE,DEN,Jordan Clarkson,106,23.4333333333333,23,0.433333333333334,65,56,9,11,-2
21700937,203918,CLE,DEN,Rodney Hood,115,26.1166666666667,26,0.116666666666667,62,62,0,-1,1
21700937,1626204,CLE,DEN,Larry Nance Jr.,88,19.8166666666667,20,-0.183333333333334,50,41,9,9,0
21700937,1626224,CLE,DEN,Cedi Osman,108,23.2666666666667,24,-0.733333333333334,59,74,-15,-15,0
21700937,2210,DEN,CLE,Richard Jefferson,70,15.3833333333333,15,0.383333333333333,43,41,2,2,0
21700937,2734,DEN,CLE,Devin Harris,72,16.5666666666667,17,-0.433333333333334,35,46,-11,-9,-2
21700937,200794,DEN,CLE,Paul Millsap,118,25.4,26,-0.600000000000001,64,56,8,7,1
21700937,201163,DEN,CLE,Wilson Chandler,121,27.1666666666667,27,0.166666666666664,70,62,8,7,1
21700937,203115,DEN,CLE,Will Barton,149,33.3833333333333,33,0.383333333333333,88,79,9,8,1
21700937,203486,DEN,CLE,Mason Plumlee,72,15.4333333333333,16,-0.566666666666666,38,40,-2,-3,1
21700937,203914,DEN,CLE,Gary Harris,167,36.45,37,-0.549999999999997,97,89,8,7,1
21700937,203999,DEN,CLE,Nikola Jokic,144,32.2333333333333,32,0.233333333333334,88,76,12,12,0
21700937,1627736,DEN,CLE,Malik Beasley,25,5.23333333333333,5,0.233333333333333,17,14,3,3,0
21700937,1627750,DEN,CLE,Jamal Murray,142,31.0833333333333,31,0.0833333333333357,90,77,13,11,2
21700938,2548,MIA,DET,Dwyane Wade,113,22.4333333333333,23,-0.566666666666666,49,42,7,8,-1
21700938,2617,MIA,DET,Udonis Haslem,4,1.01666666666667,1,0.0166666666666666,0,5,-5,-3,-2
21700938,201609,MIA,DET,Goran Dragic,144,30.2333333333333,31,-0.766666666666666,65,62,3,2,1
21700938,201949,MIA,DET,James Johnson,127,26.2333333333333,27,-0.766666666666666,50,54,-4,-5,1
21700938,202337,MIA,DET,Luke Babbitt,115,25,25,0,56,55,1,1,0
21700938,202355,MIA,DET,Hassan Whiteside,118,24.3666666666667,25,-0.633333333333333,43,52,-9,-9,0
21700938,203482,MIA,DET,Kelly Olynyk,112,23.1666666666667,23,0.166666666666664,62,44,18,18,0
21700938,203585,MIA,DET,Rodney McGruder,106,23.2166666666667,23,0.216666666666665,50,42,8,9,-1
21700938,1626159,MIA,DET,Justise Winslow,134,27.3333333333333,27,0.333333333333332,69,47,22,20,2
21700938,1626196,MIA,DET,Josh Richardson,177,34.6666666666667,35,-0.333333333333329,81,77,4,4,0
21700938,201229,DET,MIA,Anthony Tolliver,56,11.0166666666667,12,-0.983333333333334,20,36,-16,-16,0
21700938,201933,DET,MIA,Blake Griffin,174,36.5166666666667,36,0.516666666666666,76,69,7,7,0
21700938,202397,DET,MIA,Ish Smith,138,27.1166666666667,28,-0.883333333333333,59,55,4,4,0
21700938,202779,DET,MIA,Dwight Buycks,92,20.4166666666667,20,0.416666666666664,37,50,-13,-13,0
21700938,203083,DET,MIA,Andre Drummond,184,37.4166666666667,38,-0.583333333333329,81,89,-8,-8,0
21700938,203493,DET,MIA,Reggie Bullock,160,33.15,33,0.149999999999999,68,64,4,5,-1
21700938,203516,DET,MIA,James Ennis III,147,29.7,30,-0.299999999999997,65,69,-4,-4,0
21700938,203961,DET,MIA,Eric Moreland,46,10.1166666666667,10,0.116666666666667,15,16,-1,-1,0
21700938,204038,DET,MIA,Langston Galloway,56,11.6,12,-0.399999999999999,23,30,-7,-8,1
21700938,1626169,DET,MIA,Stanley Johnson,97,20.6166666666667,21,-0.383333333333333,36,47,-11,-11,0
21700939,201143,BOS,HOU,Al Horford,151,31.1166666666667,31,0.116666666666667,59,77,-18,-22,4
21700939,202328,BOS,HOU,Greg Monroe,95,19.1833333333333,19,0.183333333333334,70,47,23,23,0
21700939,202681,BOS,HOU,Kyrie Irving,173,35.4666666666667,35,0.466666666666669,73,87,-14,-17,3
21700939,202694,BOS,HOU,Marcus Morris,164,33.6166666666667,34,-0.383333333333333,88,88,0,5,-5
21700939,203382,BOS,HOU,Aron Baynes,54,12.05,12,0.0500000000000007,23,32,-9,-9,0
21700939,203935,BOS,HOU,Marcus Smart,147,29.05,29,0.0499999999999972,77,71,6,6,0
21700939,1626179,BOS,HOU,Terry Rozier,139,28.6833333333333,28,0.68333333333333,83,75,8,9,-1
21700939,1627759,BOS,HOU,Jaylen Brown,113,23.3333333333333,24,-0.666666666666664,52,58,-6,-10,4
21700939,1628369,BOS,HOU,Jayson Tatum,129,27.5,28,-0.5,75,75,0,0,0
21700939,2207,HOU,BOS,Joe Johnson,64,13.4,13,0.4,33,43,-10,-9,-1
21700939,2403,HOU,BOS,Nene,67,14.3333333333333,14,0.333333333333332,36,48,-12,-16,4
21700939,2772,HOU,BOS,Trevor Ariza,168,34,34,0,83,71,12,13,-1
21700939,101108,HOU,BOS,Chris Paul,173,35.0833333333333,35,0.0833333333333286,93,102,-9,-7,-2
21700939,200782,HOU,BOS,PJ Tucker,142,29.3166666666667,29,0.316666666666666,77,69,8,8,0
21700939,201569,HOU,BOS,Eric Gordon,130,27.3,27,0.300000000000001,68,70,-2,-7,5
21700939,201601,HOU,BOS,Luc Mbah a Moute,74,15.25,15,0.25,35,42,-7,-7,0
21700939,201935,HOU,BOS,James Harden,184,37.7,38,-0.299999999999997,101,83,18,21,-3
21700939,203991,HOU,BOS,Clint Capela,163,33.6166666666667,34,-0.383333333333333,84,72,12,19,-7
21700940,201572,LAL,SAS,Brook Lopez,127,25.2166666666667,26,-0.783333333333331,51,68,-17,-17,0
21700940,202738,LAL,SAS,Isaiah Thomas,157,28.9166666666667,29,-0.0833333333333357,73,69,4,6,-2
21700940,203484,LAL,SAS,Kentavious Caldwell-Pope,214,42.9166666666667,43,-0.0833333333333286,105,96,9,3,6
21700940,203898,LAL,SAS,Tyler Ennis,66,13.1833333333333,13,0.183333333333334,28,34,-6,-4,-2
21700940,203944,LAL,SAS,Julius Randle,166,33.2833333333333,33,0.283333333333331,80,75,5,5,0
21700940,204037,LAL,SAS,Travis Wear,63,12.9333333333333,13,-0.0666666666666664,39,23,16,18,-2
21700940,1627780,LAL,SAS,Gary Payton II,8,0.75,1,-0.25,2,5,-3,-3,0
21700940,1627826,LAL,SAS,Ivica Zubac,81,14.2833333333333,14,0.283333333333333,35,30,5,7,-2
21700940,1628366,LAL,SAS,Lonzo Ball,183,34.8,35,-0.200000000000003,88,78,10,8,2
21700940,1628398,LAL,SAS,Kyle Kuzma,180,33.6333333333333,33,0.633333333333333,79,82,-3,-3,0
21700940,1938,SAS,LAL,Manu Ginobili,127,22.8,24,-1.2,52,65,-13,-13,0
21700940,2200,SAS,LAL,Pau Gasol,164,32.9833333333333,33,-0.0166666666666657,87,76,11,14,-3
21700940,2225,SAS,LAL,Tony Parker,116,21.6333333333333,22,-0.366666666666667,48,60,-12,-16,4
21700940,200752,SAS,LAL,Rudy Gay,137,26.2666666666667,26,0.266666666666666,63,68,-5,-4,-1
21700940,201980,SAS,LAL,Danny Green,129,23.85,24,-0.149999999999999,53,71,-18,-18,0
21700940,201988,SAS,LAL,Patty Mills,148,29.0666666666667,29,0.0666666666666664,73,61,12,16,-4
21700940,202722,SAS,LAL,Davis Bertans,112,21.7166666666667,22,-0.283333333333331,49,48,1,2,-1
21700940,203530,SAS,LAL,Joffrey Lauvergne,85,15,15,0,25,40,-15,-16,1
21700940,203937,SAS,LAL,Kyle Anderson,109,22.1833333333333,22,0.183333333333334,56,44,12,8,4
21700940,1627749,SAS,LAL,Dejounte Murray,118,24.4166666666667,24,0.416666666666664,54,47,7,7,0
21700941,202323,POR,OKC,Evan Turner,167,32.8833333333333,33,-0.116666666666667,75,74,1,3,-2
21700941,202329,POR,OKC,Al-Farouq Aminu,97,18.8833333333333,19,-0.116666666666667,34,47,-13,-13,0
21700941,202334,POR,OKC,Ed Davis,106,20.35,20,0.350000000000001,59,39,20,18,2
21700941,203081,POR,OKC,Damian Lillard,188,36.8666666666667,37,-0.133333333333333,80,81,-1,-1,0
21700941,203086,POR,OKC,Meyers Leonard,39,9.16666666666667,9,0.166666666666668,19,20,-1,-1,0
21700941,203468,POR,OKC,CJ McCollum,186,37.5,38,-0.5,84,81,3,3,0
21700941,203894,POR,OKC,Shabazz Napier,62,14.1,14,0.0999999999999996,35,24,11,13,-2
21700941,203994,POR,OKC,Jusuf Nurkic,89,18.0666666666667,18,0.0666666666666664,30,41,-11,-11,0
21700941,1626192,POR,OKC,Pat Connaughton,106,23.6666666666667,24,-0.333333333333336,52,40,12,12,0
21700941,1628380,POR,OKC,Zach Collins,135,28.5166666666667,28,0.516666666666666,72,53,19,17,2
21700941,101109,OKC,POR,Raymond Felton,104,23.0833333333333,23,0.0833333333333357,46,45,1,2,-1
21700941,201147,OKC,POR,Corey Brewer,58,11.65,12,-0.35,19,32,-13,-14,1
21700941,201566,OKC,POR,Russell Westbrook,183,34.25,35,-0.75,75,80,-5,-7,2
21700941,202331,OKC,POR,Paul George,192,37.3833333333333,37,0.383333333333333,83,85,-2,0,-2
21700941,202335,OKC,POR,Patrick Patterson,157,33.3166666666667,33,0.316666666666663,70,76,-6,-7,1
21700941,203500,OKC,POR,Steven Adams,190,36.3,36,0.299999999999997,75,84,-9,-8,-1
21700941,203518,OKC,POR,Alex Abrines,64,14.5,15,-0.5,26,34,-8,-7,-1
21700941,203924,OKC,POR,Jerami Grant,123,26.3833333333333,26,0.383333333333333,55,56,-1,-1,0
21700941,203962,OKC,POR,Josh Huestis,104,23.1333333333333,23,0.133333333333333,51,48,3,2,1
21700942,1713,SAC,UTA,Vince Carter,118,25.55,26,-0.449999999999999,40,51,-11,-9,-2
21700942,2216,SAC,UTA,Zach Randolph,119,25.75,26,-0.25,47,54,-7,-6,-1
21700942,201585,SAC,UTA,Kosta Koufos,106,23.9333333333333,25,-1.06666666666667,41,51,-10,-10,0
21700942,203992,SAC,UTA,Bogdan Bogdanovic,129,28.5166666666667,28,0.516666666666666,57,55,2,1,1
21700942,1627741,SAC,UTA,Buddy Hield,140,29.1333333333333,29,0.133333333333333,55,63,-8,-7,-1
21700942,1627746,SAC,UTA,Skal Labissiere,144,29.6333333333333,29,0.633333333333333,58,62,-4,-4,0
21700942,1628368,SAC,UTA,De'Aaron Fox,125,27.7166666666667,28,-0.283333333333335,53,57,-4,-3,-1
21700942,1628382,SAC,UTA,Justin Jackson,136,28.35,29,-0.649999999999999,66,56,10,7,3
21700942,1628412,SAC,UTA,Frank Mason,98,20,21,-1,38,41,-3,-4,1
21700942,201937,UTA,SAC,Ricky Rubio,158,33.6,34,-0.399999999999999,65,69,-4,-1,-3
21700942,201973,UTA,SAC,Jonas Jerebko,85,16.7833333333333,17,-0.216666666666669,32,29,3,4,-1
21700942,202324,UTA,SAC,Derrick Favors,142,29.9166666666667,30,-0.0833333333333357,59,52,7,5,2
21700942,203109,UTA,SAC,Jae Crowder,136,28.3,28,0.300000000000001,59,60,-1,-1,0
21700942,203497,UTA,SAC,Rudy Gobert,161,35.7,36,-0.299999999999997,74,66,8,10,-2
21700942,203526,UTA,SAC,Raul Neto,27,5.48333333333333,5,0.483333333333333,13,12,1,1,0
21700942,204060,UTA,SAC,Joe Ingles,150,33.55,34,-0.450000000000003,68,66,2,2,0
21700942,1626220,UTA,SAC,Royce O'Neale,84,17.3,18,-0.699999999999999,40,31,9,7,2
21700942,1628378,UTA,SAC,Donovan Mitchell,172,37.95,38,-0.0499999999999972,80,70,10,8,2
21700943,203101,ATL,PHX,Miles Plumlee,123,25.1833333333333,26,-0.816666666666666,70,58,12,10,2
21700943,203471,ATL,PHX,Dennis Schroder,115,23.7,24,-0.300000000000001,59,56,3,3,0
21700943,203473,ATL,PHX,Dewayne Dedmon,109,21.7166666666667,22,-0.283333333333331,44,54,-10,-10,0
21700943,203488,ATL,PHX,Mike Muscala,112,23.0333333333333,23,0.0333333333333314,65,51,14,14,0
21700943,1627098,ATL,PHX,Malcolm Delaney,70,15.05,15,0.0500000000000007,36,35,1,1,0
21700943,1627752,ATL,PHX,Taurean Prince,160,31.6,31,0.599999999999998,77,78,-1,-1,0
21700943,1627819,ATL,PHX,Isaiah Taylor,99,19.4666666666667,20,-0.533333333333331,41,44,-3,-2,-1
21700943,1628381,ATL,PHX,John Collins,115,22.8166666666667,22,0.816666666666666,43,54,-11,-9,-2
21700943,1628416,ATL,PHX,Tyler Dorsey,168,32.7833333333333,32,0.783333333333331,72,79,-7,-8,1
21700943,1628537,ATL,PHX,Jaylen Morris,119,24.65,25,-0.350000000000001,58,51,7,7,0
21700943,2199,PHX,ATL,Tyson Chandler,125,26.0833333333333,26,0.0833333333333357,57,68,-11,-11,0
21700943,203458,PHX,ATL,Alex Len,14,2.41666666666667,2,0.416666666666667,2,5,-3,-2,-1
21700943,203584,PHX,ATL,Troy Daniels,79,15.3333333333333,15,0.333333333333334,36,37,-1,-3,2
21700943,203901,PHX,ATL,Elfrid Payton,148,29.2833333333333,29,0.283333333333331,69,71,-2,-2,0
21700943,203933,PHX,ATL,T.J. Warren,207,42.15,42,0.150000000000006,102,98,4,4,0
21700943,1626164,PHX,ATL,Devin Booker,173,33.9333333333333,34,-0.0666666666666629,79,81,-2,0,-2
21700943,1627733,PHX,ATL,Dragan Bender,169,34.2,34,0.200000000000003,84,82,2,1,1
21700943,1627737,PHX,ATL,Marquese Chriss,90,18.2166666666667,18,0.216666666666669,45,35,10,10,0
21700943,1627885,PHX,ATL,Shaquille Harrison,61,13.2,13,0.199999999999999,31,30,1,1,0
21700943,1628367,PHX,ATL,Josh Jackson,124,25.1833333333333,25,0.18333333333333,55,58,-3,-3,0
21700944,101139,TOR,CHA,CJ Miles,92,19.2666666666667,19,0.266666666666666,42,44,-2,1,-3
21700944,200768,TOR,CHA,Kyle Lowry,165,34.75,35,-0.25,75,71,4,6,-2
21700944,201586,TOR,CHA,Serge Ibaka,143,30.3666666666667,30,0.366666666666667,70,60,10,6,4
21700944,201942,TOR,CHA,DeMar DeRozan,172,36,36,0,83,69,14,14,0
21700944,202685,TOR,CHA,Jonas Valanciunas,136,29.8166666666667,30,-0.183333333333334,60,57,3,9,-6
21700944,203512,TOR,CHA,Lucas Nogueira,22,4.71666666666667,5,-0.283333333333333,12,11,1,3,-2
21700944,1626153,TOR,CHA,Delon Wright,59,12.8,13,-0.199999999999999,23,29,-6,-8,2
21700944,1626181,TOR,CHA,Norman Powell,21,4.26666666666667,4,0.266666666666667,6,5,1,3,-2
21700944,1626259,TOR,CHA,Malcolm Miller,57,13.3166666666667,14,-0.683333333333334,30,23,7,5,2
21700944,1627751,TOR,CHA,Jakob Poeltl,66,13.1333333333333,14,-0.866666666666667,29,29,0,-4,4
21700944,1627783,TOR,CHA,Pascal Siakam,89,17.9,18,-0.100000000000001,35,39,-4,-6,2
21700944,1627832,TOR,CHA,Fred VanVleet,118,23.5,24,-0.5,50,53,-3,-4,1
21700944,2730,CHA,TOR,Dwight Howard,104,23.4166666666667,24,-0.583333333333336,43,51,-8,-11,3
21700944,101107,CHA,TOR,Marvin Williams,96,21.25,22,-0.75,36,46,-10,-10,0
21700944,201587,CHA,TOR,Nicolas Batum,165,34.4,35,-0.600000000000001,74,76,-2,-3,1
21700944,202689,CHA,TOR,Kemba Walker,187,38.8833333333333,39,-0.116666666666667,77,85,-8,-8,0
21700944,203077,CHA,TOR,Michael Kidd-Gilchrist,81,18.0666666666667,19,-0.933333333333334,34,40,-6,-12,6
21700944,203087,CHA,TOR,Jeremy Lamb,131,26.5666666666667,26,0.566666666666666,60,56,4,8,-4
21700944,203469,CHA,TOR,Cody Zeller,122,24.4833333333333,24,0.483333333333334,55,50,5,6,-1
21700944,203487,CHA,TOR,Michael Carter-Williams,88,18.6,19,-0.399999999999999,35,37,-2,0,-2
21700944,1626163,CHA,TOR,Frank Kaminsky,134,26.7833333333333,26,0.783333333333331,62,59,3,5,-2
21700944,1626203,CHA,TOR,Treveon Graham,32,7.38333333333333,7,0.383333333333333,14,15,-1,0,-1
21700945,201152,IND,WAS,Thaddeus Young,145,32.5833333333333,33,-0.416666666666671,66,64,2,2,0
21700945,202362,IND,WAS,Lance Stephenson,41,9.18333333333333,10,-0.816666666666666,9,27,-18,-16,-2
21700945,202709,IND,WAS,Cory Joseph,167,37.8166666666667,38,-0.183333333333337,85,71,14,15,-1
21700945,202711,IND,WAS,Bojan Bogdanovic,171,37.85,38,-0.149999999999999,78,79,-1,0,-1
21700945,203506,IND,WAS,Victor Oladipo,176,39.4333333333333,39,0.433333333333337,88,70,18,19,-1
21700945,203922,IND,WAS,Glenn Robinson III,48,10.7666666666667,11,-0.233333333333334,19,20,-1,-3,2
21700945,1626167,IND,WAS,Myles Turner,169,37.95,38,-0.0499999999999972,87,68,19,20,-1
21700945,1626202,IND,WAS,Joe Young,49,10.8,11,-0.199999999999999,12,25,-13,-12,-1
21700945,1627734,IND,WAS,Domantas Sabonis,82,18.75,18,0.75,33,40,-7,-7,0
21700945,1628388,IND,WAS,TJ Leaf,22,4.86666666666667,5,-0.133333333333333,8,11,-3,-3,0
21700945,101133,WAS,IND,Ian Mahinmi,111,23.65,24,-0.350000000000001,48,38,10,11,-1
21700945,101162,WAS,IND,Marcin Gortat,94,22.0666666666667,22,0.0666666666666664,45,51,-6,-8,2
21700945,201975,WAS,IND,Jodie Meeks,120,25.9333333333333,26,-0.06666666666667,50,46,4,5,-1
21700945,202693,WAS,IND,Markieff Morris,118,27.7,28,-0.299999999999997,47,68,-21,-21,0
21700945,203078,WAS,IND,Bradley Beal,192,43,43,0,83,92,-9,-10,1
21700945,203107,WAS,IND,Tomas Satoransky,96,21.9833333333333,22,-0.0166666666666657,45,51,-6,-8,2
21700945,203118,WAS,IND,Mike Scott,105,22.5833333333333,22,0.583333333333336,50,37,13,12,1
21700945,203490,WAS,IND,Otto Porter Jr.,157,35.4333333333333,36,-0.566666666666663,76,71,5,2,3
21700945,204025,WAS,IND,Tim Frazier,77,17.65,18,-0.350000000000001,31,31,0,2,-2
21700946,200765,NOP,DAL,Rajon Rondo,149,32.1166666666667,32,0.116666666666667,78,76,2,1,1
21700946,201950,NOP,DAL,Jrue Holiday,149,32.1833333333333,32,0.183333333333337,89,64,25,27,-2
21700946,202703,NOP,DAL,Nikola Mirotic,142,30.9333333333333,31,-0.06666666666667,78,67,11,11,0
21700946,202732,NOP,DAL,DeAndre Liggins,11,2.26666666666667,3,-0.733333333333333,7,10,-3,-3,0
21700946,202734,NOP,DAL,E'Twaun Moore,139,30.4666666666667,30,0.466666666666669,77,59,18,18,0
21700946,203076,NOP,DAL,Anthony Davis,173,36.65,37,-0.349999999999994,98,77,21,21,0
21700946,203121,NOP,DAL,Darius Miller,122,22.7333333333333,23,-0.266666666666666,62,55,7,5,2
21700946,203546,NOP,DAL,Ian Clark,106,19.4166666666667,20,-0.583333333333336,56,55,1,1,0
21700946,1627215,NOP,DAL,Walter Lemon Jr.,42,8.43333333333333,9,-0.566666666666666,23,24,-1,0,-1
21700946,1627767,NOP,DAL,Cheick Diallo,117,22.6333333333333,23,-0.366666666666667,62,58,4,4,0
21700946,1717,DAL,NOP,Dirk Nowitzki,120,25.3333333333333,26,-0.666666666666664,58,61,-3,-3,0
21700946,200826,DAL,NOP,J.J. Barea,111,22.1833333333333,22,0.183333333333334,52,67,-15,-13,-2
21700946,203084,DAL,NOP,Harrison Barnes,145,30.75,31,-0.25,68,81,-13,-11,-2
21700946,203457,DAL,NOP,Nerlens Noel,93,18.2,18,0.199999999999999,39,52,-13,-13,0
21700946,203816,DAL,NOP,Scotty Hopson,47,8.25,8,0.25,17,29,-12,-8,-4
21700946,203926,DAL,NOP,Doug McDermott,166,33.45,34,-0.549999999999997,83,92,-9,-11,2
21700946,203939,DAL,NOP,Dwight Powell,104,22.75,23,-0.25,54,56,-2,0,-2
21700946,1626257,DAL,NOP,Salah Mejri,30,6.35,6,0.35,13,16,-3,-5,2
21700946,1627812,DAL,NOP,Yogi Ferrell,98,22.65,23,-0.350000000000001,49,55,-6,-9,3
21700946,1627858,DAL,NOP,Kyle Collinsworth,88,16.9333333333333,17,-0.0666666666666664,46,44,2,1,1
21700946,1628372,DAL,NOP,Dennis Smith Jr.,148,30.9833333333333,31,-0.0166666666666657,66,77,-11,-13,2
21700947,1891,MIL,PHI,Jason Terry,123,25.9333333333333,26,-0.0666666666666664,71,43,28,29,-1
21700947,202339,MIL,PHI,Eric Bledsoe,195,40.1833333333333,40,0.183333333333337,100,97,3,6,-3
21700947,203089,MIL,PHI,John Henson,91,20.55,22,-1.45,49,51,-2,-4,2
21700947,203092,MIL,PHI,Tyler Zeller,107,20.7666666666667,20,0.766666666666666,59,38,21,22,-1
21700947,203114,MIL,PHI,Khris Middleton,167,34.6666666666667,35,-0.333333333333336,81,94,-13,-14,1
21700947,203503,MIL,PHI,Tony Snell,109,21.7333333333333,22,-0.266666666666666,51,60,-9,-11,2
21700947,203507,MIL,PHI,Giannis Antetokounmpo,200,41.3833333333333,42,-0.616666666666667,96,92,4,0,4
21700947,203953,MIL,PHI,Jabari Parker,99,21.2,21,0.199999999999999,54,41,13,12,1
21700947,1627748,MIL,PHI,Thon Maker,25,4.63333333333333,5,-0.366666666666667,9,14,-5,-5,0
21700947,1628425,MIL,PHI,Sterling Brown,34,7.36666666666667,7,0.366666666666667,20,15,5,5,0
21700947,101141,PHI,MIL,Ersan Ilyasova,93,18.1833333333333,18,0.183333333333334,35,51,-16,-15,-1
21700947,101161,PHI,MIL,Amir Johnson,67,14.6333333333333,15,-0.366666666666667,34,33,1,1,0
21700947,200755,PHI,MIL,JJ Redick,155,31.5333333333333,32,-0.466666666666669,72,88,-16,-11,-5
21700947,201158,PHI,MIL,Marco Belinelli,119,24.3,24,0.299999999999997,56,56,0,0,0
21700947,203496,PHI,MIL,Robert Covington,131,27.95,28,-0.0500000000000007,61,70,-9,-10,1
21700947,203954,PHI,MIL,Joel Embiid,152,31.05,31,0.0499999999999972,70,82,-12,-10,-2
21700947,203967,PHI,MIL,Dario Saric,148,31.5,31,0.5,79,70,9,8,1
21700947,204456,PHI,MIL,T.J. McConnell,108,21.9333333333333,22,-0.0666666666666664,42,57,-15,-16,1
21700947,1627732,PHI,MIL,Ben Simmons,167,34.95,35,-0.0499999999999972,88,81,7,7,0
21700947,1627789,PHI,MIL,Timothe Luwawu-Cabarrot,10,2.38333333333333,3,-0.616666666666667,8,2,6,6,0
21700948,101150,LAC,BKN,Lou Williams,158,33.15,33,0.149999999999999,88,96,-8,-10,2
21700948,201599,LAC,BKN,DeAndre Jordan,168,35.9333333333333,36,-0.0666666666666629,89,76,13,13,0
21700948,202325,LAC,BKN,Wesley Johnson,53,10.9333333333333,11,-0.0666666666666664,23,18,5,5,0
21700948,202699,LAC,BKN,Tobias Harris,179,38.1666666666667,38,0.166666666666671,93,89,4,8,-4
21700948,203085,LAC,BKN,Austin Rivers,166,36.4666666666667,37,-0.533333333333331,90,77,13,9,4
21700948,203930,LAC,BKN,Sean Kilpatrick,61,11.5333333333333,11,0.533333333333333,33,43,-10,-6,-4
21700948,1626149,LAC,BKN,Montrezl Harrell,67,13.9666666666667,14,-0.033333333333335,38,48,-10,-10,0
21700948,1626155,LAC,BKN,Sam Dekker,40,7.93333333333333,8,-0.0666666666666664,26,27,-1,-5,4
21700948,1628414,LAC,BKN,Sindarius Thornwell,115,23.15,23,0.149999999999999,59,64,-5,-7,2
21700948,1628462,LAC,BKN,Milos Teodosic,128,28.7666666666667,29,-0.233333333333334,76,62,14,18,-4
21700948,201960,BKN,LAC,DeMarre Carroll,128,28.5,29,-0.5,59,73,-14,-15,1
21700948,201967,BKN,LAC,Dante Cunningham,109,22.1833333333333,22,0.183333333333334,72,56,16,18,-2
21700948,203459,BKN,LAC,Allen Crabbe,128,29.4333333333333,29,0.43333333333333,62,71,-9,-13,4
21700948,203915,BKN,LAC,Spencer Dinwiddie,168,35.95,36,-0.0499999999999972,84,85,-1,-1,0
21700948,203925,BKN,LAC,Joe Harris,126,25.5,26,-0.5,76,69,7,13,-6
21700948,1626156,BKN,LAC,D'Angelo Russell,99,20.3,20,0.299999999999997,51,58,-7,-9,2
21700948,1626178,BKN,LAC,Rondae Hollis-Jefferson,155,31.8,32,-0.200000000000003,83,84,-1,-2,1
21700948,1627747,BKN,LAC,Caris LeVert,145,29.25,29,0.25,85,78,7,7,0
21700948,1628386,BKN,LAC,Jarrett Allen,77,17.0833333333333,17,0.0833333333333357,28,41,-13,-13,0
21700949,201563,NYK,SAC,Michael Beasley,114,24.85,25,-0.149999999999999,54,51,3,3,0
21700949,201584,NYK,SAC,Courtney Lee,112,24.6666666666667,25,-0.333333333333336,50,54,-4,-4,0
21700949,202498,NYK,SAC,Lance Thomas,58,14,14,0,25,34,-9,-9,0
21700949,202683,NYK,SAC,Enes Kanter,103,21.8833333333333,22,-0.116666666666667,40,49,-9,-9,0
21700949,203124,NYK,SAC,Kyle O'Quinn,112,26.1166666666667,26,0.116666666666667,59,53,6,6,0
21700949,203501,NYK,SAC,Tim Hardaway Jr.,169,37.45,37,0.450000000000003,79,77,2,-2,4
21700949,203504,NYK,SAC,Trey Burke,113,26.8166666666667,27,-0.183333333333334,59,55,4,6,-2
21700949,1626144,NYK,SAC,Emmanuel Mudiay,90,18.95,19,-0.0500000000000007,36,42,-6,-6,0
21700949,1627786,NYK,SAC,Troy Williams,58,12.7833333333333,13,-0.216666666666667,24,30,-6,-4,-2
21700949,1628373,NYK,SAC,Frank Ntilikina,103,23.3333333333333,23,0.333333333333332,49,48,1,1,0
21700949,1628439,NYK,SAC,Isaiah Hicks,43,9.15,9,0.15,20,17,3,3,0
21700949,1713,SAC,NYK,Vince Carter,103,24.2166666666667,24,0.216666666666669,49,51,-2,-4,2
21700949,201585,SAC,NYK,Kosta Koufos,118,25.8,26,-0.199999999999999,56,51,5,7,-2
21700949,202066,SAC,NYK,Garrett Temple,91,20.8666666666667,21,-0.133333333333333,38,43,-5,-9,4
21700949,203992,SAC,NYK,Bogdan Bogdanovic,131,27.65,27,0.649999999999999,63,54,9,10,-1
21700949,203998,SAC,NYK,Bruno Caboclo,38,8.2,8,0.199999999999999,16,20,-4,-2,-2
21700949,1627741,SAC,NYK,Buddy Hield,113,26.4333333333333,27,-0.566666666666666,52,55,-3,-4,1
21700949,1627746,SAC,NYK,Skal Labissiere,151,33.65,34,-0.350000000000001,75,70,5,5,0
21700949,1628368,SAC,NYK,De'Aaron Fox,134,28.6833333333333,29,-0.31666666666667,63,56,7,7,0
21700949,1628382,SAC,NYK,Justin Jackson,115,25.1833333333333,25,0.183333333333334,59,52,7,9,-2
21700949,1628412,SAC,NYK,Frank Mason,81,19.3166666666667,19,0.31666666666667,39,43,-4,-4,0
21700950,2544,CLE,DET,LeBron James,133,28.7333333333333,29,-0.266666666666666,74,60,14,14,0
21700950,2594,CLE,DET,Kyle Korver,109,23.1,23,0.100000000000001,55,36,19,20,-1
21700950,2747,CLE,DET,JR Smith,96,21.8,22,-0.199999999999999,53,49,4,4,0
21700950,101181,CLE,DET,Jose Calderon,67,15.3,16,-0.699999999999999,28,27,1,0,1
21700950,201588,CLE,DET,George Hill,102,23.2333333333333,23,0.233333333333334,57,51,6,9,-3
21700950,203903,CLE,DET,Jordan Clarkson,96,20.0666666666667,20,0.0666666666666664,47,31,16,13,3
21700950,203918,CLE,DET,Rodney Hood,139,30,30,0,78,60,18,19,-1
21700950,204066,CLE,DET,John Holland,21,4.45,5,-0.55,8,8,0,0,0
21700950,1626204,CLE,DET,Larry Nance Jr.,141,31.8833333333333,32,-0.116666666666667,76,61,15,15,0
21700950,1626224,CLE,DET,Cedi Osman,105,22.4833333333333,23,-0.516666666666666,45,35,10,9,1
21700950,1627790,CLE,DET,Ante Zizic,78,15.8666666666667,16,-0.133333333333333,36,29,7,7,0
21700950,1628506,CLE,DET,London Perrantes,8,1.83333333333333,2,-0.166666666666667,3,3,0,0,0
21700950,201229,DET,CLE,Anthony Tolliver,86,19.05,19,0.0500000000000007,32,42,-10,-11,1
21700950,201933,DET,CLE,Blake Griffin,136,29.1166666666667,29,0.116666666666667,60,76,-16,-15,-1
21700950,202397,DET,CLE,Ish Smith,133,30.0166666666667,30,0.0166666666666657,62,68,-6,-4,-2
21700950,202779,DET,CLE,Dwight Buycks,62,12.9333333333333,13,-0.0666666666666664,20,34,-14,-16,2
21700950,203083,DET,CLE,Andre Drummond,132,29.6333333333333,30,-0.366666666666667,60,72,-12,-11,-1
21700950,203493,DET,CLE,Reggie Bullock,136,29.1166666666667,29,0.116666666666667,60,76,-16,-15,-1
21700950,203516,DET,CLE,James Ennis III,126,28.7166666666667,28,0.716666666666669,57,69,-12,-13,1
21700950,203961,DET,CLE,Eric Moreland,60,12.6166666666667,13,-0.383333333333333,20,24,-4,-5,1
21700950,204038,DET,CLE,Langston Galloway,46,10.0666666666667,10,0.0666666666666664,16,18,-2,-2,0
21700950,1626169,DET,CLE,Stanley Johnson,133,27.95,28,-0.0500000000000007,47,63,-16,-16,0
21700950,1627740,DET,CLE,Henry Ellenson,24,5.08333333333333,5,0.083333333333333,8,10,-2,-2,0
21700950,1628379,DET,CLE,Luke Kennard,21,4.45,5,-0.55,8,8,0,0,0
21700951,1891,MIL,IND,Jason Terry,84,21.2333333333333,21,0.233333333333334,49,30,19,17,2
21700951,202339,MIL,IND,Eric Bledsoe,147,34.8,35,-0.200000000000003,58,67,-9,-9,0
21700951,203089,MIL,IND,John Henson,116,25.7,26,-0.299999999999997,49,52,-3,-3,0
21700951,203114,MIL,IND,Khris Middleton,150,34.5666666666667,35,-0.433333333333337,51,74,-23,-23,0
21700951,203498,MIL,IND,Shabazz Muhammad,28,7.26666666666667,7,0.266666666666667,19,9,10,8,2
21700951,203503,MIL,IND,Tony Snell,113,25.8,26,-0.200000000000003,38,57,-19,-19,0
21700951,203507,MIL,IND,Giannis Antetokounmpo,152,36.7833333333333,37,-0.216666666666669,64,63,1,2,-1
21700951,203953,MIL,IND,Jabari Parker,101,23.5666666666667,24,-0.433333333333334,55,48,7,8,-1
21700951,1627748,MIL,IND,Thon Maker,73,18.7833333333333,18,0.783333333333331,35,40,-5,-3,-2
21700951,1628425,MIL,IND,Sterling Brown,51,11.5,11,0.5,27,20,7,7,0
21700951,201152,IND,MIL,Thaddeus Young,161,38.4666666666667,39,-0.533333333333331,68,68,0,-1,1
21700951,202362,IND,MIL,Lance Stephenson,79,19.4166666666667,19,0.416666666666664,37,48,-11,-11,0
21700951,202709,IND,MIL,Cory Joseph,141,34.1333333333333,34,0.133333333333333,63,58,5,5,0
21700951,202711,IND,MIL,Bojan Bogdanovic,149,34.5166666666667,35,-0.483333333333334,66,54,12,10,2
21700951,203506,IND,MIL,Victor Oladipo,140,33.4166666666667,33,0.416666666666664,61,55,6,6,0
21700951,203922,IND,MIL,Glenn Robinson III,55,12.6333333333333,13,-0.366666666666667,31,30,1,4,-3
21700951,1626167,IND,MIL,Myles Turner,123,29.4333333333333,29,0.43333333333333,57,40,17,17,0
21700951,1626202,IND,MIL,Joe Young,62,13.8666666666667,14,-0.133333333333333,29,31,-2,-2,0
21700951,1627734,IND,MIL,Domantas Sabonis,88,20.4,20,0.399999999999999,40,51,-11,-11,0
21700951,1628388,IND,MIL,TJ Leaf,17,3.71666666666667,4,-0.283333333333334,8,10,-2,-2,0
21700952,2548,MIA,PHX,Dwyane Wade,105,21.6,22,-0.399999999999999,56,42,14,15,-1
21700952,2617,MIA,PHX,Udonis Haslem,16,3.16666666666667,3,0.166666666666667,6,7,-1,-1,0
21700952,201609,MIA,PHX,Goran Dragic,109,23.2333333333333,23,0.233333333333334,64,51,13,13,0
21700952,201949,MIA,PHX,James Johnson,96,20.4833333333333,21,-0.516666666666666,57,49,8,8,0
21700952,202337,MIA,PHX,Luke Babbitt,126,25.7666666666667,26,-0.233333333333334,65,58,7,7,0
21700952,202355,MIA,PHX,Hassan Whiteside,117,24.9666666666667,25,-0.0333333333333314,69,53,16,16,0
21700952,203482,MIA,PHX,Kelly Olynyk,97,20.2666666666667,20,0.266666666666666,56,40,16,17,-1
21700952,203585,MIA,PHX,Rodney McGruder,112,23.15,23,0.149999999999999,59,50,9,9,0
21700952,204020,MIA,PHX,Tyler Johnson,87,18.0333333333333,18,0.0333333333333314,44,39,5,6,-1
21700952,1626159,MIA,PHX,Justise Winslow,152,31.35,31,0.350000000000001,77,65,12,13,-1
21700952,1626196,MIA,PHX,Josh Richardson,85,18.6166666666667,19,-0.383333333333333,55,37,18,19,-1
21700952,1627884,MIA,PHX,Derrick Jones Jr.,24,4.6,5,-0.4,6,12,-6,-6,0
21700952,1628389,MIA,PHX,Bam Adebayo,24,4.6,5,-0.4,6,12,-6,-6,0
21700952,2199,PHX,MIA,Tyson Chandler,81,17.7833333333333,18,-0.216666666666669,42,52,-10,-10,0
21700952,203458,PHX,MIA,Alex Len,59,12.2,12,0.199999999999999,25,27,-2,-2,0
21700952,203901,PHX,MIA,Elfrid Payton,110,24,24,0,48,69,-21,-24,3
21700952,203933,PHX,MIA,T.J. Warren,157,33.2166666666667,33,0.216666666666669,66,97,-31,-30,-1
21700952,1626164,PHX,MIA,Devin Booker,156,33.2166666666667,33,0.216666666666669,78,93,-15,-17,2
21700952,1627733,PHX,MIA,Dragan Bender,143,30.35,31,-0.649999999999999,66,83,-17,-18,1
21700952,1627737,PHX,MIA,Marquese Chriss,135,27.1166666666667,27,0.116666666666667,57,61,-4,-5,1
21700952,1627885,PHX,MIA,Shaquille Harrison,120,24.4833333333333,24,0.483333333333334,54,54,0,2,-2
21700952,1628367,PHX,MIA,Josh Jackson,149,29.7,29,0.699999999999999,60,72,-12,-13,1
21700952,1628409,PHX,MIA,Alec Peters,16,3.16666666666667,3,0.166666666666667,7,6,1,1,0
21700952,1628432,PHX,MIA,Davon Reed,24,4.6,5,-0.4,12,6,6,6,0
21700953,201143,BOS,CHI,Al Horford,98,22.2333333333333,22,0.233333333333334,62,31,31,31,0
21700953,202328,BOS,CHI,Greg Monroe,93,19.3166666666667,19,0.316666666666666,30,41,-11,-9,-2
21700953,202694,BOS,CHI,Marcus Morris,99,22.05,22,0.0499999999999972,42,48,-6,-8,2
21700953,203382,BOS,CHI,Aron Baynes,81,17.6833333333333,18,-0.316666666666666,51,23,28,26,2
21700953,203499,BOS,CHI,Shane Larkin,72,15.9166666666667,16,-0.0833333333333339,48,26,22,20,2
21700953,203935,BOS,CHI,Marcus Smart,118,26.6166666666667,26,0.616666666666667,52,50,2,4,-2
21700953,1626179,BOS,CHI,Terry Rozier,144,31.35,32,-0.649999999999999,58,66,-8,-8,0
21700953,1627759,BOS,CHI,Jaylen Brown,126,28.4833333333333,28,0.483333333333334,76,47,29,29,0
21700953,1627846,BOS,CHI,Abdel Nader,56,12,12,0,19,36,-17,-17,0
21700953,1628369,BOS,CHI,Jayson Tatum,85,19.6833333333333,20,-0.316666666666666,53,28,25,25,0
21700953,1628400,BOS,CHI,Semi Ojeleye,32,6.58333333333333,7,-0.416666666666666,8,17,-9,-7,-2
21700953,1628464,BOS,CHI,Daniel Theis,81,18.0833333333333,18,0.0833333333333322,26,32,-6,-6,0
21700953,203897,CHI,BOS,Zach LaVine,118,26.9,27,-0.100000000000001,39,68,-29,-29,0
21700953,203943,CHI,BOS,Noah Vonleh,79,16.6333333333333,17,-0.366666666666667,40,27,13,13,0
21700953,204067,CHI,BOS,Jarell Eddie,14,3.13333333333333,3,0.133333333333333,13,2,11,10,1
21700953,1626166,CHI,BOS,Cameron Payne,93,19.7666666666667,20,-0.233333333333334,41,33,8,10,-2
21700953,1626170,CHI,BOS,Jerian Grant,37,7.98333333333333,8,-0.0166666666666675,22,12,10,12,-2
21700953,1626171,CHI,BOS,Bobby Portis,119,27.0666666666667,27,0.0666666666666664,37,70,-33,-33,0
21700953,1626245,CHI,BOS,Cristiano Felicio,103,22,22,0,53,37,16,16,0
21700953,1627739,CHI,BOS,Kris Dunn,124,28.2333333333333,28,0.233333333333334,48,72,-24,-26,2
21700953,1627756,CHI,BOS,Denzel Valentine,133,28.9,29,-0.100000000000001,53,58,-5,-2,-3
21700953,1628021,CHI,BOS,David Nwaba,132,29.0833333333333,30,-0.916666666666668,51,70,-19,-23,4
21700953,1628374,CHI,BOS,Lauri Markkanen,133,30.3,30,0.300000000000001,48,76,-28,-28,0
21700954,1938,SAS,MEM,Manu Ginobili,89,20.2333333333333,20,0.233333333333334,44,32,12,14,-2
21700954,2200,SAS,MEM,Pau Gasol,103,23.6333333333333,24,-0.366666666666667,46,43,3,5,-2
21700954,2225,SAS,MEM,Tony Parker,124,26.1,26,0.100000000000001,59,50,9,8,1
21700954,200746,SAS,MEM,LaMarcus Aldridge,135,31.4166666666667,31,0.416666666666664,63,73,-10,-9,-1
21700954,200752,SAS,MEM,Rudy Gay,62,14.4833333333333,14,0.483333333333333,26,29,-3,-6,3
21700954,201980,SAS,MEM,Danny Green,121,25.8666666666667,26,-0.133333333333333,54,53,1,-1,2
21700954,201988,SAS,MEM,Patty Mills,98,23.1,23,0.100000000000001,44,52,-8,-8,0
21700954,202722,SAS,MEM,Davis Bertans,88,19.15,19,0.149999999999999,50,35,15,16,-1
21700954,203530,SAS,MEM,Joffrey Lauvergne,31,7.1,7,0.0999999999999996,14,14,0,-1,1
21700954,203937,SAS,MEM,Kyle Anderson,112,25.7833333333333,26,-0.216666666666669,55,59,-4,-4,0
21700954,1627749,SAS,MEM,Dejounte Murray,73,18.15,18,0.149999999999999,32,39,-7,-5,-2
21700954,1627854,SAS,MEM,Bryn Forbes,19,4.98333333333333,5,-0.0166666666666666,13,11,2,1,1
21700954,201188,MEM,SAS,Marc Gasol,165,36.9333333333333,37,-0.0666666666666629,76,74,2,2,0
21700954,202718,MEM,SAS,Chandler Parsons,63,15.25,15,0.25,30,27,3,1,2
21700954,203210,MEM,SAS,JaMychal Green,148,33.4666666666667,33,0.466666666666669,70,68,2,-1,3
21700954,1627738,MEM,SAS,Deyonta Davis,46,11.0666666666667,11,0.0666666666666664,22,26,-4,-4,0
21700954,1627782,MEM,SAS,Wayne Selden,59,14.7833333333333,15,-0.216666666666667,35,31,4,3,1
21700954,1627988,MEM,SAS,Myke Henry,129,28.0833333333333,28,0.0833333333333357,55,55,0,1,-1
21700954,1628397,MEM,SAS,Ivan Rabb,63,14.5333333333333,15,-0.466666666666667,28,32,-4,-1,-3
21700954,1628415,MEM,SAS,Dillon Brooks,156,34.55,35,-0.450000000000003,72,77,-5,-3,-2
21700954,1628424,MEM,SAS,Kobi Simmons,108,25.85,26,-0.149999999999999,53,51,2,3,-1
21700954,1628504,MEM,SAS,Xavier Rathan-Mayes,118,25.4833333333333,26,-0.516666666666666,49,59,-10,-11,1
21700955,201571,ORL,UTA,D.J. Augustin,119,28.85,29,-0.149999999999999,49,61,-12,-12,0
21700955,202687,ORL,UTA,Bismack Biyombo,72,15.85,16,-0.15,28,23,5,4,1
21700955,202696,ORL,UTA,Nikola Vucevic,132,31.8833333333333,32,-0.116666666666667,52,71,-19,-18,-1
21700955,202714,ORL,UTA,Shelvin Mack,91,20.4833333333333,20,0.483333333333334,34,38,-4,-4,0
21700955,203095,ORL,UTA,Evan Fournier,134,31.9333333333333,32,-0.06666666666667,57,67,-10,-10,0
21700955,203613,ORL,UTA,Jonathon Simmons,118,28,29,-1,50,57,-7,-11,4
21700955,203932,ORL,UTA,Aaron Gordon,136,32.55,33,-0.450000000000003,54,68,-14,-14,0
21700955,1626209,ORL,UTA,Mario Hezonja,91,19.9833333333333,20,-0.0166666666666657,31,35,-4,-4,0
21700955,1628371,ORL,UTA,Jonathan Isaac,80,18.0166666666667,18,0.0166666666666657,31,33,-2,0,-2
21700955,1628411,ORL,UTA,Wes Iwundu,47,11.1166666666667,11,0.116666666666667,14,17,-3,-1,-2
21700955,201937,UTA,ORL,Ricky Rubio,145,35.0666666666667,35,0.0666666666666629,76,56,20,16,4
21700955,201973,UTA,ORL,Jonas Jerebko,88,20.3,20,0.299999999999997,40,30,10,12,-2
21700955,202327,UTA,ORL,Ekpe Udoh,53,11.1333333333333,11,0.133333333333333,11,19,-8,-8,0
21700955,202692,UTA,ORL,Alec Burks,31,6.1,6,0.0999999999999996,6,11,-5,-5,0
21700955,203109,UTA,ORL,Jae Crowder,116,27.4333333333333,28,-0.566666666666666,54,50,4,4,0
21700955,203497,UTA,ORL,Rudy Gobert,151,36.6,37,-0.400000000000006,83,61,22,22,0
21700955,203526,UTA,ORL,Raul Neto,32,6.65,7,-0.35,7,11,-4,-3,-1
21700955,204060,UTA,ORL,Joe Ingles,156,37.8666666666667,38,-0.133333333333333,79,65,14,15,-1
21700955,1626220,UTA,ORL,Royce O'Neale,79,17.45,17,0.449999999999999,27,28,-1,0,-1
21700955,1628378,UTA,ORL,Donovan Mitchell,169,40.0666666666667,41,-0.933333333333337,87,69,18,17,1
21700956,201572,LAL,POR,Brook Lopez,131,26.7833333333333,26,0.783333333333331,55,52,3,3,0
21700956,202738,LAL,POR,Isaiah Thomas,151,30.4166666666667,30,0.416666666666664,64,87,-23,-17,-6
21700956,203484,LAL,POR,Kentavious Caldwell-Pope,197,40.9166666666667,41,-0.0833333333333357,91,81,10,10,0
21700956,203898,LAL,POR,Tyler Ennis,27,5.61666666666667,6,-0.383333333333334,15,20,-5,-5,0
21700956,203944,LAL,POR,Julius Randle,158,33.6666666666667,34,-0.333333333333329,71,66,5,7,-2
21700956,204037,LAL,POR,Travis Wear,74,16.1166666666667,16,0.116666666666667,35,42,-7,-9,2
21700956,1627826,LAL,POR,Ivica Zubac,79,16.0333333333333,16,0.0333333333333314,36,48,-12,-12,0
21700956,1628366,LAL,POR,Lonzo Ball,157,32.7,33,-0.300000000000004,66,69,-3,-7,4
21700956,1628398,LAL,POR,Kyle Kuzma,181,37.6666666666667,38,-0.333333333333336,82,75,7,5,2
21700956,202323,POR,LAL,Evan Turner,111,22.6833333333333,23,-0.316666666666666,38,47,-9,-9,0
21700956,202329,POR,LAL,Al-Farouq Aminu,155,31.8833333333333,32,-0.116666666666667,78,61,17,19,-2
21700956,202334,POR,LAL,Ed Davis,75,15.9833333333333,16,-0.0166666666666675,36,43,-7,-9,2
21700956,203081,POR,LAL,Damian Lillard,188,38.8666666666667,39,-0.133333333333333,85,84,1,6,-5
21700956,203086,POR,LAL,Meyers Leonard,47,9.56666666666667,9,0.566666666666666,13,22,-9,-7,-2
21700956,203468,POR,LAL,CJ McCollum,185,38.1333333333333,38,0.133333333333333,79,76,3,3,0
21700956,203894,POR,LAL,Shabazz Napier,127,26.8833333333333,27,-0.116666666666667,78,63,15,13,2
21700956,203994,POR,LAL,Jusuf Nurkic,140,29.25,29,0.25,64,54,10,10,0
21700956,1626192,POR,LAL,Pat Connaughton,85,17.4833333333333,18,-0.516666666666666,46,39,7,4,3
21700956,1628380,POR,LAL,Zach Collins,42,9.18333333333333,9,0.183333333333334,23,26,-3,-5,2
21700957,101141,PHI,CHA,Ersan Ilyasova,104,23.3333333333333,24,-0.666666666666668,67,48,19,19,0
21700957,101161,PHI,CHA,Amir Johnson,54,12.7333333333333,13,-0.266666666666666,38,26,12,11,1
21700957,200755,PHI,CHA,JJ Redick,111,23.0166666666667,24,-0.983333333333334,61,65,-4,-5,1
21700957,201158,PHI,CHA,Marco Belinelli,124,28.75,28,0.75,81,57,24,26,-2
21700957,203496,PHI,CHA,Robert Covington,140,29.7833333333333,30,-0.216666666666669,75,73,2,2,0
21700957,203954,PHI,CHA,Joel Embiid,134,28.6166666666667,29,-0.383333333333333,74,78,-4,-5,1
21700957,203967,PHI,CHA,Dario Saric,134,28.0333333333333,28,0.0333333333333314,73,72,1,3,-2
21700957,204456,PHI,CHA,T.J. McConnell,108,23.8666666666667,24,-0.133333333333333,64,59,5,5,0
21700957,1626147,PHI,CHA,Justin Anderson,8,1.8,2,-0.2,2,4,-2,-2,0
21700957,1626158,PHI,CHA,Richaun Holmes,12,2.81666666666667,3,-0.183333333333334,4,4,0,0,0
21700957,1627732,PHI,CHA,Ben Simmons,154,33.2666666666667,33,0.266666666666666,97,80,17,16,1
21700957,1627789,PHI,CHA,Timothe Luwawu-Cabarrot,12,2.81666666666667,3,-0.183333333333334,4,4,0,0,0
21700957,2730,CHA,PHI,Dwight Howard,144,30.4,30,0.399999999999999,74,84,-10,-10,0
21700957,101107,CHA,PHI,Marvin Williams,115,23.9333333333333,24,-0.0666666666666664,61,66,-5,-4,-1
21700957,201587,CHA,PHI,Nicolas Batum,146,31.45,31,0.449999999999999,78,89,-11,-11,0
21700957,202689,CHA,PHI,Kemba Walker,163,34.95,35,-0.0499999999999972,79,100,-21,-19,-2
21700957,202933,CHA,PHI,Julyan Stone,14,3.13333333333333,3,0.133333333333333,6,4,2,2,0
21700957,203077,CHA,PHI,Michael Kidd-Gilchrist,63,14.1833333333333,14,0.183333333333334,29,37,-8,-10,2
21700957,203087,CHA,PHI,Jeremy Lamb,79,18.0333333333333,18,0.0333333333333314,42,47,-5,-6,1
21700957,203469,CHA,PHI,Cody Zeller,61,14.2333333333333,14,0.233333333333334,34,40,-6,-6,0
21700957,1626163,CHA,PHI,Frank Kaminsky,90,20.7,21,-0.300000000000001,47,58,-11,-12,1
21700957,1626195,CHA,PHI,Willy Hernangomez,14,3.13333333333333,3,0.133333333333333,6,4,2,2,0
21700957,1626203,CHA,PHI,Treveon Graham,114,24.3666666666667,25,-0.633333333333333,59,65,-6,-3,-3
21700957,1628370,CHA,PHI,Malik Monk,67,15.1833333333333,16,-0.816666666666666,40,32,8,6,2
21700957,1628407,CHA,PHI,Dwayne Bacon,25,5.13333333333333,5,0.133333333333333,15,14,1,1,0
21700958,203101,ATL,TOR,Miles Plumlee,79,14.2,14,0.199999999999999,27,37,-10,-14,4
21700958,203145,ATL,TOR,Kent Bazemore,128,27.95,28,-0.0499999999999972,53,57,-4,-4,0
21700958,203471,ATL,TOR,Dennis Schroder,131,27.0833333333333,28,-0.916666666666664,52,58,-6,-10,4
21700958,203473,ATL,TOR,Dewayne Dedmon,124,26.5833333333333,27,-0.416666666666664,60,55,5,7,-2
21700958,203488,ATL,TOR,Mike Muscala,99,18.7333333333333,19,-0.266666666666666,33,46,-13,-13,0
21700958,203705,ATL,TOR,Josh Magette,13,2.55,3,-0.45,5,7,-2,1,-3
21700958,1627752,ATL,TOR,Taurean Prince,137,29.25,29,0.25,54,57,-3,-2,-1
21700958,1627819,ATL,TOR,Isaiah Taylor,95,19.3166666666667,19,0.31666666666667,34,46,-12,-5,-7
21700958,1628381,ATL,TOR,John Collins,130,28.5166666666667,29,-0.483333333333334,54,60,-6,-6,0
21700958,1628416,ATL,TOR,Tyler Dorsey,123,24.65,25,-0.350000000000001,38,59,-21,-21,0
21700958,1628537,ATL,TOR,Jaylen Morris,101,19.5833333333333,20,-0.416666666666664,35,48,-13,-13,0
21700958,101139,TOR,ATL,CJ Miles,134,27.0333333333333,27,0.0333333333333314,64,41,23,22,1
21700958,200768,TOR,ATL,Kyle Lowry,105,22.7,23,-0.299999999999997,54,49,5,5,0
21700958,201586,TOR,ATL,Serge Ibaka,124,25.3,25,0.300000000000001,58,57,1,0,1
21700958,201942,TOR,ATL,DeMar DeRozan,130,27.25,28,-0.75,65,53,12,17,-5
21700958,202685,TOR,ATL,Jonas Valanciunas,121,25.75,26,-0.25,53,57,-4,-4,0
21700958,203512,TOR,ATL,Lucas Nogueira,8,1.16666666666667,1,0.166666666666667,2,3,-1,-1,0
21700958,1626153,TOR,ATL,Delon Wright,92,18.85,18,0.850000000000001,39,32,7,0,7
21700958,1626181,TOR,ATL,Norman Powell,34,6.76666666666667,7,-0.233333333333333,16,12,4,6,-2
21700958,1626259,TOR,ATL,Malcolm Miller,68,14.2166666666667,15,-0.783333333333333,28,32,-4,-4,0
21700958,1627751,TOR,ATL,Jakob Poeltl,103,20.7666666666667,21,-0.233333333333334,51,29,22,21,1
21700958,1627783,TOR,ATL,Pascal Siakam,90,18.4666666666667,18,0.466666666666669,37,27,10,10,0
21700958,1627832,TOR,ATL,Fred VanVleet,143,28.9833333333333,29,-0.0166666666666657,61,50,11,9,2
21700958,1628035,TOR,ATL,Alfonzo McKinnie,8,1.16666666666667,1,0.166666666666667,2,3,-1,-1,0
21700959,2548,MIA,WAS,Dwyane Wade,132,28.45,28,0.449999999999999,66,53,13,12,1
21700959,201609,MIA,WAS,Goran Dragic,158,35.8333333333333,36,-0.166666666666671,71,78,-7,-12,5
21700959,201949,MIA,WAS,James Johnson,64,14.2166666666667,14,0.216666666666667,29,43,-14,-14,0
21700959,202337,MIA,WAS,Luke Babbitt,25,5.55,6,-0.45,7,18,-11,-11,0
21700959,202355,MIA,WAS,Hassan Whiteside,94,21.5,21,0.5,42,59,-17,-17,0
21700959,203482,MIA,WAS,Kelly Olynyk,112,24.9666666666667,25,-0.0333333333333314,60,45,15,18,-3
21700959,203585,MIA,WAS,Rodney McGruder,81,18.6,19,-0.399999999999999,45,38,7,8,-1
21700959,204020,MIA,WAS,Tyler Johnson,172,38.3333333333333,38,0.333333333333329,87,84,3,5,-2
21700959,1626159,MIA,WAS,Justise Winslow,170,38.6833333333333,38,0.683333333333337,84,74,10,12,-2
21700959,1626196,MIA,WAS,Josh Richardson,156,35.1,35,0.0999999999999943,68,86,-18,-20,2
21700959,1628389,MIA,WAS,Bam Adebayo,16,3.76666666666667,4,-0.233333333333333,6,7,-1,-1,0
21700959,101133,WAS,MIA,Ian Mahinmi,20,4.38333333333333,4,0.383333333333333,2,12,-10,-10,0
21700959,101162,WAS,MIA,Marcin Gortat,100,22.8166666666667,23,-0.183333333333334,56,48,8,8,0
21700959,201160,WAS,MIA,Jason Smith,15,3.45,4,-0.55,8,9,-1,-1,0
21700959,201196,WAS,MIA,Ramon Sessions,62,14.0333333333333,13,1.03333333333333,23,36,-13,-17,4
21700959,201975,WAS,MIA,Jodie Meeks,50,10.1166666666667,10,0.116666666666667,19,27,-8,-8,0
21700959,202693,WAS,MIA,Markieff Morris,185,41.6166666666667,42,-0.38333333333334,97,82,15,17,-2
21700959,203078,WAS,MIA,Bradley Beal,190,42.7,43,-0.299999999999997,99,86,13,15,-2
21700959,203107,WAS,MIA,Tomas Satoransky,177,39.3833333333333,40,-0.616666666666667,98,77,21,21,0
21700959,203118,WAS,MIA,Mike Scott,118,27.0333333333333,27,0.0333333333333314,56,55,1,1,0
21700959,203490,WAS,MIA,Otto Porter Jr.,136,31.2833333333333,32,-0.716666666666669,75,73,2,4,-2
21700959,1626162,WAS,MIA,Kelly Oubre Jr.,127,28.1833333333333,28,0.183333333333334,52,60,-8,-10,2
21700960,2403,HOU,OKC,Nene,77,16.6333333333333,17,-0.366666666666667,45,31,14,16,-2
21700960,2772,HOU,OKC,Trevor Ariza,159,32.75,33,-0.25,81,87,-6,-6,0
21700960,101108,HOU,OKC,Chris Paul,153,32.1333333333333,33,-0.866666666666667,79,68,11,11,0
21700960,101123,HOU,OKC,Gerald Green,70,15.05,15,0.0500000000000007,41,25,16,16,0
21700960,200782,HOU,OKC,PJ Tucker,129,26.1833333333333,26,0.18333333333333,69,67,2,2,0
21700960,201569,HOU,OKC,Eric Gordon,144,28.9833333333333,29,-0.0166666666666657,80,72,8,8,0
21700960,201601,HOU,OKC,Luc Mbah a Moute,109,23.6666666666667,24,-0.333333333333332,55,47,8,6,2
21700960,201935,HOU,OKC,James Harden,176,36.05,36,0.0499999999999972,94,91,3,3,0
21700960,203991,HOU,OKC,Clint Capela,128,27.55,27,0.550000000000001,66,72,-6,-6,0
21700960,2546,OKC,HOU,Carmelo Anthony,159,33.0333333333333,33,0.0333333333333314,87,85,2,6,-4
21700960,101109,OKC,HOU,Raymond Felton,47,9.98333333333333,10,-0.0166666666666657,17,22,-5,-7,2
21700960,201147,OKC,HOU,Corey Brewer,111,22.9,23,-0.100000000000001,51,67,-16,-20,4
21700960,201566,OKC,HOU,Russell Westbrook,191,39.4,39,0.399999999999999,100,104,-4,-4,0
21700960,202331,OKC,HOU,Paul George,188,38.6,38,0.600000000000001,97,101,-4,-2,-2
21700960,202335,OKC,HOU,Patrick Patterson,49,10.35,11,-0.649999999999999,15,26,-11,-11,0
21700960,203500,OKC,HOU,Steven Adams,185,38.4,38,0.399999999999999,97,100,-3,-3,0
21700960,203518,OKC,HOU,Alex Abrines,1,0.0833333333333333,0,0.0833333333333333,,0,,0,
21700960,203924,OKC,HOU,Jerami Grant,99,19.9333333333333,20,-0.06666666666667,46,49,-3,-3,0
21700960,203962,OKC,HOU,Josh Huestis,83,18.7,19,-0.300000000000001,40,39,1,1,0
21700960,1626177,OKC,HOU,Dakari Johnson,1,0.0833333333333333,0,0.0833333333333333,,0,,0,
21700960,1628390,OKC,HOU,Terrance Ferguson,31,7.53333333333333,8,-0.466666666666667,10,17,-7,-7,0
21700961,1717,DAL,DEN,Dirk Nowitzki,112,22.45,22,0.449999999999999,59,58,1,0,1
21700961,200826,DAL,DEN,J.J. Barea,118,22.7,23,-0.300000000000001,51,59,-8,-8,0
21700961,203084,DAL,DEN,Harrison Barnes,157,31.7333333333333,32,-0.266666666666666,76,61,15,12,3
21700961,203457,DAL,DEN,Nerlens Noel,128,25.4333333333333,26,-0.566666666666666,59,49,10,11,-1
21700961,203926,DAL,DEN,Doug McDermott,135,26.5333333333333,27,-0.466666666666669,67,57,10,12,-2
21700961,203939,DAL,DEN,Dwight Powell,119,24.0833333333333,24,0.0833333333333322,64,62,2,3,-1
21700961,1627812,DAL,DEN,Yogi Ferrell,188,38.0333333333333,38,0.0333333333333314,99,83,16,19,-3
21700961,1627858,DAL,DEN,Kyle Collinsworth,74,13.85,13,0.85,29,38,-9,-11,2
21700961,1628372,DAL,DEN,Dennis Smith Jr.,169,34.6,35,-0.400000000000006,86,68,18,17,1
21700961,2734,DEN,DAL,Devin Harris,115,22.1166666666667,22,0.116666666666667,55,50,5,6,-1
21700961,200794,DEN,DAL,Paul Millsap,94,19.5666666666667,20,-0.433333333333334,36,49,-13,-14,1
21700961,201163,DEN,DAL,Wilson Chandler,158,31.7666666666667,32,-0.233333333333334,65,84,-19,-18,-1
21700961,203115,DEN,DAL,Will Barton,156,30.6666666666667,31,-0.333333333333336,70,75,-5,-4,-1
21700961,203486,DEN,DAL,Mason Plumlee,94,18.4333333333333,18,0.43333333333333,45,39,6,5,1
21700961,203914,DEN,DAL,Gary Harris,156,31.6833333333333,32,-0.316666666666666,63,82,-19,-21,2
21700961,203999,DEN,DAL,Nikola Jokic,126,25.55,26,-0.449999999999999,59,69,-10,-8,-2
21700961,1626168,DEN,DAL,Trey Lyles,98,18.65,18,0.649999999999999,48,44,4,5,-1
21700961,1627736,DEN,DAL,Malik Beasley,87,17.1,17,0.100000000000001,42,34,8,6,2
21700961,1627750,DEN,DAL,Jamal Murray,116,23.8833333333333,24,-0.116666666666667,52,64,-12,-12,0
21700962,201563,NYK,POR,Michael Beasley,115,25.1,25,0.100000000000001,41,56,-15,-16,1
21700962,202498,NYK,POR,Lance Thomas,90,19.5333333333333,20,-0.466666666666669,39,47,-8,-7,-1
21700962,202683,NYK,POR,Enes Kanter,121,26.75,27,-0.25,53,63,-10,-11,1
21700962,203124,NYK,POR,Kyle O'Quinn,84,17.8833333333333,18,-0.116666666666667,27,40,-13,-12,-1
21700962,203501,NYK,POR,Tim Hardaway Jr.,161,35.4166666666667,35,0.416666666666671,65,89,-24,-26,2
21700962,203504,NYK,POR,Trey Burke,93,19.95,20,-0.0499999999999972,34,44,-10,-10,0
21700962,1626144,NYK,POR,Emmanuel Mudiay,118,25.7666666666667,26,-0.233333333333334,51,67,-16,-13,-3
21700962,1627786,NYK,POR,Troy Williams,74,16.35,16,0.349999999999998,30,25,5,2,3
21700962,1628373,NYK,POR,Frank Ntilikina,124,27.5833333333333,28,-0.416666666666664,54,64,-10,-12,2
21700962,1628422,NYK,POR,Damyean Dotson,87,18.2333333333333,18,0.233333333333334,27,44,-17,-13,-4
21700962,1628436,NYK,POR,Luke Kornet,14,3.13333333333333,3,0.133333333333333,7,8,-1,-1,0
21700962,1628439,NYK,POR,Isaiah Hicks,14,3.13333333333333,3,0.133333333333333,7,8,-1,-1,0
21700962,202323,POR,NYK,Evan Turner,95,20.4166666666667,21,-0.583333333333336,49,41,8,7,1
21700962,202329,POR,NYK,Al-Farouq Aminu,116,25.3166666666667,25,0.316666666666666,63,54,9,9,0
21700962,202334,POR,NYK,Ed Davis,123,26.7166666666667,26,0.716666666666669,55,48,7,11,-4
21700962,203081,POR,NYK,Damian Lillard,147,31.5,32,-0.5,80,66,14,14,0
21700962,203468,POR,NYK,CJ McCollum,159,34.6833333333333,35,-0.316666666666663,76,57,19,19,0
21700962,203894,POR,NYK,Shabazz Napier,121,26.5333333333333,26,0.533333333333331,60,44,16,14,2
21700962,203994,POR,NYK,Jusuf Nurkic,83,18.15,19,-0.850000000000001,48,32,16,14,2
21700962,1626192,POR,NYK,Pat Connaughton,108,24.1333333333333,24,0.133333333333333,52,39,13,18,-5
21700962,1627735,POR,NYK,Wade Baldwin IV,13,2.9,3,-0.1,8,7,1,-1,2
21700962,1627774,POR,NYK,Jake Layman,14,3.13333333333333,3,0.133333333333333,8,7,1,1,0
21700962,1628380,POR,NYK,Zach Collins,103,22.45,23,-0.549999999999997,48,33,15,15,0
21700962,1628403,POR,NYK,Caleb Swanigan,13,2.9,3,-0.1,8,7,1,-1,2
21700963,2733,GSW,BKN,Shaun Livingston,64,14.7,15,-0.300000000000001,28,33,-5,-5,0
21700963,2738,GSW,BKN,Andre Iguodala,117,25.2333333333333,26,-0.766666666666666,67,55,12,12,0
21700963,201142,GSW,BKN,Kevin Durant,154,34.7166666666667,35,-0.283333333333331,72,74,-2,-3,1
21700963,201156,GSW,BKN,Nick Young,68,14.1,14,0.0999999999999996,36,33,3,2,1
21700963,201580,GSW,BKN,JaVale McGee,66,14.7666666666667,15,-0.233333333333333,33,30,3,3,0
21700963,201939,GSW,BKN,Stephen Curry,155,33.7833333333333,34,-0.216666666666669,88,75,13,11,2
21700963,202691,GSW,BKN,Klay Thompson,171,38.3,38,0.299999999999997,85,78,7,8,-1
21700963,203110,GSW,BKN,Draymond Green,162,36.5333333333333,37,-0.466666666666669,83,76,7,6,1
21700963,1626172,GSW,BKN,Kevon Looney,74,15.6833333333333,16,-0.316666666666666,34,29,5,5,0
21700963,1626188,GSW,BKN,Quinn Cook,8,1.28333333333333,1,0.283333333333333,3,3,0,2,-2
21700963,1628395,GSW,BKN,Jordan Bell,51,10.4,10,0.4,41,19,22,24,-2
21700963,201960,BKN,GSW,DeMarre Carroll,125,27.8833333333333,28,-0.116666666666667,57,67,-10,-11,1
21700963,201967,BKN,GSW,Dante Cunningham,111,24.0666666666667,24,0.0666666666666664,48,65,-17,-19,2
21700963,203112,BKN,GSW,Quincy Acy,16,2.9,3,-0.1,5,4,1,1,0
21700963,203459,BKN,GSW,Allen Crabbe,129,28.3333333333333,28,0.333333333333332,58,66,-8,-9,1
21700963,203915,BKN,GSW,Spencer Dinwiddie,141,30.45,30,0.449999999999999,62,73,-11,-12,1
21700963,203925,BKN,GSW,Joe Harris,103,22.8166666666667,23,-0.183333333333334,45,61,-16,-18,2
21700963,1626156,BKN,GSW,D'Angelo Russell,147,33.85,34,-0.150000000000006,75,78,-3,0,-3
21700963,1626178,BKN,GSW,Rondae Hollis-Jefferson,113,24.7,25,-0.299999999999997,55,57,-2,-1,-1
21700963,1627747,BKN,GSW,Caris LeVert,117,24.8,25,-0.199999999999999,54,60,-6,-5,-1
21700963,1628386,BKN,GSW,Jarrett Allen,88,19.7,20,-0.300000000000001,46,39,7,9,-2
21700964,2731,NOP,LAC,Emeka Okafor,104,21.1166666666667,21,0.116666666666667,61,38,23,22,1
21700964,200765,NOP,LAC,Rajon Rondo,147,29.2833333333333,29,0.283333333333331,77,67,10,9,1
21700964,201950,NOP,LAC,Jrue Holiday,188,36.1833333333333,36,0.18333333333333,101,84,17,17,0
21700964,202703,NOP,LAC,Nikola Mirotic,127,24.9666666666667,25,-0.0333333333333314,55,68,-13,-10,-3
21700964,202734,NOP,LAC,E'Twaun Moore,182,34.8666666666667,35,-0.133333333333333,100,77,23,24,-1
21700964,203076,NOP,LAC,Anthony Davis,198,37.3166666666667,37,0.316666666666663,96,93,3,3,0
21700964,203121,NOP,LAC,Darius Miller,135,25.1333333333333,25,0.133333333333333,51,68,-17,-16,-1
21700964,203546,NOP,LAC,Ian Clark,136,25.6666666666667,25,0.666666666666664,53,69,-16,-19,3
21700964,1627767,NOP,LAC,Cheick Diallo,28,5.38333333333333,5,0.383333333333333,11,16,-5,-5,0
21700964,101150,LAC,NOP,Lou Williams,183,34.5333333333333,34,0.533333333333331,100,75,25,27,-2
21700964,201599,LAC,NOP,DeAndre Jordan,142,27.8333333333333,28,-0.166666666666664,60,81,-21,-21,0
21700964,202325,LAC,NOP,Wesley Johnson,38,6.78333333333333,7,-0.216666666666667,12,23,-11,-11,0
21700964,202699,LAC,NOP,Tobias Harris,195,38.1,38,0.100000000000001,85,97,-12,-11,-1
21700964,203085,LAC,NOP,Austin Rivers,201,39.3333333333333,40,-0.666666666666671,98,103,-5,-5,0
21700964,203930,LAC,NOP,Sean Kilpatrick,19,3.53333333333333,4,-0.466666666666667,8,10,-2,-2,0
21700964,1626149,LAC,NOP,Montrezl Harrell,161,30.6833333333333,31,-0.31666666666667,86,70,16,16,0
21700964,1626155,LAC,NOP,Sam Dekker,17,3.23333333333333,3,0.233333333333333,9,8,1,1,0
21700964,1628414,LAC,NOP,Sindarius Thornwell,143,28.15,28,0.149999999999999,66,56,10,7,3
21700964,1628462,LAC,NOP,Milos Teodosic,146,27.7333333333333,27,0.733333333333334,56,82,-26,-26,0
21700965,201152,IND,UTA,Thaddeus Young,137,30.3166666666667,31,-0.683333333333337,65,63,2,0,2
21700965,202344,IND,UTA,Trevor Booker,62,13.75,14,-0.25,15,33,-18,-16,-2
21700965,202362,IND,UTA,Lance Stephenson,66,13.8,13,0.800000000000001,21,40,-19,-19,0
21700965,202709,IND,UTA,Cory Joseph,167,37.45,38,-0.549999999999997,75,85,-10,-10,0
21700965,202711,IND,UTA,Bojan Bogdanovic,146,32.3166666666667,33,-0.683333333333337,58,70,-12,-12,0
21700965,203506,IND,UTA,Victor Oladipo,144,33.2166666666667,34,-0.783333333333331,65,69,-4,-2,-2
21700965,203922,IND,UTA,Glenn Robinson III,53,12.6333333333333,13,-0.366666666666667,19,26,-7,-7,0
21700965,1626167,IND,UTA,Myles Turner,132,29.75,30,-0.25,63,61,2,2,0
21700965,1626202,IND,UTA,Joe Young,49,10.7666666666667,10,0.766666666666666,11,19,-8,-10,2
21700965,1627734,IND,UTA,Domantas Sabonis,81,18.5,18,0.5,22,48,-26,-26,0
21700965,1627816,IND,UTA,Alex Poythress,14,3.41666666666667,3,0.416666666666667,3,3,0,0,0
21700965,1628388,IND,UTA,TJ Leaf,14,3.41666666666667,3,0.416666666666667,3,3,0,0,0
21700965,201937,UTA,IND,Ricky Rubio,143,32.55,33,-0.450000000000003,65,65,0,0,0
21700965,201973,UTA,IND,Jonas Jerebko,57,12.2333333333333,12,0.233333333333334,33,16,17,17,0
21700965,202324,UTA,IND,Derrick Favors,112,25.4333333333333,26,-0.566666666666666,48,45,3,5,-2
21700965,202327,UTA,IND,Ekpe Udoh,7,1.33333333333333,1,0.333333333333333,3,3,0,0,0
21700965,203109,UTA,IND,Jae Crowder,127,28.7666666666667,28,0.766666666666666,63,46,17,17,0
21700965,203497,UTA,IND,Rudy Gobert,169,38.4166666666667,39,-0.583333333333336,86,71,15,15,0
21700965,203526,UTA,IND,Raul Neto,42,8.73333333333333,9,-0.266666666666668,24,9,15,15,0
21700965,204060,UTA,IND,Joe Ingles,153,34.7833333333333,35,-0.216666666666669,82,58,24,22,2
21700965,1626220,UTA,IND,Royce O'Neale,90,19.6333333333333,20,-0.366666666666667,39,33,6,6,0
21700965,1628378,UTA,IND,Donovan Mitchell,158,36.1166666666667,36,0.11666666666666,74,71,3,3,0
21700965,1628396,UTA,IND,Tony Bradley,7,1.33333333333333,1,0.333333333333333,3,3,0,0,0
21700966,101139,TOR,DET,CJ Miles,103,21.8166666666667,22,-0.18333333333333,50,48,2,6,-4
21700966,200768,TOR,DET,Kyle Lowry,199,41.2666666666667,41,0.266666666666666,104,95,9,13,-4
21700966,201586,TOR,DET,Serge Ibaka,60,12.05,12,0.0500000000000007,21,27,-6,-7,1
21700966,201942,TOR,DET,DeMar DeRozan,210,43.55,43,0.549999999999997,110,102,8,9,-1
21700966,202685,TOR,DET,Jonas Valanciunas,154,31.6166666666667,31,0.616666666666667,70,76,-6,-1,-5
21700966,203512,TOR,DET,Lucas Nogueira,20,4.08333333333333,4,0.083333333333333,14,11,3,1,2
21700966,1626153,TOR,DET,Delon Wright,30,6.96666666666667,7,-0.0333333333333332,6,19,-13,-13,0
21700966,1626181,TOR,DET,Norman Powell,137,28.3166666666667,28,0.316666666666666,72,60,12,12,0
21700966,1626259,TOR,DET,Malcolm Miller,18,4.35,5,-0.65,7,6,1,1,0
21700966,1627751,TOR,DET,Jakob Poeltl,75,17.3,18,-0.700000000000003,37,32,5,2,3
21700966,1627783,TOR,DET,Pascal Siakam,127,28.6833333333333,28,0.683333333333334,70,66,4,1,3
21700966,1627832,TOR,DET,Fred VanVleet,112,25,25,0,44,53,-9,-14,5
21700966,201229,DET,TOR,Anthony Tolliver,68,15.1833333333333,15,0.183333333333334,29,32,-3,-4,1
21700966,201933,DET,TOR,Blake Griffin,183,37.9166666666667,38,-0.0833333333333357,91,91,0,-1,1
21700966,202397,DET,TOR,Ish Smith,181,37.3666666666667,38,-0.63333333333334,89,91,-2,-1,-1
21700966,202779,DET,TOR,Dwight Buycks,68,15.6333333333333,15,0.633333333333333,30,30,0,-1,1
21700966,203083,DET,TOR,Andre Drummond,180,37.4666666666667,37,0.466666666666669,82,97,-15,-14,-1
21700966,203493,DET,TOR,Reggie Bullock,192,39,39,0,85,103,-18,-18,0
21700966,203516,DET,TOR,James Ennis III,165,36.05,36,0.0499999999999972,79,82,-3,-3,0
21700966,203961,DET,TOR,Eric Moreland,67,15.4333333333333,16,-0.566666666666666,36,22,14,15,-1
21700966,1628379,DET,TOR,Luke Kennard,141,30.95,31,-0.0500000000000007,74,57,17,17,0
21700967,203200,CHI,MEM,Justin Holiday,75,17.05,17,0.0500000000000007,38,29,9,6,3
21700967,203897,CHI,MEM,Zach LaVine,153,32.95,33,-0.0500000000000043,86,72,14,19,-5
21700967,203943,CHI,MEM,Noah Vonleh,65,13.3,13,0.300000000000001,24,35,-11,-9,-2
21700967,1626166,CHI,MEM,Cameron Payne,77,16.1,16,0.0999999999999979,36,38,-2,-3,1
21700967,1626171,CHI,MEM,Bobby Portis,143,29.4166666666667,30,-0.583333333333336,73,73,0,-1,1
21700967,1626245,CHI,MEM,Cristiano Felicio,83,18.5,18,0.5,46,37,9,10,-1
21700967,1627739,CHI,MEM,Kris Dunn,149,31.8166666666667,32,-0.183333333333337,83,72,11,12,-1
21700967,1627756,CHI,MEM,Denzel Valentine,103,21.6333333333333,21,0.633333333333333,53,58,-5,-2,-3
21700967,1628021,CHI,MEM,David Nwaba,121,24.2,24,0.199999999999999,61,61,0,-5,5
21700967,1628374,CHI,MEM,Lauri Markkanen,161,34.6166666666667,35,-0.383333333333333,95,75,20,18,2
21700967,201188,MEM,CHI,Marc Gasol,124,27.1666666666667,27,0.166666666666664,59,70,-11,-10,-1
21700967,203210,MEM,CHI,JaMychal Green,126,27,27,0,52,71,-19,-17,-2
21700967,203463,MEM,CHI,Ben McLemore,182,37.4,38,-0.600000000000001,84,91,-7,-7,0
21700967,1627738,MEM,CHI,Deyonta Davis,91,18.4,19,-0.600000000000001,49,45,4,3,1
21700967,1627782,MEM,CHI,Wayne Selden,72,15.9666666666667,16,-0.0333333333333332,40,44,-4,-5,1
21700967,1627988,MEM,CHI,Myke Henry,86,18.45,19,-0.549999999999997,38,51,-13,-11,-2
21700967,1628397,MEM,CHI,Ivan Rabb,52,11.35,11,0.35,25,23,2,0,2
21700967,1628415,MEM,CHI,Dillon Brooks,136,28.0833333333333,28,0.0833333333333322,69,67,2,1,1
21700967,1628424,MEM,CHI,Kobi Simmons,132,27.6666666666667,28,-0.333333333333336,66,64,2,1,1
21700967,1628504,MEM,CHI,Xavier Rathan-Mayes,129,28.1,28,0.100000000000001,68,69,-1,0,-1
21700968,2772,HOU,MIL,Trevor Ariza,166,35.4833333333333,36,-0.516666666666666,83,71,12,11,1
21700968,101108,HOU,MIL,Chris Paul,146,33.0833333333333,34,-0.916666666666664,75,63,12,11,1
21700968,101123,HOU,MIL,Gerald Green,59,12.7833333333333,13,-0.216666666666667,31,28,3,4,-1
21700968,200782,HOU,MIL,PJ Tucker,150,33.5166666666667,34,-0.483333333333334,89,69,20,21,-1
21700968,201569,HOU,MIL,Eric Gordon,161,33.5666666666667,33,0.566666666666663,82,74,8,9,-1
21700968,201601,HOU,MIL,Luc Mbah a Moute,144,29.9166666666667,30,-0.0833333333333357,71,67,4,3,1
21700968,201935,HOU,MIL,James Harden,162,34.7166666666667,35,-0.283333333333331,75,70,5,5,0
21700968,203991,HOU,MIL,Clint Capela,80,18.5833333333333,19,-0.416666666666664,34,31,3,3,0
21700968,204028,HOU,MIL,Tarik Black,42,8.1,8,0.0999999999999996,10,22,-12,-12,0
21700968,1891,MIL,HOU,Jason Terry,143,30,30,0,70,64,6,6,0
21700968,202339,MIL,HOU,Eric Bledsoe,155,34.9333333333333,35,-0.0666666666666629,67,84,-17,-17,0
21700968,203089,MIL,HOU,John Henson,80,19.6,20,-0.399999999999999,37,39,-2,-1,-1
21700968,203114,MIL,HOU,Khris Middleton,189,39.7333333333333,40,-0.266666666666666,82,93,-11,-11,0
21700968,203503,MIL,HOU,Tony Snell,115,25.2166666666667,25,0.216666666666669,46,61,-15,-17,2
21700968,203507,MIL,HOU,Giannis Antetokounmpo,177,37.4833333333333,38,-0.516666666666666,76,87,-11,-11,0
21700968,203953,MIL,HOU,Jabari Parker,122,25.6333333333333,25,0.633333333333333,56,61,-5,-6,1
21700968,1628425,MIL,HOU,Sterling Brown,129,27.15,27,0.149999999999999,61,61,0,2,-2
21700969,2731,NOP,SAC,Emeka Okafor,73,16.4166666666667,17,-0.583333333333332,39,31,8,6,2
21700969,200765,NOP,SAC,Rajon Rondo,147,31.4166666666667,32,-0.583333333333336,73,69,4,2,2
21700969,201950,NOP,SAC,Jrue Holiday,154,33.5833333333333,34,-0.416666666666671,81,73,8,8,0
21700969,202703,NOP,SAC,Nikola Mirotic,144,31.15,31,0.149999999999999,81,72,9,11,-2
21700969,202732,NOP,SAC,DeAndre Liggins,34,8.68333333333333,9,-0.316666666666666,10,17,-7,-9,2
21700969,202734,NOP,SAC,E'Twaun Moore,154,34.3333333333333,34,0.333333333333336,85,74,11,13,-2
21700969,203076,NOP,SAC,Anthony Davis,107,22.8666666666667,23,-0.133333333333333,50,42,8,8,0
21700969,203121,NOP,SAC,Darius Miller,132,28.7666666666667,29,-0.233333333333334,76,62,14,16,-2
21700969,203546,NOP,SAC,Ian Clark,96,18.7333333333333,19,-0.266666666666666,52,38,14,14,0
21700969,1627767,NOP,SAC,Cheick Diallo,54,12.3833333333333,12,0.383333333333333,23,27,-4,-4,0
21700969,2216,SAC,NOP,Zach Randolph,121,26.1333333333333,26,0.133333333333333,48,59,-11,-9,-2
21700969,201585,SAC,NOP,Kosta Koufos,95,20.4166666666667,20,0.416666666666664,37,43,-6,-6,0
21700969,202066,SAC,NOP,Garrett Temple,90,19.3333333333333,20,-0.666666666666664,35,49,-14,-14,0
21700969,203960,SAC,NOP,JaKarr Sampson,82,17.7833333333333,18,-0.216666666666669,47,43,4,2,2
21700969,203992,SAC,NOP,Bogdan Bogdanovic,120,26.3833333333333,26,0.383333333333333,48,63,-15,-13,-2
21700969,203998,SAC,NOP,Bruno Caboclo,26,6.06666666666667,6,0.0666666666666664,15,11,4,4,0
21700969,1627741,SAC,NOP,Buddy Hield,140,30.5,31,-0.5,67,76,-9,-8,-1
21700969,1627746,SAC,NOP,Skal Labissiere,124,27.25,28,-0.75,64,71,-7,-7,0
21700969,1628368,SAC,NOP,De'Aaron Fox,24,5.06666666666667,5,0.0666666666666664,12,11,1,1,0
21700969,1628382,SAC,NOP,Justin Jackson,141,30.0333333333333,30,0.0333333333333314,68,69,-1,-4,3
21700969,1628412,SAC,NOP,Frank Mason,132,29.3666666666667,29,0.366666666666667,64,75,-11,-11,0
21700970,2544,CLE,DEN,LeBron James,185,39.0666666666667,39,0.0666666666666629,97,89,8,8,0
21700970,2594,CLE,DEN,Kyle Korver,101,20.8166666666667,21,-0.183333333333334,47,41,6,5,1
21700970,2747,CLE,DEN,JR Smith,117,24.9166666666667,25,-0.0833333333333357,68,62,6,8,-2
21700970,201145,CLE,DEN,Jeff Green,88,17.15,17,0.149999999999999,38,33,5,8,-3
21700970,201588,CLE,DEN,George Hill,144,30.75,31,-0.25,81,72,9,9,0
21700970,203903,CLE,DEN,Jordan Clarkson,96,19.5,20,-0.5,35,43,-8,-8,0
21700970,203918,CLE,DEN,Rodney Hood,139,30.2,31,-0.799999999999997,75,75,0,-3,3
21700970,1626204,CLE,DEN,Larry Nance Jr.,170,36.9,37,-0.100000000000001,85,79,6,5,1
21700970,1626224,CLE,DEN,Cedi Osman,62,12.0166666666667,12,0.0166666666666657,18,25,-7,-5,-2
21700970,1627790,CLE,DEN,Ante Zizic,43,8.26666666666667,9,-0.733333333333334,21,21,0,-2,2
21700970,2210,DEN,CLE,Richard Jefferson,5,0.866666666666667,1,-0.133333333333333,2,5,-3,-3,0
21700970,2734,DEN,CLE,Devin Harris,76,15.2,15,0.199999999999999,31,32,-1,-1,0
21700970,200794,DEN,CLE,Paul Millsap,117,25.9166666666667,26,-0.0833333333333357,59,62,-3,-5,2
21700970,201163,DEN,CLE,Wilson Chandler,165,35.8833333333333,36,-0.116666666666667,81,86,-5,-5,0
21700970,203115,DEN,CLE,Will Barton,142,28.8833333333333,29,-0.116666666666667,61,65,-4,0,-4
21700970,203486,DEN,CLE,Mason Plumlee,69,14.35,14,0.35,29,35,-6,-6,0
21700970,203914,DEN,CLE,Gary Harris,175,38.2,38,0.200000000000003,92,89,3,3,0
21700970,203999,DEN,CLE,Nikola Jokic,160,33.5666666666667,33,0.566666666666663,79,78,1,1,0
21700970,1626168,DEN,CLE,Trey Lyles,67,13.15,13,0.15,27,28,-1,-2,1
21700970,1627736,DEN,CLE,Malik Beasley,39,6.53333333333333,7,-0.466666666666667,14,18,-4,-4,0
21700970,1627750,DEN,CLE,Jamal Murray,130,27.0333333333333,27,0.0333333333333314,65,67,-2,-3,1
21700971,201572,LAL,ORL,Brook Lopez,158,34.5,35,-0.5,75,90,-15,-15,0
21700971,202738,LAL,ORL,Isaiah Thomas,120,25.8833333333333,26,-0.116666666666667,58,51,7,10,-3
21700971,203484,LAL,ORL,Kentavious Caldwell-Pope,170,38.3,39,-0.700000000000003,84,100,-16,-15,-1
21700971,203944,LAL,ORL,Julius Randle,144,30.4833333333333,30,0.483333333333331,72,65,7,3,4
21700971,204037,LAL,ORL,Travis Wear,5,1.43333333333333,2,-0.566666666666667,2,2,0,0,0
21700971,1627826,LAL,ORL,Ivica Zubac,63,13.5,14,-0.5,33,17,16,16,0
21700971,1627936,LAL,ORL,Alex Caruso,63,13.75,13,0.75,32,17,15,15,0
21700971,1628366,LAL,ORL,Lonzo Ball,172,37.1666666666667,37,0.166666666666664,82,92,-10,-10,0
21700971,1628398,LAL,ORL,Kyle Kuzma,195,42.1166666666667,42,0.11666666666666,97,90,7,5,2
21700971,1628418,LAL,ORL,Thomas Bryant,15,2.86666666666667,3,-0.133333333333333,5,11,-6,-4,-2
21700971,201167,ORL,LAL,Arron Afflalo,25,6.68333333333333,7,-0.316666666666666,8,18,-10,-10,0
21700971,201571,ORL,LAL,D.J. Augustin,144,30.7666666666667,31,-0.233333333333334,71,70,1,3,-2
21700971,202687,ORL,LAL,Bismack Biyombo,64,13.4166666666667,13,0.416666666666668,15,32,-17,-17,0
21700971,202696,ORL,LAL,Nikola Vucevic,157,34.5833333333333,35,-0.416666666666671,92,76,16,16,0
21700971,202714,ORL,LAL,Shelvin Mack,90,19.6,19,0.600000000000001,38,42,-4,-6,2
21700971,203095,ORL,LAL,Evan Fournier,88,18.95,19,-0.0500000000000007,48,38,10,12,-2
21700971,203613,ORL,LAL,Jonathon Simmons,155,34.5333333333333,35,-0.466666666666669,85,76,9,9,0
21700971,203932,ORL,LAL,Aaron Gordon,158,35.95,36,-0.0499999999999972,94,77,17,18,-1
21700971,1626209,ORL,LAL,Mario Hezonja,118,25.7333333333333,25,0.733333333333334,45,63,-18,-18,0
21700971,1628371,ORL,LAL,Jonathan Isaac,70,13.4833333333333,14,-0.516666666666666,25,30,-5,-8,3
21700971,1628411,ORL,LAL,Wes Iwundu,36,6.3,6,0.3,14,18,-4,-4,0
21700972,201960,BKN,CHA,DeMarre Carroll,152,31.3,31,0.300000000000001,84,65,19,16,3
21700972,201967,BKN,CHA,Dante Cunningham,122,24.8166666666667,25,-0.183333333333334,62,60,2,4,-2
21700972,203112,BKN,CHA,Quincy Acy,9,2.28333333333333,2,0.283333333333333,2,4,-2,-2,0
21700972,203459,BKN,CHA,Allen Crabbe,161,33.1166666666667,33,0.116666666666667,92,75,17,17,0
21700972,203915,BKN,CHA,Spencer Dinwiddie,111,22.15,23,-0.850000000000001,65,49,16,16,0
21700972,203917,BKN,CHA,Nik Stauskas,9,2.28333333333333,2,0.283333333333333,2,4,-2,-2,0
21700972,203925,BKN,CHA,Joe Harris,98,20.45,20,0.450000000000003,47,50,-3,-4,1
21700972,1626156,BKN,CHA,D'Angelo Russell,104,22.4333333333333,23,-0.566666666666666,52,56,-4,-5,1
21700972,1626178,BKN,CHA,Rondae Hollis-Jefferson,151,30.3166666666667,30,0.316666666666666,82,69,13,13,0
21700972,1627747,BKN,CHA,Caris LeVert,146,29.95,30,-0.0500000000000007,76,72,4,5,-1
21700972,1628386,BKN,CHA,Jarrett Allen,102,20.9,21,-0.100000000000001,61,46,15,12,3
21700972,2730,CHA,BKN,Dwight Howard,130,26.7,27,-0.300000000000001,55,70,-15,-14,-1
21700972,101107,CHA,BKN,Marvin Williams,123,25.5166666666667,26,-0.483333333333334,51,65,-14,-12,-2
21700972,201587,CHA,BKN,Nicolas Batum,162,33.0166666666667,33,0.0166666666666657,68,90,-22,-20,-2
21700972,202689,CHA,BKN,Kemba Walker,155,31.3666666666667,31,0.366666666666667,69,89,-20,-21,1
21700972,202933,CHA,BKN,Julyan Stone,11,2.63333333333333,3,-0.366666666666667,4,2,2,3,-1
21700972,203077,CHA,BKN,Michael Kidd-Gilchrist,97,19.6833333333333,20,-0.316666666666666,44,55,-11,-10,-1
21700972,203087,CHA,BKN,Jeremy Lamb,108,21.9666666666667,22,-0.0333333333333314,58,60,-2,-3,1
21700972,203469,CHA,BKN,Cody Zeller,91,18.55,19,-0.450000000000003,49,53,-4,-3,-1
21700972,1626163,CHA,BKN,Frank Kaminsky,110,22.4833333333333,22,0.483333333333334,59,60,-1,-2,1
21700972,1626195,CHA,BKN,Willy Hernangomez,12,2.75,3,-0.25,6,2,4,3,1
21700972,1626203,CHA,BKN,Treveon Graham,51,11.3,11,0.300000000000001,30,20,10,9,1
21700972,1628370,CHA,BKN,Malik Monk,103,21.2833333333333,21,0.283333333333331,51,57,-6,-3,-3
21700972,1628407,CHA,BKN,Dwayne Bacon,12,2.75,3,-0.25,6,2,4,3,1
21700973,2548,MIA,PHI,Dwyane Wade,107,23.3,23,0.299999999999997,43,48,-5,-5,0
21700973,201609,MIA,PHI,Goran Dragic,172,33.6,34,-0.399999999999999,84,81,3,3,0
21700973,201949,MIA,PHI,James Johnson,112,20.75,21,-0.25,47,49,-2,-2,0
21700973,201961,MIA,PHI,Wayne Ellington,93,21.7666666666667,22,-0.233333333333334,49,35,14,16,-2
21700973,202355,MIA,PHI,Hassan Whiteside,150,28.6166666666667,29,-0.383333333333333,73,74,-1,-1,0
21700973,203482,MIA,PHI,Kelly Olynyk,101,23.7333333333333,24,-0.266666666666666,52,37,15,15,0
21700973,204020,MIA,PHI,Tyler Johnson,129,25.4,25,0.399999999999999,54,61,-7,-7,0
21700973,1626159,MIA,PHI,Justise Winslow,119,27.1333333333333,27,0.133333333333333,61,50,11,11,0
21700973,1626196,MIA,PHI,Josh Richardson,114,21.5833333333333,22,-0.416666666666664,53,45,8,6,2
21700973,1628389,MIA,PHI,Bam Adebayo,58,13.5333333333333,14,-0.466666666666667,24,15,9,9,0
21700973,101141,PHI,MIA,Ersan Ilyasova,90,19.9833333333333,20,-0.0166666666666657,36,35,1,1,0
21700973,101161,PHI,MIA,Amir Johnson,77,16.35,16,0.350000000000001,34,36,-2,-4,2
21700973,200755,PHI,MIA,JJ Redick,147,29.6,30,-0.399999999999999,69,63,6,6,0
21700973,201158,PHI,MIA,Marco Belinelli,139,30.15,30,0.149999999999999,60,72,-12,-12,0
21700973,203496,PHI,MIA,Robert Covington,141,29.45,29,0.449999999999999,47,66,-19,-18,-1
21700973,203954,PHI,MIA,Joel Embiid,138,28.0166666666667,28,0.0166666666666657,60,62,-2,0,-2
21700973,203967,PHI,MIA,Dario Saric,156,31.1166666666667,31,0.116666666666667,68,83,-15,-15,0
21700973,204456,PHI,MIA,T.J. McConnell,89,19.5333333333333,20,-0.466666666666669,38,33,5,4,1
21700973,1627732,PHI,MIA,Ben Simmons,178,35.2166666666667,35,0.216666666666669,83,90,-7,-7,0
21700974,201143,BOS,MIN,Al Horford,166,34.2,34,0.200000000000003,89,77,12,13,-1
21700974,202328,BOS,MIN,Greg Monroe,45,9,9,0,23,20,3,3,0
21700974,202681,BOS,MIN,Kyrie Irving,137,29.65,30,-0.350000000000001,72,68,4,5,-1
21700974,202694,BOS,MIN,Marcus Morris,158,32.6333333333333,33,-0.366666666666667,84,68,16,16,0
21700974,203382,BOS,MIN,Aron Baynes,46,10.5666666666667,10,0.566666666666666,19,30,-11,-11,0
21700974,203935,BOS,MIN,Marcus Smart,163,32.7,33,-0.299999999999997,83,67,16,15,1
21700974,1626179,BOS,MIN,Terry Rozier,116,24.4166666666667,24,0.416666666666664,60,55,5,7,-2
21700974,1627759,BOS,MIN,Jaylen Brown,132,28.3,28,0.300000000000001,66,55,11,12,-1
21700974,1628369,BOS,MIN,Jayson Tatum,102,21.8,22,-0.200000000000003,47,58,-11,-11,0
21700974,1628400,BOS,MIN,Semi Ojeleye,34,7.03333333333333,7,0.0333333333333332,23,24,-1,-4,3
21700974,1628464,BOS,MIN,Daniel Theis,41,9.53333333333333,10,-0.466666666666667,19,23,-4,-5,1
21700974,2037,MIN,BOS,Jamal Crawford,114,23.9666666666667,24,-0.0333333333333314,55,64,-9,-9,0
21700974,201952,MIN,BOS,Jeff Teague,148,31.2,31,0.199999999999996,72,77,-5,-6,1
21700974,201959,MIN,BOS,Taj Gibson,168,35.5333333333333,36,-0.466666666666669,82,80,2,4,-2
21700974,202357,MIN,BOS,Nemanja Bjelica,187,40.05,40,0.0499999999999972,91,93,-2,-3,1
21700974,203476,MIN,BOS,Gorgui Dieng,77,16.2833333333333,16,0.283333333333331,35,37,-2,-2,0
21700974,203952,MIN,BOS,Andrew Wiggins,181,38.5333333333333,38,0.533333333333331,86,96,-10,-11,1
21700974,1626145,MIN,BOS,Tyus Jones,80,16.7666666666667,17,-0.233333333333334,37,40,-3,-2,-1
21700974,1626157,MIN,BOS,Karl-Anthony Towns,185,37.5,38,-0.5,87,98,-11,-11,0
21700975,2199,PHX,OKC,Tyson Chandler,97,19.5666666666667,20,-0.433333333333334,35,55,-20,-20,0
21700975,203458,PHX,OKC,Alex Len,58,11.3166666666667,11,0.316666666666666,24,28,-4,-4,0
21700975,203584,PHX,OKC,Troy Daniels,142,29.1333333333333,30,-0.866666666666667,51,72,-21,-21,0
21700975,203901,PHX,OKC,Elfrid Payton,145,29.55,30,-0.449999999999999,47,77,-30,-32,2
21700975,1626164,PHX,OKC,Devin Booker,178,35.1166666666667,35,0.11666666666666,67,86,-19,-19,0
21700975,1627733,PHX,OKC,Dragan Bender,152,31.5166666666667,32,-0.483333333333334,50,73,-23,-25,2
21700975,1627737,PHX,OKC,Marquese Chriss,113,23.2166666666667,24,-0.783333333333331,47,52,-5,-5,0
21700975,1627885,PHX,OKC,Shaquille Harrison,95,20.2,20,0.199999999999999,42,41,1,3,-2
21700975,1628367,PHX,OKC,Josh Jackson,60,12.9333333333333,13,-0.0666666666666664,24,24,0,0,0
21700975,1628409,PHX,OKC,Alec Peters,45,9.68333333333333,10,-0.316666666666666,18,22,-4,-2,-2
21700975,1628432,PHX,OKC,Davon Reed,75,16.0166666666667,16,0.0166666666666657,30,45,-15,-15,0
21700975,2546,OKC,PHX,Carmelo Anthony,128,25.6,26,-0.399999999999999,70,50,20,21,-1
21700975,2555,OKC,PHX,Nick Collison,17,3.85,4,-0.15,10,11,-1,-1,0
21700975,101109,OKC,PHX,Raymond Felton,74,16.45,16,0.449999999999999,26,29,-3,-3,0
21700975,201147,OKC,PHX,Corey Brewer,141,28.0333333333333,28,0.0333333333333314,80,54,26,26,0
21700975,201566,OKC,PHX,Russell Westbrook,150,29.4833333333333,29,0.483333333333334,84,57,27,27,0
21700975,202331,OKC,PHX,Paul George,137,28.1166666666667,29,-0.883333333333333,74,46,28,30,-2
21700975,202335,OKC,PHX,Patrick Patterson,94,20.55,21,-0.449999999999999,34,32,2,-1,3
21700975,203500,OKC,PHX,Steven Adams,152,29.8166666666667,30,-0.183333333333334,83,57,26,27,-1
21700975,203518,OKC,PHX,Alex Abrines,45,9.15,9,0.15,20,19,1,-1,2
21700975,203924,OKC,PHX,Jerami Grant,73,15.4833333333333,16,-0.516666666666666,33,24,9,10,-1
21700975,203962,OKC,PHX,Josh Huestis,89,19.25,20,-0.75,40,34,6,6,0
21700975,1626177,OKC,PHX,Dakari Johnson,8,1.71666666666667,2,-0.283333333333333,5,1,4,4,0
21700975,1628390,OKC,PHX,Terrance Ferguson,52,10.75,11,-0.25,16,21,-5,-5,0
21700976,2585,GSW,SAS,Zaza Pachulia,56,10.25,10,0.25,28,30,-2,-4,2
21700976,2733,GSW,SAS,Shaun Livingston,118,24.2,24,0.200000000000003,61,56,5,3,2
21700976,201142,GSW,SAS,Kevin Durant,193,38.7666666666667,39,-0.233333333333334,91,91,0,0,0
21700976,201156,GSW,SAS,Nick Young,128,26.9166666666667,27,-0.0833333333333357,58,59,-1,-2,1
21700976,201580,GSW,SAS,JaVale McGee,85,17.0833333333333,17,0.0833333333333322,39,37,2,4,-2
21700976,201939,GSW,SAS,Stephen Curry,11,2.36666666666667,2,0.366666666666667,2,3,-1,-1,0
21700976,201956,GSW,SAS,Omri Casspi,62,11.9666666666667,12,-0.0333333333333332,22,37,-15,-16,1
21700976,202691,GSW,SAS,Klay Thompson,173,36.2333333333333,36,0.233333333333334,88,72,16,19,-3
21700976,203110,GSW,SAS,Draymond Green,173,36.2833333333333,36,0.283333333333331,88,72,16,17,-1
21700976,1626172,GSW,SAS,Kevon Looney,66,14.4333333333333,14,0.433333333333334,26,30,-4,-6,2
21700976,1626188,GSW,SAS,Quinn Cook,105,21.4166666666667,22,-0.583333333333336,47,48,-1,1,-2
21700976,1938,SAS,GSW,Manu Ginobili,36,7.11666666666667,7,0.116666666666667,14,21,-7,-7,0
21700976,2225,SAS,GSW,Tony Parker,91,18.0333333333333,18,0.033333333333335,45,49,-4,-3,-1
21700976,200746,SAS,GSW,LaMarcus Aldridge,178,36.8833333333333,37,-0.116666666666667,78,82,-4,-6,2
21700976,200752,SAS,GSW,Rudy Gay,79,16.05,16,0.0499999999999972,42,43,-1,1,-2
21700976,201980,SAS,GSW,Danny Green,106,21.6,21,0.600000000000001,50,59,-9,-7,-2
21700976,201988,SAS,GSW,Patty Mills,149,30.8833333333333,31,-0.116666666666667,65,63,2,-2,4
21700976,202722,SAS,GSW,Davis Bertans,137,27.8666666666667,28,-0.133333333333333,59,57,2,4,-2
21700976,203530,SAS,GSW,Joffrey Lauvergne,56,11.1,11,0.0999999999999996,29,28,1,3,-2
21700976,203937,SAS,GSW,Kyle Anderson,159,33.45,33,0.450000000000003,67,67,0,-2,2
21700976,1627749,SAS,GSW,Dejounte Murray,138,29.4833333333333,30,-0.516666666666666,60,58,2,-1,3
21700976,1627854,SAS,GSW,Bryn Forbes,41,7.45,7,0.45,26,23,3,5,-2
21700977,201577,CHI,DET,Robin Lopez,52,11.9666666666667,12,-0.0333333333333332,26,21,5,5,0
21700977,203200,CHI,DET,Justin Holiday,52,11.9666666666667,12,-0.0333333333333332,26,21,5,5,0
21700977,203897,CHI,DET,Zach LaVine,120,26.4333333333333,27,-0.56666666666667,42,59,-17,-17,0
21700977,203943,CHI,DET,Noah Vonleh,91,19.6166666666667,19,0.616666666666667,36,41,-5,-5,0
21700977,1626166,CHI,DET,Cameron Payne,107,22.7666666666667,23,-0.233333333333334,41,44,-3,-4,1
21700977,1626171,CHI,DET,Bobby Portis,124,27.7833333333333,28,-0.216666666666669,47,58,-11,-12,1
21700977,1626245,CHI,DET,Cristiano Felicio,50,9.88333333333333,10,-0.116666666666667,17,22,-5,-3,-2
21700977,1627739,CHI,DET,Kris Dunn,111,24.9666666666667,25,-0.0333333333333314,42,53,-11,-12,1
21700977,1627756,CHI,DET,Denzel Valentine,143,30.9,31,-0.100000000000001,57,68,-11,-11,0
21700977,1628021,CHI,DET,David Nwaba,111,23.4,23,0.399999999999999,34,46,-12,-12,0
21700977,1628374,CHI,DET,Lauri Markkanen,122,26.3666666666667,27,-0.633333333333333,40,58,-18,-17,-1
21700977,1628469,CHI,DET,Antonio Blakeney,12,2.86666666666667,3,-0.133333333333334,7,4,3,3,0
21700977,2749,DET,CHI,Jameer Nelson,82,16.6666666666667,17,-0.333333333333336,30,33,-3,-3,0
21700977,201229,DET,CHI,Anthony Tolliver,59,12.1166666666667,12,0.116666666666667,25,25,0,1,-1
21700977,201933,DET,CHI,Blake Griffin,155,34.9333333333333,35,-0.06666666666667,74,54,20,19,1
21700977,202397,DET,CHI,Ish Smith,137,31.1166666666667,31,0.116666666666667,69,50,19,19,0
21700977,203083,DET,CHI,Andre Drummond,132,29.6,30,-0.399999999999999,67,47,20,18,2
21700977,203493,DET,CHI,Reggie Bullock,146,32.5166666666667,33,-0.483333333333334,68,53,15,16,-1
21700977,203516,DET,CHI,James Ennis III,139,30.95,31,-0.0500000000000043,61,50,11,10,1
21700977,203687,DET,CHI,Reggie Hearn,5,0.733333333333333,1,-0.266666666666667,0,4,-4,-4,0
21700977,203961,DET,CHI,Eric Moreland,87,18.1833333333333,18,0.183333333333334,32,36,-4,-2,-2
21700977,1627740,DET,CHI,Henry Ellenson,5,0.733333333333333,1,-0.266666666666667,0,4,-4,-4,0
21700977,1628379,DET,CHI,Luke Kennard,148,31.3666666666667,31,0.366666666666667,69,59,10,10,0
21700978,203101,ATL,IND,Miles Plumlee,81,18.1,18,0.100000000000001,40,40,0,2,-2
21700978,203145,ATL,IND,Kent Bazemore,88,20.1666666666667,20,0.166666666666664,31,47,-16,-19,3
21700978,203471,ATL,IND,Dennis Schroder,110,24.3166666666667,24,0.316666666666666,38,56,-18,-19,1
21700978,203473,ATL,IND,Dewayne Dedmon,120,26.4333333333333,27,-0.566666666666666,47,63,-16,-19,3
21700978,203488,ATL,IND,Mike Muscala,99,20.9666666666667,21,-0.0333333333333314,41,48,-7,-5,-2
21700978,203705,ATL,IND,Josh Magette,69,15.3666666666667,15,0.366666666666667,40,37,3,3,0
21700978,1627752,ATL,IND,Taurean Prince,82,18.4833333333333,18,0.483333333333334,30,44,-14,-15,1
21700978,1627819,ATL,IND,Isaiah Taylor,29,6.41666666666667,6,0.416666666666666,9,15,-6,-5,-1
21700978,1628381,ATL,IND,John Collins,120,26.0666666666667,26,0.06666666666667,40,64,-24,-25,1
21700978,1628416,ATL,IND,Tyler Dorsey,121,24.9,25,-0.100000000000001,51,60,-9,-6,-3
21700978,1628510,ATL,IND,Andrew White III,58,13.3666666666667,13,0.366666666666667,30,29,1,2,-1
21700978,1628537,ATL,IND,Jaylen Morris,123,24.5,25,-0.5,38,57,-19,-19,0
21700978,201152,IND,ATL,Thaddeus Young,108,23.25,23,0.25,62,40,22,23,-1
21700978,201954,IND,ATL,Darren Collison,96,20.9333333333333,21,-0.06666666666667,46,39,7,7,0
21700978,202344,IND,ATL,Trevor Booker,83,18.1666666666667,18,0.166666666666664,37,36,1,2,-1
21700978,202362,IND,ATL,Lance Stephenson,71,16.45,16,0.449999999999999,34,39,-5,-4,-1
21700978,202709,IND,ATL,Cory Joseph,164,34.5833333333333,35,-0.416666666666664,83,57,26,26,0
21700978,202711,IND,ATL,Bojan Bogdanovic,146,30.4,30,0.399999999999999,74,50,24,25,-1
21700978,203506,IND,ATL,Victor Oladipo,118,25.1666666666667,25,0.166666666666664,68,42,26,25,1
21700978,203922,IND,ATL,Glenn Robinson III,58,14.2666666666667,14,0.266666666666666,31,32,-1,-2,1
21700978,1626167,IND,ATL,Myles Turner,123,26.5666666666667,27,-0.43333333333333,72,46,26,26,0
21700978,1626202,IND,ATL,Joe Young,7,1.65,2,-0.35,0,2,-2,-2,0
21700978,1627734,IND,ATL,Domantas Sabonis,115,25.0166666666667,25,0.0166666666666657,50,50,0,-1,1
21700978,1628388,IND,ATL,TJ Leaf,11,2.63333333333333,3,-0.366666666666667,3,2,1,0,1
21700979,2207,HOU,TOR,Joe Johnson,73,16.4666666666667,16,0.466666666666669,34,38,-4,-4,0
21700979,2403,HOU,TOR,Nene,16,3.83333333333333,4,-0.166666666666667,3,9,-6,-6,0
21700979,2772,HOU,TOR,Trevor Ariza,170,36.3166666666667,36,0.316666666666663,83,80,3,3,0
21700979,101108,HOU,TOR,Chris Paul,155,33.1,33,0.100000000000001,67,75,-8,-6,-2
21700979,200782,HOU,TOR,PJ Tucker,166,36.9166666666667,37,-0.0833333333333357,85,80,5,5,0
21700979,201569,HOU,TOR,Eric Gordon,129,29.85,29,0.850000000000001,71,71,0,0,0
21700979,201601,HOU,TOR,Luc Mbah a Moute,104,24.5,24,0.5,55,57,-2,-2,0
21700979,201935,HOU,TOR,James Harden,155,33.2166666666667,33,0.216666666666669,75,72,3,1,2
21700979,203991,HOU,TOR,Clint Capela,122,25.8,26,-0.199999999999999,52,58,-6,-6,0
21700979,101139,TOR,HOU,CJ Miles,82,18.9166666666667,19,-0.0833333333333357,41,43,-2,4,-6
21700979,200768,TOR,HOU,Kyle Lowry,154,32.8666666666667,33,-0.133333333333333,70,75,-5,-3,-2
21700979,201586,TOR,HOU,Serge Ibaka,117,24.1833333333333,24,0.183333333333334,55,51,4,3,1
21700979,201942,TOR,HOU,DeMar DeRozan,169,36.35,37,-0.649999999999999,84,76,8,8,0
21700979,202685,TOR,HOU,Jonas Valanciunas,127,27.9,28,-0.100000000000001,65,57,8,7,1
21700979,1626181,TOR,HOU,Norman Powell,146,31.0333333333333,31,0.0333333333333314,70,72,-2,-7,5
21700979,1626259,TOR,HOU,Malcolm Miller,42,10.0666666666667,10,0.0666666666666664,22,22,0,0,0
21700979,1627751,TOR,HOU,Jakob Poeltl,84,19.2333333333333,19,0.233333333333334,42,42,0,0,0
21700979,1627783,TOR,HOU,Pascal Siakam,72,16.55,16,0.549999999999997,38,36,2,3,-1
21700979,1627832,TOR,HOU,Fred VanVleet,97,22.9,23,-0.100000000000001,53,51,2,0,2
21700980,201937,UTA,MEM,Ricky Rubio,130,30.6,31,-0.399999999999999,64,43,21,20,1
21700980,201973,UTA,MEM,Jonas Jerebko,55,12.3666666666667,12,0.366666666666667,20,27,-7,-7,0
21700980,202324,UTA,MEM,Derrick Favors,121,28.1,28,0.100000000000001,47,53,-6,-6,0
21700980,202327,UTA,MEM,Ekpe Udoh,9,1.36666666666667,2,-0.633333333333333,6,2,4,4,0
21700980,203109,UTA,MEM,Jae Crowder,149,33.1333333333333,34,-0.866666666666667,68,56,12,12,0
21700980,203497,UTA,MEM,Rudy Gobert,141,33.7,34,-0.299999999999997,69,47,22,22,0
21700980,203526,UTA,MEM,Raul Neto,57,12.0166666666667,13,-0.983333333333334,23,24,-1,0,-1
21700980,204060,UTA,MEM,Joe Ingles,139,31.3833333333333,32,-0.616666666666667,65,53,12,9,3
21700980,1626220,UTA,MEM,Royce O'Neale,89,19.7666666666667,19,0.766666666666666,39,31,8,12,-4
21700980,1627777,UTA,MEM,Georges Niang,6,1.1,1,0.1,4,2,2,4,-2
21700980,1628378,UTA,MEM,Donovan Mitchell,144,34.4666666666667,35,-0.533333333333331,70,52,18,15,3
21700980,201188,MEM,UTA,Marc Gasol,134,31.8833333333333,32,-0.116666666666667,47,67,-20,-19,-1
21700980,203210,MEM,UTA,JaMychal Green,133,31.65,31,0.649999999999999,44,70,-26,-24,-2
21700980,203463,MEM,UTA,Ben McLemore,125,27.65,28,-0.350000000000001,48,49,-1,-1,0
21700980,1626185,MEM,UTA,Jarell Martin,136,30.3,30,0.299999999999997,55,59,-4,-6,2
21700980,1627738,MEM,UTA,Deyonta Davis,74,15.7166666666667,16,-0.283333333333335,31,28,3,2,1
21700980,1627744,MEM,UTA,Brice Johnson,5,0.933333333333333,1,-0.0666666666666668,0,4,-4,-2,-2
21700980,1627782,MEM,UTA,Wayne Selden,65,15.4,16,-0.6,24,28,-4,-4,0
21700980,1628397,MEM,UTA,Ivan Rabb,6,1.1,1,0.1,2,4,-2,-4,2
21700980,1628415,MEM,UTA,Dillon Brooks,138,32.2166666666667,32,0.216666666666669,59,59,0,-2,2
21700980,1628424,MEM,UTA,Kobi Simmons,106,25.1166666666667,26,-0.883333333333333,39,53,-14,-16,2
21700980,1628504,MEM,UTA,Xavier Rathan-Mayes,118,26.0333333333333,26,0.0333333333333314,41,54,-13,-9,-4
21700981,1891,MIL,NYK,Jason Terry,84,16.9333333333333,17,-0.0666666666666664,43,42,1,4,-3
21700981,202339,MIL,NYK,Eric Bledsoe,131,28.4666666666667,28,0.466666666666669,75,63,12,7,5
21700981,203089,MIL,NYK,John Henson,133,30.45,31,-0.550000000000001,74,66,8,11,-3
21700981,203092,MIL,NYK,Tyler Zeller,93,16.9666666666667,17,-0.033333333333335,46,46,0,-3,3
21700981,203114,MIL,NYK,Khris Middleton,146,31.0166666666667,31,0.0166666666666657,73,75,-2,-4,2
21700981,203498,MIL,NYK,Shabazz Muhammad,28,5.98333333333333,6,-0.0166666666666666,14,16,-2,0,-2
21700981,203503,MIL,NYK,Tony Snell,119,26.6166666666667,27,-0.383333333333333,60,60,0,2,-2
21700981,203507,MIL,NYK,Giannis Antetokounmpo,160,35.2,35,0.200000000000003,89,70,19,19,0
21700981,203953,MIL,NYK,Jabari Parker,120,23.5666666666667,23,0.566666666666666,64,63,1,1,0
21700981,204098,MIL,NYK,Xavier Munford,7,1.1,2,-0.9,2,5,-3,-3,0
21700981,1628425,MIL,NYK,Sterling Brown,109,20.7833333333333,22,-1.21666666666667,60,54,6,6,0
21700981,201563,NYK,MIL,Michael Beasley,115,22.7166666666667,23,-0.283333333333331,62,63,-1,0,-1
21700981,202498,NYK,MIL,Lance Thomas,153,32.6833333333333,33,-0.31666666666667,75,77,-2,-1,-1
21700981,202683,NYK,MIL,Enes Kanter,95,21.3833333333333,22,-0.616666666666667,49,51,-2,-1,-1
21700981,203124,NYK,MIL,Kyle O'Quinn,87,17.5833333333333,17,0.583333333333332,39,46,-7,-6,-1
21700981,203501,NYK,MIL,Tim Hardaway Jr.,145,31.45,32,-0.550000000000001,77,73,4,4,0
21700981,203504,NYK,MIL,Trey Burke,69,14.2333333333333,14,0.233333333333334,28,43,-15,-15,0
21700981,1626144,NYK,MIL,Emmanuel Mudiay,128,27.9,28,-0.100000000000001,66,68,-2,-5,3
21700981,1627786,NYK,MIL,Troy Williams,135,26.1333333333333,26,0.133333333333333,66,74,-8,-5,-3
21700981,1628373,NYK,MIL,Frank Ntilikina,151,32.3833333333333,33,-0.616666666666667,72,74,-2,-2,0
21700981,1628422,NYK,MIL,Damyean Dotson,34,7.3,8,-0.7,18,19,-1,-3,2
21700981,1628436,NYK,MIL,Luke Kornet,18,3.31666666666667,3,0.316666666666666,8,12,-4,-6,2
21700982,2731,NOP,WAS,Emeka Okafor,100,20.9,21,-0.100000000000001,36,43,-7,-7,0
21700982,200765,NOP,WAS,Rajon Rondo,98,19.85,20,-0.149999999999999,28,51,-23,-23,0
21700982,201950,NOP,WAS,Jrue Holiday,134,27.9166666666667,28,-0.0833333333333357,42,64,-22,-22,0
21700982,202703,NOP,WAS,Nikola Mirotic,129,26.45,27,-0.550000000000001,40,66,-26,-26,0
21700982,202732,NOP,WAS,DeAndre Liggins,102,21.5166666666667,22,-0.483333333333334,57,50,7,7,0
21700982,202734,NOP,WAS,E'Twaun Moore,117,24.4833333333333,24,0.483333333333334,44,57,-13,-13,0
21700982,203121,NOP,WAS,Darius Miller,159,32.75,33,-0.25,73,83,-10,-10,0
21700982,203546,NOP,WAS,Ian Clark,152,31.5666666666667,32,-0.433333333333337,73,78,-5,-5,0
21700982,1627215,NOP,WAS,Walter Lemon Jr.,59,11.9666666666667,12,-0.033333333333335,35,33,2,2,0
21700982,1627767,NOP,WAS,Cheick Diallo,105,22.4333333333333,22,0.43333333333333,57,55,2,2,0
21700982,101133,WAS,NOP,Ian Mahinmi,27,5.93333333333333,6,-0.0666666666666664,6,8,-2,-2,0
21700982,101162,WAS,NOP,Marcin Gortat,78,16.4333333333333,16,0.433333333333334,35,29,6,6,0
21700982,201160,WAS,NOP,Jason Smith,33,6.31666666666667,6,0.316666666666666,15,21,-6,-6,0
21700982,201196,WAS,NOP,Ramon Sessions,108,22.3666666666667,22,0.366666666666667,54,57,-3,-3,0
21700982,201975,WAS,NOP,Jodie Meeks,105,21.5166666666667,21,0.516666666666666,57,59,-2,-4,2
21700982,202693,WAS,NOP,Markieff Morris,126,26.4833333333333,26,0.483333333333334,59,38,21,21,0
21700982,203078,WAS,NOP,Bradley Beal,137,29.05,29,0.0500000000000007,67,50,17,17,0
21700982,203107,WAS,NOP,Tomas Satoransky,149,31.25,31,0.25,80,54,26,26,0
21700982,203118,WAS,NOP,Mike Scott,72,15.1666666666667,15,0.166666666666666,42,38,4,4,0
21700982,203490,WAS,NOP,Otto Porter Jr.,126,25.5833333333333,26,-0.416666666666668,67,36,31,31,0
21700982,204025,WAS,NOP,Tim Frazier,33,6.31666666666667,6,0.316666666666666,15,21,-6,-6,0
21700982,1626162,WAS,NOP,Kelly Oubre Jr.,161,33.4166666666667,33,0.416666666666664,83,74,9,11,-2
21700983,2734,DEN,LAL,Devin Harris,79,15.8333333333333,16,-0.166666666666668,34,39,-5,-5,0
21700983,200794,DEN,LAL,Paul Millsap,140,29.95,30,-0.0500000000000007,82,72,10,12,-2
21700983,203115,DEN,LAL,Will Barton,187,38.8833333333333,39,-0.116666666666667,108,83,25,25,0
21700983,203486,DEN,LAL,Mason Plumlee,88,18.0333333333333,18,0.0333333333333314,41,47,-6,-6,0
21700983,203914,DEN,LAL,Gary Harris,183,38.3666666666667,39,-0.633333333333333,100,99,1,2,-1
21700983,203999,DEN,LAL,Nikola Jokic,153,32.5333333333333,33,-0.466666666666669,93,80,13,13,0
21700983,1626168,DEN,LAL,Trey Lyles,57,11.1833333333333,11,0.183333333333334,28,25,3,3,0
21700983,1627750,DEN,LAL,Jamal Murray,164,34.9666666666667,35,-0.0333333333333314,95,91,4,4,0
21700983,1627823,DEN,LAL,Juancho Hernangomez,94,18.75,19,-0.25,44,44,0,-3,3
21700983,201572,LAL,DEN,Brook Lopez,147,31.6666666666667,32,-0.333333333333332,77,95,-18,-18,0
21700983,202738,LAL,DEN,Isaiah Thomas,144,28.9666666666667,29,-0.033333333333335,67,70,-3,-1,-2
21700983,203484,LAL,DEN,Kentavious Caldwell-Pope,182,38.8833333333333,39,-0.116666666666667,93,107,-14,-16,2
21700983,203898,LAL,DEN,Tyler Ennis,84,16.9833333333333,17,-0.0166666666666657,46,33,13,13,0
21700983,203944,LAL,DEN,Julius Randle,132,28.4666666666667,29,-0.533333333333331,74,77,-3,-6,3
21700983,204037,LAL,DEN,Travis Wear,44,8.73333333333333,9,-0.266666666666668,22,17,5,5,0
21700983,1627826,LAL,DEN,Ivica Zubac,42,8.56666666666667,9,-0.433333333333334,11,21,-10,-9,-1
21700983,1628366,LAL,DEN,Lonzo Ball,179,37.45,38,-0.549999999999997,90,104,-14,-14,0
21700983,1628398,LAL,DEN,Kyle Kuzma,191,38.7833333333333,39,-0.216666666666669,100,101,-1,1,-2
21700984,2585,GSW,POR,Zaza Pachulia,25,6.26666666666667,6,0.266666666666667,11,14,-3,-3,0
21700984,2733,GSW,POR,Shaun Livingston,77,17.75,18,-0.25,38,48,-10,-8,-2
21700984,201142,GSW,POR,Kevin Durant,171,36.35,37,-0.650000000000006,85,98,-13,-11,-2
21700984,201156,GSW,POR,Nick Young,108,23.85,24,-0.149999999999999,51,65,-14,-12,-2
21700984,201580,GSW,POR,JaVale McGee,88,19.5833333333333,20,-0.416666666666664,50,49,1,2,-1
21700984,201956,GSW,POR,Omri Casspi,45,9.9,10,-0.0999999999999996,26,26,0,-2,2
21700984,202691,GSW,POR,Klay Thompson,160,35.6666666666667,36,-0.333333333333329,79,94,-15,-15,0
21700984,203110,GSW,POR,Draymond Green,169,37.3333333333333,38,-0.666666666666671,82,97,-15,-15,0
21700984,1626172,GSW,POR,Kevon Looney,89,20.05,20,0.0500000000000007,45,50,-5,-10,5
21700984,1626188,GSW,POR,Quinn Cook,139,29.95,30,-0.0500000000000007,70,77,-7,-9,2
21700984,1627745,GSW,POR,Damian Jones,9,1.8,2,-0.2,3,7,-4,-2,-2
21700984,202323,POR,GSW,Evan Turner,119,27.15,27,0.149999999999999,78,55,23,22,1
21700984,202329,POR,GSW,Al-Farouq Aminu,99,20.95,21,-0.0500000000000007,49,51,-2,-2,0
21700984,202334,POR,GSW,Ed Davis,112,26.0166666666667,26,0.0166666666666657,70,54,16,14,2
21700984,203081,POR,GSW,Damian Lillard,176,37.3333333333333,37,0.333333333333329,100,86,14,11,3
21700984,203090,POR,GSW,Maurice Harkless,92,19.45,20,-0.550000000000001,44,49,-5,-7,2
21700984,203468,POR,GSW,CJ McCollum,171,38.15,38,0.150000000000006,100,83,17,17,0
21700984,203894,POR,GSW,Shabazz Napier,69,16.0166666666667,16,0.0166666666666657,41,36,5,7,-2
21700984,203994,POR,GSW,Jusuf Nurkic,99,20.95,21,-0.0500000000000007,49,51,-2,-2,0
21700984,1626192,POR,GSW,Pat Connaughton,29,5.85,6,-0.15,20,14,6,8,-2
21700984,1627774,POR,GSW,Jake Layman,3,0.65,1,-0.35,3,3,0,2,-2
21700984,1628380,POR,GSW,Zach Collins,108,25.3333333333333,26,-0.666666666666664,68,55,13,13,0
21700984,1628403,POR,GSW,Caleb Swanigan,3,0.65,1,-0.35,3,3,0,2,-2
21700985,201571,ORL,SAC,D.J. Augustin,120,27.8166666666667,28,-0.183333333333334,52,55,-3,-1,-2
21700985,202687,ORL,SAC,Bismack Biyombo,66,14.8333333333333,15,-0.166666666666668,24,22,2,2,0
21700985,202696,ORL,SAC,Nikola Vucevic,144,33.15,33,0.149999999999999,64,72,-8,-8,0
21700985,202714,ORL,SAC,Shelvin Mack,119,26.3,25,1.3,48,52,-4,-6,2
21700985,203613,ORL,SAC,Jonathon Simmons,154,34.8666666666667,35,-0.133333333333333,69,74,-5,-5,0
21700985,203920,ORL,SAC,Khem Birch,53,11.9,12,-0.0999999999999996,22,24,-2,-2,0
21700985,1626209,ORL,SAC,Mario Hezonja,140,33.0833333333333,33,0.0833333333333286,54,61,-7,-5,-2
21700985,1628371,ORL,SAC,Jonathan Isaac,113,25.3166666666667,26,-0.683333333333334,50,54,-4,-2,-2
21700985,1628411,ORL,SAC,Wes Iwundu,97,22.65,23,-0.350000000000001,41,40,1,-1,2
21700985,1628681,ORL,SAC,Rodney Purvis,44,10,10,0,16,16,0,-2,2
21700985,1713,SAC,ORL,Vince Carter,126,28.2,28,0.199999999999999,53,60,-7,-9,2
21700985,201585,SAC,ORL,Kosta Koufos,168,38.5666666666667,38,0.566666666666663,81,70,11,12,-1
21700985,202066,SAC,ORL,Garrett Temple,131,30.1666666666667,30,0.166666666666664,64,53,11,13,-2
21700985,203992,SAC,ORL,Bogdan Bogdanovic,114,26.9,27,-0.100000000000001,53,50,3,1,2
21700985,204022,SAC,ORL,Jack Cooley,35,7.73333333333333,8,-0.266666666666667,11,14,-3,-4,1
21700985,1627741,SAC,ORL,Buddy Hield,136,29.7333333333333,30,-0.266666666666666,50,58,-8,-6,-2
21700985,1627746,SAC,ORL,Skal Labissiere,91,21.4666666666667,22,-0.533333333333331,43,32,11,13,-2
21700985,1628382,SAC,ORL,Justin Jackson,128,29.3833333333333,30,-0.616666666666667,63,51,12,12,0
21700985,1628412,SAC,ORL,Frank Mason,121,27.7666666666667,28,-0.233333333333334,52,52,0,-2,2
21700986,2544,CLE,LAC,LeBron James,188,39.2333333333333,39,0.233333333333334,82,98,-16,-16,0
21700986,2594,CLE,LAC,Kyle Korver,116,23.45,24,-0.550000000000001,46,54,-8,-7,-1
21700986,2747,CLE,LAC,JR Smith,164,34.5666666666667,35,-0.433333333333337,70,86,-16,-15,-1
21700986,101181,CLE,LAC,Jose Calderon,6,1.46666666666667,2,-0.533333333333333,0,2,-2,-3,1
21700986,201145,CLE,LAC,Jeff Green,125,24.2166666666667,25,-0.783333333333331,64,56,8,8,0
21700986,201588,CLE,LAC,George Hill,152,32.6166666666667,32,0.616666666666667,68,72,-4,-2,-2
21700986,203903,CLE,LAC,Jordan Clarkson,127,25.1833333333333,25,0.183333333333334,59,68,-9,-9,0
21700986,203918,CLE,LAC,Rodney Hood,29,6.5,7,-0.5,11,17,-6,-8,2
21700986,204066,CLE,LAC,John Holland,5,1.35,2,-0.65,0,2,-2,-2,0
21700986,1626204,CLE,LAC,Larry Nance Jr.,141,29.8166666666667,30,-0.183333333333334,62,78,-16,-15,-1
21700986,1626224,CLE,LAC,Cedi Osman,58,10.7666666666667,11,-0.233333333333334,30,29,1,0,1
21700986,1627790,CLE,LAC,Ante Zizic,39,7.4,8,-0.6,18,16,2,1,1
21700986,1628506,CLE,LAC,London Perrantes,5,1.35,2,-0.65,0,2,-2,-2,0
21700986,101150,LAC,CLE,Lou Williams,199,40.5,41,-0.5,97,92,5,7,-2
21700986,201599,LAC,CLE,DeAndre Jordan,159,33.1666666666667,34,-0.833333333333329,77,68,9,12,-3
21700986,202699,LAC,CLE,Tobias Harris,150,32.5666666666667,33,-0.433333333333337,77,65,12,12,0
21700986,203085,LAC,CLE,Austin Rivers,178,37.4,38,-0.599999999999994,89,76,13,15,-2
21700986,1626149,LAC,CLE,Montrezl Harrell,103,19.8166666666667,20,-0.183333333333334,56,44,12,12,0
21700986,1626246,LAC,CLE,Boban Marjanovic,50,9.61666666666667,10,-0.383333333333333,22,27,-5,-8,3
21700986,1628393,LAC,CLE,Jawun Evans,47,9.46666666666667,9,0.466666666666667,24,20,4,2,2
21700986,1628414,LAC,CLE,Sindarius Thornwell,177,37.0833333333333,37,0.0833333333333286,94,73,21,21,0
21700986,1628462,LAC,CLE,Milos Teodosic,92,18.3,18,0.299999999999997,44,45,-1,-3,2
21700987,2199,PHX,CHA,Tyson Chandler,98,21.2833333333333,21,0.283333333333331,47,61,-14,-15,1
21700987,201162,PHX,CHA,Jared Dudley,133,28.3833333333333,29,-0.616666666666667,80,68,12,13,-1
21700987,203458,PHX,CHA,Alex Len,32,6.81666666666667,7,-0.183333333333334,9,18,-9,-9,0
21700987,203584,PHX,CHA,Troy Daniels,164,35.6666666666667,36,-0.333333333333329,85,94,-9,-9,0
21700987,203901,PHX,CHA,Elfrid Payton,126,26.9333333333333,27,-0.0666666666666664,48,69,-21,-22,1
21700987,1627733,PHX,CHA,Dragan Bender,150,31.9833333333333,32,-0.0166666666666657,75,81,-6,-4,-2
21700987,1627737,PHX,CHA,Marquese Chriss,95,19.7166666666667,20,-0.283333333333331,40,50,-10,-13,3
21700987,1627755,PHX,CHA,Tyler Ulis,108,22.8666666666667,23,-0.133333333333333,67,58,9,10,-1
21700987,1627885,PHX,CHA,Shaquille Harrison,93,20.6,21,-0.399999999999999,53,50,3,3,0
21700987,1628432,PHX,CHA,Davon Reed,116,24.0833333333333,25,-0.916666666666664,66,56,10,11,-1
21700987,2730,CHA,PHX,Dwight Howard,173,37.35,37,0.349999999999994,99,82,17,15,2
21700987,101107,CHA,PHX,Marvin Williams,125,26.7,27,-0.299999999999997,76,62,14,10,4
21700987,201587,CHA,PHX,Nicolas Batum,166,35.85,36,-0.149999999999999,96,71,25,24,1
21700987,202689,CHA,PHX,Kemba Walker,184,39.3333333333333,39,0.333333333333336,108,97,11,9,2
21700987,203077,CHA,PHX,Michael Kidd-Gilchrist,137,29.2333333333333,30,-0.766666666666666,84,58,26,25,1
21700987,203087,CHA,PHX,Jeremy Lamb,81,17.5333333333333,18,-0.466666666666665,37,53,-16,-17,1
21700987,1626163,CHA,PHX,Frank Kaminsky,94,20.4666666666667,20,0.466666666666665,41,50,-9,-5,-4
21700987,1626203,CHA,PHX,Treveon Graham,54,10.8166666666667,11,-0.183333333333334,26,34,-8,-10,2
21700987,1628370,CHA,PHX,Malik Monk,61,12.6666666666667,13,-0.333333333333334,24,40,-16,-17,1
21700987,1628407,CHA,PHX,Dwayne Bacon,40,8.38333333333333,8,0.383333333333333,14,23,-9,-9,0
21700988,2548,MIA,WAS,Dwyane Wade,68,15,15,0,33,29,4,3,1
21700988,2617,MIA,WAS,Udonis Haslem,37,7.95,8,-0.0500000000000007,12,23,-11,-11,0
21700988,201609,MIA,WAS,Goran Dragic,88,18.35,19,-0.649999999999999,62,33,29,30,-1
21700988,201949,MIA,WAS,James Johnson,91,19.5333333333333,20,-0.466666666666669,61,43,18,18,0
21700988,201961,MIA,WAS,Wayne Ellington,113,24.5,24,0.5,68,48,20,20,0
21700988,202337,MIA,WAS,Luke Babbitt,47,10.1833333333333,10,0.183333333333334,21,25,-4,-4,0
21700988,203482,MIA,WAS,Kelly Olynyk,101,21.4166666666667,22,-0.583333333333336,67,46,21,19,2
21700988,203585,MIA,WAS,Rodney McGruder,94,20.0166666666667,20,0.0166666666666657,41,42,-1,-1,0
21700988,204020,MIA,WAS,Tyler Johnson,124,25.9833333333333,26,-0.0166666666666657,87,60,27,27,0
21700988,1626159,MIA,WAS,Justise Winslow,135,29.0333333333333,29,0.0333333333333314,68,61,7,9,-2
21700988,1626175,MIA,WAS,Jordan Mickey,37,7.95,8,-0.0500000000000007,12,23,-11,-11,0
21700988,1626196,MIA,WAS,Josh Richardson,98,21.2666666666667,21,0.266666666666666,63,46,17,17,0
21700988,1628389,MIA,WAS,Bam Adebayo,82,17.5666666666667,18,-0.433333333333334,50,31,19,19,0
21700988,101162,WAS,MIA,Marcin Gortat,79,17.3333333333333,17,0.333333333333336,29,48,-19,-19,0
21700988,201160,WAS,MIA,Jason Smith,54,11.7666666666667,12,-0.233333333333334,26,26,0,0,0
21700988,201196,WAS,MIA,Ramon Sessions,107,22.9666666666667,23,-0.033333333333335,54,59,-5,-5,0
21700988,201975,WAS,MIA,Jodie Meeks,130,27.4166666666667,28,-0.583333333333336,64,73,-9,-9,0
21700988,202693,WAS,MIA,Markieff Morris,89,19.1166666666667,19,0.116666666666667,42,59,-17,-21,4
21700988,203078,WAS,MIA,Bradley Beal,125,26.5166666666667,27,-0.483333333333334,52,78,-26,-26,0
21700988,203107,WAS,MIA,Tomas Satoransky,139,29.4833333333333,29,0.483333333333334,58,81,-23,-23,0
21700988,203118,WAS,MIA,Mike Scott,72,15.2833333333333,15,0.283333333333333,34,42,-8,-4,-4
21700988,203490,WAS,MIA,Otto Porter Jr.,118,25.5166666666667,26,-0.483333333333334,52,69,-17,-17,0
21700988,204025,WAS,MIA,Tim Frazier,68,14.9833333333333,15,-0.0166666666666657,36,38,-2,-2,0
21700988,1626162,WAS,MIA,Kelly Oubre Jr.,134,28.3666666666667,29,-0.633333333333333,63,72,-9,-9,0
21700989,1717,DAL,MEM,Dirk Nowitzki,67,15.15,16,-0.850000000000001,27,29,-2,0,-2
21700989,200826,DAL,MEM,J.J. Barea,99,22.7666666666667,23,-0.233333333333334,48,38,10,12,-2
21700989,202083,DAL,MEM,Wesley Matthews,114,24.8,25,-0.200000000000003,52,44,8,6,2
21700989,203084,DAL,MEM,Harrison Barnes,141,30.9666666666667,31,-0.033333333333335,76,55,21,19,2
21700989,203926,DAL,MEM,Doug McDermott,114,25.0333333333333,25,0.0333333333333314,64,42,22,23,-1
21700989,203939,DAL,MEM,Dwight Powell,122,28.2333333333333,29,-0.766666666666666,61,51,10,8,2
21700989,1626257,DAL,MEM,Salah Mejri,11,2.53333333333333,3,-0.466666666666667,8,2,6,6,0
21700989,1627812,DAL,MEM,Yogi Ferrell,140,30.35,31,-0.649999999999999,85,49,36,34,2
21700989,1627827,DAL,MEM,Dorian Finney-Smith,87,19,18,1,54,32,22,21,1
21700989,1627858,DAL,MEM,Kyle Collinsworth,55,12.5833333333333,13,-0.416666666666668,27,18,9,11,-2
21700989,1628467,DAL,MEM,Maxi Kleber,120,26,26,0,68,40,28,30,-2
21700989,202718,MEM,DAL,Chandler Parsons,66,15.2166666666667,15,0.216666666666665,31,36,-5,-9,4
21700989,203210,MEM,DAL,JaMychal Green,128,29.4,29,0.399999999999999,54,63,-9,-13,4
21700989,203463,MEM,DAL,Ben McLemore,158,35.05,35,0.0499999999999972,61,76,-15,-15,0
21700989,1626185,MEM,DAL,Jarell Martin,132,29.6833333333333,29,0.68333333333333,54,60,-6,-6,0
21700989,1627738,MEM,DAL,Deyonta Davis,117,25.2666666666667,25,0.266666666666666,32,66,-34,-30,-4
21700989,1627744,MEM,DAL,Brice Johnson,20,5,6,-1,6,17,-11,-11,0
21700989,1628397,MEM,DAL,Ivan Rabb,74,15.95,17,-1.05,25,44,-19,-15,-4
21700989,1628415,MEM,DAL,Dillon Brooks,132,29.65,30,-0.350000000000001,59,68,-9,-7,-2
21700989,1628424,MEM,DAL,Kobi Simmons,167,36.0333333333333,36,0.0333333333333314,52,91,-39,-41,2
21700989,1628504,MEM,DAL,Xavier Rathan-Mayes,76,16.1666666666667,17,-0.833333333333332,26,49,-23,-23,0
21700990,1938,SAS,OKC,Manu Ginobili,97,19.5666666666667,19,0.566666666666666,44,52,-8,-7,-1
21700990,2200,SAS,OKC,Pau Gasol,112,24.3833333333333,25,-0.616666666666667,40,51,-11,-11,0
21700990,2225,SAS,OKC,Tony Parker,93,18.2833333333333,18,0.283333333333331,39,43,-4,-4,0
21700990,200746,SAS,OKC,LaMarcus Aldridge,118,25.95,26,-0.0500000000000007,45,49,-4,-4,0
21700990,200752,SAS,OKC,Rudy Gay,110,22.6833333333333,23,-0.31666666666667,45,50,-5,-5,0
21700990,201980,SAS,OKC,Danny Green,82,17.4,18,-0.600000000000001,30,45,-15,-16,1
21700990,201988,SAS,OKC,Patty Mills,110,23.95,24,-0.0499999999999972,40,46,-6,-4,-2
21700990,202722,SAS,OKC,Davis Bertans,83,18.1666666666667,18,0.166666666666664,42,47,-5,-5,0
21700990,203464,SAS,OKC,Brandon Paul,5,1.2,1,0.2,4,2,2,2,0
21700990,203530,SAS,OKC,Joffrey Lauvergne,28,6.61666666666667,7,-0.383333333333333,22,15,7,7,0
21700990,203937,SAS,OKC,Kyle Anderson,110,25.75,26,-0.25,42,47,-5,-8,3
21700990,1627749,SAS,OKC,Dejounte Murray,127,29.5833333333333,30,-0.416666666666664,55,61,-6,-6,0
21700990,1627854,SAS,OKC,Bryn Forbes,25,5.8,6,-0.2,22,12,10,11,-1
21700990,2546,OKC,SAS,Carmelo Anthony,144,31.3,32,-0.699999999999999,56,69,-13,-13,0
21700990,2555,OKC,SAS,Nick Collison,27,6.31666666666667,6,0.316666666666666,13,12,1,-2,3
21700990,101109,OKC,SAS,Raymond Felton,58,12.75,12,0.75,33,23,10,9,1
21700990,201147,OKC,SAS,Corey Brewer,141,29.6333333333333,30,-0.366666666666667,61,63,-2,3,-5
21700990,201566,OKC,SAS,Russell Westbrook,162,35.1166666666667,36,-0.883333333333333,71,71,0,1,-1
21700990,202331,OKC,SAS,Paul George,174,36.8,37,-0.200000000000003,70,77,-7,-7,0
21700990,202335,OKC,SAS,Patrick Patterson,100,20.7333333333333,21,-0.266666666666666,51,36,15,15,0
21700990,203500,OKC,SAS,Steven Adams,78,17.2666666666667,17,0.266666666666666,33,29,4,3,1
21700990,203518,OKC,SAS,Alex Abrines,75,17.5833333333333,18,-0.416666666666668,43,31,12,7,5
21700990,203924,OKC,SAS,Jerami Grant,91,20.1166666666667,20,0.116666666666667,55,42,13,17,-4
21700990,203962,OKC,SAS,Josh Huestis,50,11.7166666666667,12,-0.283333333333333,34,17,17,17,0
21700991,101150,LAC,ORL,Lou Williams,159,33.8833333333333,35,-1.11666666666667,79,80,-1,3,-4
21700991,201599,LAC,ORL,DeAndre Jordan,161,33.8,34,-0.200000000000003,79,81,-2,2,-4
21700991,202325,LAC,ORL,Wesley Johnson,80,17.7666666666667,17,0.766666666666666,38,35,3,7,-4
21700991,202699,LAC,ORL,Tobias Harris,175,37.3,37,0.299999999999997,87,87,0,2,-2
21700991,203085,LAC,ORL,Austin Rivers,158,33.5333333333333,34,-0.466666666666669,77,82,-5,-1,-4
21700991,1626149,LAC,ORL,Montrezl Harrell,62,14.3333333333333,14,0.333333333333332,36,24,12,6,6
21700991,1626246,LAC,ORL,Boban Marjanovic,42,9.9,10,-0.0999999999999996,24,18,6,6,0
21700991,1628393,LAC,ORL,Jawun Evans,60,12.9833333333333,13,-0.0166666666666657,32,30,2,-2,4
21700991,1628414,LAC,ORL,Sindarius Thornwell,64,13.9166666666667,14,-0.0833333333333339,41,37,4,-2,6
21700991,1628462,LAC,ORL,Milos Teodosic,139,30.9166666666667,31,-0.0833333333333322,72,51,21,19,2
21700991,201571,ORL,LAC,D.J. Augustin,135,28.6,29,-0.399999999999999,70,69,1,-1,2
21700991,202687,ORL,LAC,Bismack Biyombo,79,18.6,18,0.600000000000001,34,47,-13,-11,-2
21700991,202696,ORL,LAC,Nikola Vucevic,141,29.0666666666667,30,-0.933333333333334,71,66,5,3,2
21700991,202714,ORL,LAC,Shelvin Mack,104,23.5833333333333,24,-0.416666666666664,43,51,-8,-6,-2
21700991,203613,ORL,LAC,Jonathon Simmons,164,34.7166666666667,35,-0.283333333333331,83,80,3,5,-2
21700991,203920,ORL,LAC,Khem Birch,78,17.9,18,-0.100000000000001,33,42,-9,-10,1
21700991,1626209,ORL,LAC,Mario Hezonja,118,24.2,25,-0.800000000000001,64,60,4,5,-1
21700991,1628371,ORL,LAC,Jonathan Isaac,117,24.6166666666667,25,-0.383333333333333,59,58,1,3,-2
21700991,1628411,ORL,LAC,Wes Iwundu,108,24.1,24,0.100000000000001,46,59,-13,-15,2
21700991,1628681,ORL,LAC,Rodney Purvis,56,12.95,13,-0.0500000000000007,22,33,-11,-13,2
21700992,201563,NYK,TOR,Michael Beasley,147,29.25,30,-0.75,59,79,-20,-10,-10
21700992,201584,NYK,TOR,Courtney Lee,93,20,20,0,47,65,-18,-16,-2
21700992,203124,NYK,TOR,Kyle O'Quinn,103,21.9833333333333,22,-0.0166666666666657,51,70,-19,-22,3
21700992,203501,NYK,TOR,Tim Hardaway Jr.,184,37.4,38,-0.600000000000001,87,107,-20,-19,-1
21700992,203504,NYK,TOR,Trey Burke,71,14.6666666666667,15,-0.333333333333334,37,45,-8,-16,8
21700992,1626144,NYK,TOR,Emmanuel Mudiay,148,30.5,30,0.5,68,80,-12,-13,1
21700992,1627786,NYK,TOR,Troy Williams,26,6.25,6,0.25,12,12,0,0,0
21700992,1628373,NYK,TOR,Frank Ntilikina,155,31.2166666666667,32,-0.783333333333331,58,83,-25,-16,-9
21700992,1628422,NYK,TOR,Damyean Dotson,13,3.06666666666667,3,0.0666666666666664,6,4,2,2,0
21700992,1628436,NYK,TOR,Luke Kornet,161,33.35,34,-0.649999999999999,73,89,-16,-13,-3
21700992,1628439,NYK,TOR,Isaiah Hicks,49,10.8166666666667,11,-0.183333333333334,27,26,1,-7,8
21700992,101139,TOR,NYK,CJ Miles,83,17.8833333333333,18,-0.116666666666667,56,37,19,22,-3
21700992,200768,TOR,NYK,Kyle Lowry,140,27.8333333333333,28,-0.166666666666668,80,71,9,12,-3
21700992,201586,TOR,NYK,Serge Ibaka,127,24.4666666666667,25,-0.533333333333331,67,65,2,5,-3
21700992,201942,TOR,NYK,DeMar DeRozan,142,28.3333333333333,28,0.333333333333332,82,68,14,19,-5
21700992,202685,TOR,NYK,Jonas Valanciunas,113,22.05,22,0.0500000000000007,59,49,10,2,8
21700992,203512,TOR,NYK,Lucas Nogueira,20,5.1,5,0.0999999999999996,10,8,2,2,0
21700992,1626153,TOR,NYK,Delon Wright,88,19.3666666666667,20,-0.633333333333333,50,37,13,11,2
21700992,1626181,TOR,NYK,Norman Powell,100,21.2666666666667,22,-0.733333333333334,53,49,4,5,-1
21700992,1626259,TOR,NYK,Malcolm Miller,60,11.9,12,-0.0999999999999996,28,24,4,4,0
21700992,1627751,TOR,NYK,Jakob Poeltl,97,20.55,21,-0.450000000000003,63,48,15,26,-11
21700992,1627783,TOR,NYK,Pascal Siakam,83,18.1333333333333,18,0.133333333333333,55,32,23,23,0
21700992,1627832,TOR,NYK,Fred VanVleet,77,16.5166666666667,16,0.516666666666666,47,29,18,17,1
21700992,1628502,TOR,NYK,Nigel Hayes,20,5.1,5,0.0999999999999996,10,8,2,2,0
21700993,203101,ATL,CHI,Miles Plumlee,79,16.3666666666667,16,0.366666666666667,44,45,-1,-3,2
21700993,203145,ATL,CHI,Kent Bazemore,59,12.4333333333333,12,0.433333333333334,26,33,-7,-7,0
21700993,203473,ATL,CHI,Dewayne Dedmon,141,30.1833333333333,31,-0.81666666666667,72,83,-11,-9,-2
21700993,203488,ATL,CHI,Mike Muscala,109,22.6333333333333,23,-0.366666666666667,71,64,7,4,3
21700993,203705,ATL,CHI,Josh Magette,98,21.4166666666667,22,-0.583333333333332,60,56,4,2,2
21700993,1627752,ATL,CHI,Taurean Prince,160,35.0333333333333,35,0.0333333333333314,96,86,10,10,0
21700993,1627819,ATL,CHI,Isaiah Taylor,126,27.3333333333333,27,0.333333333333332,71,69,2,4,-2
21700993,1628381,ATL,CHI,John Collins,119,26.65,27,-0.350000000000001,57,66,-9,-6,-3
21700993,1628416,ATL,CHI,Tyler Dorsey,133,27.7166666666667,28,-0.283333333333335,70,82,-12,-11,-1
21700993,1628510,ATL,CHI,Andrew White III,66,13.8166666666667,14,-0.183333333333334,31,46,-15,-16,1
21700993,1628537,ATL,CHI,Jaylen Morris,30,6,6,0,12,15,-3,-3,0
21700993,201577,CHI,ATL,Robin Lopez,52,12,12,0,20,34,-14,-14,0
21700993,203897,CHI,ATL,Zach LaVine,132,28.35,28,0.350000000000001,66,74,-8,-8,0
21700993,203943,CHI,ATL,Noah Vonleh,91,18.6,19,-0.399999999999999,59,39,20,20,0
21700993,1626166,CHI,ATL,Cameron Payne,86,17.5666666666667,17,0.566666666666666,63,39,24,24,0
21700993,1626171,CHI,ATL,Bobby Portis,138,27.4166666666667,27,0.416666666666664,91,70,21,21,0
21700993,1626245,CHI,ATL,Cristiano Felicio,36,9.06666666666667,9,0.0666666666666664,22,20,2,2,0
21700993,1627739,CHI,ATL,Kris Dunn,138,30.35,31,-0.649999999999999,66,83,-17,-17,0
21700993,1627756,CHI,ATL,Denzel Valentine,122,26.2833333333333,26,0.283333333333331,76,65,11,11,0
21700993,1628021,CHI,ATL,David Nwaba,100,22.15,23,-0.850000000000001,56,59,-3,-5,2
21700993,1628374,CHI,ATL,Lauri Markkanen,131,28.75,29,-0.25,66,81,-15,-15,0
21700993,1628469,CHI,ATL,Antonio Blakeney,94,19.05,19,0.0499999999999972,60,46,14,16,-2
21700994,2585,GSW,MIN,Zaza Pachulia,130,25.7,25,0.699999999999999,67,58,9,8,1
21700994,2733,GSW,MIN,Shaun Livingston,104,20.8833333333333,21,-0.116666666666667,57,44,13,15,-2
21700994,201142,GSW,MIN,Kevin Durant,185,38.6833333333333,39,-0.316666666666663,77,94,-17,-19,2
21700994,201156,GSW,MIN,Nick Young,109,21.4166666666667,22,-0.583333333333336,56,42,14,16,-2
21700994,201580,GSW,MIN,JaVale McGee,63,14.25,14,0.25,21,35,-14,-15,1
21700994,201956,GSW,MIN,Omri Casspi,34,6.96666666666667,7,-0.0333333333333332,14,14,0,2,-2
21700994,202691,GSW,MIN,Klay Thompson,191,39.6166666666667,40,-0.38333333333334,79,90,-11,-11,0
21700994,203110,GSW,MIN,Draymond Green,171,34.25,35,-0.75,70,80,-10,-8,-2
21700994,1626172,GSW,MIN,Kevon Looney,35,7.66666666666667,7,0.666666666666666,21,21,0,0,0
21700994,1626188,GSW,MIN,Quinn Cook,138,28.9833333333333,29,-0.0166666666666657,53,67,-14,-18,4
21700994,2037,MIN,GSW,Jamal Crawford,104,21.3666666666667,22,-0.633333333333333,44,51,-7,-9,2
21700994,201565,MIN,GSW,Derrick Rose,33,6.55,7,-0.45,10,27,-17,-17,0
21700994,201952,MIN,GSW,Jeff Teague,171,35.3,36,-0.700000000000003,84,65,19,19,0
21700994,201959,MIN,GSW,Taj Gibson,184,38.8,39,-0.200000000000003,90,75,15,15,0
21700994,202357,MIN,GSW,Nemanja Bjelica,198,39.8,40,-0.200000000000003,93,87,6,8,-2
21700994,203476,MIN,GSW,Gorgui Dieng,44,8.96666666666667,9,-0.0333333333333332,20,28,-8,-9,1
21700994,203952,MIN,GSW,Andrew Wiggins,177,36.5333333333333,37,-0.466666666666669,90,69,21,21,0
21700994,1626145,MIN,GSW,Tyus Jones,61,12.3833333333333,12,0.383333333333333,25,38,-13,-13,0
21700994,1626157,MIN,GSW,Karl-Anthony Towns,188,38.7166666666667,39,-0.283333333333331,89,75,14,15,-1
21700995,2731,NOP,UTA,Emeka Okafor,96,18.3666666666667,18,0.366666666666667,36,50,-14,-14,0
21700995,200765,NOP,UTA,Rajon Rondo,112,23.0333333333333,23,0.0333333333333314,45,55,-10,-9,-1
21700995,201950,NOP,UTA,Jrue Holiday,197,39.6666666666667,39,0.666666666666671,84,93,-9,-11,2
21700995,202703,NOP,UTA,Nikola Mirotic,97,18.5333333333333,18,0.533333333333331,39,37,2,4,-2
21700995,202732,NOP,UTA,DeAndre Liggins,41,7.68333333333333,8,-0.316666666666666,13,23,-10,-8,-2
21700995,202734,NOP,UTA,E'Twaun Moore,136,27.6833333333333,28,-0.316666666666666,58,66,-8,-10,2
21700995,203076,NOP,UTA,Anthony Davis,199,40.1,40,0.0999999999999943,85,93,-8,-10,2
21700995,203121,NOP,UTA,Darius Miller,163,32.6833333333333,33,-0.31666666666667,70,80,-10,-12,2
21700995,203546,NOP,UTA,Ian Clark,136,26.1,26,0.100000000000001,57,68,-11,-9,-2
21700995,1627767,NOP,UTA,Cheick Diallo,28,5.48333333333333,6,-0.516666666666667,8,15,-7,-6,-1
21700995,201937,UTA,NOP,Ricky Rubio,169,34.7833333333333,35,-0.216666666666669,84,71,13,15,-2
21700995,201973,UTA,NOP,Jonas Jerebko,61,11.3333333333333,11,0.333333333333332,20,26,-6,-9,3
21700995,202324,UTA,NOP,Derrick Favors,93,18.3833333333333,18,0.383333333333333,48,40,8,7,1
21700995,202327,UTA,NOP,Ekpe Udoh,28,5.03333333333333,5,0.0333333333333332,10,14,-4,-4,0
21700995,203109,UTA,NOP,Jae Crowder,163,32.1333333333333,32,0.133333333333333,86,64,22,22,0
21700995,203497,UTA,NOP,Rudy Gobert,198,39.8166666666667,40,-0.183333333333337,97,75,22,24,-2
21700995,203526,UTA,NOP,Raul Neto,26,4.6,5,-0.4,8,13,-5,-7,2
21700995,204060,UTA,NOP,Joe Ingles,179,35.3166666666667,36,-0.68333333333333,82,78,4,10,-6
21700995,1626220,UTA,NOP,Royce O'Neale,80,16.2666666666667,16,0.266666666666666,40,34,6,2,4
21700995,1628378,UTA,NOP,Donovan Mitchell,205,40.85,41,-0.149999999999999,103,80,23,25,-2
21700995,1628571,UTA,NOP,Erik McCree,3,0.816666666666667,1,-0.183333333333333,2,0,2,0,2
21700996,2210,DEN,SAC,Richard Jefferson,21,4.63333333333333,5,-0.366666666666666,14,11,3,1,2
21700996,2734,DEN,SAC,Devin Harris,95,20.1,20,0.100000000000001,52,53,-1,-1,0
21700996,200794,DEN,SAC,Paul Millsap,105,23.5166666666667,24,-0.483333333333334,69,36,33,32,1
21700996,201163,DEN,SAC,Wilson Chandler,119,26.3166666666667,26,0.316666666666666,71,48,23,23,0
21700996,201589,DEN,SAC,Darrell Arthur,16,3.5,4,-0.5,9,11,-2,-2,0
21700996,203115,DEN,SAC,Will Barton,115,24.5833333333333,24,0.583333333333332,61,60,1,3,-2
21700996,203486,DEN,SAC,Mason Plumlee,95,20.5333333333333,20,0.533333333333331,52,57,-5,-4,-1
21700996,203914,DEN,SAC,Gary Harris,139,32.15,33,-0.850000000000001,92,65,27,27,0
21700996,203999,DEN,SAC,Nikola Jokic,134,29.2666666666667,30,-0.733333333333334,85,52,33,33,0
21700996,1626168,DEN,SAC,Trey Lyles,81,18.0166666666667,18,0.0166666666666657,45,50,-5,-5,0
21700996,1627736,DEN,SAC,Malik Beasley,30,6.38333333333333,7,-0.616666666666667,19,23,-4,-4,0
21700996,1627750,DEN,SAC,Jamal Murray,130,28.75,29,-0.25,81,54,27,27,0
21700996,1713,SAC,DEN,Vince Carter,40,8.93333333333333,9,-0.0666666666666664,23,25,-2,-4,2
21700996,2216,SAC,DEN,Zach Randolph,99,21.5666666666667,22,-0.433333333333334,34,60,-26,-24,-2
21700996,201585,SAC,DEN,Kosta Koufos,88,20,20,0,33,57,-24,-24,0
21700996,202066,SAC,DEN,Garrett Temple,92,19.75,20,-0.25,53,50,3,1,2
21700996,203992,SAC,DEN,Bogdan Bogdanovic,103,23.1666666666667,23,0.166666666666664,40,66,-26,-26,0
21700996,203998,SAC,DEN,Bruno Caboclo,60,13.0833333333333,13,0.0833333333333322,31,30,1,1,0
21700996,1626161,SAC,DEN,Willie Cauley-Stein,134,29.5,30,-0.5,73,82,-9,-8,-1
21700996,1627741,SAC,DEN,Buddy Hield,126,26.8,27,-0.200000000000003,70,70,0,-1,1
21700996,1628368,SAC,DEN,De'Aaron Fox,136,29.8,30,-0.199999999999999,64,86,-22,-22,0
21700996,1628382,SAC,DEN,Justin Jackson,122,27.4,28,-0.600000000000001,59,80,-21,-19,-2
21700996,1628412,SAC,DEN,Frank Mason,80,17.75,18,-0.25,40,44,-4,-4,0
21700997,1717,DAL,HOU,Dirk Nowitzki,93,21.95,22,-0.0500000000000007,40,67,-27,-27,0
21700997,200826,DAL,HOU,J.J. Barea,102,23.1,23,0.100000000000001,41,42,-1,-1,0
21700997,203084,DAL,HOU,Harrison Barnes,146,31.8,32,-0.200000000000003,50,73,-23,-23,0
21700997,203457,DAL,HOU,Nerlens Noel,73,15.0833333333333,15,0.0833333333333322,26,16,10,9,1
21700997,203926,DAL,HOU,Doug McDermott,125,26.3166666666667,27,-0.683333333333334,46,36,10,8,2
21700997,203939,DAL,HOU,Dwight Powell,93,22.25,23,-0.75,42,68,-26,-25,-1
21700997,1627812,DAL,HOU,Yogi Ferrell,129,28.9666666666667,29,-0.0333333333333314,48,75,-27,-29,2
21700997,1627858,DAL,HOU,Kyle Collinsworth,115,25.1333333333333,25,0.133333333333333,48,55,-7,-2,-5
21700997,1627866,DAL,HOU,Jameel Warney,39,8,8,0,13,13,0,-2,2
21700997,1628372,DAL,HOU,Dennis Smith Jr.,140,30.5,31,-0.5,50,70,-20,-21,1
21700997,1628405,DAL,HOU,Johnathan Motley,14,2.7,3,-0.3,5,2,3,3,0
21700997,1628467,DAL,HOU,Maxi Kleber,11,2.28333333333333,2,0.283333333333333,1,8,-7,-5,-2
21700997,2207,HOU,DAL,Joe Johnson,121,26.0666666666667,27,-0.933333333333334,38,42,-4,-4,0
21700997,2772,HOU,DAL,Trevor Ariza,156,34.2333333333333,35,-0.766666666666666,81,59,22,22,0
21700997,101108,HOU,DAL,Chris Paul,133,30.1,30,0.100000000000001,82,52,30,31,-1
21700997,101123,HOU,DAL,Gerald Green,93,20.1833333333333,20,0.183333333333334,40,27,13,13,0
21700997,200782,HOU,DAL,PJ Tucker,88,19.95,20,-0.0500000000000007,57,42,15,17,-2
21700997,201569,HOU,DAL,Eric Gordon,138,30.9,31,-0.100000000000001,79,51,28,27,1
21700997,201601,HOU,DAL,Luc Mbah a Moute,149,31.7833333333333,32,-0.216666666666669,51,58,-7,-7,0
21700997,203991,HOU,DAL,Clint Capela,102,23.1,23,0.100000000000001,57,48,9,7,2
21700997,204028,HOU,DAL,Tarik Black,100,21.7666666666667,22,-0.233333333333334,40,31,9,9,0
21700998,202328,BOS,IND,Greg Monroe,75,16.8333333333333,17,-0.166666666666668,31,41,-10,-10,0
21700998,202681,BOS,IND,Kyrie Irving,74,15.9,16,-0.100000000000001,35,24,11,11,0
21700998,202694,BOS,IND,Marcus Morris,145,31.6833333333333,32,-0.31666666666667,67,64,3,3,0
21700998,203382,BOS,IND,Aron Baynes,88,19.15,19,0.149999999999999,39,33,6,6,0
21700998,203499,BOS,IND,Shane Larkin,71,16.2166666666667,17,-0.783333333333331,33,34,-1,1,-2
21700998,203935,BOS,IND,Marcus Smart,163,35.9833333333333,36,-0.0166666666666657,74,76,-2,-4,2
21700998,1626179,BOS,IND,Terry Rozier,151,33.9666666666667,34,-0.0333333333333314,66,70,-4,-6,2
21700998,1627846,BOS,IND,Abdel Nader,33,7.61666666666667,8,-0.383333333333333,13,20,-7,-4,-3
21700998,1628369,BOS,IND,Jayson Tatum,150,34.3166666666667,34,0.316666666666663,70,73,-3,-4,1
21700998,1628400,BOS,IND,Semi Ojeleye,41,9.06666666666667,9,0.0666666666666664,24,23,1,1,0
21700998,1628464,BOS,IND,Daniel Theis,79,19.2666666666667,19,0.266666666666666,33,37,-4,-2,-2
21700998,201152,IND,BOS,Thaddeus Young,105,23.1,23,0.100000000000001,47,51,-4,-6,2
21700998,201954,IND,BOS,Darren Collison,107,24,24,0,49,42,7,7,0
21700998,202344,IND,BOS,Trevor Booker,81,18.5,19,-0.5,34,37,-3,-3,0
21700998,202362,IND,BOS,Lance Stephenson,62,14.3333333333333,14,0.333333333333332,23,28,-5,-6,1
21700998,202709,IND,BOS,Cory Joseph,128,28.5666666666667,29,-0.433333333333334,58,63,-5,-4,-1
21700998,202711,IND,BOS,Bojan Bogdanovic,128,28.55,29,-0.450000000000003,62,64,-2,-1,-1
21700998,203506,IND,BOS,Victor Oladipo,163,35.9833333333333,36,-0.0166666666666657,76,74,2,4,-2
21700998,203922,IND,BOS,Glenn Robinson III,55,12.8166666666667,13,-0.183333333333334,31,20,11,10,1
21700998,1626167,IND,BOS,Myles Turner,158,35.45,36,-0.549999999999997,76,76,0,0,0
21700998,1627734,IND,BOS,Domantas Sabonis,83,18.7,19,-0.300000000000001,39,30,9,9,0
21700999,201960,BKN,PHI,DeMarre Carroll,116,25.1,25,0.100000000000001,45,57,-12,-12,0
21700999,201967,BKN,PHI,Dante Cunningham,88,17.6833333333333,17,0.683333333333334,42,50,-8,-12,4
21700999,202389,BKN,PHI,Timofey Mozgov,33,6.63333333333333,7,-0.366666666666667,11,11,0,1,-1
21700999,203112,BKN,PHI,Quincy Acy,33,6.63333333333333,7,-0.366666666666667,11,11,0,1,-1
21700999,203459,BKN,PHI,Allen Crabbe,117,24.45,24,0.449999999999999,49,55,-6,-6,0
21700999,203915,BKN,PHI,Spencer Dinwiddie,139,29.2166666666667,29,0.216666666666669,59,70,-11,-15,4
21700999,203917,BKN,PHI,Nik Stauskas,33,6.63333333333333,7,-0.366666666666667,11,11,0,1,-1
21700999,203925,BKN,PHI,Joe Harris,125,25.5166666666667,26,-0.483333333333334,51,69,-18,-15,-3
21700999,1626143,BKN,PHI,Jahlil Okafor,26,5.6,6,-0.4,10,11,-1,1,-2
21700999,1626156,BKN,PHI,D'Angelo Russell,125,28.1833333333333,28,0.183333333333334,52,78,-26,-24,-2
21700999,1626178,BKN,PHI,Rondae Hollis-Jefferson,113,22.7166666666667,23,-0.283333333333331,53,67,-14,-15,1
21700999,1627747,BKN,PHI,Caris LeVert,132,26.5833333333333,27,-0.416666666666668,55,70,-15,-13,-2
21700999,1628386,BKN,PHI,Jarrett Allen,70,15.05,16,-0.949999999999999,31,40,-9,-7,-2
21700999,101141,PHI,BKN,Ersan Ilyasova,130,26.8833333333333,27,-0.116666666666667,67,47,20,18,2
21700999,200755,PHI,BKN,JJ Redick,117,23.9333333333333,24,-0.0666666666666664,64,53,11,13,-2
21700999,201158,PHI,BKN,Marco Belinelli,118,25.2333333333333,25,0.233333333333334,67,47,20,18,2
21700999,203496,PHI,BKN,Robert Covington,130,28.4,29,-0.600000000000001,70,56,14,13,1
21700999,203954,PHI,BKN,Joel Embiid,121,26.1,26,0.100000000000001,68,54,14,19,-5
21700999,203967,PHI,BKN,Dario Saric,116,24.1833333333333,24,0.18333333333333,60,49,11,9,2
21700999,204456,PHI,BKN,T.J. McConnell,144,28.95,29,-0.0500000000000007,74,57,17,16,1
21700999,1626147,PHI,BKN,Justin Anderson,30,6,6,0,11,11,0,-1,1
21700999,1626158,PHI,BKN,Richaun Holmes,80,16.3,16,0.299999999999997,42,36,6,4,2
21700999,1627732,PHI,BKN,Ben Simmons,136,28.4666666666667,29,-0.533333333333331,66,60,6,6,0
21700999,1627789,PHI,BKN,Timothe Luwawu-Cabarrot,28,5.55,6,-0.45,11,10,1,0,1
21701000,2544,CLE,LAL,LeBron James,154,31.2833333333333,31,0.283333333333331,74,85,-11,-13,2
21701000,2594,CLE,LAL,Kyle Korver,140,28.7,28,0.699999999999999,68,85,-17,-13,-4
21701000,2747,CLE,LAL,JR Smith,108,22.5333333333333,23,-0.466666666666669,52,54,-2,-4,2
21701000,101181,CLE,LAL,Jose Calderon,100,21.1,21,0.100000000000001,48,55,-7,-3,-4
21701000,201145,CLE,LAL,Jeff Green,102,21.5666666666667,22,-0.433333333333334,51,52,-1,-5,4
21701000,201588,CLE,LAL,George Hill,131,26.7833333333333,27,-0.216666666666669,65,72,-7,-9,2
21701000,203903,CLE,LAL,Jordan Clarkson,83,16.6666666666667,16,0.666666666666664,35,54,-19,-17,-2
21701000,204066,CLE,LAL,John Holland,89,18.6833333333333,19,-0.316666666666666,45,49,-4,-2,-2
21701000,1626204,CLE,LAL,Larry Nance Jr.,125,25.7666666666667,26,-0.233333333333334,64,65,-1,-5,4
21701000,1627790,CLE,LAL,Ante Zizic,99,20.0333333333333,20,0.0333333333333314,44,52,-8,-6,-2
21701000,1628506,CLE,LAL,London Perrantes,29,6.3,6,0.3,19,12,7,7,0
21701000,201572,LAL,CLE,Brook Lopez,164,32.7833333333333,33,-0.216666666666669,85,74,11,13,-2
21701000,202682,LAL,CLE,Derrick Williams,2,0.633333333333333,0,0.633333333333333,2,0,2,0,2
21701000,202738,LAL,CLE,Isaiah Thomas,152,30.5833333333333,31,-0.416666666666664,90,73,17,18,-1
21701000,203484,LAL,CLE,Kentavious Caldwell-Pope,180,37.2666666666667,38,-0.733333333333334,101,86,15,15,0
21701000,203944,LAL,CLE,Julius Randle,185,37.8333333333333,38,-0.166666666666671,105,86,19,19,0
21701000,204037,LAL,CLE,Travis Wear,56,12.05,12,0.0500000000000007,30,34,-4,-4,0
21701000,1627826,LAL,CLE,Ivica Zubac,25,5.68333333333333,6,-0.316666666666666,8,11,-3,-3,0
21701000,1627936,LAL,CLE,Alex Caruso,63,12.7833333333333,12,0.783333333333333,33,34,-1,-1,0
21701000,1628366,LAL,CLE,Lonzo Ball,140,30.8666666666667,32,-1.13333333333333,74,74,0,-1,1
21701000,1628398,LAL,CLE,Kyle Kuzma,193,38.9333333333333,39,-0.0666666666666629,107,93,14,14,0
21701001,2207,HOU,SAS,Joe Johnson,114,25.7333333333333,26,-0.266666666666666,54,60,-6,-4,-2
21701001,2403,HOU,SAS,Nene,67,15.2833333333333,15,0.283333333333335,39,38,1,1,0
21701001,2772,HOU,SAS,Trevor Ariza,140,30.6833333333333,31,-0.316666666666666,69,50,19,17,2
21701001,101108,HOU,SAS,Chris Paul,102,22.8,23,-0.199999999999999,61,42,19,19,0
21701001,101123,HOU,SAS,Gerald Green,91,20.2,20,0.199999999999999,40,40,0,0,0
21701001,200782,HOU,SAS,PJ Tucker,93,20.2833333333333,21,-0.716666666666669,53,33,20,23,-3
21701001,201569,HOU,SAS,Eric Gordon,108,22.8,23,-0.199999999999999,52,50,2,4,-2
21701001,201601,HOU,SAS,Luc Mbah a Moute,100,22.85,22,0.850000000000001,51,51,0,-5,5
21701001,201935,HOU,SAS,James Harden,132,28.9333333333333,29,-0.06666666666667,67,50,17,17,0
21701001,203991,HOU,SAS,Clint Capela,120,25.8,26,-0.200000000000003,54,46,8,8,0
21701001,204028,HOU,SAS,Tarik Black,18,4.05,4,0.0499999999999998,5,5,0,0,0
21701001,2200,SAS,HOU,Pau Gasol,64,14.4833333333333,15,-0.516666666666666,19,33,-14,-14,0
21701001,2225,SAS,HOU,Tony Parker,77,15.75,16,-0.25,34,42,-8,-8,0
21701001,200752,SAS,HOU,Rudy Gay,106,23.4833333333333,24,-0.516666666666666,39,55,-16,-16,0
21701001,201980,SAS,HOU,Danny Green,58,13.55,14,-0.449999999999999,27,30,-3,-3,0
21701001,201988,SAS,HOU,Patty Mills,37,8.61666666666667,9,-0.383333333333333,14,23,-9,-9,0
21701001,202722,SAS,HOU,Davis Bertans,89,19.7166666666667,20,-0.283333333333335,45,43,2,2,0
21701001,203464,SAS,HOU,Brandon Paul,144,32.1666666666667,32,0.166666666666664,70,69,1,3,-2
21701001,203530,SAS,HOU,Joffrey Lauvergne,89,18.5,19,-0.5,41,49,-8,-8,0
21701001,203937,SAS,HOU,Kyle Anderson,70,15,15,0,20,37,-17,-17,0
21701001,1627749,SAS,HOU,Dejounte Murray,87,19.65,20,-0.350000000000001,29,51,-22,-22,0
21701001,1627854,SAS,HOU,Bryn Forbes,114,24.55,25,-0.450000000000003,55,53,2,2,0
21701001,1627856,SAS,HOU,Matt Costello,64,14.9,15,-0.0999999999999996,33,27,6,6,0
21701001,1628401,SAS,HOU,Derrick White,86,19.05,19,0.0499999999999972,39,33,6,4,2
21701002,1891,MIL,MEM,Jason Terry,38,8.1,8,0.0999999999999996,21,19,2,3,-1
21701002,201943,MIL,MEM,Brandon Jennings,115,24.0833333333333,24,0.0833333333333322,60,48,12,11,1
21701002,202339,MIL,MEM,Eric Bledsoe,106,23.8,24,-0.200000000000003,61,55,6,7,-1
21701002,203089,MIL,MEM,John Henson,118,27,27,0,62,58,4,5,-1
21701002,203092,MIL,MEM,Tyler Zeller,98,19.95,20,-0.0500000000000007,52,41,11,12,-1
21701002,203114,MIL,MEM,Khris Middleton,160,35.6166666666667,35,0.616666666666667,87,68,19,21,-2
21701002,203503,MIL,MEM,Tony Snell,137,30.2,31,-0.800000000000004,76,68,8,7,1
21701002,203507,MIL,MEM,Giannis Antetokounmpo,127,27.8666666666667,28,-0.133333333333333,72,67,5,3,2
21701002,203953,MIL,MEM,Jabari Parker,102,21.35,21,0.350000000000001,49,40,9,11,-2
21701002,1627748,MIL,MEM,Thon Maker,5,0.933333333333333,1,-0.0666666666666667,7,4,3,1,2
21701002,1628391,MIL,MEM,D.J. Wilson,3,0.883333333333333,1,-0.116666666666667,5,3,2,2,0
21701002,1628425,MIL,MEM,Sterling Brown,96,19.6333333333333,20,-0.366666666666667,53,44,9,7,2
21701002,201188,MEM,MIL,Marc Gasol,132,30.7666666666667,31,-0.233333333333334,65,74,-9,-9,0
21701002,202718,MEM,MIL,Chandler Parsons,81,16.7666666666667,16,0.766666666666666,25,41,-16,-16,0
21701002,203210,MEM,MIL,JaMychal Green,122,28.4666666666667,29,-0.533333333333331,64,69,-5,-7,2
21701002,203463,MEM,MIL,Ben McLemore,112,22.6166666666667,22,0.616666666666667,47,64,-17,-15,-2
21701002,1626185,MEM,MIL,Jarell Martin,132,28.6166666666667,29,-0.383333333333333,68,68,0,0,0
21701002,1627738,MEM,MIL,Deyonta Davis,89,17.1166666666667,17,0.116666666666667,38,47,-9,-9,0
21701002,1627744,MEM,MIL,Brice Johnson,3,0.883333333333333,1,-0.116666666666667,3,5,-2,-2,0
21701002,1627782,MEM,MIL,Wayne Selden,78,15.3166666666667,15,0.316666666666666,33,37,-4,-3,-1
21701002,1628397,MEM,MIL,Ivan Rabb,3,0.883333333333333,1,-0.116666666666667,3,5,-2,-2,0
21701002,1628415,MEM,MIL,Dillon Brooks,132,30.1,30,0.100000000000001,66,74,-8,-9,1
21701002,1628424,MEM,MIL,Kobi Simmons,109,26.4333333333333,27,-0.566666666666666,62,65,-3,-2,-1
21701002,1628504,MEM,MIL,Xavier Rathan-Mayes,112,21.45,21,0.449999999999999,41,56,-15,-16,1
21701003,1713,SAC,OKC,Vince Carter,107,23,23,0,43,45,-2,0,-2
21701003,2216,SAC,OKC,Zach Randolph,111,23.25,23,0.25,56,63,-7,-9,2
21701003,201585,SAC,OKC,Kosta Koufos,73,15.8333333333333,16,-0.166666666666668,29,35,-6,-6,0
21701003,202066,SAC,OKC,Garrett Temple,129,29.2833333333333,29,0.283333333333331,52,53,-1,1,-2
21701003,203992,SAC,OKC,Bogdan Bogdanovic,138,29.4666666666667,29,0.466666666666669,74,78,-4,-6,2
21701003,1626161,SAC,OKC,Willie Cauley-Stein,126,28.7333333333333,29,-0.266666666666666,60,56,4,4,0
21701003,1627741,SAC,OKC,Buddy Hield,64,14.8,15,-0.199999999999999,16,19,-3,-2,-1
21701003,1628368,SAC,OKC,De'Aaron Fox,159,33.3833333333333,34,-0.616666666666667,83,84,-1,-3,2
21701003,1628382,SAC,OKC,Justin Jackson,128,26.9,27,-0.100000000000001,74,75,-1,-2,1
21701003,1628412,SAC,OKC,Frank Mason,60,14.4333333333333,14,0.433333333333334,18,22,-4,-2,-2
21701003,2546,OKC,SAC,Carmelo Anthony,147,31.5833333333333,32,-0.416666666666664,80,77,3,5,-2
21701003,101109,OKC,SAC,Raymond Felton,68,15.5166666666667,16,-0.483333333333334,26,25,1,1,0
21701003,201147,OKC,SAC,Corey Brewer,157,32.9,33,-0.100000000000001,79,82,-3,-3,0
21701003,201566,OKC,SAC,Russell Westbrook,166,35.7666666666667,36,-0.233333333333334,83,79,4,4,0
21701003,202331,OKC,SAC,Paul George,179,38.2,38,0.200000000000003,91,89,2,3,-1
21701003,202335,OKC,SAC,Patrick Patterson,92,20.6833333333333,21,-0.31666666666667,34,39,-5,-5,0
21701003,203500,OKC,SAC,Steven Adams,108,22.6166666666667,23,-0.383333333333333,57,48,9,9,0
21701003,203518,OKC,SAC,Alex Abrines,26,6.83333333333333,7,-0.166666666666666,17,11,6,5,1
21701003,203924,OKC,SAC,Jerami Grant,91,20.75,21,-0.25,41,38,3,1,2
21701003,203962,OKC,SAC,Josh Huestis,15,3.5,3,0.5,5,5,0,0,0
21701003,1628390,OKC,SAC,Terrance Ferguson,46,10.7333333333333,11,-0.266666666666666,17,12,5,5,0
21701004,201609,MIA,POR,Goran Dragic,150,30.95,31,-0.0500000000000043,62,76,-14,-14,0
21701004,201949,MIA,POR,James Johnson,119,24.2333333333333,24,0.233333333333334,55,68,-13,-13,0
21701004,201961,MIA,POR,Wayne Ellington,141,30.2833333333333,30,0.283333333333335,62,80,-18,-11,-7
21701004,203482,MIA,POR,Kelly Olynyk,107,23.1833333333333,24,-0.816666666666666,48,49,-1,-5,4
21701004,203585,MIA,POR,Rodney McGruder,116,25.7333333333333,26,-0.266666666666666,52,58,-6,-4,-2
21701004,204020,MIA,POR,Tyler Johnson,161,33.95,35,-1.05,70,89,-19,-21,2
21701004,1626159,MIA,POR,Justise Winslow,136,29.5166666666667,30,-0.483333333333334,56,62,-6,-6,0
21701004,1626196,MIA,POR,Josh Richardson,74,15.25,16,-0.75,37,28,9,2,7
21701004,1628389,MIA,POR,Bam Adebayo,121,24.9833333333333,25,-0.0166666666666657,53,65,-12,-8,-4
21701004,202323,POR,MIA,Evan Turner,143,31.4666666666667,31,0.466666666666669,71,56,15,14,1
21701004,202329,POR,MIA,Al-Farouq Aminu,157,32.1166666666667,32,0.116666666666667,83,67,16,16,0
21701004,202334,POR,MIA,Ed Davis,75,16.9666666666667,17,-0.0333333333333314,32,35,-3,-3,0
21701004,203081,POR,MIA,Damian Lillard,177,36.5333333333333,37,-0.466666666666669,96,74,22,25,-3
21701004,203090,POR,MIA,Maurice Harkless,82,16.15,17,-0.850000000000001,44,43,1,2,-1
21701004,203468,POR,MIA,CJ McCollum,153,31.9166666666667,32,-0.0833333333333357,78,80,-2,-1,-1
21701004,203894,POR,MIA,Shabazz Napier,62,13.5666666666667,14,-0.433333333333334,20,27,-7,-8,1
21701004,203994,POR,MIA,Jusuf Nurkic,148,30.2333333333333,30,0.233333333333334,81,64,17,19,-2
21701004,1626192,POR,MIA,Pat Connaughton,58,13.2166666666667,13,0.216666666666665,36,17,19,16,3
21701004,1628380,POR,MIA,Zach Collins,70,15.9166666666667,16,-0.0833333333333339,34,32,2,0,2
21701005,2744,IND,PHI,Al Jefferson,28,6.8,6,0.8,4,12,-8,-6,-2
21701005,201152,IND,PHI,Thaddeus Young,149,31.0666666666667,31,0.0666666666666664,67,65,2,2,0
21701005,201954,IND,PHI,Darren Collison,100,21.1,21,0.100000000000001,41,43,-2,-4,2
21701005,202344,IND,PHI,Trevor Booker,81,17.0166666666667,17,0.0166666666666657,36,37,-1,-3,2
21701005,202362,IND,PHI,Lance Stephenson,86,18.0833333333333,18,0.0833333333333322,36,35,1,-3,4
21701005,202709,IND,PHI,Cory Joseph,158,32.9166666666667,33,-0.0833333333333286,68,69,-1,-1,0
21701005,202711,IND,PHI,Bojan Bogdanovic,121,25.7666666666667,26,-0.233333333333334,49,62,-13,-13,0
21701005,203506,IND,PHI,Victor Oladipo,160,33.8333333333333,33,0.833333333333336,72,63,9,14,-5
21701005,203922,IND,PHI,Glenn Robinson III,60,12.1,12,0.0999999999999996,37,22,15,16,-1
21701005,1626167,IND,PHI,Myles Turner,147,30.2666666666667,30,0.266666666666666,71,59,12,13,-1
21701005,1627734,IND,PHI,Domantas Sabonis,50,10.55,11,-0.449999999999999,24,23,1,0,1
21701005,101141,PHI,IND,Ersan Ilyasova,99,20.0666666666667,20,0.0666666666666664,37,43,-6,-3,-3
21701005,101161,PHI,IND,Amir Johnson,47,10.0333333333333,10,0.0333333333333332,27,25,2,1,1
21701005,200755,PHI,IND,JJ Redick,138,28.1333333333333,29,-0.866666666666667,57,60,-3,0,-3
21701005,201158,PHI,IND,Marco Belinelli,128,26.55,26,0.549999999999997,54,60,-6,-8,2
21701005,203496,PHI,IND,Robert Covington,175,37.6666666666667,38,-0.333333333333329,82,67,15,15,0
21701005,203954,PHI,IND,Joel Embiid,155,32.6166666666667,33,-0.383333333333333,64,64,0,1,-1
21701005,203967,PHI,IND,Dario Saric,154,32.9833333333333,33,-0.0166666666666657,68,70,-2,-5,3
21701005,204456,PHI,IND,T.J. McConnell,103,21.6,21,0.600000000000001,38,54,-16,-14,-2
21701005,1627732,PHI,IND,Ben Simmons,141,29.85,30,-0.149999999999999,63,62,1,-2,3
21701006,2037,MIN,WAS,Jamal Crawford,131,29,29,0,73,64,9,13,-4
21701006,201565,MIN,WAS,Derrick Rose,51,10.4166666666667,11,-0.583333333333334,28,26,2,1,1
21701006,201952,MIN,WAS,Jeff Teague,129,28.3,29,-0.700000000000003,68,74,-6,-4,-2
21701006,201959,MIN,WAS,Taj Gibson,123,26.9,27,-0.100000000000001,61,67,-6,-9,3
21701006,202332,MIN,WAS,Cole Aldrich,6,1.03333333333333,1,0.0333333333333332,4,2,2,2,0
21701006,202357,MIN,WAS,Nemanja Bjelica,169,38.4,39,-0.599999999999994,94,85,9,6,3
21701006,203476,MIN,WAS,Gorgui Dieng,40,7.6,8,-0.4,18,16,2,3,-1
21701006,203952,MIN,WAS,Andrew Wiggins,165,37.5166666666667,37,0.516666666666666,88,85,3,4,-1
21701006,1626145,MIN,WAS,Tyus Jones,87,19.6333333333333,19,0.633333333333333,48,37,11,9,2
21701006,1626157,MIN,WAS,Karl-Anthony Towns,179,40.8666666666667,41,-0.133333333333333,98,99,-1,0,-1
21701006,101133,WAS,MIN,Ian Mahinmi,102,22.35,23,-0.649999999999999,44,57,-13,-11,-2
21701006,101162,WAS,MIN,Marcin Gortat,110,24.5333333333333,24,0.533333333333331,64,57,7,5,2
21701006,201196,WAS,MIN,Ramon Sessions,76,16.2166666666667,16,0.216666666666669,34,43,-9,-7,-2
21701006,201975,WAS,MIN,Jodie Meeks,71,14.3666666666667,14,0.366666666666667,33,36,-3,-1,-2
21701006,202693,WAS,MIN,Markieff Morris,143,33.05,33,0.0499999999999972,75,75,0,-3,3
21701006,203078,WAS,MIN,Bradley Beal,145,33.5666666666667,34,-0.433333333333337,78,80,-2,-4,2
21701006,203107,WAS,MIN,Tomas Satoransky,140,31.7166666666667,32,-0.283333333333335,77,73,4,2,2
21701006,203118,WAS,MIN,Mike Scott,62,13.0833333333333,13,0.0833333333333322,32,34,-2,1,-3
21701006,203490,WAS,MIN,Otto Porter Jr.,157,35.1666666666667,35,0.166666666666671,87,79,8,8,0
21701006,1626162,WAS,MIN,Kelly Oubre Jr.,74,15.6166666666667,16,-0.383333333333333,31,46,-15,-15,0
21701007,203471,ATL,OKC,Dennis Schroder,154,33.2,33,0.200000000000003,65,93,-28,-25,-3
21701007,203473,ATL,OKC,Dewayne Dedmon,133,27.1333333333333,28,-0.866666666666667,59,73,-14,-16,2
21701007,203488,ATL,OKC,Mike Muscala,111,24.6,24,0.600000000000001,52,52,0,3,-3
21701007,1627752,ATL,OKC,Taurean Prince,169,33.9833333333333,34,-0.0166666666666657,76,91,-15,-16,1
21701007,1627814,ATL,OKC,Damion Lee,84,17.25,17,0.25,44,36,8,9,-1
21701007,1627819,ATL,OKC,Isaiah Taylor,103,20.9166666666667,21,-0.0833333333333322,51,47,4,0,4
21701007,1628381,ATL,OKC,John Collins,140,29.9833333333333,31,-1.01666666666667,62,83,-21,-22,1
21701007,1628416,ATL,OKC,Tyler Dorsey,83,18.3833333333333,19,-0.616666666666667,38,48,-10,-10,0
21701007,1628463,ATL,OKC,Tyler Cavanaugh,68,14.2166666666667,14,0.216666666666665,41,30,11,11,0
21701007,1628510,ATL,OKC,Andrew White III,85,20.1666666666667,20,0.166666666666664,47,42,5,6,-1
21701007,2546,OKC,ATL,Carmelo Anthony,147,29.45,29,0.449999999999999,86,57,29,31,-2
21701007,2555,OKC,ATL,Nick Collison,14,2.88333333333333,3,-0.116666666666667,4,9,-5,-7,2
21701007,101109,OKC,ATL,Raymond Felton,88,20.3833333333333,20,0.383333333333333,49,41,8,6,2
21701007,201147,OKC,ATL,Corey Brewer,159,32.0666666666667,32,0.06666666666667,93,65,28,26,2
21701007,201566,OKC,ATL,Russell Westbrook,174,35.05,35,0.0499999999999972,91,73,18,20,-2
21701007,202331,OKC,ATL,Paul George,124,25.6,26,-0.399999999999999,74,59,15,15,0
21701007,202335,OKC,ATL,Patrick Patterson,79,18.5166666666667,19,-0.483333333333334,33,50,-17,-19,2
21701007,203518,OKC,ATL,Alex Abrines,62,14.4666666666667,14,0.466666666666665,22,38,-16,-14,-2
21701007,203924,OKC,ATL,Jerami Grant,159,32.9833333333333,33,-0.0166666666666657,86,72,14,16,-2
21701007,203962,OKC,ATL,Josh Huestis,20,5.05,5,0.0499999999999998,11,9,2,2,0
21701007,1626177,OKC,ATL,Dakari Johnson,29,6.2,7,-0.8,18,13,5,5,0
21701007,1627772,OKC,ATL,Daniel Hamilton,4,0.85,1,-0.15,0,4,-4,-4,0
21701007,1628390,OKC,ATL,Terrance Ferguson,71,16.3333333333333,16,0.333333333333336,28,45,-17,-17,0
21701008,201960,BKN,TOR,DeMarre Carroll,138,28.6333333333333,29,-0.366666666666667,65,65,0,2,-2
21701008,201967,BKN,TOR,Dante Cunningham,112,24.0333333333333,24,0.0333333333333314,62,61,1,3,-2
21701008,203112,BKN,TOR,Quincy Acy,71,16.1666666666667,17,-0.833333333333332,33,37,-4,-6,2
21701008,203459,BKN,TOR,Allen Crabbe,143,30.1333333333333,30,0.133333333333333,68,72,-4,-2,-2
21701008,203915,BKN,TOR,Spencer Dinwiddie,132,28.6,28,0.600000000000001,72,75,-3,-6,3
21701008,203925,BKN,TOR,Joe Harris,95,21.4,21,0.399999999999999,42,56,-14,-14,0
21701008,1626156,BKN,TOR,D'Angelo Russell,154,33.7666666666667,35,-1.23333333333333,69,78,-9,-6,-3
21701008,1626178,BKN,TOR,Rondae Hollis-Jefferson,124,27,27,0,42,71,-29,-27,-2
21701008,1627747,BKN,TOR,Caris LeVert,136,28.6,29,-0.399999999999999,52,65,-13,-14,1
21701008,101139,TOR,BKN,CJ Miles,85,19.2,19,0.200000000000003,46,37,9,6,3
21701008,200768,TOR,BKN,Kyle Lowry,153,32.6,32,0.600000000000001,80,70,10,6,4
21701008,201586,TOR,BKN,Serge Ibaka,127,26.6166666666667,27,-0.383333333333333,70,63,7,7,0
21701008,201942,TOR,BKN,DeMar DeRozan,150,32.1833333333333,33,-0.81666666666667,76,72,4,2,2
21701008,202685,TOR,BKN,Jonas Valanciunas,124,26.0166666666667,27,-0.983333333333334,64,59,5,5,0
21701008,203512,TOR,BKN,Lucas Nogueira,5,0.816666666666667,1,-0.183333333333333,2,2,0,2,-2
21701008,1626153,TOR,BKN,Delon Wright,74,16.5666666666667,17,-0.433333333333334,40,32,8,7,1
21701008,1626181,TOR,BKN,Norman Powell,53,11.6833333333333,12,-0.316666666666666,28,38,-10,-8,-2
21701008,1626259,TOR,BKN,Malcolm Miller,30,4.91666666666667,5,-0.0833333333333339,8,14,-6,-4,-2
21701008,1627751,TOR,BKN,Jakob Poeltl,92,20.8333333333333,20,0.833333333333336,50,40,10,7,3
21701008,1627783,TOR,BKN,Pascal Siakam,84,19.0166666666667,19,0.0166666666666657,42,34,8,7,1
21701008,1627832,TOR,BKN,Fred VanVleet,123,27.0666666666667,28,-0.933333333333334,72,42,30,31,-1
21701008,1628502,TOR,BKN,Nigel Hayes,5,0.816666666666667,1,-0.183333333333333,2,2,0,2,-2
21701009,1717,DAL,NYK,Dirk Nowitzki,99,21.6333333333333,22,-0.366666666666667,48,47,1,1,0
21701009,200826,DAL,NYK,J.J. Barea,94,20.7166666666667,21,-0.283333333333331,54,56,-2,-2,0
21701009,203084,DAL,NYK,Harrison Barnes,157,33.7166666666667,34,-0.283333333333331,74,57,17,17,0
21701009,203457,DAL,NYK,Nerlens Noel,90,20.0333333333333,20,0.0333333333333314,45,37,8,10,-2
21701009,203926,DAL,NYK,Doug McDermott,96,21.3166666666667,21,0.316666666666666,54,52,2,2,0
21701009,203939,DAL,NYK,Dwight Powell,39,8.91666666666667,9,-0.0833333333333339,24,26,-2,-2,0
21701009,1627812,DAL,NYK,Yogi Ferrell,129,27.7833333333333,28,-0.216666666666669,56,49,7,7,0
21701009,1627827,DAL,NYK,Dorian Finney-Smith,95,20.5166666666667,21,-0.483333333333334,43,34,9,9,0
21701009,1627858,DAL,NYK,Kyle Collinsworth,101,22.25,22,0.25,56,51,5,5,0
21701009,1627866,DAL,NYK,Jameel Warney,53,11.3,12,-0.699999999999999,29,27,2,0,2
21701009,1628372,DAL,NYK,Dennis Smith Jr.,142,30.8166666666667,31,-0.183333333333334,67,49,18,18,0
21701009,201563,NYK,DAL,Michael Beasley,152,33.2833333333333,33,0.283333333333331,71,85,-14,-10,-4
21701009,201584,NYK,DAL,Courtney Lee,72,15.05,15,0.0500000000000007,25,28,-3,-3,0
21701009,202498,NYK,DAL,Lance Thomas,101,22,23,-1,41,40,1,-5,6
21701009,202683,NYK,DAL,Enes Kanter,96,20.6833333333333,21,-0.316666666666666,34,40,-6,-6,0
21701009,203124,NYK,DAL,Kyle O'Quinn,95,21.15,21,0.149999999999999,52,57,-5,-5,0
21701009,203501,NYK,DAL,Tim Hardaway Jr.,179,38.7833333333333,39,-0.216666666666669,72,88,-16,-18,2
21701009,203504,NYK,DAL,Trey Burke,69,14.7166666666667,15,-0.283333333333335,33,34,-1,-1,0
21701009,1626144,NYK,DAL,Emmanuel Mudiay,118,25.8666666666667,26,-0.133333333333333,46,57,-11,-9,-2
21701009,1627786,NYK,DAL,Troy Williams,98,22.2166666666667,22,0.216666666666669,46,54,-8,-8,0
21701009,1628373,NYK,DAL,Frank Ntilikina,75,16.2333333333333,16,0.233333333333334,40,45,-5,-5,0
21701009,1628422,NYK,DAL,Damyean Dotson,40,9.01666666666667,9,0.0166666666666657,25,22,3,5,-2
21701010,201577,CHI,LAC,Robin Lopez,55,12,12,0,27,31,-4,-4,0
21701010,203897,CHI,LAC,Zach LaVine,127,26.05,26,0.0499999999999972,51,61,-10,-13,3
21701010,203943,CHI,LAC,Noah Vonleh,126,27.1833333333333,27,0.183333333333334,54,71,-17,-16,-1
21701010,1626166,CHI,LAC,Cameron Payne,103,21.5333333333333,22,-0.466666666666669,40,47,-7,-5,-2
21701010,1626171,CHI,LAC,Bobby Portis,133,26.7333333333333,27,-0.266666666666666,60,58,2,1,1
21701010,1626245,CHI,LAC,Cristiano Felicio,146,29.6833333333333,30,-0.316666666666666,71,64,7,7,0
21701010,1627739,CHI,LAC,Kris Dunn,127,26.2666666666667,26,0.266666666666666,66,65,1,-1,2
21701010,1627756,CHI,LAC,Denzel Valentine,99,20.5833333333333,21,-0.416666666666668,42,43,-1,-3,2
21701010,1628021,CHI,LAC,David Nwaba,133,27.65,28,-0.350000000000001,66,74,-8,-2,-6
21701010,1628469,CHI,LAC,Antonio Blakeney,101,21.3166666666667,21,0.316666666666666,53,46,7,6,1
21701010,101150,LAC,CHI,Lou Williams,165,34.5333333333333,35,-0.466666666666669,85,78,7,7,0
21701010,201599,LAC,CHI,DeAndre Jordan,178,37.4666666666667,38,-0.533333333333331,94,77,17,17,0
21701010,202325,LAC,CHI,Wesley Johnson,29,5.6,6,-0.4,8,16,-8,-8,0
21701010,202699,LAC,CHI,Tobias Harris,178,37.4666666666667,37,0.466666666666669,94,77,17,16,1
21701010,203085,LAC,CHI,Austin Rivers,168,35.7166666666667,36,-0.283333333333331,91,75,16,15,1
21701010,1626149,LAC,CHI,Montrezl Harrell,52,10.3333333333333,11,-0.666666666666668,18,29,-11,-10,-1
21701010,1626155,LAC,CHI,Sam Dekker,25,4.93333333333333,5,-0.0666666666666664,10,13,-3,-3,0
21701010,1626246,LAC,CHI,Boban Marjanovic,27,5.4,6,-0.6,8,16,-8,-8,0
21701010,1628393,LAC,CHI,Jawun Evans,66,12.8166666666667,13,-0.183333333333334,25,31,-6,-9,3
21701010,1628414,LAC,CHI,Sindarius Thornwell,143,30.15,30,0.149999999999999,79,61,18,19,-1
21701010,1628462,LAC,CHI,Milos Teodosic,119,24.5833333333333,25,-0.416666666666668,48,57,-9,-6,-3
21701011,2731,NOP,CHA,Emeka Okafor,131,26.0666666666667,26,0.0666666666666664,60,62,-2,-6,4
21701011,200765,NOP,CHA,Rajon Rondo,180,36.2833333333333,36,0.283333333333331,94,86,8,10,-2
21701011,201950,NOP,CHA,Jrue Holiday,188,38.7666666666667,39,-0.233333333333334,91,86,5,4,1
21701011,202703,NOP,CHA,Nikola Mirotic,155,30.9166666666667,31,-0.0833333333333357,79,75,4,5,-1
21701011,202732,NOP,CHA,DeAndre Liggins,27,5.48333333333333,6,-0.516666666666667,18,15,3,3,0
21701011,202734,NOP,CHA,E'Twaun Moore,168,33.3,33,0.299999999999997,82,81,1,0,1
21701011,203076,NOP,CHA,Anthony Davis,192,39.0166666666667,39,0.0166666666666657,99,93,6,9,-3
21701011,203121,NOP,CHA,Darius Miller,55,9.78333333333333,10,-0.216666666666667,22,28,-6,-7,1
21701011,203546,NOP,CHA,Ian Clark,99,20.3833333333333,21,-0.616666666666667,50,49,1,2,-1
21701011,2730,CHA,NOP,Dwight Howard,168,34.2333333333333,34,0.233333333333334,75,77,-2,1,-3
21701011,101107,CHA,NOP,Marvin Williams,97,19.75,20,-0.25,47,44,3,4,-1
21701011,201587,CHA,NOP,Nicolas Batum,209,41.6666666666667,42,-0.333333333333329,100,99,1,1,0
21701011,202689,CHA,NOP,Kemba Walker,189,38.7666666666667,39,-0.233333333333334,87,91,-4,-4,0
21701011,203077,CHA,NOP,Michael Kidd-Gilchrist,122,24.5833333333333,25,-0.416666666666668,53,65,-12,-14,2
21701011,203087,CHA,NOP,Jeremy Lamb,114,23.2666666666667,23,0.266666666666666,59,52,7,7,0
21701011,1626163,CHA,NOP,Frank Kaminsky,142,28.25,28,0.25,68,75,-7,-6,-1
21701011,1626203,CHA,NOP,Treveon Graham,71,13.7666666666667,14,-0.233333333333334,40,42,-2,-7,5
21701011,1628370,CHA,NOP,Malik Monk,63,12.1666666666667,12,0.166666666666668,34,37,-3,-1,-2
21701011,1628407,CHA,NOP,Dwayne Bacon,20,3.55,4,-0.45,12,13,-1,-1,0
21701012,201167,ORL,SAS,Arron Afflalo,69,15.6333333333333,16,-0.366666666666667,21,22,-1,1,-2
21701012,201571,ORL,SAS,D.J. Augustin,117,24.9,25,-0.100000000000001,37,63,-26,-27,1
21701012,201578,ORL,SAS,Marreese Speights,69,15.6333333333333,16,-0.366666666666667,21,22,-1,1,-2
21701012,202687,ORL,SAS,Bismack Biyombo,38,8.53333333333333,8,0.533333333333333,14,26,-12,-12,0
21701012,202696,ORL,SAS,Nikola Vucevic,110,23.7166666666667,24,-0.283333333333331,37,60,-23,-25,2
21701012,202714,ORL,SAS,Shelvin Mack,89,19.8666666666667,20,-0.133333333333333,27,42,-15,-15,0
21701012,203613,ORL,SAS,Jonathon Simmons,111,23.9,24,-0.100000000000001,40,67,-27,-28,1
21701012,203920,ORL,SAS,Khem Birch,95,21.7833333333333,22,-0.216666666666669,32,37,-5,-6,1
21701012,1626209,ORL,SAS,Mario Hezonja,134,28.3166666666667,28,0.316666666666666,43,74,-31,-31,0
21701012,1628371,ORL,SAS,Jonathan Isaac,110,24.1833333333333,24,0.183333333333334,38,64,-26,-28,2
21701012,1628411,ORL,SAS,Wes Iwundu,79,18.4666666666667,18,0.466666666666669,26,32,-6,-5,-1
21701012,1628681,ORL,SAS,Rodney Purvis,64,14.4833333333333,15,-0.516666666666668,24,31,-7,-5,-2
21701012,1938,SAS,ORL,Manu Ginobili,69,14.3166666666667,14,0.316666666666666,35,21,14,15,-1
21701012,2200,SAS,ORL,Pau Gasol,70,14.95,15,-0.0500000000000007,35,20,15,15,0
21701012,2225,SAS,ORL,Tony Parker,91,19.6666666666667,20,-0.333333333333336,45,24,21,19,2
21701012,200746,SAS,ORL,LaMarcus Aldridge,118,25.75,26,-0.25,67,40,27,27,0
21701012,200752,SAS,ORL,Rudy Gay,86,19.15,19,0.149999999999999,36,28,8,8,0
21701012,201980,SAS,ORL,Danny Green,99,21.6666666666667,22,-0.333333333333336,61,36,25,24,1
21701012,201988,SAS,ORL,Patty Mills,116,25.2833333333333,25,0.283333333333331,66,40,26,28,-2
21701012,202722,SAS,ORL,Davis Bertans,38,9,9,0,7,12,-5,-5,0
21701012,203464,SAS,ORL,Brandon Paul,49,11.9,12,-0.100000000000001,12,15,-3,-3,0
21701012,203530,SAS,ORL,Joffrey Lauvergne,38,9,9,0,7,12,-5,-5,0
21701012,203937,SAS,ORL,Kyle Anderson,100,22,22,0,64,36,28,28,0
21701012,1627749,SAS,ORL,Dejounte Murray,110,24.1333333333333,24,0.133333333333333,63,44,19,21,-2
21701012,1627854,SAS,ORL,Bryn Forbes,101,22.6,23,-0.399999999999999,42,32,10,8,2
21701013,201937,UTA,DET,Ricky Rubio,135,29.1666666666667,29,0.166666666666664,68,39,29,30,-1
21701013,201973,UTA,DET,Jonas Jerebko,89,19.5833333333333,19,0.583333333333336,48,41,7,5,2
21701013,202324,UTA,DET,Derrick Favors,120,27.4333333333333,28,-0.56666666666667,66,50,16,18,-2
21701013,202327,UTA,DET,Ekpe Udoh,30,6.2,6,0.2,9,14,-5,-5,0
21701013,202692,UTA,DET,Alec Burks,74,15.5166666666667,16,-0.483333333333334,28,30,-2,-2,0
21701013,203109,UTA,DET,Jae Crowder,113,24.3666666666667,24,0.366666666666667,59,34,25,25,0
21701013,203497,UTA,DET,Rudy Gobert,138,30.4166666666667,31,-0.583333333333336,72,44,28,28,0
21701013,204060,UTA,DET,Joe Ingles,120,26.45,27,-0.550000000000001,57,38,19,19,0
21701013,1626220,UTA,DET,Royce O'Neale,79,17.2833333333333,17,0.283333333333335,46,28,18,18,0
21701013,1627777,UTA,DET,Georges Niang,27,5.48333333333333,6,-0.516666666666667,7,14,-7,-8,1
21701013,1628378,UTA,DET,Donovan Mitchell,150,33.2666666666667,33,0.266666666666666,84,49,35,35,0
21701013,1628571,UTA,DET,Erik McCree,20,4.16666666666667,4,0.166666666666667,6,14,-8,-8,0
21701013,2749,DET,UTA,Jameer Nelson,121,26,26,0,44,57,-13,-15,2
21701013,201229,DET,UTA,Anthony Tolliver,59,12.5166666666667,13,-0.483333333333334,22,40,-18,-18,0
21701013,201933,DET,UTA,Blake Griffin,129,29.1,29,0.100000000000001,43,61,-18,-18,0
21701013,202397,DET,UTA,Ish Smith,98,21.8666666666667,22,-0.133333333333333,35,53,-18,-16,-2
21701013,203083,DET,UTA,Andre Drummond,107,23.9166666666667,24,-0.0833333333333357,39,61,-22,-22,0
21701013,203516,DET,UTA,James Ennis III,48,11.1333333333333,12,-0.866666666666667,21,26,-5,-7,2
21701013,203961,DET,UTA,Eric Moreland,112,23.95,24,-0.0500000000000007,40,49,-9,-9,0
21701013,204038,DET,UTA,Langston Galloway,79,16.95,17,-0.0500000000000007,29,34,-5,-6,1
21701013,1626169,DET,UTA,Stanley Johnson,142,31.6833333333333,31,0.68333333333333,49,78,-29,-29,0
21701013,1627740,DET,UTA,Henry Ellenson,31,6.25,6,0.25,14,9,5,5,0
21701013,1628379,DET,UTA,Luke Kennard,169,35.9666666666667,36,-0.0333333333333314,59,82,-23,-20,-3
21701014,2544,CLE,PHX,LeBron James,188,33.2,33,0.200000000000003,94,73,21,23,-2
21701014,2594,CLE,PHX,Kyle Korver,131,23.2166666666667,23,0.216666666666665,70,46,24,22,2
21701014,2747,CLE,PHX,JR Smith,118,21.9333333333333,22,-0.06666666666667,55,48,7,10,-3
21701014,101181,CLE,PHX,Jose Calderon,78,17.1,17,0.100000000000001,36,44,-8,-8,0
21701014,201145,CLE,PHX,Jeff Green,150,27.35,27,0.350000000000001,75,56,19,18,1
21701014,201588,CLE,PHX,George Hill,153,27.1833333333333,27,0.183333333333334,76,54,22,20,2
21701014,203903,CLE,PHX,Jordan Clarkson,133,26.4666666666667,27,-0.533333333333335,64,71,-7,-3,-4
21701014,204066,CLE,PHX,John Holland,154,28.2333333333333,28,0.233333333333334,77,65,12,10,2
21701014,1626204,CLE,PHX,Larry Nance Jr.,76,14.35,14,0.35,42,27,15,17,-2
21701014,1627790,CLE,PHX,Ante Zizic,68,14.5833333333333,15,-0.416666666666668,40,34,6,3,3
21701014,1628506,CLE,PHX,London Perrantes,26,6.38333333333333,6,0.383333333333333,16,17,-1,-2,1
21701014,201162,PHX,CLE,Jared Dudley,112,20.2333333333333,20,0.233333333333334,50,45,5,5,0
21701014,203458,PHX,CLE,Alex Len,26,4.75,5,-0.25,12,13,-1,-1,0
21701014,203584,PHX,CLE,Troy Daniels,93,17.4,17,0.399999999999999,39,45,-6,-7,1
21701014,203901,PHX,CLE,Elfrid Payton,117,23.0833333333333,23,0.0833333333333357,47,64,-17,-20,3
21701014,203933,PHX,CLE,T.J. Warren,173,32.55,33,-0.450000000000003,64,91,-27,-21,-6
21701014,1626164,PHX,CLE,Devin Booker,193,33.8,34,-0.200000000000003,70,95,-25,-27,2
21701014,1627733,PHX,CLE,Dragan Bender,116,23.4833333333333,24,-0.516666666666666,42,65,-23,-24,1
21701014,1627737,PHX,CLE,Marquese Chriss,98,17.4,17,0.399999999999999,52,46,6,4,2
21701014,1627755,PHX,CLE,Tyler Ulis,87,14.9666666666667,15,-0.0333333333333332,39,37,2,2,0
21701014,1627885,PHX,CLE,Shaquille Harrison,56,11.2166666666667,11,0.216666666666667,27,31,-4,-3,-1
21701014,1628367,PHX,CLE,Josh Jackson,178,34.7333333333333,35,-0.266666666666666,76,97,-21,-20,-1
21701014,1628432,PHX,CLE,Davon Reed,26,6.38333333333333,6,0.383333333333333,17,16,1,2,-1
21701015,2734,DEN,LAL,Devin Harris,68,14.0666666666667,14,0.0666666666666664,22,32,-10,-9,-1
21701015,200794,DEN,LAL,Paul Millsap,125,25.9833333333333,26,-0.0166666666666657,63,59,4,7,-3
21701015,201163,DEN,LAL,Wilson Chandler,201,40.35,41,-0.650000000000006,90,87,3,4,-1
21701015,201589,DEN,LAL,Darrell Arthur,3,0.5,0,0.5,2,2,0,-2,2
21701015,203115,DEN,LAL,Will Barton,133,25.3333333333333,25,0.333333333333332,50,68,-18,-19,1
21701015,203486,DEN,LAL,Mason Plumlee,106,20.65,21,-0.350000000000001,32,44,-12,-12,0
21701015,203914,DEN,LAL,Gary Harris,172,34.5166666666667,35,-0.483333333333334,76,83,-7,-7,0
21701015,203999,DEN,LAL,Nikola Jokic,129,26.3833333333333,27,-0.616666666666667,69,66,3,5,-2
21701015,1626168,DEN,LAL,Trey Lyles,83,16.4166666666667,16,0.416666666666668,30,39,-9,-12,3
21701015,1627750,DEN,LAL,Jamal Murray,170,33.4666666666667,34,-0.533333333333331,81,80,1,0,1
21701015,201572,LAL,DEN,Brook Lopez,130,25.7333333333333,26,-0.266666666666666,59,61,-2,-4,2
21701015,202738,LAL,DEN,Isaiah Thomas,153,30.7833333333333,31,-0.216666666666669,81,64,17,15,2
21701015,203484,LAL,DEN,Kentavious Caldwell-Pope,182,35.6833333333333,36,-0.316666666666663,85,85,0,3,-3
21701015,203944,LAL,DEN,Julius Randle,199,38.8166666666667,39,-0.183333333333337,93,81,12,13,-1
21701015,204037,LAL,DEN,Travis Wear,56,12.4166666666667,13,-0.583333333333332,26,21,5,5,0
21701015,1627826,LAL,DEN,Ivica Zubac,21,4.65,5,-0.35,8,12,-4,-2,-2
21701015,1627936,LAL,DEN,Alex Caruso,47,9.91666666666667,10,-0.0833333333333322,27,18,9,6,3
21701015,1628366,LAL,DEN,Lonzo Ball,203,40.4,41,-0.599999999999994,98,81,17,18,-1
21701015,1628398,LAL,DEN,Kyle Kuzma,199,39.2666666666667,39,0.266666666666666,83,92,-9,-9,0
21701016,1891,MIL,ORL,Jason Terry,118,23.8666666666667,24,-0.133333333333333,57,53,4,4,0
21701016,201943,MIL,ORL,Brandon Jennings,43,8.35,9,-0.65,14,28,-14,-13,-1
21701016,202339,MIL,ORL,Eric Bledsoe,155,31.45,32,-0.550000000000001,86,87,-1,-3,2
21701016,203089,MIL,ORL,John Henson,143,29.5833333333333,30,-0.416666666666664,70,82,-12,-12,0
21701016,203092,MIL,ORL,Tyler Zeller,52,11.1,11,0.0999999999999996,26,23,3,2,1
21701016,203114,MIL,ORL,Khris Middleton,170,33.9666666666667,34,-0.0333333333333314,93,105,-12,-12,0
21701016,203498,MIL,ORL,Shabazz Muhammad,32,7,7,0,19,10,9,9,0
21701016,203503,MIL,ORL,Tony Snell,83,17.65,18,-0.350000000000001,49,45,4,3,1
21701016,203507,MIL,ORL,Giannis Antetokounmpo,199,40.5,40,0.5,105,93,12,10,2
21701016,203953,MIL,ORL,Jabari Parker,114,22.15,22,0.149999999999999,49,60,-11,-12,1
21701016,1627748,MIL,ORL,Thon Maker,18,3.81666666666667,4,-0.183333333333334,5,7,-2,-2,0
21701016,1628425,MIL,ORL,Sterling Brown,48,9.48333333333333,10,-0.516666666666666,12,32,-20,-19,-1
21701016,201571,ORL,MIL,D.J. Augustin,180,36,36,0,105,90,15,15,0
21701016,202687,ORL,MIL,Bismack Biyombo,67,14.5666666666667,15,-0.433333333333334,29,31,-2,-1,-1
21701016,202696,ORL,MIL,Nikola Vucevic,168,33.2166666666667,33,0.216666666666669,96,86,10,10,0
21701016,202714,ORL,MIL,Shelvin Mack,136,27.2166666666667,27,0.216666666666669,73,68,5,4,1
21701016,203613,ORL,MIL,Jonathon Simmons,190,37.65,38,-0.349999999999994,108,88,20,21,-1
21701016,203920,ORL,MIL,Khem Birch,147,29.3,29,0.299999999999997,88,72,16,12,4
21701016,1626209,ORL,MIL,Mario Hezonja,117,24.9166666666667,25,-0.0833333333333357,62,59,3,5,-2
21701016,1628371,ORL,MIL,Jonathan Isaac,86,17.95,18,-0.0500000000000007,35,45,-10,-5,-5
21701016,1628411,ORL,MIL,Wes Iwundu,57,12.3166666666667,12,0.316666666666666,22,27,-5,-4,-1
21701016,1628681,ORL,MIL,Rodney Purvis,27,5.78333333333333,6,-0.216666666666667,7,19,-12,-12,0
21701017,202328,BOS,WAS,Greg Monroe,113,24.7166666666667,25,-0.283333333333331,61,46,15,17,-2
21701017,202694,BOS,WAS,Marcus Morris,200,44.2833333333333,44,0.283333333333331,91,104,-13,-13,0
21701017,203382,BOS,WAS,Aron Baynes,142,33.3333333333333,33,0.333333333333329,60,75,-15,-16,1
21701017,203499,BOS,WAS,Shane Larkin,116,24.9,24,0.899999999999999,55,48,7,7,0
21701017,1626179,BOS,WAS,Terry Rozier,211,47.4333333333333,48,-0.56666666666667,99,107,-8,-8,0
21701017,1627824,BOS,WAS,Guerschon Yabusele,74,17.4333333333333,18,-0.566666666666666,41,36,5,2,3
21701017,1627846,BOS,WAS,Abdel Nader,111,23.8666666666667,24,-0.133333333333333,54,53,1,1,0
21701017,1628369,BOS,WAS,Jayson Tatum,203,46.85,46,0.850000000000001,101,92,9,14,-5
21701017,1628400,BOS,WAS,Semi Ojeleye,135,26.9333333333333,27,-0.06666666666667,58,64,-6,-9,3
21701017,101133,WAS,BOS,Ian Mahinmi,117,25.95,26,-0.0500000000000007,56,54,2,2,0
21701017,101162,WAS,BOS,Marcin Gortat,109,24.6833333333333,25,-0.316666666666666,52,54,-2,-2,0
21701017,201196,WAS,BOS,Ramon Sessions,85,17.5333333333333,17,0.533333333333331,34,39,-5,-6,1
21701017,201975,WAS,BOS,Jodie Meeks,58,12.1833333333333,12,0.183333333333334,22,30,-8,-6,-2
21701017,202693,WAS,BOS,Markieff Morris,192,43.5,43,0.5,97,87,10,8,2
21701017,203078,WAS,BOS,Bradley Beal,210,47.1,47,0.100000000000001,110,96,14,12,2
21701017,203107,WAS,BOS,Tomas Satoransky,153,34.85,35,-0.150000000000006,75,71,4,5,-1
21701017,203118,WAS,BOS,Mike Scott,73,16.4166666666667,17,-0.583333333333332,27,42,-15,-11,-4
21701017,203490,WAS,BOS,Otto Porter Jr.,190,42.4833333333333,42,0.483333333333334,102,90,12,10,2
21701017,1626162,WAS,BOS,Kelly Oubre Jr.,118,25.05,25,0.0499999999999972,50,57,-7,-7,0
21701018,201609,MIA,SAC,Goran Dragic,179,38.95,39,-0.0499999999999972,96,89,7,9,-2
21701018,201949,MIA,SAC,James Johnson,157,33.8333333333333,34,-0.166666666666671,87,67,20,20,0
21701018,201961,MIA,SAC,Wayne Ellington,167,35.9666666666667,36,-0.0333333333333314,81,87,-6,-7,1
21701018,202337,MIA,SAC,Luke Babbitt,62,13.3333333333333,14,-0.666666666666666,31,29,2,4,-2
21701018,203482,MIA,SAC,Kelly Olynyk,140,30.8666666666667,31,-0.133333333333333,67,67,0,0,0
21701018,203585,MIA,SAC,Rodney McGruder,88,19.1,19,0.100000000000001,36,50,-14,-12,-2
21701018,204020,MIA,SAC,Tyler Johnson,132,27.7833333333333,28,-0.216666666666669,59,73,-14,-18,4
21701018,1626159,MIA,SAC,Justise Winslow,167,37.5666666666667,38,-0.433333333333337,79,84,-5,-7,2
21701018,1628389,MIA,SAC,Bam Adebayo,128,27.6,27,0.600000000000001,59,69,-10,-9,-1
21701018,1713,SAC,MIA,Vince Carter,87,17.8333333333333,18,-0.166666666666668,40,40,0,-2,2
21701018,2216,SAC,MIA,Zach Randolph,146,33.05,33,0.0499999999999972,79,78,1,3,-2
21701018,201585,SAC,MIA,Kosta Koufos,84,18.6333333333333,18,0.633333333333333,46,41,5,6,-1
21701018,202066,SAC,MIA,Garrett Temple,99,22.0833333333333,22,0.0833333333333357,50,45,5,6,-1
21701018,203992,SAC,MIA,Bogdan Bogdanovic,154,32.45,32,0.450000000000003,70,82,-12,-13,1
21701018,1626161,SAC,MIA,Willie Cauley-Stein,169,36.3666666666667,36,0.366666666666667,81,78,3,2,1
21701018,1627741,SAC,MIA,Buddy Hield,140,31.3166666666667,31,0.316666666666666,72,63,9,11,-2
21701018,1628368,SAC,MIA,De'Aaron Fox,166,35.4333333333333,35,0.433333333333337,79,78,1,0,1
21701018,1628382,SAC,MIA,Justin Jackson,97,20.2666666666667,21,-0.733333333333334,54,49,5,3,2
21701018,1628412,SAC,MIA,Frank Mason,78,17.5666666666667,18,-0.433333333333334,44,41,3,4,-1
21701019,2585,GSW,LAL,Zaza Pachulia,113,23.0166666666667,23,0.0166666666666657,64,57,7,5,2
21701019,2733,GSW,LAL,Shaun Livingston,103,19.9666666666667,20,-0.0333333333333314,42,41,1,4,-3
21701019,2738,GSW,LAL,Andre Iguodala,112,22.2666666666667,22,0.266666666666666,50,42,8,6,2
21701019,201142,GSW,LAL,Kevin Durant,172,35.4,35,0.399999999999999,88,86,2,2,0
21701019,201156,GSW,LAL,Nick Young,149,31.35,31,0.350000000000001,79,75,4,7,-3
21701019,201580,GSW,LAL,JaVale McGee,68,13.1666666666667,13,0.166666666666668,30,26,4,5,-1
21701019,201956,GSW,LAL,Omri Casspi,94,19.9166666666667,20,-0.0833333333333357,47,37,10,11,-1
21701019,1626172,GSW,LAL,Kevon Looney,118,25.3166666666667,25,0.316666666666666,70,53,17,17,0
21701019,1626188,GSW,LAL,Quinn Cook,129,27.6666666666667,28,-0.333333333333336,75,65,10,7,3
21701019,1627745,GSW,LAL,Damian Jones,5,1.01666666666667,1,0.0166666666666666,0,4,-4,-2,-2
21701019,1628395,GSW,LAL,Jordan Bell,93,18.1333333333333,18,0.133333333333333,40,42,-2,-5,3
21701019,1628449,GSW,LAL,Chris Boucher,4,0.95,1,-0.05,0,2,-2,-2,0
21701019,201572,LAL,GSW,Brook Lopez,178,35.7166666666667,36,-0.283333333333331,85,97,-12,-12,0
21701019,202682,LAL,GSW,Derrick Williams,42,8.05,8,0.0500000000000007,8,12,-4,-5,1
21701019,202738,LAL,GSW,Isaiah Thomas,176,36.5833333333333,37,-0.416666666666671,86,94,-8,-10,2
21701019,203484,LAL,GSW,Kentavious Caldwell-Pope,156,31.95,32,-0.0499999999999972,76,87,-11,-10,-1
21701019,203898,LAL,GSW,Tyler Ennis,56,12.2166666666667,12,0.216666666666665,27,24,3,4,-1
21701019,203944,LAL,GSW,Julius Randle,160,33.3166666666667,34,-0.683333333333337,80,84,-4,-9,5
21701019,204037,LAL,GSW,Travis Wear,66,14.75,16,-1.25,32,36,-4,1,-5
21701019,1627826,LAL,GSW,Ivica Zubac,29,5.56666666666667,6,-0.433333333333334,9,9,0,2,-2
21701019,1627936,LAL,GSW,Alex Caruso,102,20.75,21,-0.25,37,42,-5,-6,1
21701019,1628366,LAL,GSW,Lonzo Ball,195,39.2666666666667,39,0.266666666666666,90,100,-10,-10,0
21701020,2744,IND,TOR,Al Jefferson,121,24.8166666666667,25,-0.183333333333334,53,48,5,3,2
21701020,201152,IND,TOR,Thaddeus Young,145,30.5166666666667,31,-0.483333333333334,55,67,-12,-10,-2
21701020,201954,IND,TOR,Darren Collison,138,28.5833333333333,28,0.583333333333332,64,64,0,2,-2
21701020,202344,IND,TOR,Trevor Booker,89,19.0666666666667,19,0.0666666666666664,49,41,8,5,3
21701020,202362,IND,TOR,Lance Stephenson,81,16.9166666666667,17,-0.0833333333333357,39,36,3,0,3
21701020,202709,IND,TOR,Cory Joseph,116,25.0666666666667,26,-0.933333333333334,46,56,-10,-12,2
21701020,202711,IND,TOR,Bojan Bogdanovic,149,30.8333333333333,31,-0.166666666666668,63,69,-6,-6,0
21701020,203506,IND,TOR,Victor Oladipo,151,32.2166666666667,32,0.216666666666669,60,75,-15,-10,-5
21701020,203922,IND,TOR,Glenn Robinson III,58,11.3833333333333,11,0.383333333333333,29,26,3,3,0
21701020,1626167,IND,TOR,Myles Turner,87,19.85,20,-0.149999999999999,37,48,-11,-10,-1
21701020,101139,TOR,IND,CJ Miles,95,21,21,0,45,49,-4,-2,-2
21701020,200768,TOR,IND,Kyle Lowry,153,32.45,32,0.450000000000003,75,61,14,12,2
21701020,201586,TOR,IND,Serge Ibaka,150,31.8166666666667,32,-0.183333333333334,75,59,16,15,1
21701020,201942,TOR,IND,DeMar DeRozan,151,31.9333333333333,32,-0.0666666666666664,74,63,11,13,-2
21701020,202685,TOR,IND,Jonas Valanciunas,131,27.2666666666667,27,0.266666666666666,59,53,6,6,0
21701020,1626153,TOR,IND,Delon Wright,90,19.2,19,0.200000000000003,43,41,2,2,0
21701020,1626259,TOR,IND,Malcolm Miller,107,22.1333333333333,22,0.133333333333333,48,42,6,4,2
21701020,1627751,TOR,IND,Jakob Poeltl,74,16.0166666666667,16,0.0166666666666657,35,39,-4,-4,0
21701020,1627783,TOR,IND,Pascal Siakam,97,20.1,20,0.100000000000001,43,44,-1,-2,1
21701020,1627832,TOR,IND,Fred VanVleet,87,17.3333333333333,18,-0.666666666666664,33,44,-11,-9,-2
21701021,203471,ATL,CHA,Dennis Schroder,127,26.2833333333333,27,-0.716666666666669,58,69,-11,-11,0
21701021,203473,ATL,CHA,Dewayne Dedmon,101,21.3833333333333,22,-0.616666666666667,53,53,0,-2,2
21701021,203488,ATL,CHA,Mike Muscala,93,19.2666666666667,19,0.266666666666666,36,48,-12,-10,-2
21701021,1627752,ATL,CHA,Taurean Prince,173,35.6666666666667,37,-1.33333333333333,90,96,-6,-6,0
21701021,1627814,ATL,CHA,Damion Lee,132,26.2666666666667,26,0.266666666666666,74,72,2,3,-1
21701021,1627819,ATL,CHA,Isaiah Taylor,113,22.9666666666667,23,-0.033333333333335,58,62,-4,-1,-3
21701021,1628381,ATL,CHA,John Collins,137,28.3166666666667,29,-0.683333333333334,65,83,-18,-19,1
21701021,1628416,ATL,CHA,Tyler Dorsey,129,27.0666666666667,27,0.0666666666666664,57,78,-21,-23,2
21701021,1628463,ATL,CHA,Tyler Cavanaugh,77,14.9166666666667,15,-0.0833333333333322,41,42,-1,1,-2
21701021,1628510,ATL,CHA,Andrew White III,88,17.2833333333333,17,0.283333333333331,48,42,6,8,-2
21701021,2730,CHA,ATL,Dwight Howard,155,32.1333333333333,32,0.133333333333333,95,73,22,21,1
21701021,101107,CHA,ATL,Marvin Williams,126,26.9333333333333,27,-0.06666666666667,82,52,30,32,-2
21701021,201587,CHA,ATL,Nicolas Batum,194,40.3166666666667,40,0.316666666666663,113,88,25,25,0
21701021,202689,CHA,ATL,Kemba Walker,166,34.55,35,-0.450000000000003,104,84,20,19,1
21701021,202933,CHA,ATL,Julyan Stone,8,1.21666666666667,1,0.216666666666667,0,5,-5,-5,0
21701021,203077,CHA,ATL,Michael Kidd-Gilchrist,74,15.35,16,-0.65,37,33,4,5,-1
21701021,203087,CHA,ATL,Jeremy Lamb,126,25.65,25,0.649999999999999,71,70,1,-5,6
21701021,1626163,CHA,ATL,Frank Kaminsky,97,19.7166666666667,20,-0.283333333333331,46,55,-9,-9,0
21701021,1626195,CHA,ATL,Willy Hernangomez,8,1.21666666666667,1,0.216666666666667,0,5,-5,-5,0
21701021,1626203,CHA,ATL,Treveon Graham,95,18.8,19,-0.199999999999999,44,49,-5,-5,0
21701021,1628370,CHA,ATL,Malik Monk,78,15.2166666666667,15,0.216666666666667,28,38,-10,-11,1
21701021,1628407,CHA,ATL,Dwayne Bacon,43,8.31666666666667,8,0.316666666666666,25,28,-3,-2,-1
21701022,201563,NYK,PHI,Michael Beasley,172,33.5333333333333,34,-0.466666666666669,76,83,-7,-7,0
21701022,201584,NYK,PHI,Courtney Lee,185,37.5833333333333,37,0.583333333333329,85,97,-12,-11,-1
21701022,202683,NYK,PHI,Enes Kanter,120,23.55,24,-0.450000000000003,53,67,-14,-13,-1
21701022,203124,NYK,PHI,Kyle O'Quinn,118,24.45,24,0.450000000000003,56,51,5,5,0
21701022,203501,NYK,PHI,Tim Hardaway Jr.,178,34.8333333333333,35,-0.166666666666671,76,87,-11,-10,-1
21701022,203504,NYK,PHI,Trey Burke,120,25.1166666666667,25,0.116666666666667,61,50,11,12,-1
21701022,1626144,NYK,PHI,Emmanuel Mudiay,147,27.8,28,-0.199999999999999,61,75,-14,-13,-1
21701022,1628373,NYK,PHI,Frank Ntilikina,60,13.1666666666667,13,0.166666666666666,33,31,2,2,0
21701022,1628422,NYK,PHI,Damyean Dotson,26,6.06666666666667,6,0.0666666666666664,11,15,-4,-4,0
21701022,1628439,NYK,PHI,Isaiah Hicks,64,13.9,14,-0.0999999999999996,33,34,-1,-1,0
21701022,101141,PHI,NYK,Ersan Ilyasova,116,24.4166666666667,24,0.416666666666664,51,52,-1,0,-1
21701022,101161,PHI,NYK,Amir Johnson,55,10.9666666666667,11,-0.0333333333333332,23,22,1,0,1
21701022,200755,PHI,NYK,JJ Redick,150,29.7,30,-0.299999999999997,76,65,11,12,-1
21701022,201158,PHI,NYK,Marco Belinelli,140,27.7166666666667,28,-0.283333333333331,60,56,4,1,3
21701022,203496,PHI,NYK,Robert Covington,157,31.6666666666667,32,-0.333333333333332,90,77,13,11,2
21701022,203954,PHI,NYK,Joel Embiid,150,31.9,32,-0.0999999999999979,84,75,9,10,-1
21701022,203967,PHI,NYK,Dario Saric,141,27.6,28,-0.399999999999999,71,67,4,4,0
21701022,204456,PHI,NYK,T.J. McConnell,113,22.7,23,-0.299999999999997,50,51,-1,-3,2
21701022,1627732,PHI,NYK,Ben Simmons,168,33.3333333333333,33,0.333333333333329,85,80,5,5,0
21701023,2207,HOU,LAC,Joe Johnson,69,14.5333333333333,15,-0.466666666666667,35,27,8,7,1
21701023,2403,HOU,LAC,Nene,25,5.28333333333333,5,0.283333333333333,12,13,-1,-2,1
21701023,2772,HOU,LAC,Trevor Ariza,158,33.4666666666667,33,0.466666666666669,66,69,-3,-2,-1
21701023,101108,HOU,LAC,Chris Paul,153,31.5333333333333,32,-0.466666666666669,60,70,-10,-10,0
21701023,200782,HOU,LAC,PJ Tucker,143,29.6,29,0.600000000000001,52,63,-11,-11,0
21701023,201569,HOU,LAC,Eric Gordon,138,29.8333333333333,30,-0.166666666666664,72,53,19,19,0
21701023,201601,HOU,LAC,Luc Mbah a Moute,114,25.3,25,0.300000000000001,69,47,22,22,0
21701023,201935,HOU,LAC,James Harden,163,34.6333333333333,34,0.633333333333333,70,69,1,1,0
21701023,203991,HOU,LAC,Clint Capela,172,35.8166666666667,36,-0.183333333333337,69,69,0,1,-1
21701023,101150,LAC,HOU,Lou Williams,175,36.6166666666667,36,0.616666666666667,70,72,-2,-2,0
21701023,201599,LAC,HOU,DeAndre Jordan,164,34.5,35,-0.5,69,69,0,0,0
21701023,202325,LAC,HOU,Wesley Johnson,28,5.26666666666667,5,0.266666666666667,7,10,-3,-3,0
21701023,202699,LAC,HOU,Tobias Harris,185,39.75,40,-0.25,81,83,-2,-2,0
21701023,203085,LAC,HOU,Austin Rivers,183,38.9333333333333,39,-0.06666666666667,75,79,-4,-4,0
21701023,1626149,LAC,HOU,Montrezl Harrell,63,13.5,13,0.5,27,32,-5,-5,0
21701023,1626155,LAC,HOU,Sam Dekker,25,5.41666666666667,6,-0.583333333333333,15,15,0,0,0
21701023,1628393,LAC,HOU,Jawun Evans,46,9.4,9,0.399999999999999,21,24,-3,-3,0
21701023,1628414,LAC,HOU,Sindarius Thornwell,173,36.7666666666667,37,-0.233333333333334,77,78,-1,-1,0
21701023,1628462,LAC,HOU,Milos Teodosic,93,19.85,20,-0.149999999999999,38,43,-5,-5,0
21701024,201577,CHI,MEM,Robin Lopez,58,12,12,0,22,29,-7,-7,0
21701024,203897,CHI,MEM,Zach LaVine,121,25.7166666666667,26,-0.283333333333331,55,63,-8,-6,-2
21701024,203943,CHI,MEM,Noah Vonleh,152,32.5166666666667,33,-0.483333333333334,74,86,-12,-15,3
21701024,1626166,CHI,MEM,Cameron Payne,118,25.3833333333333,25,0.383333333333333,63,58,5,8,-3
21701024,1626171,CHI,MEM,Bobby Portis,105,22.7,23,-0.300000000000001,57,44,13,16,-3
21701024,1626245,CHI,MEM,Cristiano Felicio,111,24,24,0,58,54,4,4,0
21701024,1627739,CHI,MEM,Kris Dunn,117,25.2,25,0.200000000000003,57,63,-6,-7,1
21701024,1627756,CHI,MEM,Denzel Valentine,93,20.5166666666667,20,0.516666666666666,57,39,18,17,1
21701024,1627835,CHI,MEM,Paul Zipser,66,13.5333333333333,13,0.533333333333333,25,27,-2,-2,0
21701024,1628021,CHI,MEM,David Nwaba,66,13.7,14,-0.300000000000001,28,38,-10,-9,-1
21701024,1628469,CHI,MEM,Antonio Blakeney,118,24.7333333333333,25,-0.266666666666666,59,49,10,6,4
21701024,201188,MEM,CHI,Marc Gasol,155,33.2166666666667,33,0.216666666666669,88,80,8,8,0
21701024,201936,MEM,CHI,Tyreke Evans,156,32.9833333333333,33,-0.0166666666666657,90,77,13,15,-2
21701024,202718,MEM,CHI,Chandler Parsons,27,5.76666666666667,6,-0.233333333333333,7,17,-10,-13,3
21701024,203210,MEM,CHI,JaMychal Green,175,37.45,38,-0.549999999999997,96,83,13,14,-1
21701024,203463,MEM,CHI,Ben McLemore,33,7.46666666666667,8,-0.533333333333333,13,17,-4,-8,4
21701024,1626185,MEM,CHI,Jarell Martin,149,31.1666666666667,31,0.166666666666664,68,69,-1,5,-6
21701024,1627362,MEM,CHI,Briante Weber,97,20.7,21,-0.300000000000001,44,50,-6,-8,2
21701024,1627738,MEM,CHI,Deyonta Davis,70,14.7833333333333,15,-0.216666666666669,22,31,-9,-9,0
21701024,1627782,MEM,CHI,Wayne Selden,94,19.7333333333333,19,0.733333333333334,43,52,-9,-6,-3
21701024,1628415,MEM,CHI,Dillon Brooks,138,29.7,30,-0.300000000000001,69,62,7,4,3
21701024,1628424,MEM,CHI,Kobi Simmons,31,7.03333333333333,7,0.0333333333333332,10,17,-7,-7,0
21701025,2731,NOP,SAS,Emeka Okafor,61,12.3166666666667,12,0.316666666666666,22,30,-8,-2,-6
21701025,200765,NOP,SAS,Rajon Rondo,119,23.9166666666667,24,-0.0833333333333357,35,56,-21,-23,2
21701025,201950,NOP,SAS,Jrue Holiday,184,38.3166666666667,38,0.316666666666663,81,70,11,14,-3
21701025,202703,NOP,SAS,Nikola Mirotic,146,29.1,29,0.0999999999999979,59,69,-10,-9,-1
21701025,202732,NOP,SAS,DeAndre Liggins,33,7.4,8,-0.6,13,14,-1,1,-2
21701025,202734,NOP,SAS,E'Twaun Moore,152,31.6,32,-0.399999999999999,62,58,4,1,3
21701025,203076,NOP,SAS,Anthony Davis,168,35.5333333333333,36,-0.466666666666669,71,65,6,1,5
21701025,203121,NOP,SAS,Darius Miller,143,29.5333333333333,29,0.533333333333331,56,65,-9,-10,1
21701025,203546,NOP,SAS,Ian Clark,154,32.0333333333333,32,0.0333333333333314,66,63,3,2,1
21701025,1938,SAS,NOP,Manu Ginobili,111,22.6166666666667,22,0.616666666666667,44,47,-3,1,-4
21701025,2200,SAS,NOP,Pau Gasol,50,10.05,10,0.0500000000000007,27,19,8,8,0
21701025,2225,SAS,NOP,Tony Parker,94,19.4333333333333,19,0.433333333333334,41,44,-3,-1,-2
21701025,200746,SAS,NOP,LaMarcus Aldridge,182,37.9,38,-0.100000000000001,71,74,-3,-3,0
21701025,200752,SAS,NOP,Rudy Gay,28,5.45,6,-0.55,20,8,12,12,0
21701025,201980,SAS,NOP,Danny Green,140,29.4666666666667,30,-0.533333333333331,61,51,10,6,4
21701025,201988,SAS,NOP,Patty Mills,165,34.3,34,0.299999999999997,67,70,-3,-4,1
21701025,202722,SAS,NOP,Davis Bertans,43,8.86666666666667,8,0.866666666666667,11,13,-2,-2,0
21701025,203937,SAS,NOP,Kyle Anderson,161,33.6333333333333,34,-0.366666666666667,67,72,-5,-5,0
21701025,1627749,SAS,NOP,Dejounte Murray,125,26.1166666666667,26,0.116666666666667,50,46,4,2,2
21701025,1627854,SAS,NOP,Bryn Forbes,61,11.9166666666667,12,-0.0833333333333339,31,21,10,11,-1
21701026,2734,DEN,DET,Devin Harris,68,15,15,0,35,32,3,6,-3
21701026,200794,DEN,DET,Paul Millsap,149,30.6666666666667,31,-0.333333333333336,83,72,11,12,-1
21701026,201163,DEN,DET,Wilson Chandler,183,39.7,40,-0.299999999999997,92,103,-11,-10,-1
21701026,203115,DEN,DET,Will Barton,147,31.3166666666667,32,-0.683333333333334,76,67,9,9,0
21701026,203486,DEN,DET,Mason Plumlee,58,12.25,12,0.25,30,32,-2,-2,0
21701026,203914,DEN,DET,Gary Harris,136,28.05,28,0.0500000000000007,74,70,4,3,1
21701026,203999,DEN,DET,Nikola Jokic,178,38.15,38,0.149999999999999,95,82,13,15,-2
21701026,1626168,DEN,DET,Trey Lyles,50,11.1666666666667,11,0.166666666666666,26,23,3,3,0
21701026,1627736,DEN,DET,Malik Beasley,4,0.166666666666667,0,0.166666666666667,5,3,2,-2,4
21701026,1627750,DEN,DET,Jamal Murray,157,32.8666666666667,33,-0.133333333333333,84,81,3,1,2
21701026,201229,DET,DEN,Anthony Tolliver,88,19.7666666666667,20,-0.233333333333334,49,54,-5,-3,-2
21701026,201933,DET,DEN,Blake Griffin,176,36.7166666666667,37,-0.283333333333331,92,92,0,1,-1
21701026,202397,DET,DEN,Ish Smith,122,24.85,25,-0.149999999999999,59,70,-11,-11,0
21701026,202779,DET,DEN,Dwight Buycks,104,23.0166666666667,23,0.0166666666666657,54,50,4,4,0
21701026,203083,DET,DEN,Andre Drummond,160,33.2333333333333,34,-0.766666666666666,77,77,0,-3,3
21701026,203493,DET,DEN,Reggie Bullock,168,35.4166666666667,35,0.416666666666671,88,91,-3,-1,-2
21701026,203516,DET,DEN,James Ennis III,128,27.0833333333333,27,0.0833333333333322,65,77,-12,-12,0
21701026,203961,DET,DEN,Eric Moreland,28,6.01666666666667,6,0.0166666666666666,8,17,-9,-9,0
21701026,1626169,DET,DEN,Stanley Johnson,74,16.1,16,0.100000000000001,28,33,-5,-5,0
21701026,1628379,DET,DEN,Luke Kennard,82,17.1333333333333,18,-0.866666666666667,45,39,6,4,2
21701027,201162,PHX,UTA,Jared Dudley,51,10.1666666666667,10,0.166666666666668,17,16,1,0,1
21701027,203458,PHX,UTA,Alex Len,117,23.3666666666667,23,0.366666666666667,46,71,-25,-25,0
21701027,203584,PHX,UTA,Troy Daniels,57,11.6333333333333,12,-0.366666666666667,25,40,-15,-15,0
21701027,203901,PHX,UTA,Elfrid Payton,78,16.5666666666667,17,-0.433333333333334,28,41,-13,-13,0
21701027,203933,PHX,UTA,T.J. Warren,186,36.4833333333333,36,0.483333333333334,69,89,-20,-22,2
21701027,1626164,PHX,UTA,Devin Booker,173,34.15,34,0.150000000000006,58,72,-14,-15,1
21701027,1627733,PHX,UTA,Dragan Bender,145,28.5666666666667,29,-0.433333333333334,50,68,-18,-19,1
21701027,1627737,PHX,UTA,Marquese Chriss,73,14.1666666666667,14,0.166666666666668,22,22,0,2,-2
21701027,1627755,PHX,UTA,Tyler Ulis,79,15.45,16,-0.550000000000001,30,40,-10,-9,-1
21701027,1627885,PHX,UTA,Shaquille Harrison,96,17.75,18,-0.25,34,41,-7,-6,-1
21701027,1628367,PHX,UTA,Josh Jackson,122,23.4333333333333,24,-0.566666666666666,47,54,-7,-10,3
21701027,1628409,PHX,UTA,Alec Peters,19,3.63333333333333,4,-0.366666666666667,7,13,-6,-4,-2
21701027,1628432,PHX,UTA,Davon Reed,19,3.63333333333333,4,-0.366666666666667,7,13,-6,-4,-2
21701027,201937,UTA,PHX,Ricky Rubio,156,31.0833333333333,31,0.0833333333333322,80,53,27,31,-4
21701027,201973,UTA,PHX,Jonas Jerebko,46,9.01666666666667,10,-0.983333333333334,20,19,1,-3,4
21701027,202324,UTA,PHX,Derrick Favors,113,23.0833333333333,23,0.0833333333333357,49,43,6,10,-4
21701027,202327,UTA,PHX,Ekpe Udoh,24,4.3,4,0.300000000000001,13,7,6,6,0
21701027,202692,UTA,PHX,Alec Burks,19,3.63333333333333,4,-0.366666666666667,13,7,6,4,2
21701027,203109,UTA,PHX,Jae Crowder,148,27.9,28,-0.100000000000001,63,54,9,7,2
21701027,203497,UTA,PHX,Rudy Gobert,168,34.2,34,0.200000000000003,89,63,26,24,2
21701027,203957,UTA,PHX,Dante Exum,75,14.5166666666667,14,0.516666666666666,32,29,3,3,0
21701027,204060,UTA,PHX,Joe Ingles,159,31.3166666666667,31,0.316666666666666,73,50,23,24,-1
21701027,1626220,UTA,PHX,Royce O'Neale,110,21.1333333333333,21,0.133333333333333,47,44,3,6,-3
21701027,1627777,UTA,PHX,Georges Niang,15,2.8,3,-0.2,8,5,3,2,1
21701027,1628378,UTA,PHX,Donovan Mitchell,182,36.0166666666667,36,0.0166666666666657,93,66,27,26,1
21701028,2544,CLE,POR,LeBron James,186,40.55,41,-0.450000000000003,91,92,-1,-3,2
21701028,2594,CLE,POR,Kyle Korver,173,38.1333333333333,38,0.133333333333333,88,89,-1,1,-2
21701028,2747,CLE,POR,JR Smith,126,27.35,27,0.350000000000001,52,62,-10,-10,0
21701028,201145,CLE,POR,Jeff Green,156,33.5166666666667,34,-0.483333333333334,70,79,-9,-9,0
21701028,201588,CLE,POR,George Hill,155,35.1333333333333,36,-0.866666666666667,76,80,-4,-3,-1
21701028,203903,CLE,POR,Jordan Clarkson,108,24.2,24,0.199999999999999,57,58,-1,-2,1
21701028,203918,CLE,POR,Rodney Hood,83,18.1833333333333,18,0.18333333333333,42,50,-8,-10,2
21701028,204066,CLE,POR,John Holland,62,14.95,15,-0.0500000000000007,36,38,-2,0,-2
21701028,1627790,CLE,POR,Ante Zizic,26,6.31666666666667,6,0.316666666666666,13,17,-4,-4,0
21701028,202323,POR,CLE,Evan Turner,117,25.7166666666667,26,-0.283333333333335,54,58,-4,0,-4
21701028,202329,POR,CLE,Al-Farouq Aminu,166,36,37,-1,81,77,4,6,-2
21701028,202334,POR,CLE,Ed Davis,94,21.2,21,0.199999999999999,52,45,7,9,-2
21701028,203081,POR,CLE,Damian Lillard,164,35.9833333333333,36,-0.0166666666666657,82,83,-1,-1,0
21701028,203090,POR,CLE,Maurice Harkless,112,25.5833333333333,26,-0.416666666666668,63,55,8,6,2
21701028,203468,POR,CLE,CJ McCollum,167,37.2666666666667,38,-0.733333333333334,91,84,7,7,0
21701028,203894,POR,CLE,Shabazz Napier,69,15.95,16,-0.0500000000000007,45,34,11,7,4
21701028,203994,POR,CLE,Jusuf Nurkic,85,18.6,19,-0.399999999999999,45,43,2,2,0
21701028,1626192,POR,CLE,Pat Connaughton,65,14.15,14,0.149999999999999,32,33,-1,-3,2
21701028,1628380,POR,CLE,Zach Collins,36,7.88333333333333,8,-0.116666666666666,20,13,7,7,0
21701029,201143,BOS,ORL,Al Horford,142,31.2,31,0.199999999999999,59,42,17,22,-5
21701029,202328,BOS,ORL,Greg Monroe,102,21.35,21,0.350000000000001,42,48,-6,-12,6
21701029,202694,BOS,ORL,Marcus Morris,152,32.8666666666667,33,-0.133333333333333,57,47,10,10,0
21701029,203382,BOS,ORL,Aron Baynes,100,22.3666666666667,23,-0.633333333333333,38,26,12,18,-6
21701029,203499,BOS,ORL,Shane Larkin,90,18.45,19,-0.550000000000001,34,42,-8,-6,-2
21701029,1626179,BOS,ORL,Terry Rozier,160,33.5166666666667,34,-0.483333333333334,69,54,15,21,-6
21701029,1627824,BOS,ORL,Guerschon Yabusele,11,1.68333333333333,2,-0.316666666666667,5,9,-4,-2,-2
21701029,1627846,BOS,ORL,Abdel Nader,113,23.2333333333333,24,-0.766666666666666,43,51,-8,-11,3
21701029,1628369,BOS,ORL,Jayson Tatum,139,30.2666666666667,30,0.266666666666666,58,44,14,16,-2
21701029,1628400,BOS,ORL,Semi Ojeleye,111,22.4,23,-0.600000000000001,45,52,-7,-11,4
21701029,201571,ORL,BOS,D.J. Augustin,138,29.3333333333333,30,-0.666666666666668,53,60,-7,-11,4
21701029,202687,ORL,BOS,Bismack Biyombo,95,19.6333333333333,19,0.633333333333333,33,35,-2,-1,-1
21701029,202696,ORL,BOS,Nikola Vucevic,129,27.8333333333333,29,-1.16666666666667,50,55,-5,-8,3
21701029,202714,ORL,BOS,Shelvin Mack,127,26,26,0,56,47,9,9,0
21701029,203613,ORL,BOS,Jonathon Simmons,160,33.7166666666667,34,-0.283333333333331,56,70,-14,-17,3
21701029,203920,ORL,BOS,Khem Birch,72,15.8,16,-0.199999999999999,25,31,-6,-9,3
21701029,1626209,ORL,BOS,Mario Hezonja,134,28.0666666666667,28,0.0666666666666664,48,62,-14,-16,2
21701029,1628371,ORL,BOS,Jonathan Isaac,109,23.7166666666667,25,-1.28333333333333,32,38,-6,-5,-1
21701029,1628411,ORL,BOS,Wes Iwundu,94,19.6333333333333,20,-0.366666666666667,35,34,1,5,-4
21701029,1628681,ORL,BOS,Rodney Purvis,62,13.6,14,-0.399999999999999,27,18,9,8,1
21701030,201960,BKN,PHI,DeMarre Carroll,153,30.95,31,-0.0499999999999972,69,68,1,5,-4
21701030,201967,BKN,PHI,Dante Cunningham,32,6.4,6,0.4,22,17,5,3,2
21701030,203112,BKN,PHI,Quincy Acy,80,17.3666666666667,18,-0.633333333333333,44,51,-7,-7,0
21701030,203915,BKN,PHI,Spencer Dinwiddie,145,30.7666666666667,31,-0.233333333333334,77,79,-2,-4,2
21701030,203925,BKN,PHI,Joe Harris,170,36.1166666666667,36,0.116666666666667,86,81,5,8,-3
21701030,1626143,BKN,PHI,Jahlil Okafor,56,13.0166666666667,13,0.0166666666666657,28,22,6,4,2
21701030,1626156,BKN,PHI,D'Angelo Russell,137,26.8166666666667,27,-0.183333333333334,60,76,-16,-18,2
21701030,1626178,BKN,PHI,Rondae Hollis-Jefferson,136,27.3,27,0.300000000000001,68,72,-4,-6,2
21701030,1627747,BKN,PHI,Caris LeVert,127,28.3,28,0.299999999999997,70,71,-1,4,-5
21701030,1628386,BKN,PHI,Jarrett Allen,114,22.8833333333333,23,-0.116666666666667,51,63,-12,-9,-3
21701030,101141,PHI,BKN,Ersan Ilyasova,107,24.0166666666667,24,0.0166666666666657,63,59,4,3,1
21701030,200755,PHI,BKN,JJ Redick,150,30.4,30,0.399999999999999,90,64,26,23,3
21701030,201158,PHI,BKN,Marco Belinelli,118,26.0166666666667,26,0.0166666666666657,58,65,-7,-5,-2
21701030,203496,PHI,BKN,Robert Covington,114,23.3166666666667,24,-0.683333333333334,63,54,9,3,6
21701030,203954,PHI,BKN,Joel Embiid,155,32.0833333333333,33,-0.916666666666671,86,66,20,20,0
21701030,203967,PHI,BKN,Dario Saric,135,27.5166666666667,28,-0.483333333333334,60,69,-9,-3,-6
21701030,204456,PHI,BKN,T.J. McConnell,68,14.8666666666667,15,-0.133333333333333,39,36,3,2,1
21701030,1626147,PHI,BKN,Justin Anderson,70,14.3333333333333,14,0.333333333333334,27,44,-17,-18,1
21701030,1626158,PHI,BKN,Richaun Holmes,51,10.5666666666667,10,0.566666666666666,23,32,-9,-9,0
21701030,1627732,PHI,BKN,Ben Simmons,182,36.8,37,-0.200000000000003,91,86,5,4,1
21701031,1717,DAL,TOR,Dirk Nowitzki,110,24.5666666666667,24,0.566666666666666,64,61,3,1,2
21701031,200826,DAL,TOR,J.J. Barea,83,18.7333333333333,19,-0.266666666666666,54,50,4,3,1
21701031,203084,DAL,TOR,Harrison Barnes,170,39.4166666666667,40,-0.583333333333329,72,89,-17,-15,-2
21701031,203457,DAL,TOR,Nerlens Noel,113,26.7333333333333,27,-0.266666666666666,53,53,0,-3,3
21701031,203926,DAL,TOR,Doug McDermott,71,16.15,16,0.149999999999999,45,44,1,3,-2
21701031,203939,DAL,TOR,Dwight Powell,142,33.1333333333333,33,0.133333333333333,62,71,-9,-9,0
21701031,1627812,DAL,TOR,Yogi Ferrell,141,32.1666666666667,32,0.166666666666664,64,83,-19,-20,1
21701031,1627827,DAL,TOR,Dorian Finney-Smith,99,23.15,23,0.149999999999999,46,48,-2,-2,0
21701031,1627866,DAL,TOR,Jameel Warney,29,7.28333333333333,7,0.283333333333333,17,20,-3,-3,0
21701031,1628372,DAL,TOR,Dennis Smith Jr.,156,36.25,36,0.25,74,74,0,1,-1
21701031,1628467,DAL,TOR,Maxi Kleber,36,7.16666666666667,7,0.166666666666666,24,17,7,9,-2
21701031,101139,TOR,DAL,CJ Miles,99,21.8833333333333,22,-0.116666666666667,51,59,-8,-7,-1
21701031,201586,TOR,DAL,Serge Ibaka,149,34.9666666666667,35,-0.0333333333333314,73,67,6,7,-1
21701031,201942,TOR,DAL,DeMar DeRozan,180,41.8166666666667,41,0.816666666666663,97,80,17,19,-2
21701031,202685,TOR,DAL,Jonas Valanciunas,103,23.25,23,0.25,46,44,2,5,-3
21701031,1626153,TOR,DAL,Delon Wright,162,38.3333333333333,39,-0.666666666666664,85,75,10,13,-3
21701031,1626259,TOR,DAL,Malcolm Miller,33,6.68333333333333,7,-0.316666666666666,15,24,-9,-9,0
21701031,1627751,TOR,DAL,Jakob Poeltl,80,18.15,18,0.149999999999999,47,51,-4,-9,5
21701031,1627783,TOR,DAL,Pascal Siakam,128,29.5333333333333,30,-0.466666666666669,78,68,10,8,2
21701031,1627832,TOR,DAL,Fred VanVleet,132,30.65,31,-0.350000000000001,81,71,10,7,3
21701031,1628384,TOR,DAL,OG Anunoby,84,19.4833333333333,19,0.483333333333334,37,36,1,1,0
21701032,101150,LAC,OKC,Lou Williams,195,37.8666666666667,38,-0.13333333333334,93,100,-7,-8,1
21701032,201599,LAC,OKC,DeAndre Jordan,150,30.4833333333333,31,-0.516666666666666,73,68,5,-2,7
21701032,202699,LAC,OKC,Tobias Harris,184,36.1333333333333,37,-0.866666666666667,88,85,3,4,-1
21701032,203085,LAC,OKC,Austin Rivers,197,38.4666666666667,39,-0.533333333333331,91,87,4,5,-1
21701032,1626149,LAC,OKC,Montrezl Harrell,84,16.1666666666667,16,0.166666666666668,38,52,-14,-10,-4
21701032,1626155,LAC,OKC,Sam Dekker,19,3.86666666666667,4,-0.133333333333333,8,16,-8,-8,0
21701032,1626246,LAC,OKC,Boban Marjanovic,47,8.65,8,0.649999999999999,19,19,0,0,0
21701032,1628393,LAC,OKC,Jawun Evans,45,9.18333333333333,9,0.183333333333334,22,33,-11,-13,2
21701032,1628414,LAC,OKC,Sindarius Thornwell,142,28,28,0,66,65,1,2,-1
21701032,1628462,LAC,OKC,Milos Teodosic,147,29.4333333333333,29,0.433333333333334,67,75,-8,-10,2
21701032,2546,OKC,LAC,Carmelo Anthony,156,31.5,31,0.5,73,76,-3,-4,1
21701032,101109,OKC,LAC,Raymond Felton,56,11.45,12,-0.550000000000001,35,26,9,9,0
21701032,201147,OKC,LAC,Corey Brewer,150,30.4666666666667,31,-0.533333333333331,71,76,-5,-4,-1
21701032,201566,OKC,LAC,Russell Westbrook,186,36.2,37,-0.799999999999997,85,87,-2,-1,-1
21701032,202331,OKC,LAC,Paul George,193,38.1,38,0.0999999999999943,95,91,4,5,-1
21701032,202335,OKC,LAC,Patrick Patterson,86,16.15,17,-0.850000000000001,47,37,10,12,-2
21701032,203500,OKC,LAC,Steven Adams,191,37.9,38,-0.100000000000001,87,93,-6,-2,-4
21701032,203518,OKC,LAC,Alex Abrines,49,9.55,10,-0.449999999999999,25,22,3,3,0
21701032,203924,OKC,LAC,Jerami Grant,51,9.75,10,-0.25,33,20,13,10,3
21701032,1628390,OKC,LAC,Terrance Ferguson,92,17.1833333333333,17,0.183333333333334,49,37,12,12,0
21701033,2561,GSW,SAC,David West,71,15.7666666666667,16,-0.233333333333334,24,35,-11,-10,-1
21701033,2585,GSW,SAC,Zaza Pachulia,74,17.0333333333333,17,0.0333333333333314,32,26,6,6,0
21701033,2733,GSW,SAC,Shaun Livingston,82,19,19,0,40,40,0,0,0
21701033,2738,GSW,SAC,Andre Iguodala,139,30.8666666666667,31,-0.133333333333333,56,58,-2,-2,0
21701033,201156,GSW,SAC,Nick Young,160,36.25,36,0.25,66,74,-8,-8,0
21701033,201580,GSW,SAC,JaVale McGee,42,9.63333333333333,9,0.633333333333333,25,24,1,1,0
21701033,201956,GSW,SAC,Omri Casspi,30,6.15,6,0.15,21,19,2,2,0
21701033,203110,GSW,SAC,Draymond Green,146,33.4666666666667,34,-0.533333333333331,65,72,-7,-6,-1
21701033,1626172,GSW,SAC,Kevon Looney,89,19.5833333333333,20,-0.416666666666664,44,46,-2,-3,1
21701033,1626188,GSW,SAC,Quinn Cook,177,40.1333333333333,40,0.133333333333333,72,72,0,0,0
21701033,1628395,GSW,SAC,Jordan Bell,50,11.7,12,-0.300000000000001,20,24,-4,-5,1
21701033,2216,SAC,GSW,Zach Randolph,83,19.25,19,0.25,31,41,-10,-10,0
21701033,201585,SAC,GSW,Kosta Koufos,109,25,25,0,54,44,10,10,0
21701033,202066,SAC,GSW,Garrett Temple,104,23.7833333333333,24,-0.216666666666669,49,45,4,3,1
21701033,203992,SAC,GSW,Bogdan Bogdanovic,108,24.1333333333333,24,0.133333333333333,49,48,1,2,-1
21701033,1626161,SAC,GSW,Willie Cauley-Stein,118,26.0166666666667,26,0.0166666666666657,50,48,2,2,0
21701033,1627741,SAC,GSW,Buddy Hield,135,30.2166666666667,30,0.216666666666665,72,57,15,15,0
21701033,1627746,SAC,GSW,Skal Labissiere,114,25.5666666666667,26,-0.433333333333334,61,53,8,8,0
21701033,1628368,SAC,GSW,De'Aaron Fox,114,25.3833333333333,25,0.383333333333333,49,56,-7,-7,0
21701033,1628382,SAC,GSW,Justin Jackson,77,17.7,18,-0.300000000000001,26,36,-10,-10,0
21701033,1628412,SAC,GSW,Frank Mason,98,22.5333333333333,23,-0.466666666666669,49,37,12,12,0
21701034,201572,LAL,MIA,Brook Lopez,154,33.0833333333333,33,0.0833333333333286,67,65,2,0,2
21701034,202738,LAL,MIA,Isaiah Thomas,125,26.35,27,-0.649999999999999,42,51,-9,-9,0
21701034,203484,LAL,MIA,Kentavious Caldwell-Pope,180,38.9166666666667,39,-0.0833333333333286,77,74,3,3,0
21701034,203898,LAL,MIA,Tyler Ennis,51,11.5833333333333,12,-0.416666666666668,18,24,-6,-6,0
21701034,203944,LAL,MIA,Julius Randle,173,38.05,38,0.0499999999999972,81,77,4,6,-2
21701034,204037,LAL,MIA,Travis Wear,64,14,14,0,24,27,-3,-3,0
21701034,1627826,LAL,MIA,Ivica Zubac,35,7.13333333333333,7,0.133333333333333,8,13,-5,-5,0
21701034,1628366,LAL,MIA,Lonzo Ball,177,38.2333333333333,38,0.233333333333334,73,72,1,1,0
21701034,1628398,LAL,MIA,Kyle Kuzma,146,32.4,33,-0.600000000000001,65,57,8,8,0
21701034,201609,MIA,LAL,Goran Dragic,145,31.2833333333333,31,0.283333333333331,66,70,-4,0,-4
21701034,201949,MIA,LAL,James Johnson,121,25.15,25,0.149999999999999,48,56,-8,-8,0
21701034,201961,MIA,LAL,Wayne Ellington,140,31.25,31,0.25,57,46,11,9,2
21701034,203482,MIA,LAL,Kelly Olynyk,105,24.2,24,0.200000000000003,42,38,4,2,2
21701034,203585,MIA,LAL,Rodney McGruder,67,14.8166666666667,15,-0.183333333333334,32,30,2,-2,4
21701034,204020,MIA,LAL,Tyler Johnson,132,28,28,0,52,52,0,0,0
21701034,1626159,MIA,LAL,Justise Winslow,89,19.1,19,0.100000000000001,39,28,11,11,0
21701034,1626196,MIA,LAL,Josh Richardson,144,31.3166666666667,32,-0.683333333333334,56,65,-9,-7,-2
21701034,1628389,MIA,LAL,Bam Adebayo,162,34.6333333333333,35,-0.366666666666667,68,70,-2,0,-2
21701035,2744,IND,WAS,Al Jefferson,109,25.5,26,-0.5,53,55,-2,-5,3
21701035,201152,IND,WAS,Thaddeus Young,117,26.6833333333333,27,-0.316666666666666,46,68,-22,-21,-1
21701035,201954,IND,WAS,Darren Collison,117,26.9166666666667,27,-0.0833333333333357,64,71,-7,-5,-2
21701035,202344,IND,WAS,Trevor Booker,82,18.1333333333333,18,0.133333333333333,40,47,-7,-6,-1
21701035,202362,IND,WAS,Lance Stephenson,128,28.2333333333333,29,-0.766666666666666,77,61,16,16,0
21701035,202709,IND,WAS,Cory Joseph,103,23.7333333333333,24,-0.266666666666666,37,60,-23,-24,1
21701035,202711,IND,WAS,Bojan Bogdanovic,117,28.1,28,0.100000000000001,52,58,-6,-4,-2
21701035,203506,IND,WAS,Victor Oladipo,129,29.2,29,0.199999999999999,55,73,-18,-18,0
21701035,203922,IND,WAS,Glenn Robinson III,69,15.2166666666667,16,-0.783333333333333,36,28,8,8,0
21701035,1626202,IND,WAS,Joe Young,32,5.83333333333333,6,-0.166666666666666,19,8,11,10,1
21701035,1627816,IND,WAS,Alex Poythress,29,5.43333333333333,6,-0.566666666666666,16,8,8,7,1
21701035,1628388,IND,WAS,TJ Leaf,28,5.43333333333333,6,-0.566666666666666,15,8,7,7,0
21701035,101133,WAS,IND,Ian Mahinmi,39,8.68333333333333,9,-0.316666666666666,18,23,-5,-6,1
21701035,101162,WAS,IND,Marcin Gortat,105,24.1166666666667,25,-0.883333333333333,61,40,21,22,-1
21701035,201196,WAS,IND,Ramon Sessions,78,18.05,18,0.0500000000000007,38,46,-8,-9,1
21701035,201975,WAS,IND,Jodie Meeks,94,20.65,21,-0.350000000000001,40,53,-13,-13,0
21701035,202693,WAS,IND,Markieff Morris,134,29.3333333333333,30,-0.666666666666664,71,55,16,18,-2
21701035,203078,WAS,IND,Bradley Beal,139,30.8666666666667,31,-0.133333333333333,75,59,16,16,0
21701035,203107,WAS,IND,Tomas Satoransky,161,35.8166666666667,36,-0.183333333333337,86,71,15,16,-1
21701035,203118,WAS,IND,Mike Scott,78,18.35,18,0.350000000000001,38,47,-9,-11,2
21701035,203490,WAS,IND,Otto Porter Jr.,152,34.1666666666667,34,0.166666666666664,82,68,14,14,0
21701035,1626162,WAS,IND,Kelly Oubre Jr.,80,18.3833333333333,18,0.383333333333333,36,48,-12,-12,0
21701036,2731,NOP,HOU,Emeka Okafor,53,10.5833333333333,11,-0.416666666666668,21,23,-2,-2,0
21701036,201950,NOP,HOU,Jrue Holiday,174,37.8333333333333,38,-0.166666666666671,80,82,-2,-2,0
21701036,202703,NOP,HOU,Nikola Mirotic,101,23.5666666666667,24,-0.433333333333337,55,53,2,2,0
21701036,202732,NOP,HOU,DeAndre Liggins,94,19.7666666666667,20,-0.233333333333334,35,50,-15,-15,0
21701036,202734,NOP,HOU,E'Twaun Moore,154,33.4166666666667,34,-0.583333333333336,64,76,-12,-12,0
21701036,203076,NOP,HOU,Anthony Davis,159,35.95,36,-0.0499999999999972,75,85,-10,-12,2
21701036,203121,NOP,HOU,Darius Miller,128,30.6166666666667,30,0.616666666666667,64,68,-4,-4,0
21701036,203546,NOP,HOU,Ian Clark,134,31.1833333333333,31,0.18333333333333,74,68,6,6,0
21701036,203580,NOP,HOU,Larry Drew II,18,4.36666666666667,4,0.366666666666666,11,8,3,3,0
21701036,1627767,NOP,HOU,Cheick Diallo,55,11.8833333333333,12,-0.116666666666667,26,22,4,6,-2
21701036,2207,HOU,NOP,Joe Johnson,59,14.0833333333333,14,0.0833333333333322,25,39,-14,-15,1
21701036,2772,HOU,NOP,Trevor Ariza,148,32.1166666666667,32,0.116666666666667,77,60,17,16,1
21701036,101108,HOU,NOP,Chris Paul,149,33.1166666666667,33,0.116666666666667,72,64,8,7,1
21701036,200782,HOU,NOP,PJ Tucker,142,31.0166666666667,31,0.0166666666666657,70,56,14,14,0
21701036,201569,HOU,NOP,Eric Gordon,110,24.45,24,0.449999999999999,53,62,-9,-8,-1
21701036,201583,HOU,NOP,Ryan Anderson,46,11.4,11,0.4,21,29,-8,-8,0
21701036,201601,HOU,NOP,Luc Mbah a Moute,114,26.0333333333333,26,0.0333333333333314,58,69,-11,-12,1
21701036,201935,HOU,NOP,James Harden,168,37.2833333333333,38,-0.716666666666669,90,73,17,18,-1
21701036,203991,HOU,NOP,Clint Capela,134,29.6666666666667,30,-0.333333333333332,69,53,16,18,-2
21701037,1717,DAL,BKN,Dirk Nowitzki,127,27.0333333333333,27,0.0333333333333314,63,78,-15,-15,0
21701037,203926,DAL,BKN,Doug McDermott,192,41.55,42,-0.450000000000003,95,95,0,1,-1
21701037,203939,DAL,BKN,Dwight Powell,134,27.7666666666667,29,-1.23333333333333,68,81,-13,-12,-1
21701037,1627812,DAL,BKN,Yogi Ferrell,142,31.9333333333333,32,-0.0666666666666664,63,72,-9,-7,-2
21701037,1627858,DAL,BKN,Kyle Collinsworth,83,17.7166666666667,17,0.716666666666669,36,44,-8,-9,1
21701037,1627883,DAL,BKN,Jalen Jones,132,29.25,29,0.25,68,62,6,5,1
21701037,1628372,DAL,BKN,Dennis Smith Jr.,105,22.45,23,-0.550000000000001,56,69,-13,-14,1
21701037,1628405,DAL,BKN,Johnathan Motley,84,19.8666666666667,19,0.866666666666667,38,33,5,4,1
21701037,1628467,DAL,BKN,Maxi Kleber,91,20.6,21,-0.399999999999999,43,36,7,7,0
21701037,201960,BKN,DAL,DeMarre Carroll,166,34.9666666666667,36,-1.03333333333333,88,81,7,9,-2
21701037,203112,BKN,DAL,Quincy Acy,79,18.7,19,-0.300000000000001,46,41,5,6,-1
21701037,203915,BKN,DAL,Spencer Dinwiddie,136,30.9333333333333,31,-0.0666666666666629,73,71,2,1,1
21701037,203925,BKN,DAL,Joe Harris,145,32.6833333333333,32,0.68333333333333,83,70,13,14,-1
21701037,1626143,BKN,DAL,Jahlil Okafor,26,6.2,6,0.199999999999999,14,16,-2,-2,0
21701037,1626156,BKN,DAL,D'Angelo Russell,136,28.4,29,-0.600000000000001,62,66,-4,-2,-2
21701037,1626178,BKN,DAL,Rondae Hollis-Jefferson,146,31.2833333333333,32,-0.716666666666665,73,68,5,3,2
21701037,1627747,BKN,DAL,Caris LeVert,122,27.1333333333333,27,0.133333333333333,63,56,7,5,2
21701037,1628386,BKN,DAL,Jarrett Allen,134,27.8666666666667,28,-0.133333333333333,68,61,7,6,1
21701038,101127,NYK,CHA,Jarrett Jack,33,6.91666666666667,7,-0.0833333333333339,11,22,-11,-10,-1
21701038,201563,NYK,CHA,Michael Beasley,110,22.3333333333333,23,-0.666666666666668,60,38,22,27,-5
21701038,202498,NYK,CHA,Lance Thomas,109,21.45,21,0.450000000000003,50,44,6,7,-1
21701038,202683,NYK,CHA,Enes Kanter,73,14.75,15,-0.25,31,28,3,3,0
21701038,203124,NYK,CHA,Kyle O'Quinn,86,16.95,17,-0.0500000000000007,57,27,30,29,1
21701038,203501,NYK,CHA,Tim Hardaway Jr.,147,28.5666666666667,29,-0.433333333333334,76,50,26,26,0
21701038,203504,NYK,CHA,Trey Burke,88,19.1,19,0.100000000000001,51,45,6,4,2
21701038,1626144,NYK,CHA,Emmanuel Mudiay,75,15.4,16,-0.6,36,29,7,10,-3
21701038,1627786,NYK,CHA,Troy Williams,113,22.45,23,-0.550000000000001,68,45,23,21,2
21701038,1628373,NYK,CHA,Frank Ntilikina,103,20.7666666666667,21,-0.233333333333334,65,41,24,20,4
21701038,1628422,NYK,CHA,Damyean Dotson,41,8.98333333333333,9,-0.0166666666666657,17,30,-13,-12,-1
21701038,1628436,NYK,CHA,Luke Kornet,76,15.95,16,-0.0500000000000007,36,46,-10,-9,-1
21701038,1628439,NYK,CHA,Isaiah Hicks,121,24.6333333333333,25,-0.366666666666667,62,60,2,-1,3
21701038,2730,CHA,NYK,Dwight Howard,137,26.75,27,-0.25,50,66,-16,-16,0
21701038,101107,CHA,NYK,Marvin Williams,115,22.6833333333333,23,-0.316666666666666,42,53,-11,-16,5
21701038,201587,CHA,NYK,Nicolas Batum,124,25.0166666666667,25,0.0166666666666657,48,57,-9,-9,0
21701038,202689,CHA,NYK,Kemba Walker,125,24.6333333333333,25,-0.366666666666667,50,60,-10,-16,6
21701038,202933,CHA,NYK,Julyan Stone,24,4.55,5,-0.45,15,9,6,4,2
21701038,203077,CHA,NYK,Michael Kidd-Gilchrist,119,23.1833333333333,23,0.183333333333334,41,54,-13,-13,0
21701038,203087,CHA,NYK,Jeremy Lamb,95,19.3666666666667,20,-0.633333333333333,34,69,-35,-36,1
21701038,1626163,CHA,NYK,Frank Kaminsky,100,21.25,21,0.25,44,67,-23,-16,-7
21701038,1626195,CHA,NYK,Willy Hernangomez,61,12.65,13,-0.350000000000001,34,30,4,4,0
21701038,1626203,CHA,NYK,Treveon Graham,74,16.4,17,-0.600000000000001,47,40,7,6,1
21701038,1628370,CHA,NYK,Malik Monk,110,23.0166666666667,23,0.0166666666666657,51,64,-13,-7,-6
21701038,1628407,CHA,NYK,Dwayne Bacon,91,18.75,19,-0.25,49,51,-2,0,-2
21701039,2544,CLE,CHI,LeBron James,184,39.7666666666667,40,-0.233333333333334,95,99,-4,-4,0
21701039,2747,CLE,CHI,JR Smith,95,21.8,22,-0.199999999999999,45,42,3,3,0
21701039,101181,CLE,CHI,Jose Calderon,170,36.15,36,0.149999999999999,93,86,7,6,1
21701039,201145,CLE,CHI,Jeff Green,201,42.5833333333333,43,-0.416666666666671,97,100,-3,-4,1
21701039,201588,CLE,CHI,George Hill,158,32.7333333333333,33,-0.266666666666666,88,73,15,14,1
21701039,203903,CLE,CHI,Jordan Clarkson,145,31.4666666666667,32,-0.533333333333335,69,69,0,1,-1
21701039,204066,CLE,CHI,John Holland,49,10.6,11,-0.4,27,15,12,15,-3
21701039,1627790,CLE,CHI,Ante Zizic,98,20.25,20,0.25,49,53,-4,-6,2
21701039,1628506,CLE,CHI,London Perrantes,20,4.06666666666667,4,0.0666666666666664,7,8,-1,0,-1
21701039,203200,CHI,CLE,Justin Holiday,83,16.95,17,-0.0500000000000007,40,37,3,3,0
21701039,1626166,CHI,CLE,Cameron Payne,152,31.65,32,-0.350000000000001,77,78,-1,-2,1
21701039,1626170,CHI,CLE,Jerian Grant,71,16.2,16,0.199999999999999,32,35,-3,-3,0
21701039,1626171,CHI,CLE,Bobby Portis,162,34.8,35,-0.200000000000003,74,84,-10,-10,0
21701039,1626245,CHI,CLE,Cristiano Felicio,143,30.1833333333333,30,0.183333333333334,63,78,-15,-13,-2
21701039,1627756,CHI,CLE,Denzel Valentine,177,38.3666666666667,39,-0.633333333333333,100,87,13,14,-1
21701039,1627835,CHI,CLE,Paul Zipser,115,23.85,24,-0.149999999999999,65,55,10,9,1
21701039,1628021,CHI,CLE,David Nwaba,88,20.0833333333333,20,0.0833333333333357,38,49,-11,-11,0
21701039,1628469,CHI,CLE,Antonio Blakeney,129,27.3333333333333,27,0.333333333333336,56,67,-11,-12,1
21701040,2734,DEN,MEM,Devin Harris,125,26.1333333333333,26,0.133333333333333,60,51,9,8,1
21701040,200794,DEN,MEM,Paul Millsap,130,29.55,30,-0.449999999999999,54,66,-12,-12,0
21701040,201163,DEN,MEM,Wilson Chandler,139,31.3333333333333,32,-0.666666666666668,54,70,-16,-12,-4
21701040,203115,DEN,MEM,Will Barton,150,33.8333333333333,34,-0.166666666666664,56,72,-16,-14,-2
21701040,203486,DEN,MEM,Mason Plumlee,58,11.4,11,0.399999999999999,25,24,1,-1,2
21701040,203999,DEN,MEM,Nikola Jokic,156,34.9666666666667,35,-0.0333333333333314,65,72,-7,-1,-6
21701040,1626168,DEN,MEM,Trey Lyles,96,19.7833333333333,20,-0.216666666666669,42,40,2,2,0
21701040,1627750,DEN,MEM,Jamal Murray,165,35.7333333333333,36,-0.266666666666666,70,79,-9,-8,-1
21701040,1628470,DEN,MEM,Torrey Craig,81,16.5166666666667,16,0.516666666666666,39,31,8,3,5
21701040,201188,MEM,DEN,Marc Gasol,157,35.6833333333333,36,-0.316666666666663,73,61,12,10,2
21701040,201596,MEM,DEN,Mario Chalmers,33,6.76666666666667,7,-0.233333333333333,11,15,-4,-4,0
21701040,201936,MEM,DEN,Tyreke Evans,177,37.8833333333333,38,-0.116666666666667,86,78,8,7,1
21701040,203210,MEM,DEN,JaMychal Green,132,30.3833333333333,30,0.383333333333333,63,49,14,9,5
21701040,1626185,MEM,DEN,Jarell Martin,160,35.4166666666667,36,-0.583333333333329,74,66,8,10,-2
21701040,1627362,MEM,DEN,Briante Weber,97,20.2833333333333,20,0.283333333333331,44,48,-4,-5,1
21701040,1627738,MEM,DEN,Deyonta Davis,63,12.1666666666667,12,0.166666666666666,28,32,-4,-3,-1
21701040,1627782,MEM,DEN,Wayne Selden,105,21.7666666666667,22,-0.233333333333334,46,46,0,4,-4
21701040,1628415,MEM,DEN,Dillon Brooks,176,38.9,39,-0.100000000000001,80,70,10,7,3
21701041,203471,ATL,MIL,Dennis Schroder,165,34.5166666666667,35,-0.483333333333334,78,71,7,7,0
21701041,203473,ATL,MIL,Dewayne Dedmon,149,31.0166666666667,31,0.0166666666666657,71,71,0,-2,2
21701041,203488,ATL,MIL,Mike Muscala,145,28.1833333333333,28,0.183333333333334,69,87,-18,-18,0
21701041,1627752,ATL,MIL,Taurean Prince,197,40.1,40,0.100000000000001,95,98,-3,-7,4
21701041,1627814,ATL,MIL,Damion Lee,107,20.9166666666667,21,-0.0833333333333357,61,61,0,0,0
21701041,1627819,ATL,MIL,Isaiah Taylor,126,25.1666666666667,25,0.166666666666664,62,75,-13,-13,0
21701041,1628381,ATL,MIL,John Collins,126,26.5166666666667,26,0.516666666666666,77,64,13,13,0
21701041,1628416,ATL,MIL,Tyler Dorsey,86,17.65,18,-0.350000000000001,41,46,-5,-5,0
21701041,1628463,ATL,MIL,Tyler Cavanaugh,34,6.71666666666667,7,-0.283333333333333,9,13,-4,-2,-2
21701041,1628510,ATL,MIL,Andrew White III,45,9.21666666666667,9,0.216666666666667,22,24,-2,2,-4
21701041,1891,MIL,ATL,Jason Terry,55,11.55,12,-0.449999999999999,28,27,1,1,0
21701041,201943,MIL,ATL,Brandon Jennings,87,17.4666666666667,17,0.466666666666669,43,40,3,3,0
21701041,202339,MIL,ATL,Eric Bledsoe,149,30.5333333333333,31,-0.466666666666669,79,77,2,2,0
21701041,203089,MIL,ATL,John Henson,167,34.3833333333333,34,0.383333333333333,84,77,7,7,0
21701041,203114,MIL,ATL,Khris Middleton,184,36.9833333333333,37,-0.0166666666666657,97,91,6,8,-2
21701041,203503,MIL,ATL,Tony Snell,143,29.4833333333333,29,0.483333333333334,83,70,13,13,0
21701041,203507,MIL,ATL,Giannis Antetokounmpo,192,39.1,39,0.100000000000001,93,91,2,2,0
21701041,203953,MIL,ATL,Jabari Parker,101,20.85,21,-0.149999999999999,54,57,-3,-5,2
21701041,1627748,MIL,ATL,Thon Maker,61,12.1,12,0.100000000000001,33,35,-2,-2,0
21701041,1628425,MIL,ATL,Sterling Brown,41,7.55,8,-0.449999999999999,16,20,-4,-4,0
21701042,2037,MIN,SAS,Jamal Crawford,96,21.6166666666667,21,0.616666666666667,48,61,-13,-14,1
21701042,201565,MIN,SAS,Derrick Rose,66,14.8666666666667,15,-0.133333333333333,24,45,-21,-21,0
21701042,201952,MIN,SAS,Jeff Teague,144,31.6833333333333,31,0.68333333333333,68,70,-2,-4,2
21701042,201959,MIN,SAS,Taj Gibson,158,32.9166666666667,33,-0.0833333333333357,73,75,-2,-3,1
21701042,202332,MIN,SAS,Cole Aldrich,3,0.616666666666667,1,-0.383333333333333,0,2,-2,-2,0
21701042,202357,MIN,SAS,Nemanja Bjelica,167,36.65,37,-0.350000000000001,77,85,-8,-6,-2
21701042,203476,MIN,SAS,Gorgui Dieng,50,10.8666666666667,11,-0.133333333333333,19,27,-8,-8,0
21701042,203952,MIN,SAS,Andrew Wiggins,158,34.0166666666667,34,0.0166666666666657,77,79,-2,-2,0
21701042,1626145,MIN,SAS,Tyus Jones,73,15.9,16,-0.0999999999999996,33,45,-12,-10,-2
21701042,1626157,MIN,SAS,Karl-Anthony Towns,177,39,39,0,86,94,-8,-8,0
21701042,1627875,MIN,SAS,Marcus Georges-Hunt,3,0.616666666666667,1,-0.383333333333333,0,2,-2,-2,0
21701042,1938,SAS,MIN,Manu Ginobili,77,16.7666666666667,17,-0.233333333333334,42,33,9,11,-2
21701042,2200,SAS,MIN,Pau Gasol,111,24.0166666666667,24,0.0166666666666657,70,49,21,23,-2
21701042,2225,SAS,MIN,Tony Parker,101,22,22,0,57,41,16,18,-2
21701042,200746,SAS,MIN,LaMarcus Aldridge,164,35.6833333333333,36,-0.316666666666663,83,77,6,8,-2
21701042,200752,SAS,MIN,Rudy Gay,94,20.8,21,-0.200000000000003,53,42,11,11,0
21701042,201980,SAS,MIN,Danny Green,152,33.3333333333333,33,0.333333333333329,75,74,1,5,-4
21701042,201988,SAS,MIN,Patty Mills,141,31,31,0,77,67,10,8,2
21701042,202722,SAS,MIN,Davis Bertans,3,0.616666666666667,1,-0.383333333333333,2,0,2,2,0
21701042,203464,SAS,MIN,Brandon Paul,7,1.25,2,-0.75,2,0,2,2,0
21701042,203530,SAS,MIN,Joffrey Lauvergne,3,0.616666666666667,1,-0.383333333333333,2,0,2,2,0
21701042,203937,SAS,MIN,Kyle Anderson,63,13.7666666666667,14,-0.233333333333334,24,34,-10,-14,4
21701042,1627749,SAS,MIN,Dejounte Murray,108,23.4666666666667,24,-0.533333333333331,54,56,-2,-4,2
21701042,1627854,SAS,MIN,Bryn Forbes,71,15.4333333333333,16,-0.566666666666666,44,32,12,8,4
21701043,201585,SAC,UTA,Kosta Koufos,89,19.2,19,0.199999999999999,42,43,-1,9,-10
21701043,202066,SAC,UTA,Garrett Temple,113,25.2166666666667,25,0.216666666666669,56,41,15,15,0
21701043,203960,SAC,UTA,JaKarr Sampson,102,23.3,23,0.299999999999997,47,34,13,15,-2
21701043,203992,SAC,UTA,Bogdan Bogdanovic,125,26.4666666666667,27,-0.533333333333335,50,74,-24,-28,4
21701043,1626161,SAC,UTA,Willie Cauley-Stein,132,28.9666666666667,29,-0.0333333333333314,55,64,-9,-15,6
21701043,1627741,SAC,UTA,Buddy Hield,136,28.95,29,-0.0499999999999972,66,52,14,14,0
21701043,1627746,SAC,UTA,Skal Labissiere,96,20.85,21,-0.149999999999999,41,53,-12,-14,2
21701043,1628368,SAC,UTA,De'Aaron Fox,126,27.0833333333333,27,0.0833333333333322,55,73,-18,-18,0
21701043,1628382,SAC,UTA,Justin Jackson,83,19.05,19,0.0499999999999972,31,51,-20,-20,0
21701043,1628412,SAC,UTA,Frank Mason,93,20.9166666666667,21,-0.0833333333333357,42,30,12,12,0
21701043,201937,UTA,SAC,Ricky Rubio,154,34.0166666666667,34,0.0166666666666657,85,60,25,27,-2
21701043,201973,UTA,SAC,Jonas Jerebko,43,9.23333333333333,9,0.233333333333334,16,31,-15,-15,0
21701043,202324,UTA,SAC,Derrick Favors,115,24.8833333333333,25,-0.116666666666667,47,60,-13,-15,2
21701043,203109,UTA,SAC,Jae Crowder,139,29.3,29,0.300000000000001,65,57,8,8,0
21701043,203497,UTA,SAC,Rudy Gobert,175,39.0333333333333,39,0.0333333333333314,91,74,17,19,-2
21701043,203957,UTA,SAC,Dante Exum,58,12.75,13,-0.25,13,28,-15,-15,0
21701043,204060,UTA,SAC,Joe Ingles,153,34.2833333333333,35,-0.716666666666669,82,62,20,20,0
21701043,1626220,UTA,SAC,Royce O'Neale,79,16.8833333333333,17,-0.116666666666667,21,38,-17,-19,2
21701043,1628378,UTA,SAC,Donovan Mitchell,179,39.6166666666667,39,0.616666666666667,95,75,20,20,0
21701044,2561,GSW,PHX,David West,80,17.05,17,0.0499999999999972,34,39,-5,-6,1
21701044,2585,GSW,PHX,Zaza Pachulia,88,16.8333333333333,17,-0.166666666666664,57,36,21,21,0
21701044,2733,GSW,PHX,Shaun Livingston,79,17.05,17,0.0500000000000007,34,47,-13,-13,0
21701044,2738,GSW,PHX,Andre Iguodala,132,27.5,28,-0.5,66,57,9,11,-2
21701044,201156,GSW,PHX,Nick Young,201,41.25,42,-0.75,114,84,30,29,1
21701044,201580,GSW,PHX,JaVale McGee,17,3.11666666666667,3,0.116666666666667,9,6,3,1,2
21701044,203110,GSW,PHX,Draymond Green,177,34.3833333333333,35,-0.616666666666667,95,78,17,16,1
21701044,1626172,GSW,PHX,Kevon Looney,117,24.4166666666667,25,-0.583333333333336,55,51,4,5,-1
21701044,1626188,GSW,PHX,Quinn Cook,205,39.8666666666667,40,-0.13333333333334,110,90,20,19,1
21701044,1628395,GSW,PHX,Jordan Bell,84,17.95,18,-0.0500000000000007,46,52,-6,-8,2
21701044,201162,PHX,GSW,Jared Dudley,119,24.8,25,-0.199999999999999,62,57,5,5,0
21701044,203458,PHX,GSW,Alex Len,88,16.45,17,-0.549999999999997,34,47,-13,-13,0
21701044,203584,PHX,GSW,Troy Daniels,148,28.5666666666667,29,-0.433333333333334,56,81,-25,-24,-1
21701044,203901,PHX,GSW,Elfrid Payton,143,27.1166666666667,27,0.116666666666667,60,72,-12,-11,-1
21701044,203933,PHX,GSW,T.J. Warren,152,30.7166666666667,30,0.716666666666669,71,78,-7,-6,-1
21701044,1627733,PHX,GSW,Dragan Bender,172,34.8666666666667,35,-0.133333333333333,73,96,-23,-24,1
21701044,1627737,PHX,GSW,Marquese Chriss,79,17.4333333333333,18,-0.566666666666666,41,40,1,4,-3
21701044,1627755,PHX,GSW,Tyler Ulis,15,3.4,3,0.4,9,8,1,-2,3
21701044,1627885,PHX,GSW,Shaquille Harrison,92,20.0333333333333,20,0.0333333333333314,50,49,1,2,-1
21701044,1628367,PHX,GSW,Josh Jackson,172,36.0333333333333,36,0.0333333333333314,84,92,-8,-6,-2
21701045,202323,POR,DET,Evan Turner,95,20.9333333333333,21,-0.06666666666667,42,43,-1,-3,2
21701045,202329,POR,DET,Al-Farouq Aminu,136,30.45,31,-0.549999999999997,71,55,16,17,-1
21701045,202334,POR,DET,Ed Davis,92,20.2166666666667,20,0.216666666666665,36,37,-1,-3,2
21701045,203081,POR,DET,Damian Lillard,167,37.2,37,0.200000000000003,83,61,22,23,-1
21701045,203086,POR,DET,Meyers Leonard,16,4.75,5,-0.25,13,7,6,6,0
21701045,203090,POR,DET,Maurice Harkless,118,26.3833333333333,27,-0.616666666666667,58,44,14,16,-2
21701045,203468,POR,DET,CJ McCollum,158,35.9166666666667,37,-1.08333333333333,66,65,1,0,1
21701045,203894,POR,DET,Shabazz Napier,47,10.4833333333333,11,-0.516666666666666,17,26,-9,-10,1
21701045,203994,POR,DET,Jusuf Nurkic,106,22.7166666666667,23,-0.283333333333331,51,43,8,10,-2
21701045,1626192,POR,DET,Pat Connaughton,57,12.1333333333333,12,0.133333333333333,34,22,12,13,-1
21701045,1628380,POR,DET,Zach Collins,78,17.2333333333333,17,0.233333333333334,29,32,-3,-4,1
21701045,201229,DET,POR,Anthony Tolliver,106,22.8833333333333,22,0.883333333333333,41,44,-3,-2,-1
21701045,201933,DET,POR,Blake Griffin,159,35.95,36,-0.0499999999999972,66,72,-6,-9,3
21701045,202397,DET,POR,Ish Smith,122,27.7,28,-0.300000000000001,53,57,-4,-6,2
21701045,202779,DET,POR,Dwight Buycks,92,19.9833333333333,20,-0.0166666666666657,34,43,-9,-7,-2
21701045,203083,DET,POR,Andre Drummond,163,36.5333333333333,37,-0.466666666666669,67,84,-17,-15,-2
21701045,203493,DET,POR,Reggie Bullock,137,30.8,31,-0.199999999999999,53,68,-15,-16,1
21701045,203516,DET,POR,James Ennis III,79,18.55,19,-0.449999999999999,36,42,-6,-8,2
21701045,1626169,DET,POR,Stanley Johnson,80,17.0833333333333,17,0.0833333333333322,28,37,-9,-9,0
21701045,1628379,DET,POR,Luke Kennard,132,28.9333333333333,29,-0.06666666666667,57,53,4,7,-3
21701046,2546,OKC,TOR,Carmelo Anthony,180,34.4333333333333,34,0.433333333333337,102,87,15,21,-6
21701046,101109,OKC,TOR,Raymond Felton,63,13.2166666666667,13,0.216666666666665,23,41,-18,-18,0
21701046,201147,OKC,TOR,Corey Brewer,163,30.7833333333333,31,-0.216666666666669,86,79,7,13,-6
21701046,201566,OKC,TOR,Russell Westbrook,190,37.1833333333333,37,0.183333333333337,108,93,15,17,-2
21701046,202331,OKC,TOR,Paul George,191,36.75,37,-0.25,109,93,16,21,-5
21701046,202335,OKC,TOR,Patrick Patterson,59,13.4333333333333,14,-0.566666666666666,28,38,-10,-14,4
21701046,203500,OKC,TOR,Steven Adams,172,33.1833333333333,33,0.18333333333333,101,82,19,20,-1
21701046,203518,OKC,TOR,Alex Abrines,24,6.66666666666667,7,-0.333333333333334,19,16,3,0,3
21701046,203924,OKC,TOR,Jerami Grant,67,14.6833333333333,15,-0.316666666666666,29,43,-14,-13,-1
21701046,203962,OKC,TOR,Josh Huestis,32,6.36666666666667,6,0.366666666666667,22,18,4,4,0
21701046,1628390,OKC,TOR,Terrance Ferguson,54,12.6333333333333,13,-0.366666666666667,23,35,-12,-16,4
21701046,101139,TOR,OKC,CJ Miles,132,26.2833333333333,26,0.283333333333331,75,64,11,9,2
21701046,200768,TOR,OKC,Kyle Lowry,126,26.9833333333333,27,-0.0166666666666657,72,75,-3,-5,2
21701046,201586,TOR,OKC,Serge Ibaka,151,29.3666666666667,29,0.366666666666667,71,92,-21,-23,2
21701046,201942,TOR,OKC,DeMar DeRozan,170,33.35,33,0.350000000000001,84,101,-17,-22,5
21701046,202685,TOR,OKC,Jonas Valanciunas,110,21.6333333333333,22,-0.366666666666667,54,66,-12,-12,0
21701046,203512,TOR,OKC,Lucas Nogueira,32,6.23333333333333,6,0.233333333333333,20,5,15,15,0
21701046,1626153,TOR,OKC,Delon Wright,157,30.9333333333333,31,-0.06666666666667,81,84,-3,0,-3
21701046,1626181,TOR,OKC,Norman Powell,71,13.1166666666667,13,0.116666666666667,30,34,-4,-3,-1
21701046,1627751,TOR,OKC,Jakob Poeltl,68,15.0666666666667,15,0.0666666666666664,41,45,-4,-4,0
21701046,1627783,TOR,OKC,Pascal Siakam,114,22.95,23,-0.0500000000000007,62,50,12,10,2
21701046,1628384,TOR,OKC,OG Anunoby,64,13.4166666666667,13,0.416666666666666,35,34,1,0,1
21701047,201143,BOS,NOP,Al Horford,134,28.0666666666667,28,0.0666666666666664,55,63,-8,-7,-1
21701047,202328,BOS,NOP,Greg Monroe,121,25.65,26,-0.350000000000001,46,70,-24,-24,0
21701047,202694,BOS,NOP,Marcus Morris,140,29.75,30,-0.25,59,78,-19,-19,0
21701047,203382,BOS,NOP,Aron Baynes,62,14.1666666666667,14,0.166666666666668,28,29,-1,-2,1
21701047,203499,BOS,NOP,Shane Larkin,124,27.8166666666667,28,-0.183333333333334,47,65,-18,-19,1
21701047,1626179,BOS,NOP,Terry Rozier,147,31.3833333333333,31,0.383333333333333,63,79,-16,-14,-2
21701047,1627824,BOS,NOP,Guerschon Yabusele,16,3.75,4,-0.25,7,7,0,0,0
21701047,1627846,BOS,NOP,Abdel Nader,97,21.2,22,-0.799999999999997,40,44,-4,-3,-1
21701047,1628369,BOS,NOP,Jayson Tatum,118,27.25,27,0.25,50,58,-8,-10,2
21701047,1628400,BOS,NOP,Semi Ojeleye,97,22.5333333333333,23,-0.466666666666669,42,42,0,-1,1
21701047,1628443,BOS,NOP,Kadeem Allen,13,3.1,4,-0.9,4,3,1,2,-1
21701047,1628444,BOS,NOP,Jabari Bird,11,2.91666666666667,3,-0.0833333333333335,4,2,2,2,0
21701047,2731,NOP,BOS,Emeka Okafor,74,16.9833333333333,17,-0.0166666666666657,34,33,1,1,0
21701047,200765,NOP,BOS,Rajon Rondo,151,32.5333333333333,32,0.533333333333331,78,57,21,18,3
21701047,201950,NOP,BOS,Jrue Holiday,123,28.1666666666667,28,0.166666666666664,67,56,11,14,-3
21701047,202703,NOP,BOS,Nikola Mirotic,104,22.6,23,-0.399999999999999,52,44,8,8,0
21701047,202732,NOP,BOS,DeAndre Liggins,11,2.91666666666667,3,-0.0833333333333335,2,4,-2,-2,0
21701047,202734,NOP,BOS,E'Twaun Moore,130,28.2833333333333,29,-0.716666666666669,72,55,17,17,0
21701047,203076,NOP,BOS,Anthony Davis,151,32.25,33,-0.75,81,66,15,15,0
21701047,203121,NOP,BOS,Darius Miller,38,8.6,9,-0.4,19,15,4,3,1
21701047,203524,NOP,BOS,Solomon Hill,42,8.33333333333333,8,0.333333333333332,18,19,-1,0,-1
21701047,203546,NOP,BOS,Ian Clark,120,25.55,26,-0.449999999999999,62,49,13,13,0
21701047,203580,NOP,BOS,Larry Drew II,22,5.25,6,-0.75,4,8,-4,-4,0
21701047,1627767,NOP,BOS,Cheick Diallo,103,23.2,24,-0.800000000000001,49,35,14,14,0
21701047,1628429,NOP,BOS,Charles Cooke,11,2.91666666666667,3,-0.0833333333333335,2,4,-2,-2,0
21701048,2772,HOU,MIN,Trevor Ariza,150,33.2,33,0.200000000000003,79,83,-4,-4,0
21701048,101108,HOU,MIN,Chris Paul,159,34.4,35,-0.600000000000001,94,89,5,3,2
21701048,101123,HOU,MIN,Gerald Green,72,14.7333333333333,15,-0.266666666666666,50,36,14,13,1
21701048,200782,HOU,MIN,PJ Tucker,111,23.6666666666667,24,-0.333333333333332,61,61,0,-2,2
21701048,201569,HOU,MIN,Eric Gordon,140,30.0833333333333,30,0.0833333333333357,79,74,5,8,-3
21701048,201583,HOU,MIN,Ryan Anderson,78,16.3666666666667,17,-0.633333333333333,53,42,11,12,-1
21701048,201601,HOU,MIN,Luc Mbah a Moute,88,18.9333333333333,19,-0.0666666666666664,57,48,9,8,1
21701048,201935,HOU,MIN,James Harden,168,36.7166666666667,37,-0.283333333333331,96,85,11,10,1
21701048,203991,HOU,MIN,Clint Capela,144,31.5666666666667,31,0.566666666666663,76,77,-1,-3,2
21701048,2037,MIN,HOU,Jamal Crawford,131,28.0333333333333,28,0.0333333333333314,71,75,-4,-5,1
21701048,201565,MIN,HOU,Derrick Rose,87,19.15,19,0.149999999999999,48,47,1,-1,2
21701048,201952,MIN,HOU,Jeff Teague,172,36.95,37,-0.0499999999999972,93,90,3,3,0
21701048,201959,MIN,HOU,Taj Gibson,120,25.5833333333333,26,-0.416666666666664,67,70,-3,-2,-1
21701048,202357,MIN,HOU,Nemanja Bjelica,158,34.9333333333333,35,-0.06666666666667,82,90,-8,-4,-4
21701048,203476,MIN,HOU,Gorgui Dieng,55,12.4,13,-0.600000000000001,24,35,-11,-11,0
21701048,203952,MIN,HOU,Andrew Wiggins,170,36.1,36,0.0999999999999943,89,105,-16,-15,-1
21701048,1626145,MIN,HOU,Tyus Jones,50,10.9833333333333,11,-0.0166666666666657,26,39,-13,-12,-1
21701048,1626157,MIN,HOU,Karl-Anthony Towns,167,35.5333333333333,35,0.533333333333331,95,94,1,2,-1
21701049,101150,LAC,POR,Lou Williams,155,31.05,31,0.0500000000000007,85,91,-6,-8,2
21701049,201599,LAC,POR,DeAndre Jordan,130,28.4666666666667,29,-0.533333333333335,57,74,-17,-24,7
21701049,202325,LAC,POR,Wesley Johnson,37,8.73333333333333,9,-0.266666666666668,22,15,7,11,-4
21701049,202699,LAC,POR,Tobias Harris,165,35.5333333333333,36,-0.466666666666669,72,101,-29,-28,-1
21701049,203085,LAC,POR,Austin Rivers,176,36.9833333333333,37,-0.0166666666666657,77,101,-24,-26,2
21701049,203930,LAC,POR,Sean Kilpatrick,11,3,3,0,5,2,3,5,-2
21701049,1626149,LAC,POR,Montrezl Harrell,105,20.0166666666667,20,0.0166666666666657,57,55,2,2,0
21701049,1626155,LAC,POR,Sam Dekker,8,2.23333333333333,2,0.233333333333333,5,0,5,5,0
21701049,1626246,LAC,POR,Boban Marjanovic,56,11.7166666666667,12,-0.283333333333335,36,23,13,15,-2
21701049,1628393,LAC,POR,Jawun Evans,47,9.48333333333333,10,-0.516666666666666,28,17,11,11,0
21701049,1628414,LAC,POR,Sindarius Thornwell,144,29.3333333333333,29,0.333333333333332,61,64,-3,-4,1
21701049,1628462,LAC,POR,Milos Teodosic,106,22.95,23,-0.0500000000000007,40,67,-27,-24,-3
21701049,202323,POR,LAC,Evan Turner,93,17.2166666666667,18,-0.783333333333335,44,52,-8,-10,2
21701049,202329,POR,LAC,Al-Farouq Aminu,152,32.95,33,-0.0499999999999972,92,66,26,25,1
21701049,202334,POR,LAC,Ed Davis,63,11.05,11,0.0500000000000007,27,28,-1,-2,1
21701049,203081,POR,LAC,Damian Lillard,154,31.3166666666667,31,0.316666666666666,83,62,21,23,-2
21701049,203086,POR,LAC,Meyers Leonard,20,4.4,4,0.4,11,15,-4,-6,2
21701049,203090,POR,LAC,Maurice Harkless,127,28.45,28,0.449999999999999,78,52,26,28,-2
21701049,203468,POR,LAC,CJ McCollum,151,32.35,32,0.350000000000001,83,68,15,13,2
21701049,203894,POR,LAC,Shabazz Napier,100,22.1166666666667,22,0.116666666666667,58,60,-2,-2,0
21701049,203994,POR,LAC,Jusuf Nurkic,135,30.1333333333333,30,0.133333333333333,84,61,23,26,-3
21701049,1626192,POR,LAC,Pat Connaughton,55,10.1833333333333,10,0.183333333333334,20,28,-8,-8,0
21701049,1627774,POR,LAC,Jake Layman,8,2.23333333333333,2,0.233333333333333,0,5,-5,-5,0
21701049,1628380,POR,LAC,Zach Collins,74,14.8666666666667,15,-0.133333333333333,30,43,-13,-12,-1
21701049,1628403,POR,LAC,Caleb Swanigan,8,2.23333333333333,2,0.233333333333333,0,5,-5,-5,0
21701050,2544,CLE,MIL,LeBron James,192,40.1333333333333,40,0.133333333333333,101,97,4,4,0
21701050,2594,CLE,MIL,Kyle Korver,128,28,28,0,70,70,0,8,-8
21701050,2747,CLE,MIL,JR Smith,115,22.1666666666667,23,-0.833333333333336,62,54,8,2,6
21701050,101181,CLE,MIL,Jose Calderon,93,18.2166666666667,18,0.216666666666669,48,43,5,4,1
21701050,201145,CLE,MIL,Jeff Green,193,40.4833333333333,41,-0.516666666666666,106,102,4,4,0
21701050,201567,CLE,MIL,Kevin Love,113,24.8166666666667,25,-0.183333333333334,58,60,-2,0,-2
21701050,201588,CLE,MIL,George Hill,92,20.5,21,-0.5,51,46,5,2,3
21701050,203903,CLE,MIL,Jordan Clarkson,149,28.0666666666667,28,0.0666666666666664,77,73,4,4,0
21701050,1627790,CLE,MIL,Ante Zizic,90,17.2,17,0.199999999999999,47,40,7,7,0
21701050,1891,MIL,CLE,Jason Terry,48,10.2833333333333,10,0.283333333333333,27,32,-5,-5,0
21701050,201943,MIL,CLE,Brandon Jennings,72,13.75,14,-0.25,30,38,-8,-6,-2
21701050,202339,MIL,CLE,Eric Bledsoe,161,34.1666666666667,35,-0.833333333333336,87,86,1,-1,2
21701050,203089,MIL,CLE,John Henson,84,19.9333333333333,20,-0.06666666666667,38,51,-13,-13,0
21701050,203114,MIL,CLE,Khris Middleton,185,37.6333333333333,38,-0.366666666666667,90,92,-2,-2,0
21701050,203503,MIL,CLE,Tony Snell,146,30.7833333333333,31,-0.216666666666665,78,76,2,0,2
21701050,203507,MIL,CLE,Giannis Antetokounmpo,187,38.7166666666667,39,-0.283333333333331,99,102,-3,-1,-2
21701050,203953,MIL,CLE,Jabari Parker,126,25.3333333333333,25,0.333333333333336,58,70,-12,-14,2
21701050,1627748,MIL,CLE,Thon Maker,126,23.2,23,0.200000000000003,67,60,7,9,-2
21701050,1628425,MIL,CLE,Sterling Brown,30,5.78333333333333,6,-0.216666666666667,11,13,-2,-2,0
21701051,201572,LAL,IND,Brook Lopez,160,36.7,37,-0.299999999999997,79,85,-6,-8,2
21701051,202738,LAL,IND,Isaiah Thomas,118,25.9666666666667,25,0.966666666666669,51,61,-10,-8,-2
21701051,203484,LAL,IND,Kentavious Caldwell-Pope,177,39.0666666666667,39,0.0666666666666629,86,85,1,-1,2
21701051,203898,LAL,IND,Tyler Ennis,45,8.83333333333333,9,-0.166666666666668,15,17,-2,-4,2
21701051,203944,LAL,IND,Julius Randle,147,33.9333333333333,34,-0.0666666666666629,70,84,-14,-12,-2
21701051,204037,LAL,IND,Travis Wear,64,13.2166666666667,13,0.216666666666667,28,29,-1,-1,0
21701051,1627826,LAL,IND,Ivica Zubac,38,7.38333333333333,7,0.383333333333333,12,15,-3,-7,4
21701051,1628366,LAL,IND,Lonzo Ball,162,37.2,37,0.200000000000003,81,88,-7,-3,-4
21701051,1628398,LAL,IND,Kyle Kuzma,164,36.5333333333333,37,-0.466666666666669,78,86,-8,-6,-2
21701051,2744,IND,LAL,Al Jefferson,37,7.2,7,0.199999999999999,14,23,-9,-9,0
21701051,201152,IND,LAL,Thaddeus Young,156,36.0333333333333,36,0.0333333333333314,85,74,11,13,-2
21701051,201954,IND,LAL,Darren Collison,147,32.7,33,-0.299999999999997,77,70,7,10,-3
21701051,202344,IND,LAL,Trevor Booker,82,17.3,17,0.299999999999997,38,36,2,0,2
21701051,202362,IND,LAL,Lance Stephenson,136,30.0166666666667,30,0.0166666666666657,68,54,14,13,1
21701051,202709,IND,LAL,Cory Joseph,136,29.25,29,0.25,60,53,7,5,2
21701051,202711,IND,LAL,Bojan Bogdanovic,113,24.5166666666667,25,-0.483333333333334,59,60,-1,-1,0
21701051,203506,IND,LAL,Victor Oladipo,137,31.9833333333333,32,-0.0166666666666657,77,74,3,3,0
21701051,1626167,IND,LAL,Myles Turner,131,29.8333333333333,30,-0.166666666666668,72,56,16,16,0
21701052,101141,PHI,CHA,Ersan Ilyasova,100,20.85,21,-0.149999999999999,36,49,-13,-19,6
21701052,101161,PHI,CHA,Amir Johnson,76,15.65,16,-0.350000000000001,45,24,21,23,-2
21701052,200755,PHI,CHA,JJ Redick,113,24.2833333333333,24,0.283333333333331,43,57,-14,-13,-1
21701052,201158,PHI,CHA,Marco Belinelli,110,23.7,24,-0.299999999999997,65,37,28,27,1
21701052,203496,PHI,CHA,Robert Covington,137,28.9833333333333,29,-0.0166666666666657,74,44,30,28,2
21701052,203954,PHI,CHA,Joel Embiid,141,31.1,31,0.0999999999999979,61,68,-7,-9,2
21701052,203967,PHI,CHA,Dario Saric,123,27.1333333333333,27,0.133333333333333,72,45,27,33,-6
21701052,204456,PHI,CHA,T.J. McConnell,67,14.9166666666667,15,-0.0833333333333339,21,35,-14,-16,2
21701052,1626147,PHI,CHA,Justin Anderson,92,20.2333333333333,20,0.233333333333334,36,52,-16,-14,-2
21701052,1627732,PHI,CHA,Ben Simmons,156,33.0666666666667,33,0.0666666666666629,87,59,28,30,-2
21701052,2730,CHA,PHI,Dwight Howard,127,27.85,28,-0.149999999999999,43,62,-19,-18,-1
21701052,101107,CHA,PHI,Marvin Williams,122,26.8166666666667,26,0.816666666666666,44,62,-18,-18,0
21701052,202689,CHA,PHI,Kemba Walker,186,39.9333333333333,40,-0.06666666666667,79,90,-11,-11,0
21701052,203077,CHA,PHI,Michael Kidd-Gilchrist,134,28.9666666666667,29,-0.0333333333333314,42,80,-38,-40,2
21701052,203087,CHA,PHI,Jeremy Lamb,141,30.4,30,0.399999999999999,57,67,-10,-8,-2
21701052,1626163,CHA,PHI,Frank Kaminsky,101,21.1666666666667,22,-0.833333333333336,50,46,4,4,0
21701052,1626195,CHA,PHI,Willy Hernangomez,96,20.1333333333333,20,0.133333333333333,51,46,5,4,1
21701052,1626203,CHA,PHI,Treveon Graham,28,6.18333333333333,6,0.183333333333334,13,8,5,5,0
21701052,1628370,CHA,PHI,Malik Monk,75,16.2166666666667,16,0.216666666666669,33,36,-3,-5,2
21701052,1628407,CHA,PHI,Dwayne Bacon,105,22.25,23,-0.75,58,43,15,17,-2
21701053,201960,BKN,MEM,DeMarre Carroll,157,31.4,32,-0.600000000000001,77,82,-5,-2,-3
21701053,203112,BKN,MEM,Quincy Acy,101,22.8,23,-0.200000000000003,58,53,5,3,2
21701053,203459,BKN,MEM,Allen Crabbe,141,27.1833333333333,27,0.183333333333334,74,65,9,9,0
21701053,203915,BKN,MEM,Spencer Dinwiddie,125,26.85,26,0.850000000000001,65,68,-3,-5,2
21701053,203925,BKN,MEM,Joe Harris,79,17.8,18,-0.199999999999999,37,43,-6,-6,0
21701053,1626156,BKN,MEM,D'Angelo Russell,147,29.35,29,0.349999999999998,79,67,12,12,0
21701053,1626178,BKN,MEM,Rondae Hollis-Jefferson,188,37.5333333333333,37,0.533333333333331,92,83,9,8,1
21701053,1627747,BKN,MEM,Caris LeVert,120,24.25,24,0.25,54,60,-6,-6,0
21701053,1628386,BKN,MEM,Jarrett Allen,112,22.8333333333333,23,-0.166666666666664,54,54,0,2,-2
21701053,202718,MEM,BKN,Chandler Parsons,74,15.8166666666667,16,-0.183333333333334,37,49,-12,-12,0
21701053,203210,MEM,BKN,JaMychal Green,146,29.35,29,0.350000000000001,69,75,-6,-3,-3
21701053,203463,MEM,BKN,Ben McLemore,92,20.5,20,0.5,51,42,9,8,1
21701053,1626150,MEM,BKN,Andrew Harrison,153,30.9,31,-0.100000000000001,81,62,19,21,-2
21701053,1626185,MEM,BKN,Jarell Martin,51,11.75,12,-0.25,28,31,-3,-7,4
21701053,1627362,MEM,BKN,Briante Weber,171,34.75,34,0.75,80,94,-14,-11,-3
21701053,1627738,MEM,BKN,Deyonta Davis,106,21.95,22,-0.0500000000000007,48,60,-12,-14,2
21701053,1627782,MEM,BKN,Wayne Selden,129,24.0833333333333,24,0.0833333333333322,59,54,5,8,-3
21701053,1628397,MEM,BKN,Ivan Rabb,100,21.6666666666667,22,-0.333333333333332,53,48,5,5,0
21701053,1628415,MEM,BKN,Dillon Brooks,148,29.2333333333333,30,-0.766666666666666,69,75,-6,-10,4
21701055,203200,CHI,NYK,Justin Holiday,90,17.7333333333333,18,-0.266666666666666,31,38,-7,-6,-1
21701055,203943,CHI,NYK,Noah Vonleh,140,26.2833333333333,26,0.283333333333331,61,63,-2,-3,1
21701055,1626166,CHI,NYK,Cameron Payne,141,28.7166666666667,29,-0.283333333333331,44,67,-23,-24,1
21701055,1626170,CHI,NYK,Jerian Grant,104,19.2833333333333,19,0.283333333333331,48,43,5,6,-1
21701055,1626171,CHI,NYK,Bobby Portis,133,25.0666666666667,25,0.0666666666666664,58,55,3,3,0
21701055,1626245,CHI,NYK,Cristiano Felicio,145,29.3833333333333,30,-0.616666666666667,40,64,-24,-23,-1
21701055,1627756,CHI,NYK,Denzel Valentine,106,21.4166666666667,22,-0.583333333333336,37,46,-9,-11,2
21701055,1627835,CHI,NYK,Paul Zipser,123,25.25,25,0.25,40,62,-22,-23,1
21701055,1628021,CHI,NYK,David Nwaba,105,20.8166666666667,21,-0.183333333333334,40,49,-9,-6,-3
21701055,1628469,CHI,NYK,Antonio Blakeney,138,26.05,26,0.0500000000000007,61,63,-2,-3,1
21701055,201563,NYK,CHI,Michael Beasley,111,23.1666666666667,23,0.166666666666664,54,37,17,19,-2
21701055,201584,NYK,CHI,Courtney Lee,100,20.6333333333333,21,-0.366666666666667,48,30,18,18,0
21701055,202683,NYK,CHI,Enes Kanter,85,17.75,18,-0.25,37,27,10,10,0
21701055,203124,NYK,CHI,Kyle O'Quinn,116,22.2,22,0.200000000000003,54,48,6,5,1
21701055,203501,NYK,CHI,Tim Hardaway Jr.,154,31.05,31,0.0499999999999972,72,54,18,18,0
21701055,203504,NYK,CHI,Trey Burke,112,21.35,21,0.350000000000001,51,48,3,3,0
21701055,1626144,NYK,CHI,Emmanuel Mudiay,103,21.1166666666667,21,0.116666666666667,45,31,14,14,0
21701055,1627786,NYK,CHI,Troy Williams,112,20.5166666666667,20,0.516666666666666,48,51,-3,-1,-2
21701055,1628373,NYK,CHI,Frank Ntilikina,130,24.1833333333333,24,0.183333333333334,54,53,1,1,0
21701055,1628422,NYK,CHI,Damyean Dotson,43,8.11666666666667,8,0.116666666666667,18,16,2,1,1
21701055,1628436,NYK,CHI,Luke Kornet,50,9.2,9,0.199999999999999,23,17,6,6,0
21701055,1628439,NYK,CHI,Isaiah Hicks,109,20.7166666666667,21,-0.283333333333331,46,48,-2,-4,2
21701056,2561,GSW,SAS,David West,61,13.3666666666667,13,0.366666666666667,12,25,-13,-13,0
21701056,2585,GSW,SAS,Zaza Pachulia,53,14.2166666666667,14,0.216666666666667,17,29,-12,-12,0
21701056,2733,GSW,SAS,Shaun Livingston,81,16.7166666666667,17,-0.283333333333331,27,27,0,-2,2
21701056,2738,GSW,SAS,Andre Iguodala,99,24.8166666666667,25,-0.183333333333334,42,45,-3,-3,0
21701056,201156,GSW,SAS,Nick Young,168,39.8,40,-0.200000000000003,54,76,-22,-21,-1
21701056,201580,GSW,SAS,JaVale McGee,53,11.6,12,-0.4,27,16,11,9,2
21701056,203110,GSW,SAS,Draymond Green,52,11.7166666666667,12,-0.283333333333333,14,28,-14,-16,2
21701056,1626172,GSW,SAS,Kevon Looney,103,21.7333333333333,22,-0.266666666666666,46,39,7,9,-2
21701056,1626188,GSW,SAS,Quinn Cook,158,37.5166666666667,38,-0.483333333333334,64,72,-8,-6,-2
21701056,1627775,GSW,SAS,Patrick McCaw,112,23.95,24,-0.0499999999999972,38,47,-9,-10,1
21701056,1628395,GSW,SAS,Jordan Bell,90,22.5666666666667,23,-0.433333333333334,34,41,-7,-5,-2
21701056,1938,SAS,GSW,Manu Ginobili,92,20.6666666666667,20,0.666666666666668,37,40,-3,-7,4
21701056,2200,SAS,GSW,Pau Gasol,75,16.45,16,0.449999999999999,24,42,-18,-19,1
21701056,2225,SAS,GSW,Tony Parker,59,13.2,13,0.199999999999999,22,30,-8,-8,0
21701056,200746,SAS,GSW,LaMarcus Aldridge,144,34.6,35,-0.399999999999999,68,35,33,32,1
21701056,200752,SAS,GSW,Rudy Gay,60,12.7333333333333,13,-0.266666666666666,17,26,-9,-9,0
21701056,201980,SAS,GSW,Danny Green,124,29.8666666666667,30,-0.133333333333333,60,33,27,27,0
21701056,201988,SAS,GSW,Patty Mills,142,34,34,0,66,37,29,27,2
21701056,202722,SAS,GSW,Davis Bertans,45,10.5166666666667,11,-0.483333333333334,18,23,-5,-5,0
21701056,203464,SAS,GSW,Brandon Paul,16,2.9,3,-0.1,10,5,5,5,0
21701056,203530,SAS,GSW,Joffrey Lauvergne,4,0.683333333333333,1,-0.316666666666667,3,4,-1,1,-2
21701056,203937,SAS,GSW,Kyle Anderson,92,22.1666666666667,23,-0.833333333333336,52,22,30,30,0
21701056,1627749,SAS,GSW,Dejounte Murray,125,28.8333333333333,29,-0.166666666666668,52,41,11,13,-2
21701056,1627854,SAS,GSW,Bryn Forbes,52,11.3833333333333,12,-0.616666666666667,16,37,-21,-17,-4
21701057,1713,SAC,DET,Vince Carter,76,17.8833333333333,17,0.883333333333333,29,34,-5,-3,-2
21701057,2216,SAC,DET,Zach Randolph,63,14.9,15,-0.0999999999999996,29,37,-8,-10,2
21701057,201585,SAC,DET,Kosta Koufos,78,17.8166666666667,17,0.816666666666666,25,30,-5,-5,0
21701057,202066,SAC,DET,Garrett Temple,98,23.05,23,0.0499999999999972,37,39,-2,-4,2
21701057,203998,SAC,DET,Bruno Caboclo,2,0.7,1,-0.3,0,1,-1,-1,0
21701057,1626161,SAC,DET,Willie Cauley-Stein,127,29.95,31,-1.05,65,76,-11,-11,0
21701057,1627741,SAC,DET,Buddy Hield,139,32.3833333333333,33,-0.616666666666667,67,83,-16,-16,0
21701057,1627746,SAC,DET,Skal Labissiere,110,25.2,25,0.199999999999999,47,53,-6,-2,-4
21701057,1628368,SAC,DET,De'Aaron Fox,134,31.1166666666667,31,0.116666666666667,65,79,-14,-14,0
21701057,1628382,SAC,DET,Justin Jackson,129,29.8833333333333,31,-1.11666666666667,61,72,-11,-13,2
21701057,1628412,SAC,DET,Frank Mason,69,15.95,16,-0.0499999999999989,25,26,-1,-1,0
21701057,201229,DET,SAC,Anthony Tolliver,125,28.45,29,-0.550000000000001,58,50,8,6,2
21701057,201933,DET,SAC,Blake Griffin,153,36.1833333333333,36,0.183333333333337,88,76,12,14,-2
21701057,202397,DET,SAC,Ish Smith,144,33.9333333333333,34,-0.0666666666666629,82,71,11,13,-2
21701057,202779,DET,SAC,Dwight Buycks,61,13.8333333333333,14,-0.166666666666668,24,19,5,3,2
21701057,203083,DET,SAC,Andre Drummond,131,30.5333333333333,31,-0.466666666666669,66,54,12,12,0
21701057,203493,DET,SAC,Reggie Bullock,131,30.8833333333333,31,-0.116666666666667,75,62,13,15,-2
21701057,203516,DET,SAC,James Ennis III,58,13.3,13,0.300000000000001,23,19,4,0,4
21701057,1626169,DET,SAC,Stanley Johnson,104,24.5166666666667,25,-0.483333333333334,57,47,10,12,-2
21701057,1628379,DET,SAC,Luke Kennard,118,27.2,27,0.199999999999999,57,52,5,5,0
21701058,201167,ORL,TOR,Arron Afflalo,101,23.8166666666667,23,0.816666666666666,36,40,-4,-4,0
21701058,201571,ORL,TOR,D.J. Augustin,152,35.0666666666667,35,0.0666666666666629,65,75,-10,-10,0
21701058,202687,ORL,TOR,Bismack Biyombo,71,16.3333333333333,16,0.333333333333332,31,32,-1,-1,0
21701058,202696,ORL,TOR,Nikola Vucevic,137,31.3333333333333,32,-0.666666666666668,55,61,-6,-6,0
21701058,202714,ORL,TOR,Shelvin Mack,104,23.4666666666667,24,-0.533333333333331,39,44,-5,-6,1
21701058,203920,ORL,TOR,Khem Birch,41,8.6,9,-0.4,21,16,5,6,-1
21701058,203932,ORL,TOR,Aaron Gordon,143,33.4833333333333,34,-0.516666666666666,65,70,-5,-4,-1
21701058,1626209,ORL,TOR,Mario Hezonja,80,18.6166666666667,18,0.616666666666667,32,30,2,1,1
21701058,1628371,ORL,TOR,Jonathan Isaac,123,27.3166666666667,28,-0.683333333333334,52,61,-9,-8,-1
21701058,1628411,ORL,TOR,Wes Iwundu,88,20.3,20,0.299999999999997,34,36,-2,-3,1
21701058,101139,TOR,ORL,CJ Miles,88,20.6666666666667,21,-0.333333333333332,36,30,6,6,0
21701058,200768,TOR,ORL,Kyle Lowry,158,36.3666666666667,37,-0.63333333333334,77,67,10,11,-1
21701058,201586,TOR,ORL,Serge Ibaka,123,27.75,28,-0.25,49,56,-7,-7,0
21701058,202685,TOR,ORL,Jonas Valanciunas,86,19.1333333333333,19,0.133333333333333,34,40,-6,-6,0
21701058,203485,TOR,ORL,Lorenzo Brown,81,18.7333333333333,19,-0.266666666666666,44,20,24,23,1
21701058,203512,TOR,ORL,Lucas Nogueira,70,17.3833333333333,17,0.383333333333333,35,19,16,16,0
21701058,1626153,TOR,ORL,Delon Wright,118,27.7333333333333,28,-0.266666666666666,53,42,11,12,-1
21701058,1626181,TOR,ORL,Norman Powell,81,17.5333333333333,18,-0.466666666666669,29,47,-18,-19,1
21701058,1626259,TOR,ORL,Malcolm Miller,37,8.03333333333333,8,0.0333333333333332,17,18,-1,-1,0
21701058,1627751,TOR,ORL,Jakob Poeltl,51,11.15,11,0.149999999999999,24,27,-3,-3,0
21701058,1627783,TOR,ORL,Pascal Siakam,85,19.9166666666667,20,-0.0833333333333357,44,30,14,14,0
21701058,1628384,TOR,ORL,OG Anunoby,62,13.9333333333333,14,-0.0666666666666664,23,34,-11,-11,0
21701059,201143,BOS,OKC,Al Horford,155,33.35,33,0.350000000000001,74,70,4,2,2
21701059,202328,BOS,OKC,Greg Monroe,111,21.9,22,-0.100000000000001,48,53,-5,-4,-1
21701059,202694,BOS,OKC,Marcus Morris,147,30.4166666666667,30,0.416666666666664,63,77,-14,-15,1
21701059,203382,BOS,OKC,Aron Baynes,66,14.35,15,-0.65,25,24,1,0,1
21701059,203499,BOS,OKC,Shane Larkin,118,25.0333333333333,25,0.0333333333333314,56,42,14,17,-3
21701059,1626179,BOS,OKC,Terry Rozier,163,34.35,34,0.350000000000001,68,83,-15,-16,1
21701059,1627846,BOS,OKC,Abdel Nader,90,18.15,18,0.149999999999999,36,29,7,7,0
21701059,1628369,BOS,OKC,Jayson Tatum,166,34.95,35,-0.0499999999999972,80,58,22,23,-1
21701059,1628400,BOS,OKC,Semi Ojeleye,129,27.5,27,0.5,50,59,-9,-9,0
21701059,2546,OKC,BOS,Carmelo Anthony,165,35.1166666666667,35,0.116666666666667,81,71,10,11,-1
21701059,101109,OKC,BOS,Raymond Felton,55,11.6,11,0.6,20,24,-4,-6,2
21701059,201147,OKC,BOS,Corey Brewer,168,36.3,36,0.299999999999997,77,80,-3,-3,0
21701059,201566,OKC,BOS,Russell Westbrook,174,36.4,37,-0.600000000000001,79,76,3,5,-2
21701059,202331,OKC,BOS,Paul George,190,39.3166666666667,40,-0.683333333333337,84,82,2,2,0
21701059,202335,OKC,BOS,Patrick Patterson,72,14.3666666666667,15,-0.633333333333333,24,31,-7,-7,0
21701059,203500,OKC,BOS,Steven Adams,175,37.1166666666667,37,0.11666666666666,81,76,5,7,-2
21701059,203518,OKC,BOS,Alex Abrines,18,4.05,4,0.0499999999999998,6,9,-3,-3,0
21701059,203924,OKC,BOS,Jerami Grant,46,9.4,10,-0.600000000000001,12,22,-10,-13,3
21701059,203962,OKC,BOS,Josh Huestis,21,4.28333333333333,4,0.283333333333333,6,6,0,0,0
21701059,1628390,OKC,BOS,Terrance Ferguson,61,12.05,12,0.0500000000000007,25,23,2,2,0
21701060,101150,LAC,MIN,Lou Williams,128,26.7,27,-0.300000000000001,57,73,-16,-14,-2
21701060,201599,LAC,MIN,DeAndre Jordan,155,32,32,0,68,82,-14,-16,2
21701060,202325,LAC,MIN,Wesley Johnson,35,7.96666666666667,8,-0.0333333333333332,21,17,4,4,0
21701060,202699,LAC,MIN,Tobias Harris,121,24.3166666666667,25,-0.683333333333334,49,58,-9,-6,-3
21701060,203085,LAC,MIN,Austin Rivers,167,34.2666666666667,35,-0.733333333333334,75,95,-20,-20,0
21701060,203930,LAC,MIN,Sean Kilpatrick,91,20.1333333333333,20,0.133333333333333,52,46,6,4,2
21701060,1626149,LAC,MIN,Montrezl Harrell,106,22.85,23,-0.149999999999999,57,67,-10,-13,3
21701060,1626155,LAC,MIN,Sam Dekker,33,7.5,7,0.5,18,15,3,3,0
21701060,1626246,LAC,MIN,Boban Marjanovic,43,9.23333333333333,9,0.233333333333334,26,24,2,4,-2
21701060,1628393,LAC,MIN,Jawun Evans,33,7.5,7,0.5,18,15,3,3,0
21701060,1628414,LAC,MIN,Sindarius Thornwell,126,25.6833333333333,25,0.683333333333334,56,63,-7,-5,-2
21701060,1628462,LAC,MIN,Milos Teodosic,107,21.6,22,-0.399999999999999,48,60,-12,-14,2
21701060,2037,MIN,LAC,Jamal Crawford,155,32.8833333333333,33,-0.116666666666667,84,80,4,4,0
21701060,201565,MIN,LAC,Derrick Rose,31,6.53333333333333,7,-0.466666666666667,18,12,6,6,0
21701060,201952,MIN,LAC,Jeff Teague,167,34.6333333333333,35,-0.366666666666667,91,69,22,22,0
21701060,201959,MIN,LAC,Taj Gibson,178,37.4,37,0.399999999999999,93,82,11,12,-1
21701060,202332,MIN,LAC,Cole Aldrich,8,1.58333333333333,2,-0.416666666666667,3,5,-2,0,-2
21701060,202357,MIN,LAC,Nemanja Bjelica,110,22.1666666666667,22,0.166666666666664,58,47,11,7,4
21701060,203476,MIN,LAC,Gorgui Dieng,61,12.5166666666667,13,-0.483333333333334,32,33,-1,-7,6
21701060,203952,MIN,LAC,Andrew Wiggins,178,37.8,38,-0.200000000000003,95,87,8,12,-4
21701060,1626145,MIN,LAC,Tyus Jones,62,13.3166666666667,13,0.316666666666666,32,40,-8,-8,0
21701060,1626157,MIN,LAC,Karl-Anthony Towns,195,40.9166666666667,41,-0.0833333333333286,109,90,19,22,-3
21701061,2731,NOP,DAL,Emeka Okafor,23,5.03333333333333,5,0.0333333333333332,10,11,-1,0,-1
21701061,200765,NOP,DAL,Rajon Rondo,142,30.2666666666667,30,0.266666666666666,71,61,10,8,2
21701061,202703,NOP,DAL,Nikola Mirotic,144,30.95,31,-0.0500000000000007,70,66,4,0,4
21701061,202732,NOP,DAL,DeAndre Liggins,18,4.13333333333333,4,0.133333333333333,7,11,-4,-4,0
21701061,202734,NOP,DAL,E'Twaun Moore,154,34.8833333333333,35,-0.116666666666667,98,84,14,12,2
21701061,203076,NOP,DAL,Anthony Davis,157,35,35,0,98,85,13,14,-1
21701061,203121,NOP,DAL,Darius Miller,89,18.8166666666667,19,-0.183333333333334,40,47,-7,-8,1
21701061,203524,NOP,DAL,Solomon Hill,51,11.0333333333333,11,0.0333333333333332,24,14,10,9,1
21701061,203546,NOP,DAL,Ian Clark,134,30.6666666666667,31,-0.333333333333336,68,65,3,7,-4
21701061,203580,NOP,DAL,Larry Drew II,54,13.3,13,0.300000000000001,37,33,4,6,-2
21701061,1627767,NOP,DAL,Cheick Diallo,104,24.4166666666667,24,0.416666666666664,52,48,4,6,-2
21701061,1717,DAL,NOP,Dirk Nowitzki,102,22.45,23,-0.550000000000001,61,56,5,2,3
21701061,200826,DAL,NOP,J.J. Barea,130,28.4666666666667,29,-0.533333333333331,72,75,-3,-6,3
21701061,203084,DAL,NOP,Harrison Barnes,158,34.5333333333333,34,0.533333333333331,72,83,-11,-9,-2
21701061,203457,DAL,NOP,Nerlens Noel,92,20.7,20,0.699999999999999,33,45,-12,-9,-3
21701061,203926,DAL,NOP,Doug McDermott,140,30.6833333333333,31,-0.316666666666666,79,72,7,6,1
21701061,203939,DAL,NOP,Dwight Powell,104,24.0333333333333,25,-0.966666666666669,55,59,-4,-7,3
21701061,1627812,DAL,NOP,Yogi Ferrell,120,26.9,27,-0.100000000000001,49,65,-16,-13,-3
21701061,1627827,DAL,NOP,Dorian Finney-Smith,115,25.5166666666667,26,-0.483333333333334,55,55,0,2,-2
21701061,1627858,DAL,NOP,Kyle Collinsworth,81,19.2166666666667,20,-0.783333333333331,46,51,-5,-7,2
21701061,1628467,DAL,NOP,Maxi Kleber,28,6,6,0,3,14,-11,-9,-2
21701062,203101,ATL,UTA,Miles Plumlee,53,11.45,11,0.449999999999999,17,22,-5,-5,0
21701062,203471,ATL,UTA,Dennis Schroder,170,34.3833333333333,35,-0.616666666666667,80,68,12,10,2
21701062,203473,ATL,UTA,Dewayne Dedmon,146,29.2,29,0.199999999999999,66,60,6,4,2
21701062,203488,ATL,UTA,Mike Muscala,146,29.9,30,-0.100000000000001,64,60,4,7,-3
21701062,1627752,ATL,UTA,Taurean Prince,184,36.8333333333333,37,-0.166666666666671,84,75,9,9,0
21701062,1627814,ATL,UTA,Damion Lee,163,31.7333333333333,32,-0.266666666666666,71,67,4,6,-2
21701062,1627819,ATL,UTA,Isaiah Taylor,100,19.75,20,-0.25,38,36,2,3,-1
21701062,1628416,ATL,UTA,Tyler Dorsey,94,19.5166666666667,20,-0.483333333333334,32,34,-2,-4,2
21701062,1628463,ATL,UTA,Tyler Cavanaugh,53,10.5666666666667,11,-0.433333333333334,14,21,-7,-7,0
21701062,1628510,ATL,UTA,Andrew White III,81,16.5833333333333,16,0.583333333333336,29,27,2,2,0
21701062,201937,UTA,ATL,Ricky Rubio,174,34.3,34,0.299999999999997,66,76,-10,-11,1
21701062,201973,UTA,ATL,Jonas Jerebko,65,13.3166666666667,13,0.316666666666666,31,24,7,7,0
21701062,202327,UTA,ATL,Ekpe Udoh,62,12.9333333333333,13,-0.0666666666666664,18,23,-5,-1,-4
21701062,203109,UTA,ATL,Jae Crowder,164,32.7166666666667,33,-0.283333333333331,57,71,-14,-13,-1
21701062,203497,UTA,ATL,Rudy Gobert,177,35.1166666666667,35,0.116666666666667,76,78,-2,-2,0
21701062,203957,UTA,ATL,Dante Exum,78,16.5,16,0.5,34,29,5,4,1
21701062,204060,UTA,ATL,Joe Ingles,173,35.3833333333333,36,-0.616666666666667,74,80,-6,-8,2
21701062,1626220,UTA,ATL,Royce O'Neale,90,18.8166666666667,19,-0.183333333333334,32,32,0,-3,3
21701062,1628378,UTA,ATL,Donovan Mitchell,207,40.8333333333333,41,-0.166666666666671,82,82,0,2,-2
21701063,201162,PHX,DET,Jared Dudley,74,15.8333333333333,16,-0.166666666666668,35,38,-3,-3,0
21701063,203458,PHX,DET,Alex Len,123,25,25,0,47,53,-6,-4,-2
21701063,203584,PHX,DET,Troy Daniels,149,31.3,31,0.299999999999997,62,78,-16,-18,2
21701063,203901,PHX,DET,Elfrid Payton,111,22.55,22,0.550000000000001,39,53,-14,-16,2
21701063,1627733,PHX,DET,Dragan Bender,150,30.5666666666667,30,0.566666666666666,46,70,-24,-24,0
21701063,1627737,PHX,DET,Marquese Chriss,88,17.5666666666667,18,-0.433333333333334,28,47,-19,-21,2
21701063,1627755,PHX,DET,Tyler Ulis,73,15.6,15,0.6,31,41,-10,-8,-2
21701063,1627885,PHX,DET,Shaquille Harrison,78,15.6166666666667,16,-0.383333333333333,33,35,-2,0,-2
21701063,1628367,PHX,DET,Josh Jackson,180,37.2,37,0.200000000000003,64,88,-24,-26,2
21701063,1628409,PHX,DET,Alec Peters,59,12,12,0,29,35,-6,-6,0
21701063,1628432,PHX,DET,Davon Reed,85,16.6833333333333,17,-0.316666666666666,26,37,-11,-9,-2
21701063,201229,DET,PHX,Anthony Tolliver,128,26.65,27,-0.350000000000001,64,46,18,16,2
21701063,201933,DET,PHX,Blake Griffin,157,32.5166666666667,32,0.516666666666666,86,60,26,26,0
21701063,202397,DET,PHX,Ish Smith,147,30.8666666666667,30,0.866666666666667,74,55,19,19,0
21701063,202704,DET,PHX,Reggie Jackson,74,14.9333333333333,15,-0.0666666666666664,33,24,9,9,0
21701063,202779,DET,PHX,Dwight Buycks,13,2.18333333333333,2,0.183333333333334,8,9,-1,-1,0
21701063,203083,DET,PHX,Andre Drummond,127,25.6166666666667,26,-0.383333333333333,50,39,11,12,-1
21701063,203493,DET,PHX,Reggie Bullock,103,21.1666666666667,21,0.166666666666664,51,38,13,11,2
21701063,203516,DET,PHX,James Ennis III,112,23.55,23,0.549999999999997,61,48,13,13,0
21701063,203961,DET,PHX,Eric Moreland,38,7.65,8,-0.35,20,20,0,1,-1
21701063,1626169,DET,PHX,Stanley Johnson,136,27.3333333333333,28,-0.666666666666668,60,47,13,15,-2
21701063,1627740,DET,PHX,Henry Ellenson,18,3.53333333333333,4,-0.466666666666667,10,11,-1,-1,0
21701063,1628379,DET,PHX,Luke Kennard,117,23.9166666666667,24,-0.0833333333333357,58,43,15,15,0
21701064,2207,HOU,POR,Joe Johnson,68,15.3,15,0.300000000000001,34,37,-3,-2,-1
21701064,2772,HOU,POR,Trevor Ariza,119,27.4666666666667,28,-0.533333333333331,66,67,-1,-1,0
21701064,101108,HOU,POR,Chris Paul,141,32.1166666666667,32,0.116666666666667,84,79,5,8,-3
21701064,101123,HOU,POR,Gerald Green,42,10.5833333333333,11,-0.416666666666668,29,21,8,8,0
21701064,200782,HOU,POR,PJ Tucker,119,29.1666666666667,29,0.166666666666668,72,66,6,8,-2
21701064,201569,HOU,POR,Eric Gordon,143,33.7333333333333,34,-0.266666666666666,77,71,6,6,0
21701064,201583,HOU,POR,Ryan Anderson,40,9.33333333333333,9,0.333333333333334,22,21,1,1,0
21701064,201601,HOU,POR,Luc Mbah a Moute,115,25.9333333333333,26,-0.0666666666666664,57,56,1,1,0
21701064,201935,HOU,POR,James Harden,140,32.55,33,-0.450000000000003,74,77,-3,-5,2
21701064,203991,HOU,POR,Clint Capela,108,23.8166666666667,24,-0.18333333333333,55,60,-5,-4,-1
21701064,202323,POR,HOU,Evan Turner,81,19.8166666666667,20,-0.183333333333334,44,48,-4,-7,3
21701064,202329,POR,HOU,Al-Farouq Aminu,152,34.2833333333333,34,0.283333333333331,83,81,2,0,2
21701064,202334,POR,HOU,Ed Davis,83,20.4666666666667,21,-0.533333333333331,44,49,-5,-5,0
21701064,203081,POR,HOU,Damian Lillard,160,35.8,36,-0.200000000000003,90,85,5,6,-1
21701064,203090,POR,HOU,Maurice Harkless,130,29.2666666666667,29,0.266666666666666,69,68,1,-1,2
21701064,203468,POR,HOU,CJ McCollum,151,34.4833333333333,34,0.483333333333334,75,83,-8,-6,-2
21701064,203894,POR,HOU,Shabazz Napier,65,16.8666666666667,17,-0.133333333333333,31,41,-10,-11,1
21701064,203994,POR,HOU,Jusuf Nurkic,118,26.7333333333333,27,-0.266666666666666,64,63,1,2,-1
21701064,1626192,POR,HOU,Pat Connaughton,42,9.3,9,0.300000000000001,27,21,6,4,2
21701064,1628380,POR,HOU,Zach Collins,53,12.9833333333333,13,-0.0166666666666657,28,31,-3,-2,-1
21701065,2544,CLE,TOR,LeBron James,171,39.9333333333333,39,0.93333333333333,121,111,10,12,-2
21701065,2747,CLE,TOR,JR Smith,117,27.25,27,0.25,71,70,1,3,-2
21701065,101181,CLE,TOR,Jose Calderon,116,26.75,27,-0.25,72,64,8,8,0
21701065,201145,CLE,TOR,Jeff Green,163,37.8833333333333,38,-0.116666666666667,104,100,4,4,0
21701065,201567,CLE,TOR,Kevin Love,130,29.8333333333333,30,-0.166666666666668,87,83,4,4,0
21701065,201588,CLE,TOR,George Hill,157,36.1166666666667,36,0.11666666666666,108,103,5,3,2
21701065,203903,CLE,TOR,Jordan Clarkson,89,20.7333333333333,21,-0.266666666666666,45,53,-8,-10,2
21701065,204066,CLE,TOR,John Holland,28,5.98333333333333,6,-0.0166666666666675,13,24,-11,-11,0
21701065,1627790,CLE,TOR,Ante Zizic,64,15.5166666666667,16,-0.483333333333333,39,37,2,2,0
21701065,200768,TOR,CLE,Kyle Lowry,142,33.1,33,0.100000000000001,91,100,-9,-9,0
21701065,201586,TOR,CLE,Serge Ibaka,103,23.1833333333333,23,0.183333333333334,70,73,-3,-6,3
21701065,201942,TOR,CLE,DeMar DeRozan,158,35.6333333333333,35,0.633333333333333,97,109,-12,-10,-2
21701065,202685,TOR,CLE,Jonas Valanciunas,88,19.6666666666667,20,-0.333333333333336,63,60,3,6,-3
21701065,1626153,TOR,CLE,Delon Wright,88,20.75,21,-0.25,55,43,12,12,0
21701065,1626181,TOR,CLE,Norman Powell,41,9.76666666666667,10,-0.233333333333334,24,18,6,6,0
21701065,1627751,TOR,CLE,Jakob Poeltl,111,26.85,27,-0.149999999999999,59,67,-8,-6,-2
21701065,1627783,TOR,CLE,Pascal Siakam,113,26.65,26,0.649999999999999,66,67,-1,-3,2
21701065,1627832,TOR,CLE,Fred VanVleet,124,29.2833333333333,29,0.283333333333331,76,74,2,0,2
21701065,1628384,TOR,CLE,OG Anunoby,67,15.1166666666667,15,0.116666666666667,44,49,-5,-5,0
21701066,101141,PHI,MEM,Ersan Ilyasova,105,20.35,20,0.350000000000001,54,41,13,12,1
21701066,101161,PHI,MEM,Amir Johnson,38,8.6,9,-0.4,26,16,10,10,0
21701066,200755,PHI,MEM,JJ Redick,86,17.7166666666667,18,-0.283333333333331,45,28,17,16,1
21701066,201158,PHI,MEM,Marco Belinelli,159,32,32,0,84,82,2,6,-4
21701066,203496,PHI,MEM,Robert Covington,103,22.5333333333333,23,-0.466666666666669,61,40,21,20,1
21701066,203923,PHI,MEM,James Young,46,8.96666666666667,9,-0.0333333333333332,14,31,-17,-17,0
21701066,203954,PHI,MEM,Joel Embiid,94,19.6833333333333,20,-0.31666666666667,51,32,19,19,0
21701066,203967,PHI,MEM,Dario Saric,104,22.9833333333333,23,-0.0166666666666657,64,39,25,24,1
21701066,204456,PHI,MEM,T.J. McConnell,80,16.05,16,0.0500000000000007,36,29,7,3,4
21701066,1626147,PHI,MEM,Justin Anderson,119,23.3166666666667,23,0.316666666666666,46,58,-12,-14,2
21701066,1626158,PHI,MEM,Richaun Holmes,81,15.2833333333333,15,0.283333333333333,29,49,-20,-20,0
21701066,1627732,PHI,MEM,Ben Simmons,115,24.6166666666667,25,-0.383333333333333,73,46,27,28,-1
21701066,1627743,PHI,MEM,Demetrius Jackson,40,7.56666666666667,8,-0.433333333333334,12,29,-17,-17,0
21701066,201188,MEM,PHI,Marc Gasol,115,24.6166666666667,25,-0.383333333333333,46,73,-27,-28,1
21701066,201596,MEM,PHI,Mario Chalmers,107,20.5333333333333,20,0.533333333333331,54,40,14,16,-2
21701066,202718,MEM,PHI,Chandler Parsons,81,16.5666666666667,17,-0.433333333333334,26,50,-24,-24,0
21701066,203210,MEM,PHI,JaMychal Green,128,27.4166666666667,27,0.416666666666668,52,78,-26,-24,-2
21701066,203463,MEM,PHI,Ben McLemore,70,12.9833333333333,13,-0.0166666666666657,29,27,2,1,1
21701066,1626150,MEM,PHI,Andrew Harrison,78,16.1333333333333,16,0.133333333333333,35,44,-9,-10,1
21701066,1626185,MEM,PHI,Jarell Martin,117,24.55,25,-0.450000000000003,40,73,-33,-33,0
21701066,1627362,MEM,PHI,Briante Weber,107,22.4,23,-0.600000000000001,52,51,1,2,-1
21701066,1627738,MEM,PHI,Deyonta Davis,104,20.8333333333333,21,-0.166666666666664,53,42,11,13,-2
21701066,1627744,MEM,PHI,Brice Johnson,58,10.8166666666667,11,-0.183333333333334,36,16,20,20,0
21701066,1627782,MEM,PHI,Wayne Selden,104,21.3333333333333,22,-0.666666666666668,54,44,10,11,-1
21701066,1628415,MEM,PHI,Dillon Brooks,101,21.4833333333333,22,-0.516666666666666,43,57,-14,-14,0
21701067,201960,BKN,CHA,DeMarre Carroll,160,29.5666666666667,29,0.566666666666666,67,72,-5,-1,-4
21701067,203112,BKN,CHA,Quincy Acy,118,22.65,22,0.649999999999999,56,57,-1,4,-5
21701067,203459,BKN,CHA,Allen Crabbe,153,28.5833333333333,29,-0.416666666666668,62,73,-11,-8,-3
21701067,203915,BKN,CHA,Spencer Dinwiddie,127,24.2,24,0.200000000000003,52,52,0,-2,2
21701067,203925,BKN,CHA,Joe Harris,119,23.8,24,-0.199999999999999,52,46,6,5,1
21701067,1626156,BKN,CHA,D'Angelo Russell,151,28.4666666666667,28,0.466666666666665,63,69,-6,-7,1
21701067,1626178,BKN,CHA,Rondae Hollis-Jefferson,160,30.5833333333333,31,-0.416666666666668,71,69,2,-2,4
21701067,1627747,BKN,CHA,Caris LeVert,134,26.6,27,-0.399999999999999,53,63,-10,-9,-1
21701067,1628386,BKN,CHA,Jarrett Allen,133,25.3,26,-0.700000000000003,49,54,-5,-10,5
21701067,2730,CHA,BKN,Dwight Howard,179,33.9833333333333,34,-0.0166666666666657,86,70,16,16,0
21701067,101107,CHA,BKN,Marvin Williams,124,21.9166666666667,22,-0.0833333333333357,52,51,1,2,-1
21701067,202689,CHA,BKN,Kemba Walker,196,37,37,0,93,79,14,13,1
21701067,203077,CHA,BKN,Michael Kidd-Gilchrist,120,20.75,21,-0.25,52,49,3,2,1
21701067,203087,CHA,BKN,Jeremy Lamb,164,32.0666666666667,32,0.0666666666666629,75,66,9,11,-2
21701067,1626163,CHA,BKN,Frank Kaminsky,127,26.0333333333333,26,0.0333333333333314,59,54,5,4,1
21701067,1626195,CHA,BKN,Willy Hernangomez,72,13.9666666666667,14,-0.0333333333333332,25,35,-10,-10,0
21701067,1626203,CHA,BKN,Treveon Graham,44,8.55,8,0.550000000000001,13,24,-11,-12,1
21701067,1628370,CHA,BKN,Malik Monk,88,17.3166666666667,17,0.316666666666666,32,37,-5,-4,-1
21701067,1628407,CHA,BKN,Dwayne Bacon,141,28.1666666666667,28,0.166666666666664,68,60,8,8,0
21701068,2617,MIA,NYK,Udonis Haslem,21,5.3,5,0.300000000000001,2,7,-5,-3,-2
21701068,201609,MIA,NYK,Goran Dragic,109,24.5666666666667,25,-0.433333333333334,59,57,2,2,0
21701068,201949,MIA,NYK,James Johnson,100,22.05,22,0.0499999999999972,53,50,3,3,0
21701068,201961,MIA,NYK,Wayne Ellington,110,25.75,26,-0.25,77,52,25,25,0
21701068,202337,MIA,NYK,Luke Babbitt,21,5.3,5,0.300000000000001,2,7,-5,-3,-2
21701068,203482,MIA,NYK,Kelly Olynyk,128,29.4166666666667,30,-0.583333333333336,90,56,34,32,2
21701068,203585,MIA,NYK,Rodney McGruder,107,23.6666666666667,24,-0.333333333333336,73,45,28,26,2
21701068,204020,MIA,NYK,Tyler Johnson,120,26.7666666666667,27,-0.233333333333334,67,63,4,2,2
21701068,1626159,MIA,NYK,Justise Winslow,109,25.9333333333333,26,-0.06666666666667,66,48,18,18,0
21701068,1626175,MIA,NYK,Jordan Mickey,21,5.3,5,0.300000000000001,2,7,-5,-3,-2
21701068,1626196,MIA,NYK,Josh Richardson,118,27.3,28,-0.700000000000003,75,56,19,17,2
21701068,1628389,MIA,NYK,Bam Adebayo,60,13.2666666666667,13,0.266666666666666,27,35,-8,-8,0
21701068,1628476,MIA,NYK,Derrick Walton Jr.,21,5.3,5,0.300000000000001,2,7,-5,-3,-2
21701068,201563,NYK,MIA,Michael Beasley,145,33.65,34,-0.350000000000001,74,84,-10,-6,-4
21701068,201584,NYK,MIA,Courtney Lee,90,19.4666666666667,20,-0.533333333333331,43,42,1,3,-2
21701068,202683,NYK,MIA,Enes Kanter,134,30.6666666666667,31,-0.333333333333336,66,66,0,-1,1
21701068,203124,NYK,MIA,Kyle O'Quinn,62,14.4333333333333,15,-0.566666666666666,30,51,-21,-20,-1
21701068,203501,NYK,MIA,Tim Hardaway Jr.,143,31.8166666666667,32,-0.183333333333337,73,81,-8,-8,0
21701068,203504,NYK,MIA,Trey Burke,104,25.95,26,-0.0499999999999972,50,68,-18,-20,2
21701068,1626144,NYK,MIA,Emmanuel Mudiay,124,28.2333333333333,28,0.233333333333334,68,70,-2,-2,0
21701068,1627786,NYK,MIA,Troy Williams,46,9.63333333333333,10,-0.366666666666667,11,29,-18,-18,0
21701068,1628373,NYK,MIA,Frank Ntilikina,85,19.75,20,-0.25,30,49,-19,-19,0
21701068,1628422,NYK,MIA,Damyean Dotson,48,11.9833333333333,12,-0.0166666666666657,21,20,1,1,0
21701068,1628439,NYK,MIA,Isaiah Hicks,64,14.3333333333333,14,0.333333333333332,24,35,-11,-15,4
21701069,203200,CHI,DEN,Justin Holiday,111,22.75,23,-0.25,47,71,-24,-24,0
21701069,203943,CHI,DEN,Noah Vonleh,107,23.4166666666667,24,-0.583333333333336,53,60,-7,-5,-2
21701069,1626166,CHI,DEN,Cameron Payne,104,23.0666666666667,23,0.0666666666666664,52,67,-15,-16,1
21701069,1626170,CHI,DEN,Jerian Grant,120,24.6,25,-0.399999999999999,50,68,-18,-17,-1
21701069,1626171,CHI,DEN,Bobby Portis,120,27.0166666666667,26,1.01666666666667,57,80,-23,-25,2
21701069,1626245,CHI,DEN,Cristiano Felicio,134,27.8166666666667,28,-0.183333333333334,57,80,-23,-23,0
21701069,1627756,CHI,DEN,Denzel Valentine,116,24.0333333333333,24,0.0333333333333314,48,75,-27,-26,-1
21701069,1627835,CHI,DEN,Paul Zipser,87,17.0833333333333,18,-0.916666666666664,37,50,-13,-13,0
21701069,1628021,CHI,DEN,David Nwaba,115,25.4,26,-0.600000000000001,56,67,-11,-12,1
21701069,1628469,CHI,DEN,Antonio Blakeney,106,23.15,23,0.149999999999999,53,57,-4,-4,0
21701069,2210,DEN,CHI,Richard Jefferson,19,4,4,0,5,10,-5,-5,0
21701069,2734,DEN,CHI,Devin Harris,113,24.4166666666667,25,-0.583333333333336,76,50,26,26,0
21701069,200794,DEN,CHI,Paul Millsap,126,26.8666666666667,27,-0.133333333333333,82,49,33,34,-1
21701069,201163,DEN,CHI,Wilson Chandler,143,29.35,29,0.350000000000001,91,54,37,37,0
21701069,201589,DEN,CHI,Darrell Arthur,29,7.05,7,0.0499999999999989,15,18,-3,-3,0
21701069,203115,DEN,CHI,Will Barton,126,26.1,26,0.100000000000001,80,51,29,29,0
21701069,203486,DEN,CHI,Mason Plumlee,96,19.0666666666667,19,0.0666666666666664,58,34,24,22,2
21701069,203999,DEN,CHI,Nikola Jokic,110,23.3333333333333,24,-0.666666666666668,71,54,17,18,-1
21701069,1626168,DEN,CHI,Trey Lyles,85,18.5166666666667,19,-0.483333333333334,44,49,-5,-5,0
21701069,1627736,DEN,CHI,Malik Beasley,50,11.6666666666667,12,-0.333333333333334,22,32,-10,-10,0
21701069,1627750,DEN,CHI,Jamal Murray,140,29.15,29,0.149999999999999,87,61,26,26,0
21701069,1628470,DEN,CHI,Torrey Craig,83,18.8166666666667,19,-0.183333333333334,44,48,-4,-4,0
21701070,101150,LAC,MIL,Lou Williams,164,32.1333333333333,32,0.133333333333333,95,88,7,7,0
21701070,201599,LAC,MIL,DeAndre Jordan,184,37.3666666666667,37,0.366666666666667,102,91,11,11,0
21701070,202325,LAC,MIL,Wesley Johnson,134,27.6166666666667,28,-0.383333333333333,76,68,8,8,0
21701070,202699,LAC,MIL,Tobias Harris,174,35.85,36,-0.150000000000006,98,85,13,13,0
21701070,203085,LAC,MIL,Austin Rivers,189,38.3333333333333,38,0.333333333333329,106,93,13,13,0
21701070,1626149,LAC,MIL,Montrezl Harrell,53,10.3833333333333,11,-0.616666666666667,25,29,-4,-4,0
21701070,1626155,LAC,MIL,Sam Dekker,63,11.9,12,-0.0999999999999996,29,35,-6,-6,0
21701070,1628393,LAC,MIL,Jawun Evans,12,2.05,2,0.0499999999999998,5,6,-1,-1,0
21701070,1628414,LAC,MIL,Sindarius Thornwell,75,15.2833333333333,16,-0.716666666666665,33,37,-4,-4,0
21701070,1628462,LAC,MIL,Milos Teodosic,137,27.8333333333333,28,-0.166666666666664,66,68,-2,-2,0
21701070,1891,MIL,LAC,Jason Terry,146,28.6333333333333,29,-0.366666666666667,76,73,3,5,-2
21701070,201943,MIL,LAC,Brandon Jennings,31,6.43333333333333,6,0.433333333333334,10,22,-12,-10,-2
21701070,202339,MIL,LAC,Eric Bledsoe,170,35.3166666666667,36,-0.683333333333337,94,91,3,1,2
21701070,203089,MIL,LAC,John Henson,117,25.5333333333333,25,0.533333333333331,56,62,-6,-8,2
21701070,203092,MIL,LAC,Tyler Zeller,43,8.4,8,0.4,15,28,-13,-11,-2
21701070,203114,MIL,LAC,Khris Middleton,176,36.5833333333333,37,-0.416666666666671,98,97,1,2,-1
21701070,203498,MIL,LAC,Shabazz Muhammad,72,13.8666666666667,14,-0.133333333333333,36,35,1,1,0
21701070,203503,MIL,LAC,Tony Snell,54,10.9666666666667,11,-0.033333333333335,24,30,-6,-10,4
21701070,203507,MIL,LAC,Giannis Antetokounmpo,87,16.5166666666667,17,-0.483333333333334,39,44,-5,-5,0
21701070,203953,MIL,LAC,Jabari Parker,146,30.0833333333333,30,0.0833333333333357,73,81,-8,-8,0
21701070,1627748,MIL,LAC,Thon Maker,77,13.8166666666667,14,-0.183333333333334,49,37,12,12,0
21701070,1628425,MIL,LAC,Sterling Brown,66,12.6,12,0.6,30,35,-5,-4,-1
21701071,1938,SAS,WAS,Manu Ginobili,74,17.7333333333333,18,-0.266666666666666,34,21,13,13,0
21701071,2200,SAS,WAS,Pau Gasol,67,15.6833333333333,16,-0.316666666666666,32,35,-3,-3,0
21701071,2225,SAS,WAS,Tony Parker,72,16.6,17,-0.399999999999999,34,31,3,3,0
21701071,200746,SAS,WAS,LaMarcus Aldridge,133,30.3333333333333,31,-0.666666666666668,66,45,21,21,0
21701071,200752,SAS,WAS,Rudy Gay,86,19.1666666666667,19,0.166666666666668,34,46,-12,-10,-2
21701071,201980,SAS,WAS,Danny Green,125,28.3166666666667,28,0.316666666666666,61,49,12,13,-1
21701071,201988,SAS,WAS,Patty Mills,134,31.1833333333333,31,0.183333333333337,65,55,10,10,0
21701071,202722,SAS,WAS,Davis Bertans,26,5.78333333333333,6,-0.216666666666667,7,16,-9,-9,0
21701071,203464,SAS,WAS,Brandon Paul,15,3.18333333333333,3,0.183333333333334,3,14,-11,-11,0
21701071,203530,SAS,WAS,Joffrey Lauvergne,17,4.31666666666667,4,0.316666666666666,5,16,-11,-11,0
21701071,203937,SAS,WAS,Kyle Anderson,129,29.1666666666667,30,-0.833333333333336,72,48,24,24,0
21701071,1627749,SAS,WAS,Dejounte Murray,124,28.6666666666667,29,-0.333333333333332,61,47,14,12,2
21701071,1627854,SAS,WAS,Bryn Forbes,38,8.7,9,-0.300000000000001,16,27,-11,-12,1
21701071,101133,WAS,SAS,Ian Mahinmi,103,23.2833333333333,24,-0.716666666666669,53,40,13,12,1
21701071,101162,WAS,SAS,Marcin Gortat,83,19.2166666666667,19,0.216666666666669,30,42,-12,-12,0
21701071,201160,WAS,SAS,Jason Smith,17,4.31666666666667,4,0.316666666666666,16,5,11,11,0
21701071,201196,WAS,SAS,Ramon Sessions,106,23.8,24,-0.200000000000003,52,44,8,8,0
21701071,202693,WAS,SAS,Markieff Morris,106,24.75,25,-0.25,33,53,-20,-18,-2
21701071,203078,WAS,SAS,Bradley Beal,132,31.1833333333333,31,0.18333333333333,44,64,-20,-20,0
21701071,203107,WAS,SAS,Tomas Satoransky,140,31.85,32,-0.150000000000002,65,72,-7,-9,2
21701071,203490,WAS,SAS,Otto Porter Jr.,149,33.7333333333333,34,-0.266666666666666,58,78,-20,-20,0
21701071,204025,WAS,SAS,Tim Frazier,56,13.1333333333333,13,0.133333333333333,32,25,7,8,-1
21701071,1626162,WAS,SAS,Kelly Oubre Jr.,148,33.5666666666667,34,-0.433333333333337,67,67,0,0,0
21701072,201596,MEM,CHA,Mario Chalmers,72,14.0333333333333,14,0.0333333333333332,24,40,-16,-16,0
21701072,201936,MEM,CHA,Tyreke Evans,89,19.0166666666667,19,0.0166666666666657,34,50,-16,-21,5
21701072,203210,MEM,CHA,JaMychal Green,117,24.1333333333333,24,0.133333333333333,43,66,-23,-27,4
21701072,203463,MEM,CHA,Ben McLemore,93,21.0666666666667,21,0.0666666666666664,34,57,-23,-23,0
21701072,1626185,MEM,CHA,Jarell Martin,151,32.1333333333333,32,0.133333333333333,51,95,-44,-44,0
21701072,1627362,MEM,CHA,Briante Weber,95,20.8166666666667,21,-0.183333333333334,35,64,-29,-26,-3
21701072,1627738,MEM,CHA,Deyonta Davis,106,23.9333333333333,25,-1.06666666666667,47,52,-5,-12,7
21701072,1627744,MEM,CHA,Brice Johnson,71,14.1333333333333,14,0.133333333333333,17,47,-30,-28,-2
21701072,1627782,MEM,CHA,Wayne Selden,105,21.7166666666667,21,0.716666666666669,35,78,-43,-36,-7
21701072,1628397,MEM,CHA,Ivan Rabb,29,6.68333333333333,6,0.683333333333334,10,25,-15,-13,-2
21701072,1628415,MEM,CHA,Dillon Brooks,75,16.2666666666667,16,0.266666666666666,25,52,-27,-27,0
21701072,1628424,MEM,CHA,Kobi Simmons,117,25.7333333333333,26,-0.266666666666666,40,74,-34,-32,-2
21701072,101107,CHA,MEM,Marvin Williams,129,27.9333333333333,28,-0.0666666666666664,88,41,47,47,0
21701072,202689,CHA,MEM,Kemba Walker,129,27.9333333333333,28,-0.0666666666666664,88,41,47,47,0
21701072,202933,CHA,MEM,Julyan Stone,62,13.7333333333333,14,-0.266666666666666,39,22,17,17,0
21701072,203077,CHA,MEM,Michael Kidd-Gilchrist,95,19.8666666666667,20,-0.133333333333333,48,33,15,15,0
21701072,203087,CHA,MEM,Jeremy Lamb,118,25.6666666666667,26,-0.333333333333336,83,32,51,51,0
21701072,1626163,CHA,MEM,Frank Kaminsky,91,19.7,20,-0.300000000000001,56,34,22,22,0
21701072,1626195,CHA,MEM,Willy Hernangomez,89,18.5666666666667,19,-0.433333333333334,61,25,36,36,0
21701072,1626203,CHA,MEM,Treveon Graham,113,23.1833333333333,23,0.183333333333334,68,43,25,22,3
21701072,1627779,CHA,MEM,Marcus Paige,52,11.9333333333333,12,-0.0666666666666664,28,22,6,6,0
21701072,1628370,CHA,MEM,Malik Monk,54,10.3333333333333,10,0.333333333333334,29,25,4,4,0
21701072,1628407,CHA,MEM,Dwayne Bacon,144,31.15,31,0.149999999999999,89,57,32,35,-3
21701072,1628493,CHA,MEM,Mangok Mathiang,44,9.66666666666667,9,0.666666666666668,23,20,3,3,0
21701073,201167,ORL,PHI,Arron Afflalo,76,15.4333333333333,15,0.433333333333334,33,50,-17,-16,-1
21701073,201571,ORL,PHI,D.J. Augustin,121,25.3666666666667,26,-0.633333333333333,44,64,-20,-18,-2
21701073,201578,ORL,PHI,Marreese Speights,31,7.18333333333333,7,0.183333333333334,21,21,0,0,0
21701073,202687,ORL,PHI,Bismack Biyombo,92,19.3166666666667,19,0.316666666666666,45,41,4,5,-1
21701073,202696,ORL,PHI,Nikola Vucevic,108,21.5,22,-0.5,32,56,-24,-25,1
21701073,202714,ORL,PHI,Shelvin Mack,79,15.45,15,0.449999999999999,33,33,0,-2,2
21701073,203920,ORL,PHI,Khem Birch,104,20.3333333333333,20,0.333333333333336,51,55,-4,-4,0
21701073,203932,ORL,PHI,Aaron Gordon,127,27.6666666666667,28,-0.333333333333336,47,63,-16,-16,0
21701073,1626209,ORL,PHI,Mario Hezonja,114,24.5,25,-0.5,39,59,-20,-21,1
21701073,1628411,ORL,PHI,Wes Iwundu,137,29.0833333333333,29,0.0833333333333357,55,74,-19,-20,1
21701073,1628503,ORL,PHI,Jamel Artis,57,12,12,0,33,23,10,10,0
21701073,1628681,ORL,PHI,Rodney Purvis,109,22.1666666666667,22,0.166666666666664,57,51,6,7,-1
21701073,101141,PHI,ORL,Ersan Ilyasova,96,21.5,22,-0.5,57,45,12,15,-3
21701073,101161,PHI,ORL,Amir Johnson,67,14.4666666666667,14,0.466666666666667,35,26,9,8,1
21701073,200755,PHI,ORL,JJ Redick,84,16.9,17,-0.100000000000001,56,30,26,26,0
21701073,201158,PHI,ORL,Marco Belinelli,116,23.9166666666667,24,-0.0833333333333357,41,47,-6,-6,0
21701073,203496,PHI,ORL,Robert Covington,129,25.8,26,-0.200000000000003,64,43,21,21,0
21701073,203954,PHI,ORL,Joel Embiid,100,19.8666666666667,20,-0.133333333333333,60,35,25,24,1
21701073,203967,PHI,ORL,Dario Saric,110,21.7166666666667,22,-0.283333333333331,50,38,12,11,1
21701073,204456,PHI,ORL,T.J. McConnell,100,21.5,21,0.5,53,55,-2,-3,1
21701073,1626147,PHI,ORL,Justin Anderson,77,16.65,16,0.649999999999999,42,41,1,1,0
21701073,1626158,PHI,ORL,Richaun Holmes,57,12,12,0,23,33,-10,-10,0
21701073,1627732,PHI,ORL,Ben Simmons,131,26.5,27,-0.5,65,43,22,23,-1
21701073,1627743,PHI,ORL,Demetrius Jackson,31,7.18333333333333,7,0.183333333333334,21,21,0,0,0
21701073,1627788,PHI,ORL,Furkan Korkmaz,57,12,12,0,23,33,-10,-10,0
21701074,2207,HOU,DET,Joe Johnson,146,30,30,0,59,48,11,12,-1
21701074,2772,HOU,DET,Trevor Ariza,183,38.1,38,0.100000000000001,70,72,-2,-2,0
21701074,101123,HOU,DET,Gerald Green,105,21.95,22,-0.0500000000000007,47,32,15,15,0
21701074,200782,HOU,DET,PJ Tucker,170,36.4166666666667,37,-0.583333333333329,66,72,-6,-6,0
21701074,201569,HOU,DET,Eric Gordon,200,42.1,42,0.0999999999999943,82,69,13,14,-1
21701074,201583,HOU,DET,Ryan Anderson,98,20.2333333333333,20,0.233333333333334,42,30,12,12,0
21701074,201601,HOU,DET,Luc Mbah a Moute,34,7.05,7,0.0499999999999998,13,19,-6,-6,0
21701074,201935,HOU,DET,James Harden,188,40.3666666666667,40,0.366666666666667,70,78,-8,-8,0
21701074,203991,HOU,DET,Clint Capela,131,28.6166666666667,29,-0.383333333333333,51,60,-9,-11,2
21701074,201229,DET,HOU,Anthony Tolliver,104,21.5166666666667,21,0.516666666666666,34,44,-10,-11,1
21701074,201933,DET,HOU,Blake Griffin,196,41.9,42,-0.100000000000001,80,74,6,7,-1
21701074,202397,DET,HOU,Ish Smith,156,33.3666666666667,33,0.366666666666667,63,56,7,10,-3
21701074,202704,DET,HOU,Reggie Jackson,94,19.5666666666667,20,-0.433333333333334,30,44,-14,-15,1
21701074,203083,DET,HOU,Andre Drummond,202,42.5166666666667,43,-0.483333333333334,78,82,-4,-4,0
21701074,203493,DET,HOU,Reggie Bullock,180,38.9166666666667,39,-0.0833333333333357,76,67,9,9,0
21701074,203516,DET,HOU,James Ennis III,101,20.2666666666667,20,0.266666666666666,38,46,-8,-10,2
21701074,1626169,DET,HOU,Stanley Johnson,66,14.0833333333333,14,0.0833333333333339,29,23,6,6,0
21701074,1628379,DET,HOU,Luke Kennard,156,32.7,33,-0.299999999999997,52,64,-12,-12,0
21701075,2731,NOP,LAL,Emeka Okafor,103,20.1666666666667,20,0.166666666666664,51,63,-12,-12,0
21701075,200765,NOP,LAL,Rajon Rondo,149,30.6,31,-0.400000000000002,86,71,15,13,2
21701075,201950,NOP,LAL,Jrue Holiday,151,31.7166666666667,32,-0.283333333333331,82,88,-6,-2,-4
21701075,202703,NOP,LAL,Nikola Mirotic,78,16.0666666666667,16,0.0666666666666664,35,47,-12,-10,-2
21701075,202732,NOP,LAL,DeAndre Liggins,27,5.55,5,0.55,16,15,1,3,-2
21701075,202734,NOP,LAL,E'Twaun Moore,139,28.5166666666667,29,-0.483333333333334,77,68,9,7,2
21701075,203076,NOP,LAL,Anthony Davis,173,36.4166666666667,37,-0.583333333333336,102,88,14,14,0
21701075,203121,NOP,LAL,Darius Miller,78,15.9166666666667,16,-0.0833333333333339,44,44,0,-2,2
21701075,203524,NOP,LAL,Solomon Hill,64,12.6666666666667,13,-0.333333333333332,34,39,-5,-7,2
21701075,203546,NOP,LAL,Ian Clark,114,23.6833333333333,23,0.68333333333333,60,64,-4,-2,-2
21701075,1627767,NOP,LAL,Cheick Diallo,84,18.7,19,-0.299999999999997,53,38,15,13,2
21701075,201572,LAL,NOP,Brook Lopez,142,30.1166666666667,30,0.116666666666667,74,76,-2,-4,2
21701075,202738,LAL,NOP,Isaiah Thomas,127,25.7333333333333,26,-0.266666666666666,66,71,-5,-7,2
21701075,203484,LAL,NOP,Kentavious Caldwell-Pope,209,43.1166666666667,43,0.11666666666666,119,107,12,12,0
21701075,203944,LAL,NOP,Julius Randle,170,35.1166666666667,35,0.116666666666667,99,94,5,7,-2
21701075,204037,LAL,NOP,Travis Wear,65,13.35,14,-0.65,32,34,-2,-2,0
21701075,1627826,LAL,NOP,Ivica Zubac,29,5.73333333333333,5,0.733333333333333,15,22,-7,-7,0
21701075,1628366,LAL,NOP,Lonzo Ball,215,44.4166666666667,44,0.416666666666664,114,118,-4,-2,-2
21701075,1628398,LAL,NOP,Kyle Kuzma,203,42.4166666666667,43,-0.583333333333329,106,118,-12,-12,0
21701076,1717,DAL,UTA,Dirk Nowitzki,112,24.9,25,-0.100000000000001,54,68,-14,-12,-2
21701076,200826,DAL,UTA,J.J. Barea,121,27.8,28,-0.200000000000003,61,74,-13,-13,0
21701076,203084,DAL,UTA,Harrison Barnes,145,33.0666666666667,33,0.06666666666667,74,84,-10,-10,0
21701076,203926,DAL,UTA,Doug McDermott,83,18.2166666666667,19,-0.783333333333331,43,44,-1,-3,2
21701076,203939,DAL,UTA,Dwight Powell,88,18.9333333333333,19,-0.0666666666666664,36,51,-15,-15,0
21701076,1626151,DAL,UTA,Aaron Harrison,98,19.5333333333333,20,-0.466666666666665,44,44,0,0,0
21701076,1626257,DAL,UTA,Salah Mejri,78,17.9833333333333,18,-0.0166666666666657,44,45,-1,-3,2
21701076,1627812,DAL,UTA,Yogi Ferrell,111,25.4833333333333,26,-0.516666666666666,66,65,1,1,0
21701076,1627827,DAL,UTA,Dorian Finney-Smith,97,23.0333333333333,23,0.0333333333333314,51,62,-11,-11,0
21701076,1627858,DAL,UTA,Kyle Collinsworth,25,4.75,5,-0.25,14,6,8,8,0
21701076,1627883,DAL,UTA,Jalen Jones,74,15.1,15,0.100000000000001,44,33,11,13,-2
21701076,1628467,DAL,UTA,Maxi Kleber,43,9.36666666666667,10,-0.633333333333333,29,19,10,10,0
21701076,201937,UTA,DAL,Ricky Rubio,145,33.2833333333333,34,-0.716666666666669,76,76,0,2,-2
21701076,201973,UTA,DAL,Jonas Jerebko,71,14.55,14,0.550000000000001,42,36,6,3,3
21701076,202324,UTA,DAL,Derrick Favors,141,31.2166666666667,31,0.216666666666669,81,69,12,12,0
21701076,203109,UTA,DAL,Jae Crowder,142,32.0333333333333,32,0.0333333333333314,77,81,-4,-2,-2
21701076,203497,UTA,DAL,Rudy Gobert,157,35.1833333333333,36,-0.816666666666663,80,82,-2,-2,0
21701076,203957,UTA,DAL,Dante Exum,50,9.68333333333333,10,-0.316666666666666,28,23,5,2,3
21701076,204060,UTA,DAL,Joe Ingles,145,34.2166666666667,35,-0.783333333333331,95,77,18,20,-2
21701076,1626220,UTA,DAL,Royce O'Neale,62,12.2833333333333,12,0.283333333333333,31,34,-3,-5,2
21701076,1628378,UTA,DAL,Donovan Mitchell,162,35.7166666666667,36,-0.283333333333331,85,82,3,5,-2
21701077,203101,ATL,SAC,Miles Plumlee,98,21.9833333333333,22,-0.0166666666666657,33,55,-22,-22,0
21701077,203473,ATL,SAC,Dewayne Dedmon,122,26.1833333333333,26,0.18333333333333,60,50,10,10,0
21701077,203488,ATL,SAC,Mike Muscala,109,23.3666666666667,24,-0.633333333333333,52,46,6,6,0
21701077,203705,ATL,SAC,Josh Magette,103,22,22,0,33,56,-23,-25,2
21701077,1627752,ATL,SAC,Taurean Prince,105,22.65,23,-0.350000000000001,51,45,6,6,0
21701077,1627814,ATL,SAC,Damion Lee,106,22.3666666666667,22,0.366666666666667,49,44,5,7,-2
21701077,1627819,ATL,SAC,Isaiah Taylor,120,26.2166666666667,26,0.216666666666665,60,49,11,11,0
21701077,1628416,ATL,SAC,Tyler Dorsey,122,26.3166666666667,27,-0.683333333333334,44,65,-21,-23,2
21701077,1628463,ATL,SAC,Tyler Cavanaugh,99,20.9833333333333,21,-0.0166666666666657,32,54,-22,-22,0
21701077,1628510,ATL,SAC,Andrew White III,116,25.5166666666667,26,-0.483333333333334,36,61,-25,-23,-2
21701077,1713,SAC,ATL,Vince Carter,106,23.75,24,-0.25,55,39,16,14,2
21701077,201585,SAC,ATL,Kosta Koufos,146,31.7166666666667,32,-0.283333333333331,79,56,23,21,2
21701077,203992,SAC,ATL,Bogdan Bogdanovic,88,18.5166666666667,18,0.516666666666666,41,47,-6,-6,0
21701077,203998,SAC,ATL,Bruno Caboclo,58,12.85,13,-0.15,26,17,9,13,-4
21701077,1626161,SAC,ATL,Willie Cauley-Stein,90,19.0166666666667,19,0.0166666666666657,37,45,-8,-7,-1
21701077,1627741,SAC,ATL,Buddy Hield,127,27.85,28,-0.149999999999999,62,43,19,19,0
21701077,1627746,SAC,ATL,Skal Labissiere,140,29.5666666666667,30,-0.433333333333334,66,62,4,1,3
21701077,1628368,SAC,ATL,De'Aaron Fox,93,19.45,20,-0.550000000000001,38,43,-5,-5,0
21701077,1628382,SAC,ATL,Justin Jackson,120,25.65,26,-0.350000000000001,52,51,1,3,-2
21701077,1628412,SAC,ATL,Frank Mason,132,29.2166666666667,30,-0.783333333333331,69,47,22,22,0
21701078,101150,LAC,IND,Lou Williams,159,35.6666666666667,36,-0.333333333333329,82,79,3,5,-2
21701078,201599,LAC,IND,DeAndre Jordan,137,31.7833333333333,32,-0.216666666666669,69,74,-5,-7,2
21701078,202325,LAC,IND,Wesley Johnson,85,18.5833333333333,18,0.583333333333336,35,52,-17,-19,2
21701078,202699,LAC,IND,Tobias Harris,171,38.7333333333333,39,-0.266666666666666,89,94,-5,-5,0
21701078,203085,LAC,IND,Austin Rivers,163,37.2166666666667,38,-0.783333333333331,84,89,-5,-5,0
21701078,1626149,LAC,IND,Montrezl Harrell,87,19.1666666666667,19,0.166666666666668,41,42,-1,1,-2
21701078,1626155,LAC,IND,Sam Dekker,41,9.06666666666667,9,0.0666666666666664,15,15,0,0,0
21701078,1628393,LAC,IND,Jawun Evans,10,2.33333333333333,2,0.333333333333333,5,5,0,0,0
21701078,1628414,LAC,IND,Sindarius Thornwell,68,16.4166666666667,17,-0.583333333333336,37,28,9,7,2
21701078,1628462,LAC,IND,Milos Teodosic,139,30.0333333333333,31,-0.966666666666665,63,67,-4,-2,-2
21701078,201152,IND,LAC,Thaddeus Young,162,36.4833333333333,37,-0.516666666666666,87,82,5,3,2
21701078,201954,IND,LAC,Darren Collison,113,26.6666666666667,28,-1.33333333333333,66,60,6,8,-2
21701078,202344,IND,LAC,Trevor Booker,58,13.2166666666667,13,0.216666666666669,22,22,0,0,0
21701078,202362,IND,LAC,Lance Stephenson,81,17.4833333333333,17,0.483333333333334,31,39,-8,-8,0
21701078,202709,IND,LAC,Cory Joseph,124,26.35,26,0.350000000000001,53,62,-9,-7,-2
21701078,202711,IND,LAC,Bojan Bogdanovic,145,32.9,33,-0.100000000000001,84,65,19,19,0
21701078,203506,IND,LAC,Victor Oladipo,160,36.75,37,-0.25,89,84,5,5,0
21701078,203922,IND,LAC,Glenn Robinson III,54,11.9333333333333,11,0.933333333333334,22,20,2,0,2
21701078,1626167,IND,LAC,Myles Turner,163,37.2166666666667,38,-0.783333333333331,91,86,5,5,0
21701079,2734,DEN,WAS,Devin Harris,130,27.9166666666667,28,-0.0833333333333357,65,58,7,6,1
21701079,200794,DEN,WAS,Paul Millsap,103,24.9,25,-0.100000000000001,50,52,-2,-3,1
21701079,201163,DEN,WAS,Wilson Chandler,178,40.3,40,0.299999999999997,91,83,8,7,1
21701079,203115,DEN,WAS,Will Barton,155,36.0333333333333,36,0.0333333333333314,81,75,6,6,0
21701079,203486,DEN,WAS,Mason Plumlee,85,18.3333333333333,18,0.333333333333336,42,40,2,0,2
21701079,203999,DEN,WAS,Nikola Jokic,153,37.1666666666667,37,0.166666666666671,81,73,8,12,-4
21701079,1627750,DEN,WAS,Jamal Murray,156,36,36,0,84,72,12,13,-1
21701079,1628470,DEN,WAS,Torrey Craig,95,18.9333333333333,19,-0.0666666666666664,46,42,4,-1,5
21701079,101133,WAS,DEN,Ian Mahinmi,58,13.1833333333333,13,0.183333333333334,17,27,-10,-10,0
21701079,101162,WAS,DEN,Marcin Gortat,113,27.8833333333333,27,0.883333333333333,59,60,-1,-1,0
21701079,201196,WAS,DEN,Ramon Sessions,72,16.3666666666667,16,0.366666666666667,33,36,-3,-4,1
21701079,201975,WAS,DEN,Jodie Meeks,48,9.63333333333333,10,-0.366666666666667,21,21,0,1,-1
21701079,202693,WAS,DEN,Markieff Morris,158,36.0333333333333,36,0.0333333333333314,82,84,-2,-1,-1
21701079,203078,WAS,DEN,Bradley Beal,172,39.4666666666667,40,-0.533333333333331,80,88,-8,-6,-2
21701079,203107,WAS,DEN,Tomas Satoransky,114,26,26,0,62,57,5,5,0
21701079,203118,WAS,DEN,Mike Scott,55,11.8666666666667,12,-0.133333333333333,19,25,-6,-5,-1
21701079,203490,WAS,DEN,Otto Porter Jr.,139,31.8833333333333,32,-0.116666666666667,66,73,-7,-7,0
21701079,1626162,WAS,DEN,Kelly Oubre Jr.,126,27.2666666666667,27,0.266666666666666,56,69,-13,-12,-1
21701080,2544,CLE,PHX,LeBron James,144,29.2666666666667,29,0.266666666666666,74,63,11,11,0
21701080,2747,CLE,PHX,JR Smith,140,27.3666666666667,27,0.366666666666667,67,53,14,12,2
21701080,101181,CLE,PHX,Jose Calderon,89,18.8833333333333,19,-0.116666666666667,52,36,16,18,-2
21701080,201145,CLE,PHX,Jeff Green,55,11.5666666666667,12,-0.433333333333334,30,18,12,12,0
21701080,201567,CLE,PHX,Kevin Love,146,29.85,30,-0.149999999999999,81,53,28,28,0
21701080,201588,CLE,PHX,George Hill,127,26.2,26,0.199999999999999,74,42,32,32,0
21701080,202684,CLE,PHX,Tristan Thompson,84,15.9,16,-0.0999999999999996,41,34,7,5,2
21701080,203903,CLE,PHX,Jordan Clarkson,130,25.5166666666667,26,-0.483333333333334,65,52,13,12,1
21701080,203918,CLE,PHX,Rodney Hood,104,20.5,20,0.5,38,50,-12,-11,-1
21701080,204066,CLE,PHX,John Holland,16,2.85,3,-0.15,7,8,-1,-1,0
21701080,1626204,CLE,PHX,Larry Nance Jr.,108,22.25,22,0.25,52,45,7,9,-2
21701080,1627790,CLE,PHX,Ante Zizic,26,5.16666666666667,5,0.166666666666666,12,13,-1,-1,0
21701080,1628506,CLE,PHX,London Perrantes,16,2.85,3,-0.15,7,8,-1,-1,0
21701080,201162,PHX,CLE,Jared Dudley,101,19.6166666666667,20,-0.383333333333333,37,54,-17,-17,0
21701080,203458,PHX,CLE,Alex Len,129,24.8166666666667,25,-0.183333333333334,56,55,1,3,-2
21701080,203584,PHX,CLE,Troy Daniels,164,33.25,33,0.25,68,84,-16,-16,0
21701080,203901,PHX,CLE,Elfrid Payton,104,22.0833333333333,22,0.0833333333333322,36,69,-33,-31,-2
21701080,1627733,PHX,CLE,Dragan Bender,139,28.0666666666667,28,0.0666666666666664,53,68,-15,-19,4
21701080,1627737,PHX,CLE,Marquese Chriss,170,35.0666666666667,35,0.0666666666666629,71,90,-19,-17,-2
21701080,1627755,PHX,CLE,Tyler Ulis,152,30.0333333333333,30,0.0333333333333314,66,70,-4,-4,0
21701080,1627885,PHX,CLE,Shaquille Harrison,38,7.55,8,-0.449999999999999,18,15,3,1,2
21701080,1628367,PHX,CLE,Josh Jackson,134,27.3666666666667,28,-0.633333333333333,56,61,-5,-7,2
21701080,1628432,PHX,CLE,Davon Reed,54,10.3166666666667,10,0.316666666666666,14,34,-20,-18,-2
21701081,2037,MIN,NYK,Jamal Crawford,116,25.1666666666667,25,0.166666666666668,60,51,9,8,1
21701081,201952,MIN,NYK,Jeff Teague,154,33.6833333333333,34,-0.31666666666667,70,83,-13,-14,1
21701081,201959,MIN,NYK,Taj Gibson,178,38.7666666666667,39,-0.233333333333334,82,93,-11,-13,2
21701081,202357,MIN,NYK,Nemanja Bjelica,168,37.5333333333333,38,-0.466666666666669,87,74,13,14,-1
21701081,203476,MIN,NYK,Gorgui Dieng,56,12.7166666666667,12,0.716666666666667,33,16,17,14,3
21701081,203952,MIN,NYK,Andrew Wiggins,174,37.6333333333333,38,-0.366666666666667,83,84,-1,-2,1
21701081,1626145,MIN,NYK,Tyus Jones,65,14.3166666666667,14,0.316666666666666,38,20,18,18,0
21701081,1626157,MIN,NYK,Karl-Anthony Towns,184,40.1833333333333,41,-0.816666666666663,87,94,-7,-5,-2
21701081,201563,NYK,MIN,Michael Beasley,121,26.3833333333333,27,-0.616666666666667,59,49,10,6,4
21701081,201584,NYK,MIN,Courtney Lee,58,13.95,14,-0.0500000000000007,18,42,-24,-25,1
21701081,202683,NYK,MIN,Enes Kanter,155,33.3333333333333,33,0.333333333333329,83,69,14,18,-4
21701081,203124,NYK,MIN,Kyle O'Quinn,64,14.6666666666667,15,-0.333333333333332,20,39,-19,-22,3
21701081,203501,NYK,MIN,Tim Hardaway Jr.,169,36.45,36,0.450000000000003,84,80,4,5,-1
21701081,203504,NYK,MIN,Trey Burke,144,30.7833333333333,31,-0.216666666666665,77,59,18,17,1
21701081,1626144,NYK,MIN,Emmanuel Mudiay,19,4.76666666666667,5,-0.233333333333333,7,15,-8,-8,0
21701081,1627786,NYK,MIN,Troy Williams,96,20.5833333333333,20,0.583333333333336,44,47,-3,-3,0
21701081,1628373,NYK,MIN,Frank Ntilikina,171,37.4666666666667,37,0.466666666666669,79,81,-2,2,-4
21701081,1628436,NYK,MIN,Luke Kornet,98,21.6166666666667,21,0.616666666666667,44,59,-15,-10,-5
21701082,201960,BKN,TOR,DeMarre Carroll,144,30.6333333333333,31,-0.366666666666667,79,73,6,8,-2
21701082,201967,BKN,TOR,Dante Cunningham,106,22.0166666666667,22,0.0166666666666657,53,53,0,-3,3
21701082,203459,BKN,TOR,Allen Crabbe,136,28.2166666666667,29,-0.783333333333331,71,66,5,7,-2
21701082,203915,BKN,TOR,Spencer Dinwiddie,109,24.1166666666667,24,0.116666666666667,56,57,-1,-1,0
21701082,203925,BKN,TOR,Joe Harris,86,19.6666666666667,19,0.666666666666664,41,50,-9,-9,0
21701082,1626156,BKN,TOR,D'Angelo Russell,143,30.5,31,-0.5,74,73,1,1,0
21701082,1626178,BKN,TOR,Rondae Hollis-Jefferson,140,29.4666666666667,30,-0.533333333333331,69,69,0,0,0
21701082,1627747,BKN,TOR,Caris LeVert,130,28.9333333333333,29,-0.0666666666666664,58,76,-18,-14,-4
21701082,1628386,BKN,TOR,Jarrett Allen,116,25.8666666666667,26,-0.133333333333333,59,63,-4,1,-5
21701082,200768,TOR,BKN,Kyle Lowry,175,37,37,0,94,83,11,11,0
21701082,201586,TOR,BKN,Serge Ibaka,135,30.2833333333333,31,-0.716666666666669,73,75,-2,-1,-1
21701082,201942,TOR,BKN,DeMar DeRozan,150,32.9833333333333,33,-0.0166666666666657,81,83,-2,-2,0
21701082,202685,TOR,BKN,Jonas Valanciunas,101,21.3166666666667,21,0.316666666666666,56,59,-3,-1,-2
21701082,203512,TOR,BKN,Lucas Nogueira,59,12.4,12,0.399999999999999,31,21,10,10,0
21701082,1626153,TOR,BKN,Delon Wright,100,21.4166666666667,21,0.416666666666664,46,46,0,1,-1
21701082,1626181,TOR,BKN,Norman Powell,25,5.36666666666667,5,0.366666666666667,10,14,-4,-4,0
21701082,1627751,TOR,BKN,Jakob Poeltl,34,7.56666666666667,7,0.566666666666666,14,23,-9,-9,0
21701082,1627783,TOR,BKN,Pascal Siakam,121,26.65,27,-0.350000000000001,64,51,13,9,4
21701082,1627832,TOR,BKN,Fred VanVleet,152,32.1166666666667,32,0.116666666666667,80,70,10,10,0
21701082,1628384,TOR,BKN,OG Anunoby,58,12.3166666666667,13,-0.683333333333334,31,35,-4,-4,0
21701083,203200,CHI,MIL,Justin Holiday,98,21.75,22,-0.25,55,44,11,11,0
21701083,203943,CHI,MIL,Noah Vonleh,88,19.2,20,-0.799999999999997,36,52,-16,-16,0
21701083,1626166,CHI,MIL,Cameron Payne,137,30.1833333333333,31,-0.816666666666666,74,72,2,0,2
21701083,1626170,CHI,MIL,Jerian Grant,101,21.4666666666667,22,-0.533333333333331,42,55,-13,-11,-2
21701083,1626171,CHI,MIL,Bobby Portis,102,22.2333333333333,22,0.233333333333334,49,55,-6,-5,-1
21701083,1626245,CHI,MIL,Cristiano Felicio,148,31.5666666666667,32,-0.433333333333337,72,74,-2,-2,0
21701083,1627756,CHI,MIL,Denzel Valentine,147,32.05,32,0.0499999999999972,66,78,-12,-12,0
21701083,1627853,CHI,MIL,Ryan Arcidiacono,50,10.5833333333333,10,0.583333333333332,20,28,-8,-8,0
21701083,1628021,CHI,MIL,David Nwaba,124,26.9166666666667,27,-0.0833333333333357,58,77,-19,-19,0
21701083,1628374,CHI,MIL,Lauri Markkanen,100,22.3,22,0.299999999999997,53,55,-2,-3,1
21701083,1891,MIL,CHI,Jason Terry,134,29.5166666666667,30,-0.483333333333334,80,68,12,12,0
21701083,201943,MIL,CHI,Brandon Jennings,128,27.7333333333333,28,-0.266666666666666,71,69,2,0,2
21701083,202339,MIL,CHI,Eric Bledsoe,91,19.9166666666667,20,-0.0833333333333357,47,36,11,13,-2
21701083,203089,MIL,CHI,John Henson,129,28.1166666666667,28,0.116666666666667,71,61,10,11,-1
21701083,203114,MIL,CHI,Khris Middleton,164,34.55,35,-0.450000000000003,77,71,6,8,-2
21701083,203498,MIL,CHI,Shabazz Muhammad,97,20.4166666666667,20,0.416666666666664,63,45,18,16,2
21701083,203503,MIL,CHI,Tony Snell,97,21.4833333333333,22,-0.516666666666666,55,42,13,13,0
21701083,203953,MIL,CHI,Jabari Parker,130,29.3166666666667,30,-0.683333333333337,69,65,4,4,0
21701083,1627748,MIL,CHI,Thon Maker,90,19.5333333333333,20,-0.466666666666669,47,44,3,2,1
21701083,1628425,MIL,CHI,Sterling Brown,35,7.66666666666667,8,-0.333333333333334,10,24,-14,-14,0
21701084,2548,MIA,OKC,Dwyane Wade,94,19.95,20,-0.0500000000000007,43,47,-4,-3,-1
21701084,201609,MIA,OKC,Goran Dragic,154,30.65,31,-0.350000000000001,69,69,0,-2,2
21701084,201949,MIA,OKC,James Johnson,139,28.0166666666667,29,-0.983333333333334,63,69,-6,-6,0
21701084,201961,MIA,OKC,Wayne Ellington,122,26.45,26,0.449999999999999,64,64,0,-3,3
21701084,203482,MIA,OKC,Kelly Olynyk,80,19.0833333333333,19,0.0833333333333322,36,32,4,3,1
21701084,203585,MIA,OKC,Rodney McGruder,55,11.9833333333333,12,-0.0166666666666675,18,24,-6,-4,-2
21701084,204020,MIA,OKC,Tyler Johnson,83,19.2833333333333,20,-0.716666666666669,33,32,1,-2,3
21701084,1626159,MIA,OKC,Justise Winslow,134,30.3333333333333,30,0.333333333333336,64,68,-4,0,-4
21701084,1626196,MIA,OKC,Josh Richardson,156,31.9666666666667,32,-0.0333333333333314,70,77,-7,-7,0
21701084,1628389,MIA,OKC,Bam Adebayo,103,20.7833333333333,21,-0.216666666666669,35,43,-8,-6,-2
21701084,2546,OKC,MIA,Carmelo Anthony,151,30.1,30,0.100000000000001,64,67,-3,-2,-1
21701084,101109,OKC,MIA,Raymond Felton,60,14.1666666666667,14,0.166666666666666,32,22,10,10,0
21701084,201147,OKC,MIA,Corey Brewer,139,28.35,29,-0.649999999999999,64,69,-5,-5,0
21701084,201566,OKC,MIA,Russell Westbrook,172,35.7,36,-0.299999999999997,79,80,-1,-3,2
21701084,202331,OKC,MIA,Paul George,181,37.1333333333333,37,0.133333333333333,76,77,-1,0,-1
21701084,202335,OKC,MIA,Patrick Patterson,58,13.5666666666667,14,-0.433333333333334,29,21,8,9,-1
21701084,203500,OKC,MIA,Steven Adams,154,31.2166666666667,31,0.216666666666665,73,70,3,4,-1
21701084,203518,OKC,MIA,Alex Abrines,43,10.5666666666667,11,-0.433333333333334,29,22,7,6,1
21701084,203924,OKC,MIA,Jerami Grant,86,20.5166666666667,21,-0.483333333333334,44,41,3,1,2
21701084,1628390,OKC,MIA,Terrance Ferguson,76,17.1833333333333,17,0.183333333333334,35,26,9,10,-1
21701085,1938,SAS,UTA,Manu Ginobili,129,26.2,27,-0.799999999999997,67,75,-8,-8,0
21701085,2200,SAS,UTA,Pau Gasol,57,12.25,12,0.25,23,24,-1,-5,4
21701085,2225,SAS,UTA,Tony Parker,60,13.3833333333333,13,0.383333333333333,23,31,-8,-8,0
21701085,200746,SAS,UTA,LaMarcus Aldridge,185,40.7666666666667,41,-0.233333333333334,103,96,7,10,-3
21701085,200752,SAS,UTA,Rudy Gay,112,24.7333333333333,25,-0.266666666666666,51,53,-2,1,-3
21701085,201980,SAS,UTA,Danny Green,108,23.6,25,-1.4,64,53,11,6,5
21701085,201988,SAS,UTA,Patty Mills,180,40.0166666666667,41,-0.983333333333334,97,94,3,8,-5
21701085,202722,SAS,UTA,Davis Bertans,34,7.41666666666667,8,-0.583333333333334,13,15,-2,0,-2
21701085,203937,SAS,UTA,Kyle Anderson,119,25.75,25,0.75,68,63,5,3,2
21701085,1627749,SAS,UTA,Dejounte Murray,153,35.75,35,0.75,78,66,12,13,-1
21701085,1627854,SAS,UTA,Bryn Forbes,68,15.1333333333333,14,1.13333333333333,33,30,3,5,-2
21701085,201937,UTA,SAS,Ricky Rubio,181,40.65,40,0.650000000000006,93,97,-4,-6,2
21701085,201973,UTA,SAS,Jonas Jerebko,57,12.3833333333333,13,-0.616666666666667,30,25,5,7,-2
21701085,202324,UTA,SAS,Derrick Favors,159,34.8833333333333,34,0.883333333333333,83,83,0,4,-4
21701085,203109,UTA,SAS,Jae Crowder,145,31.4166666666667,32,-0.583333333333336,69,72,-3,-2,-1
21701085,203497,UTA,SAS,Rudy Gobert,178,39.8166666666667,40,-0.183333333333337,86,96,-10,-11,1
21701085,203957,UTA,SAS,Dante Exum,48,10.1166666666667,10,0.116666666666667,24,17,7,4,3
21701085,204060,UTA,SAS,Joe Ingles,183,39.6666666666667,40,-0.333333333333329,89,95,-6,-10,4
21701085,1626220,UTA,SAS,Royce O'Neale,57,11.9833333333333,12,-0.0166666666666657,30,28,2,0,2
21701085,1628378,UTA,SAS,Donovan Mitchell,197,44.0833333333333,44,0.0833333333333286,96,107,-11,-11,0
21701086,201143,BOS,POR,Al Horford,143,32,32,0,69,73,-4,-6,2
21701086,202328,BOS,POR,Greg Monroe,85,19.2,20,-0.800000000000001,46,35,11,11,0
21701086,202694,BOS,POR,Marcus Morris,155,34.5833333333333,35,-0.416666666666671,76,74,2,-1,3
21701086,203382,BOS,POR,Aron Baynes,80,18.9333333333333,19,-0.0666666666666664,31,43,-12,-12,0
21701086,203499,BOS,POR,Shane Larkin,155,33.9666666666667,34,-0.0333333333333314,78,64,14,14,0
21701086,1626179,BOS,POR,Terry Rozier,151,34.0833333333333,34,0.0833333333333286,72,78,-6,-6,0
21701086,1627824,BOS,POR,Guerschon Yabusele,75,16.4166666666667,17,-0.583333333333336,36,25,11,11,0
21701086,1627846,BOS,POR,Abdel Nader,28,6.63333333333333,7,-0.366666666666667,12,15,-3,-2,-1
21701086,1628369,BOS,POR,Jayson Tatum,147,32.4333333333333,32,0.43333333333333,77,71,6,8,-2
21701086,1628400,BOS,POR,Semi Ojeleye,51,11.6666666666667,12,-0.333333333333334,28,22,6,8,-2
21701086,202323,POR,BOS,Evan Turner,96,21.9833333333333,22,-0.0166666666666657,43,52,-9,-11,2
21701086,202329,POR,BOS,Al-Farouq Aminu,144,32.3666666666667,32,0.366666666666667,75,69,6,6,0
21701086,202334,POR,BOS,Ed Davis,78,17.6833333333333,18,-0.316666666666666,33,42,-9,-9,0
21701086,203081,POR,BOS,Damian Lillard,171,38.7333333333333,39,-0.266666666666666,82,83,-1,1,-2
21701086,203090,POR,BOS,Maurice Harkless,125,27.5333333333333,28,-0.466666666666669,65,63,2,0,2
21701086,203468,POR,BOS,CJ McCollum,164,36.9166666666667,37,-0.0833333333333357,80,76,4,4,0
21701086,203994,POR,BOS,Jusuf Nurkic,118,26.55,27,-0.450000000000003,58,51,7,9,-2
21701086,1626192,POR,BOS,Pat Connaughton,104,22.5333333333333,23,-0.466666666666669,39,53,-14,-14,0
21701086,1628380,POR,BOS,Zach Collins,70,15.6166666666667,16,-0.383333333333333,25,36,-11,-11,0
21701087,203471,ATL,GSW,Dennis Schroder,126,28.1833333333333,29,-0.81666666666667,44,56,-12,-12,0
21701087,203473,ATL,GSW,Dewayne Dedmon,131,30.4666666666667,31,-0.533333333333331,53,60,-7,-5,-2
21701087,203488,ATL,GSW,Mike Muscala,124,27.5833333333333,28,-0.416666666666668,63,67,-4,-6,2
21701087,1627752,ATL,GSW,Taurean Prince,144,31.7666666666667,32,-0.233333333333334,58,64,-6,-6,0
21701087,1627814,ATL,GSW,Damion Lee,135,30.8333333333333,31,-0.166666666666664,61,63,-2,-4,2
21701087,1627819,ATL,GSW,Isaiah Taylor,86,19.4333333333333,19,0.433333333333334,50,50,0,0,0
21701087,1628381,ATL,GSW,John Collins,139,31.1166666666667,32,-0.883333333333333,58,66,-8,-8,0
21701087,1628416,ATL,GSW,Tyler Dorsey,105,24.4,25,-0.600000000000001,51,55,-4,-4,0
21701087,1628463,ATL,GSW,Tyler Cavanaugh,30,6.06666666666667,6,0.0666666666666664,14,19,-5,-5,0
21701087,1628510,ATL,GSW,Andrew White III,40,8.23333333333333,8,0.233333333333333,18,30,-12,-10,-2
21701087,2561,GSW,ATL,David West,60,14.5166666666667,15,-0.483333333333334,21,31,-10,-10,0
21701087,2585,GSW,ATL,Zaza Pachulia,69,15.15,15,0.15,27,25,2,4,-2
21701087,2733,GSW,ATL,Shaun Livingston,75,16.8833333333333,17,-0.116666666666667,32,38,-6,-5,-1
21701087,2738,GSW,ATL,Andre Iguodala,129,28.65,29,-0.350000000000001,78,53,25,25,0
21701087,201156,GSW,ATL,Nick Young,111,25.6666666666667,26,-0.333333333333336,58,48,10,13,-3
21701087,201580,GSW,ATL,JaVale McGee,42,8.85,9,-0.15,25,16,9,7,2
21701087,201939,GSW,ATL,Stephen Curry,115,25.0166666666667,25,0.0166666666666657,58,47,11,9,2
21701087,1626172,GSW,ATL,Kevon Looney,105,23.4166666666667,24,-0.583333333333336,56,48,8,6,2
21701087,1626188,GSW,ATL,Quinn Cook,141,31.7666666666667,32,-0.233333333333334,79,67,12,10,2
21701087,1627775,GSW,ATL,Patrick McCaw,94,21.1833333333333,22,-0.816666666666666,34,47,-13,-13,0
21701087,1628395,GSW,ATL,Jordan Bell,119,26.9833333333333,28,-1.01666666666667,62,50,12,14,-2
21701088,2037,MIN,PHI,Jamal Crawford,119,21.3333333333333,21,0.333333333333332,43,57,-14,-14,0
21701088,201166,MIN,PHI,Aaron Brooks,63,11.6333333333333,12,-0.366666666666667,37,22,15,15,0
21701088,201952,MIN,PHI,Jeff Teague,120,22.7,23,-0.299999999999997,41,67,-26,-26,0
21701088,201959,MIN,PHI,Taj Gibson,121,23.7666666666667,24,-0.233333333333334,46,66,-20,-18,-2
21701088,202332,MIN,PHI,Cole Aldrich,61,11.1833333333333,12,-0.816666666666666,37,20,17,17,0
21701088,202357,MIN,PHI,Nemanja Bjelica,147,27.9333333333333,28,-0.0666666666666664,58,78,-20,-22,2
21701088,203476,MIN,PHI,Gorgui Dieng,148,26.3666666666667,26,0.366666666666667,67,63,4,6,-2
21701088,203952,MIN,PHI,Andrew Wiggins,165,30.65,31,-0.349999999999998,55,84,-29,-30,1
21701088,1626145,MIN,PHI,Tyus Jones,135,24.9166666666667,25,-0.0833333333333357,67,53,14,14,0
21701088,1626157,MIN,PHI,Karl-Anthony Towns,116,23.25,23,0.25,43,59,-16,-18,2
21701088,1627875,MIN,PHI,Marcus Georges-Hunt,80,14.35,15,-0.65,46,31,15,16,-1
21701088,101141,PHI,MIN,Ersan Ilyasova,128,23.1666666666667,23,0.166666666666664,59,60,-1,-5,4
21701088,101161,PHI,MIN,Amir Johnson,87,15.65,16,-0.350000000000001,39,34,5,5,0
21701088,200755,PHI,MIN,JJ Redick,87,16.4833333333333,17,-0.516666666666666,44,36,8,10,-2
21701088,201158,PHI,MIN,Marco Belinelli,137,25.4166666666667,26,-0.583333333333336,68,51,17,17,0
21701088,203496,PHI,MIN,Robert Covington,147,27.6166666666667,28,-0.383333333333333,79,55,24,23,1
21701088,203954,PHI,MIN,Joel Embiid,126,23.7333333333333,24,-0.266666666666666,70,49,21,21,0
21701088,203967,PHI,MIN,Dario Saric,110,20.8,21,-0.200000000000003,56,39,17,19,-2
21701088,204456,PHI,MIN,T.J. McConnell,95,18.2666666666667,18,0.266666666666666,34,50,-16,-14,-2
21701088,1626147,PHI,MIN,Justin Anderson,97,18.0166666666667,18,0.0166666666666657,36,48,-12,-11,-1
21701088,1626158,PHI,MIN,Richaun Holmes,48,9.36666666666667,9,0.366666666666667,13,30,-17,-17,0
21701088,1627732,PHI,MIN,Ben Simmons,160,29.35,30,-0.649999999999999,86,58,28,27,1
21701088,1627788,PHI,MIN,Furkan Korkmaz,53,10.2166666666667,10,0.216666666666667,16,30,-14,-15,1
21701089,201577,CHI,DET,Robin Lopez,79,17.1333333333333,17,0.133333333333333,30,50,-20,-19,-1
21701089,203200,CHI,DET,Justin Holiday,101,21.5833333333333,22,-0.416666666666664,41,53,-12,-11,-1
21701089,203943,CHI,DET,Noah Vonleh,120,24.8333333333333,25,-0.166666666666668,43,53,-10,-9,-1
21701089,1626166,CHI,DET,Cameron Payne,134,27.8333333333333,28,-0.166666666666668,53,70,-17,-16,-1
21701089,1626170,CHI,DET,Jerian Grant,104,22.4666666666667,23,-0.533333333333331,47,58,-11,-11,0
21701089,1626171,CHI,DET,Bobby Portis,119,25.2833333333333,25,0.283333333333331,57,73,-16,-18,2
21701089,1626245,CHI,DET,Cristiano Felicio,93,19.35,20,-0.649999999999999,42,35,7,9,-2
21701089,1627756,CHI,DET,Denzel Valentine,128,27.45,27,0.449999999999999,50,68,-18,-17,-1
21701089,1627835,CHI,DET,Paul Zipser,72,15.75,16,-0.25,37,40,-3,-3,0
21701089,1627853,CHI,DET,Ryan Arcidiacono,49,10.8,11,-0.199999999999999,20,23,-3,-3,0
21701089,1628021,CHI,DET,David Nwaba,126,25.6833333333333,26,-0.316666666666666,50,62,-12,-12,0
21701089,201229,DET,CHI,Anthony Tolliver,120,25.3333333333333,26,-0.666666666666668,71,55,16,14,2
21701089,201933,DET,CHI,Blake Griffin,124,26.4166666666667,26,0.416666666666664,69,51,18,17,1
21701089,202397,DET,CHI,Ish Smith,111,22.35,23,-0.649999999999999,68,50,18,14,4
21701089,202704,DET,CHI,Reggie Jackson,98,21.9,22,-0.100000000000001,47,39,8,10,-2
21701089,202779,DET,CHI,Dwight Buycks,16,3.38333333333333,3,0.383333333333333,2,5,-3,-2,-1
21701089,203083,DET,CHI,Andre Drummond,167,35.5,36,-0.5,88,70,18,20,-2
21701089,203493,DET,CHI,Reggie Bullock,141,29.05,29,0.0500000000000007,78,58,20,19,1
21701089,203516,DET,CHI,James Ennis III,111,24,24,0,57,49,8,8,0
21701089,203961,DET,CHI,Eric Moreland,23,4.63333333333333,5,-0.366666666666667,4,7,-3,-5,2
21701089,204038,DET,CHI,Langston Galloway,16,3.38333333333333,3,0.383333333333333,2,5,-3,-2,-1
21701089,1626169,DET,CHI,Stanley Johnson,57,12.45,13,-0.550000000000001,31,18,13,12,1
21701089,1627740,DET,CHI,Henry Ellenson,16,3.38333333333333,3,0.383333333333333,2,5,-3,-2,-1
21701089,1628379,DET,CHI,Luke Kennard,125,26.3833333333333,27,-0.616666666666667,66,58,8,7,1
21701090,201167,ORL,PHX,Arron Afflalo,51,11.2166666666667,11,0.216666666666667,14,24,-10,-10,0
21701090,201571,ORL,PHX,D.J. Augustin,190,36.8666666666667,37,-0.13333333333334,91,80,11,13,-2
21701090,202687,ORL,PHX,Bismack Biyombo,58,12.6333333333333,12,0.633333333333333,16,31,-15,-15,0
21701090,202696,ORL,PHX,Nikola Vucevic,179,35.2166666666667,36,-0.783333333333331,89,68,21,21,0
21701090,202714,ORL,PHX,Shelvin Mack,134,27.0666666666667,27,0.0666666666666664,62,58,4,2,2
21701090,203920,ORL,PHX,Khem Birch,23,4.48333333333333,5,-0.516666666666667,5,11,-6,-4,-2
21701090,203932,ORL,PHX,Aaron Gordon,179,35.5166666666667,36,-0.483333333333334,89,70,19,18,1
21701090,1626209,ORL,PHX,Mario Hezonja,194,39,39,0,98,76,22,19,3
21701090,1628411,ORL,PHX,Wes Iwundu,75,15.55,16,-0.449999999999999,30,27,3,5,-2
21701090,1628503,ORL,PHX,Jamel Artis,19,4.5,5,-0.5,3,10,-7,-7,0
21701090,1628681,ORL,PHX,Rodney Purvis,83,17.2,17,0.199999999999999,28,40,-12,-12,0
21701090,201162,PHX,ORL,Jared Dudley,69,14.0166666666667,14,0.0166666666666657,37,24,13,12,1
21701090,203458,PHX,ORL,Alex Len,146,27.4166666666667,27,0.416666666666664,61,64,-3,-3,0
21701090,203584,PHX,ORL,Troy Daniels,139,28.1,28,0.0999999999999979,57,68,-11,-12,1
21701090,203901,PHX,ORL,Elfrid Payton,165,33.3,34,-0.700000000000003,67,71,-4,-2,-2
21701090,1627733,PHX,ORL,Dragan Bender,148,29.8833333333333,30,-0.116666666666667,54,65,-11,-11,0
21701090,1627737,PHX,ORL,Marquese Chriss,111,24.3833333333333,24,0.383333333333333,46,57,-11,-8,-3
21701090,1627755,PHX,ORL,Tyler Ulis,102,19.9666666666667,20,-0.0333333333333314,42,47,-5,-3,-2
21701090,1627885,PHX,ORL,Shaquille Harrison,20,4.53333333333333,4,0.533333333333333,10,8,2,-1,3
21701090,1628367,PHX,ORL,Josh Jackson,201,39.5,40,-0.5,84,92,-8,-9,1
21701090,1628432,PHX,ORL,Davon Reed,84,18.15,18,0.149999999999999,37,29,8,7,1
21701091,2731,NOP,HOU,Emeka Okafor,35,7.61666666666667,8,-0.383333333333333,18,17,1,1,0
21701091,201950,NOP,HOU,Jrue Holiday,160,31.6666666666667,32,-0.333333333333336,52,68,-16,-15,-1
21701091,202732,NOP,HOU,DeAndre Liggins,124,25.3166666666667,26,-0.683333333333334,45,55,-10,-10,0
21701091,202734,NOP,HOU,E'Twaun Moore,137,26.7166666666667,27,-0.283333333333331,46,61,-15,-15,0
21701091,203076,NOP,HOU,Anthony Davis,154,30.0333333333333,30,0.0333333333333314,52,64,-12,-11,-1
21701091,203121,NOP,HOU,Darius Miller,136,26.6,27,-0.399999999999999,53,62,-9,-9,0
21701091,203524,NOP,HOU,Solomon Hill,80,16.0666666666667,16,0.0666666666666664,32,49,-17,-16,-1
21701091,203546,NOP,HOU,Ian Clark,120,23.8166666666667,24,-0.183333333333337,47,61,-14,-13,-1
21701091,203580,NOP,HOU,Larry Drew II,89,18.5,19,-0.5,42,52,-10,-10,0
21701091,1627767,NOP,HOU,Cheick Diallo,117,25.1166666666667,25,0.116666666666667,50,67,-17,-16,-1
21701091,1628429,NOP,HOU,Charles Cooke,28,6.05,7,-0.95,13,14,-1,-1,0
21701091,2207,HOU,NOP,Joe Johnson,137,27.55,28,-0.449999999999999,71,51,20,19,1
21701091,2772,HOU,NOP,Trevor Ariza,146,29.9166666666667,31,-1.08333333333333,63,62,1,-1,2
21701091,101123,HOU,NOP,Gerald Green,156,31.9666666666667,32,-0.033333333333335,77,62,15,14,1
21701091,200782,HOU,NOP,PJ Tucker,99,20.4,20,0.399999999999999,45,31,14,15,-1
21701091,201569,HOU,NOP,Eric Gordon,145,28.2333333333333,28,0.233333333333334,77,59,18,18,0
21701091,201583,HOU,NOP,Ryan Anderson,169,33.9,34,-0.0999999999999943,90,69,21,20,1
21701091,201935,HOU,NOP,James Harden,147,29.65,30,-0.350000000000001,63,48,15,14,1
21701091,203991,HOU,NOP,Clint Capela,146,28.2666666666667,28,0.266666666666666,67,50,17,17,0
21701091,204028,HOU,NOP,Tarik Black,35,7.61666666666667,8,-0.383333333333333,17,18,-1,-1,0
21701092,201572,LAL,MEM,Brook Lopez,159,34.6666666666667,35,-0.333333333333336,69,67,2,2,0
21701092,203484,LAL,MEM,Kentavious Caldwell-Pope,191,42.1333333333333,43,-0.866666666666667,88,81,7,7,0
21701092,203898,LAL,MEM,Tyler Ennis,83,17.9333333333333,18,-0.0666666666666664,39,33,6,6,0
21701092,203944,LAL,MEM,Julius Randle,171,38.35,38,0.349999999999994,77,83,-6,-8,2
21701092,204037,LAL,MEM,Travis Wear,84,19.1166666666667,19,0.116666666666667,47,33,14,14,0
21701092,1627826,LAL,MEM,Ivica Zubac,20,3.76666666666667,4,-0.233333333333333,7,3,4,6,-2
21701092,1628366,LAL,MEM,Lonzo Ball,191,42.3166666666667,42,0.316666666666663,91,90,1,1,0
21701092,1628398,LAL,MEM,Kyle Kuzma,186,41.4666666666667,41,0.466666666666669,82,75,7,7,0
21701092,201188,MEM,LAL,Marc Gasol,148,33.15,33,0.149999999999999,69,69,0,0,0
21701092,201596,MEM,LAL,Mario Chalmers,78,16.9833333333333,16,0.983333333333334,21,26,-5,-4,-1
21701092,203210,MEM,LAL,JaMychal Green,155,35.9166666666667,36,-0.0833333333333357,80,68,12,9,3
21701092,1626150,MEM,LAL,Andrew Harrison,162,36.5,37,-0.5,74,81,-7,-8,1
21701092,1626185,MEM,LAL,Jarell Martin,176,37.4666666666667,38,-0.533333333333331,71,78,-7,-7,0
21701092,1627738,MEM,LAL,Deyonta Davis,69,14.8,15,-0.199999999999999,24,31,-7,-7,0
21701092,1627782,MEM,LAL,Wayne Selden,94,19.9666666666667,20,-0.0333333333333314,29,50,-21,-16,-5
21701092,1628415,MEM,LAL,Dillon Brooks,159,35.4166666666667,35,0.416666666666671,78,73,5,3,2
21701092,1628424,MEM,LAL,Kobi Simmons,44,9.55,10,-0.449999999999999,19,24,-5,-5,0
21701093,1717,DAL,CHA,Dirk Nowitzki,114,22.2833333333333,23,-0.716666666666669,35,47,-12,-12,0
21701093,200826,DAL,CHA,J.J. Barea,114,23.8833333333333,24,-0.116666666666667,44,54,-10,-12,2
21701093,203084,DAL,CHA,Harrison Barnes,164,35.7666666666667,36,-0.233333333333334,77,75,2,3,-1
21701093,203457,DAL,CHA,Nerlens Noel,125,27.1333333333333,27,0.133333333333333,65,58,7,8,-1
21701093,203926,DAL,CHA,Doug McDermott,124,24.6666666666667,25,-0.333333333333332,54,51,3,0,3
21701093,203939,DAL,CHA,Dwight Powell,95,17.8833333333333,18,-0.116666666666667,30,37,-7,-6,-1
21701093,1627812,DAL,CHA,Yogi Ferrell,128,24.7166666666667,24,0.716666666666669,52,55,-3,-5,2
21701093,1627827,DAL,CHA,Dorian Finney-Smith,130,27.55,28,-0.449999999999999,58,55,3,5,-2
21701093,1628372,DAL,CHA,Dennis Smith Jr.,153,32.9833333333333,33,-0.0166666666666657,72,69,3,5,-2
21701093,1628467,DAL,CHA,Maxi Kleber,13,2.96666666666667,3,-0.0333333333333332,3,9,-6,-6,0
21701093,2730,CHA,DAL,Dwight Howard,157,33.75,33,0.75,70,75,-5,-6,1
21701093,101107,CHA,DAL,Marvin Williams,117,23.8166666666667,24,-0.183333333333334,46,50,-4,-2,-2
21701093,202689,CHA,DAL,Kemba Walker,158,34.1666666666667,34,0.166666666666664,71,71,0,0,0
21701093,203077,CHA,DAL,Michael Kidd-Gilchrist,103,21.8,22,-0.200000000000003,39,44,-5,-3,-2
21701093,203087,CHA,DAL,Jeremy Lamb,145,31.1833333333333,31,0.183333333333334,66,67,-1,-3,2
21701093,1626163,CHA,DAL,Frank Kaminsky,115,24.15,24,0.149999999999999,56,48,8,6,2
21701093,1626195,CHA,DAL,Willy Hernangomez,75,14.2166666666667,15,-0.783333333333333,32,23,9,10,-1
21701093,1626203,CHA,DAL,Treveon Graham,74,13.8,14,-0.199999999999999,31,27,4,4,0
21701093,1628370,CHA,DAL,Malik Monk,81,15.3,15,0.300000000000001,34,29,5,7,-2
21701093,1628407,CHA,DAL,Dwayne Bacon,135,27.65,27,0.649999999999999,65,56,9,7,2
21701094,2544,CLE,BKN,LeBron James,177,37.8,38,-0.200000000000003,101,92,9,11,-2
21701094,2747,CLE,BKN,JR Smith,89,18.8,19,-0.199999999999999,42,50,-8,-10,2
21701094,101181,CLE,BKN,Jose Calderon,77,16.0833333333333,16,0.0833333333333357,37,35,2,4,-2
21701094,201567,CLE,BKN,Kevin Love,149,32.3666666666667,33,-0.633333333333333,86,69,17,17,0
21701094,201588,CLE,BKN,George Hill,165,36.8666666666667,37,-0.13333333333334,93,80,13,13,0
21701094,202684,CLE,BKN,Tristan Thompson,70,15.4333333333333,15,0.433333333333334,39,41,-2,-4,2
21701094,203903,CLE,BKN,Jordan Clarkson,126,28.45,28,0.449999999999999,79,73,6,8,-2
21701094,203918,CLE,BKN,Rodney Hood,147,32.9333333333333,33,-0.0666666666666629,87,79,8,6,2
21701094,204066,CLE,BKN,John Holland,13,2.56666666666667,3,-0.433333333333334,5,12,-7,-5,-2
21701094,1626204,CLE,BKN,Larry Nance Jr.,82,16.8666666666667,17,-0.133333333333333,36,39,-3,-5,2
21701094,201960,BKN,CLE,DeMarre Carroll,154,33.3833333333333,34,-0.616666666666667,88,84,4,4,0
21701094,201967,BKN,CLE,Dante Cunningham,98,21.6,22,-0.399999999999999,48,53,-5,-5,0
21701094,203459,BKN,CLE,Allen Crabbe,123,26.9833333333333,28,-1.01666666666667,61,74,-13,-12,-1
21701094,203915,BKN,CLE,Spencer Dinwiddie,115,24.4333333333333,25,-0.566666666666666,55,59,-4,-2,-2
21701094,203925,BKN,CLE,Joe Harris,123,27.4,27,0.399999999999999,77,67,10,8,2
21701094,1626156,BKN,CLE,D'Angelo Russell,118,25.9666666666667,26,-0.0333333333333314,52,72,-20,-18,-2
21701094,1626178,BKN,CLE,Rondae Hollis-Jefferson,149,32.5166666666667,33,-0.483333333333334,71,83,-12,-12,0
21701094,1627747,BKN,CLE,Caris LeVert,113,24.75,25,-0.25,66,61,5,2,3
21701094,1628386,BKN,CLE,Jarrett Allen,102,21.1333333333333,21,0.133333333333333,52,52,0,0,0
21701095,1891,MIL,SAS,Jason Terry,138,28.6166666666667,29,-0.383333333333333,65,60,5,6,-1
21701095,201943,MIL,SAS,Brandon Jennings,65,14.7166666666667,15,-0.283333333333335,25,35,-10,-12,2
21701095,202339,MIL,SAS,Eric Bledsoe,153,31.9166666666667,32,-0.0833333333333357,79,64,15,18,-3
21701095,203089,MIL,SAS,John Henson,135,29.2833333333333,29,0.283333333333335,69,56,13,12,1
21701095,203092,MIL,SAS,Tyler Zeller,27,5.53333333333333,6,-0.466666666666667,16,16,0,1,-1
21701095,203114,MIL,SAS,Khris Middleton,168,36.8833333333333,37,-0.116666666666667,84,73,11,11,0
21701095,203498,MIL,SAS,Shabazz Muhammad,49,10.1666666666667,10,0.166666666666668,19,31,-12,-13,1
21701095,203503,MIL,SAS,Tony Snell,61,13.6333333333333,13,0.633333333333333,29,28,1,1,0
21701095,203507,MIL,SAS,Giannis Antetokounmpo,173,37.8166666666667,38,-0.183333333333337,84,77,7,6,1
21701095,203953,MIL,SAS,Jabari Parker,85,18.25,18,0.25,39,44,-5,-5,0
21701095,1627748,MIL,SAS,Thon Maker,61,13.1833333333333,13,0.183333333333334,21,31,-10,-10,0
21701095,1938,SAS,MIL,Manu Ginobili,78,15.7333333333333,16,-0.266666666666666,34,42,-8,-7,-1
21701095,2200,SAS,MIL,Pau Gasol,113,24.05,24,0.0500000000000007,58,49,9,8,1
21701095,2225,SAS,MIL,Tony Parker,91,18.8166666666667,18,0.816666666666666,40,49,-9,-12,3
21701095,200746,SAS,MIL,LaMarcus Aldridge,145,31.9833333333333,32,-0.0166666666666657,67,67,0,1,-1
21701095,200752,SAS,MIL,Rudy Gay,92,18.2166666666667,18,0.216666666666669,42,47,-5,-7,2
21701095,201980,SAS,MIL,Danny Green,129,28.6166666666667,28,0.616666666666667,59,61,-2,-3,1
21701095,201988,SAS,MIL,Patty Mills,144,31.3666666666667,32,-0.633333333333333,69,68,1,3,-2
21701095,202722,SAS,MIL,Davis Bertans,7,1.6,1,0.6,4,2,2,1,1
21701095,203937,SAS,MIL,Kyle Anderson,105,23.8,24,-0.200000000000003,45,50,-5,-2,-3
21701095,1627749,SAS,MIL,Dejounte Murray,128,28.8333333333333,29,-0.166666666666664,61,55,6,7,-1
21701095,1627854,SAS,MIL,Bryn Forbes,83,16.9833333333333,17,-0.0166666666666657,36,40,-4,-4,0
21701096,2548,MIA,IND,Dwyane Wade,116,27.0833333333333,27,0.0833333333333322,50,62,-12,-12,0
21701096,201609,MIA,IND,Goran Dragic,153,35.7333333333333,36,-0.266666666666666,76,76,0,2,-2
21701096,201949,MIA,IND,James Johnson,146,34,34,0,70,69,1,-1,2
21701096,201961,MIA,IND,Wayne Ellington,119,27.5166666666667,27,0.516666666666666,51,64,-13,-12,-1
21701096,203482,MIA,IND,Kelly Olynyk,137,32.3666666666667,32,0.366666666666667,63,65,-2,-1,-1
21701096,204020,MIA,IND,Tyler Johnson,125,29.15,29,0.149999999999999,67,56,11,11,0
21701096,1626159,MIA,IND,Justise Winslow,83,19,19,0,34,44,-10,-10,0
21701096,1626196,MIA,IND,Josh Richardson,173,39.2833333333333,40,-0.716666666666669,77,81,-4,-5,1
21701096,1628389,MIA,IND,Bam Adebayo,93,20.7,21,-0.300000000000001,47,48,-1,-2,1
21701096,201152,IND,MIA,Thaddeus Young,154,35.9,36,-0.100000000000001,78,74,4,2,2
21701096,201954,IND,MIA,Darren Collison,128,30.2166666666667,30,0.216666666666665,61,66,-5,-3,-2
21701096,202344,IND,MIA,Trevor Booker,96,21.6166666666667,22,-0.383333333333333,44,45,-1,-4,3
21701096,202362,IND,MIA,Lance Stephenson,97,22.2166666666667,22,0.216666666666669,51,44,7,8,-1
21701096,202709,IND,MIA,Cory Joseph,134,31.0333333333333,31,0.0333333333333314,69,59,10,8,2
21701096,202711,IND,MIA,Bojan Bogdanovic,165,37.4,38,-0.599999999999994,83,78,5,2,3
21701096,203506,IND,MIA,Victor Oladipo,169,39.6666666666667,40,-0.333333333333329,77,81,-4,-2,-2
21701096,203922,IND,MIA,Glenn Robinson III,68,14.8833333333333,15,-0.116666666666667,35,24,11,11,0
21701096,1626167,IND,MIA,Myles Turner,134,31.9,32,-0.100000000000001,67,64,3,8,-5
21701097,101150,LAC,TOR,Lou Williams,167,34.8833333333333,35,-0.116666666666667,91,83,8,8,0
21701097,201599,LAC,TOR,DeAndre Jordan,152,31.95,32,-0.0499999999999972,67,77,-10,-8,-2
21701097,202325,LAC,TOR,Wesley Johnson,94,20.0333333333333,20,0.0333333333333314,36,44,-8,-6,-2
21701097,202699,LAC,TOR,Tobias Harris,158,32.7333333333333,33,-0.266666666666666,82,66,16,16,0
21701097,203085,LAC,TOR,Austin Rivers,165,33.9833333333333,34,-0.0166666666666657,74,78,-4,-4,0
21701097,1626149,LAC,TOR,Montrezl Harrell,97,19.6166666666667,19,0.616666666666667,54,42,12,12,0
21701097,1626155,LAC,TOR,Sam Dekker,17,3.21666666666667,3,0.216666666666667,7,9,-2,-2,0
21701097,1626246,LAC,TOR,Boban Marjanovic,32,6.18333333333333,6,0.183333333333334,22,10,12,10,2
21701097,1628414,LAC,TOR,Sindarius Thornwell,117,23.6833333333333,23,0.683333333333334,72,51,21,19,2
21701097,1628462,LAC,TOR,Milos Teodosic,161,32.8833333333333,33,-0.116666666666667,80,70,10,10,0
21701097,101139,TOR,LAC,CJ Miles,101,20.9833333333333,21,-0.0166666666666657,46,60,-14,-14,0
21701097,200768,TOR,LAC,Kyle Lowry,179,37.35,38,-0.650000000000006,88,80,8,8,0
21701097,201586,TOR,LAC,Serge Ibaka,145,29.5333333333333,30,-0.466666666666669,63,72,-9,-8,-1
21701097,201942,TOR,LAC,DeMar DeRozan,166,33.8,34,-0.200000000000003,74,77,-3,-3,0
21701097,202685,TOR,LAC,Jonas Valanciunas,92,19.9833333333333,20,-0.0166666666666657,52,41,11,9,2
21701097,1626153,TOR,LAC,Delon Wright,59,12.2666666666667,13,-0.733333333333334,21,34,-13,-13,0
21701097,1627751,TOR,LAC,Jakob Poeltl,128,25.5833333333333,25,0.583333333333336,51,65,-14,-14,0
21701097,1627783,TOR,LAC,Pascal Siakam,92,19.2333333333333,19,0.233333333333334,43,51,-8,-7,-1
21701097,1627832,TOR,LAC,Fred VanVleet,104,22.3666666666667,22,0.366666666666667,50,66,-16,-16,0
21701097,1628384,TOR,LAC,OG Anunoby,94,18.0666666666667,18,0.0666666666666664,42,39,3,3,0
21701098,201563,NYK,WAS,Michael Beasley,155,31.9,32,-0.100000000000001,72,63,9,9,0
21701098,201584,NYK,WAS,Courtney Lee,130,27.3166666666667,27,0.316666666666666,68,63,5,7,-2
21701098,202498,NYK,WAS,Lance Thomas,90,18.45,19,-0.550000000000001,36,41,-5,-5,0
21701098,202683,NYK,WAS,Enes Kanter,127,26.9666666666667,27,-0.0333333333333314,51,56,-5,-5,0
21701098,203501,NYK,WAS,Tim Hardaway Jr.,170,35.5833333333333,35,0.583333333333329,67,67,0,0,0
21701098,203504,NYK,WAS,Trey Burke,129,26.9833333333333,27,-0.0166666666666657,50,51,-1,-5,4
21701098,1626144,NYK,WAS,Emmanuel Mudiay,94,20.9333333333333,21,-0.0666666666666664,50,46,4,8,-4
21701098,1627786,NYK,WAS,Troy Williams,56,12.4166666666667,13,-0.583333333333334,34,30,4,4,0
21701098,1628373,NYK,WAS,Frank Ntilikina,96,20.6833333333333,21,-0.316666666666666,33,34,-1,-3,2
21701098,1628436,NYK,WAS,Luke Kornet,83,18.7666666666667,19,-0.233333333333334,44,34,10,10,0
21701098,101133,WAS,NYK,Ian Mahinmi,39,7.6,7,0.6,21,23,-2,-4,2
21701098,101162,WAS,NYK,Marcin Gortat,75,14.7833333333333,15,-0.216666666666667,27,32,-5,-2,-3
21701098,201160,WAS,NYK,Jason Smith,27,6.68333333333333,6,0.683333333333334,12,13,-1,-1,0
21701098,201196,WAS,NYK,Ramon Sessions,79,16.55,16,0.549999999999997,35,43,-8,-7,-1
21701098,201975,WAS,NYK,Jodie Meeks,26,4.91666666666667,5,-0.0833333333333339,13,19,-6,-6,0
21701098,202693,WAS,NYK,Markieff Morris,160,33.7166666666667,34,-0.283333333333331,64,65,-1,1,-2
21701098,203078,WAS,NYK,Bradley Beal,185,38.85,39,-0.150000000000006,74,75,-1,-1,0
21701098,203107,WAS,NYK,Tomas Satoransky,162,35.6833333333333,36,-0.316666666666663,72,65,7,6,1
21701098,203118,WAS,NYK,Mike Scott,116,26.1,26,0.100000000000001,53,55,-2,-2,0
21701098,203490,WAS,NYK,Otto Porter Jr.,139,28.2166666666667,29,-0.783333333333331,59,55,4,4,0
21701098,1626162,WAS,NYK,Kelly Oubre Jr.,122,26.9,27,-0.100000000000001,55,60,-5,-8,3
21701099,201143,BOS,SAC,Al Horford,131,31.5333333333333,32,-0.466666666666669,75,64,11,10,1
21701099,202328,BOS,SAC,Greg Monroe,89,20.8,20,0.800000000000001,34,47,-13,-11,-2
21701099,203382,BOS,SAC,Aron Baynes,93,23.4833333333333,24,-0.516666666666666,60,39,21,23,-2
21701099,203499,BOS,SAC,Shane Larkin,76,18.4166666666667,18,0.416666666666664,36,39,-3,-3,0
21701099,1626179,BOS,SAC,Terry Rozier,144,35.45,36,-0.549999999999997,82,64,18,18,0
21701099,1627759,BOS,SAC,Jaylen Brown,104,25,25,0,65,41,24,24,0
21701099,1627824,BOS,SAC,Guerschon Yabusele,37,8.53333333333333,9,-0.466666666666667,16,17,-1,-1,0
21701099,1627846,BOS,SAC,Abdel Nader,47,11.9666666666667,12,-0.0333333333333332,24,35,-11,-11,0
21701099,1628369,BOS,SAC,Jayson Tatum,118,27.6333333333333,28,-0.366666666666667,56,53,3,3,0
21701099,1628400,BOS,SAC,Semi Ojeleye,113,27.7,28,-0.300000000000001,53,53,0,-3,3
21701099,1628443,BOS,SAC,Kadeem Allen,1,0.133333333333333,0,0.133333333333333,,2,,-2,
21701099,1628444,BOS,SAC,Jabari Bird,37,8.76666666666667,9,-0.233333333333334,19,11,8,8,0
21701099,1713,SAC,BOS,Vince Carter,87,21.5833333333333,22,-0.416666666666668,40,36,4,3,1
21701099,201585,SAC,BOS,Kosta Koufos,106,26,26,0,48,49,-1,-1,0
21701099,203992,SAC,BOS,Bogdan Bogdanovic,141,34.1166666666667,34,0.116666666666667,65,81,-16,-16,0
21701099,1626161,SAC,BOS,Willie Cauley-Stein,135,32.3833333333333,33,-0.616666666666667,62,73,-11,-11,0
21701099,1627741,SAC,BOS,Buddy Hield,105,25.3833333333333,26,-0.616666666666667,46,53,-7,-7,0
21701099,1627746,SAC,BOS,Skal Labissiere,125,29.5666666666667,30,-0.433333333333334,64,73,-9,-8,-1
21701099,1628368,SAC,BOS,De'Aaron Fox,114,26.3166666666667,26,0.316666666666666,56,63,-7,-9,2
21701099,1628382,SAC,BOS,Justin Jackson,93,22.5,22,0.5,47,51,-4,-4,0
21701099,1628412,SAC,BOS,Frank Mason,84,21.5666666666667,22,-0.433333333333334,37,41,-4,-2,-2
21701100,202323,POR,OKC,Evan Turner,65,13.3833333333333,14,-0.616666666666667,25,34,-9,-11,2
21701100,202329,POR,OKC,Al-Farouq Aminu,160,33.1333333333333,33,0.133333333333333,77,66,11,13,-2
21701100,202334,POR,OKC,Ed Davis,79,18.1333333333333,18,0.133333333333333,38,48,-10,-14,4
21701100,203081,POR,OKC,Damian Lillard,190,38.6833333333333,38,0.683333333333337,93,77,16,16,0
21701100,203090,POR,OKC,Maurice Harkless,158,34.5666666666667,34,0.566666666666663,83,71,12,14,-2
21701100,203468,POR,OKC,CJ McCollum,165,37.6666666666667,38,-0.333333333333336,93,78,15,17,-2
21701100,203894,POR,OKC,Shabazz Napier,46,11.65,12,-0.350000000000001,15,37,-22,-22,0
21701100,203994,POR,OKC,Jusuf Nurkic,142,29.7333333333333,30,-0.266666666666666,69,57,12,17,-5
21701100,1626192,POR,OKC,Pat Connaughton,62,12.65,12,0.65,24,29,-5,-6,1
21701100,1628380,POR,OKC,Zach Collins,48,10.15,10,0.149999999999999,23,28,-5,-9,4
21701100,2546,OKC,POR,Carmelo Anthony,145,29.75,29,0.75,58,71,-13,-15,2
21701100,101109,OKC,POR,Raymond Felton,75,17.2166666666667,18,-0.783333333333331,44,38,6,9,-3
21701100,201147,OKC,POR,Corey Brewer,133,27.25,27,0.25,54,69,-15,-17,2
21701100,201566,OKC,POR,Russell Westbrook,166,35.7666666666667,36,-0.233333333333334,77,78,-1,-2,1
21701100,202331,OKC,POR,Paul George,185,38.7833333333333,39,-0.216666666666669,74,91,-17,-17,0
21701100,202335,OKC,POR,Patrick Patterson,51,12.1166666666667,12,0.116666666666667,31,31,0,3,-3
21701100,203500,OKC,POR,Steven Adams,172,35.8333333333333,36,-0.166666666666671,74,77,-3,-6,3
21701100,203518,OKC,POR,Alex Abrines,38,9.16666666666667,9,0.166666666666668,31,17,14,14,0
21701100,203924,OKC,POR,Jerami Grant,78,18.2,19,-0.800000000000001,47,37,10,12,-2
21701100,1628390,OKC,POR,Terrance Ferguson,72,15.6666666666667,16,-0.333333333333332,35,31,4,4,0
21701101,203473,ATL,HOU,Dewayne Dedmon,126,29.45,30,-0.550000000000001,65,77,-12,-12,0
21701101,203488,ATL,HOU,Mike Muscala,128,26.7666666666667,27,-0.233333333333334,58,67,-9,-7,-2
21701101,203705,ATL,HOU,Josh Magette,73,15.9833333333333,16,-0.0166666666666657,30,34,-4,-4,0
21701101,1627752,ATL,HOU,Taurean Prince,169,37.35,37,0.349999999999994,84,96,-12,-14,2
21701101,1627814,ATL,HOU,Damion Lee,106,24.6,25,-0.399999999999999,48,58,-10,-12,2
21701101,1627819,ATL,HOU,Isaiah Taylor,141,31.5166666666667,32,-0.483333333333334,69,84,-15,-15,0
21701101,1628381,ATL,HOU,John Collins,102,24.8833333333333,25,-0.116666666666667,46,54,-8,-10,2
21701101,1628416,ATL,HOU,Tyler Dorsey,132,28.2833333333333,29,-0.716666666666669,57,63,-6,-4,-2
21701101,1628463,ATL,HOU,Tyler Cavanaugh,36,6.2,6,0.2,14,16,-2,-2,0
21701101,1628510,ATL,HOU,Andrew White III,57,12.4666666666667,12,0.466666666666667,24,41,-17,-15,-2
21701101,2207,HOU,ATL,Joe Johnson,129,28.5333333333333,29,-0.466666666666669,73,59,14,14,0
21701101,2403,HOU,ATL,Nene,64,14.8333333333333,15,-0.166666666666666,37,22,15,13,2
21701101,2772,HOU,ATL,Trevor Ariza,140,30.75,31,-0.25,73,64,9,9,0
21701101,101123,HOU,ATL,Gerald Green,142,31.9666666666667,32,-0.033333333333335,70,64,6,8,-2
21701101,200782,HOU,ATL,PJ Tucker,130,29.9666666666667,30,-0.0333333333333314,76,62,14,14,0
21701101,201569,HOU,ATL,Eric Gordon,143,32.5166666666667,32,0.516666666666666,86,67,19,19,0
21701101,201935,HOU,ATL,James Harden,138,30.2333333333333,30,0.233333333333334,80,64,16,14,2
21701101,203991,HOU,ATL,Clint Capela,123,27.6,28,-0.399999999999999,68,65,3,3,0
21701101,204028,HOU,ATL,Tarik Black,27,5.06666666666667,5,0.0666666666666664,13,12,1,3,-2
21701101,1626154,HOU,ATL,RJ Hunter,17,3.01666666666667,3,0.0166666666666666,7,8,-1,-1,0
21701101,1627753,HOU,ATL,Zhou Qi,17,3.01666666666667,3,0.0166666666666666,7,8,-1,-1,0
21701102,2561,GSW,UTA,David West,54,12.6833333333333,13,-0.316666666666666,23,33,-10,-10,0
21701102,2585,GSW,UTA,Zaza Pachulia,56,11.45,11,0.449999999999999,25,27,-2,-1,-1
21701102,2733,GSW,UTA,Shaun Livingston,83,18.1666666666667,18,0.166666666666664,39,48,-9,-11,2
21701102,2738,GSW,UTA,Andre Iguodala,96,19.45,19,0.450000000000003,40,47,-7,-6,-1
21701102,201156,GSW,UTA,Nick Young,172,37.6333333333333,38,-0.366666666666667,69,85,-16,-15,-1
21701102,201580,GSW,UTA,JaVale McGee,90,17.9,18,-0.100000000000001,28,39,-11,-12,1
21701102,1626172,GSW,UTA,Kevon Looney,118,24.4666666666667,24,0.466666666666669,40,57,-17,-17,0
21701102,1626188,GSW,UTA,Quinn Cook,165,34.8166666666667,35,-0.183333333333337,61,76,-15,-11,-4
21701102,1627745,GSW,UTA,Damian Jones,50,11.6833333333333,12,-0.316666666666666,26,21,5,5,0
21701102,1627775,GSW,UTA,Patrick McCaw,150,32.9333333333333,33,-0.0666666666666629,64,74,-10,-14,4
21701102,1628395,GSW,UTA,Jordan Bell,76,17.15,18,-0.850000000000001,40,43,-3,-3,0
21701102,201937,UTA,GSW,Ricky Rubio,125,26.1666666666667,26,0.166666666666664,56,41,15,15,0
21701102,201973,UTA,GSW,Jonas Jerebko,41,9.21666666666667,9,0.216666666666665,17,23,-6,-7,1
21701102,202324,UTA,GSW,Derrick Favors,113,23.8666666666667,24,-0.133333333333333,63,47,16,14,2
21701102,202327,UTA,GSW,Ekpe Udoh,17,3.9,4,-0.1,6,11,-5,-5,0
21701102,202692,UTA,GSW,Alec Burks,17,3.9,4,-0.1,6,11,-5,-5,0
21701102,203109,UTA,GSW,Jae Crowder,145,30.1666666666667,30,0.166666666666664,74,57,17,19,-2
21701102,203497,UTA,GSW,Rudy Gobert,144,31.0166666666667,31,0.0166666666666657,64,52,12,14,-2
21701102,203957,UTA,GSW,Dante Exum,80,17.1833333333333,17,0.183333333333334,42,37,5,5,0
21701102,204060,UTA,GSW,Joe Ingles,149,31.9333333333333,32,-0.06666666666667,80,51,29,30,-1
21701102,204065,UTA,GSW,David Stockton,12,2.7,3,-0.3,6,11,-5,-5,0
21701102,1626220,UTA,GSW,Royce O'Neale,108,24.9,25,-0.100000000000001,59,49,10,10,0
21701102,1627777,UTA,GSW,Georges Niang,12,2.7,3,-0.3,6,11,-5,-5,0
21701102,1628378,UTA,GSW,Donovan Mitchell,147,30.6833333333333,31,-0.316666666666666,71,54,17,15,2
21701103,201563,NYK,CHA,Michael Beasley,167,34.5,35,-0.5,81,89,-8,-8,0
21701103,201584,NYK,CHA,Courtney Lee,146,32.0833333333333,32,0.0833333333333286,78,89,-11,-9,-2
21701103,202498,NYK,CHA,Lance Thomas,91,19.6666666666667,20,-0.333333333333336,53,57,-4,-4,0
21701103,202683,NYK,CHA,Enes Kanter,155,32.8,33,-0.200000000000003,83,76,7,7,0
21701103,203501,NYK,CHA,Tim Hardaway Jr.,176,36.2333333333333,36,0.233333333333334,85,89,-4,-4,0
21701103,203504,NYK,CHA,Trey Burke,192,40.5,41,-0.5,105,101,4,2,2
21701103,1627786,NYK,CHA,Troy Williams,75,16.5166666666667,17,-0.483333333333334,43,48,-5,-5,0
21701103,1628373,NYK,CHA,Frank Ntilikina,91,17.4333333333333,18,-0.566666666666666,31,44,-13,-13,0
21701103,1628436,NYK,CHA,Luke Kornet,125,26.4,27,-0.600000000000001,68,69,-1,0,-1
21701103,1628439,NYK,CHA,Isaiah Hicks,37,7.61666666666667,8,-0.383333333333333,13,23,-10,-11,1
21701103,2730,CHA,NYK,Dwight Howard,166,35.6833333333333,36,-0.316666666666663,93,78,15,15,0
21701103,101107,CHA,NYK,Marvin Williams,140,29.75,30,-0.25,78,70,8,8,0
21701103,201587,CHA,NYK,Nicolas Batum,122,23.9666666666667,24,-0.0333333333333314,55,57,-2,-1,-1
21701103,202689,CHA,NYK,Kemba Walker,178,38.4,39,-0.600000000000001,99,88,11,10,1
21701103,203077,CHA,NYK,Michael Kidd-Gilchrist,111,21.9333333333333,22,-0.06666666666667,50,52,-2,-2,0
21701103,203087,CHA,NYK,Jeremy Lamb,124,27.4333333333333,28,-0.56666666666667,80,67,13,12,1
21701103,1626163,CHA,NYK,Frank Kaminsky,111,23,23,0,59,58,1,1,0
21701103,1626195,CHA,NYK,Willy Hernangomez,85,17.0666666666667,17,0.0666666666666664,44,50,-6,-6,0
21701103,1628370,CHA,NYK,Malik Monk,78,15.7,16,-0.300000000000001,40,44,-4,-3,-1
21701103,1628407,CHA,NYK,Dwayne Bacon,140,30.8166666666667,31,-0.183333333333334,87,76,11,11,0
21701104,101112,LAL,DET,Channing Frye,34,7,7,0,18,18,0,1,-1
21701104,201572,LAL,DET,Brook Lopez,145,31.3,32,-0.700000000000003,64,71,-7,-5,-2
21701104,203484,LAL,DET,Kentavious Caldwell-Pope,178,37.95,38,-0.0499999999999972,78,83,-5,-6,1
21701104,203898,LAL,DET,Tyler Ennis,90,18.1833333333333,18,0.183333333333334,49,48,1,3,-2
21701104,203944,LAL,DET,Julius Randle,148,31.9166666666667,32,-0.0833333333333357,66,72,-6,-7,1
21701104,204037,LAL,DET,Travis Wear,87,17.45,17,0.449999999999999,43,42,1,-1,2
21701104,1627780,LAL,DET,Gary Payton II,13,2.76666666666667,3,-0.233333333333333,8,10,-2,-2,0
21701104,1627826,LAL,DET,Ivica Zubac,43,8.26666666666667,9,-0.733333333333333,22,21,1,0,1
21701104,1628366,LAL,DET,Lonzo Ball,202,42.8666666666667,43,-0.133333333333333,92,97,-5,-4,-1
21701104,1628398,LAL,DET,Kyle Kuzma,192,40.7333333333333,41,-0.266666666666666,89,98,-9,-9,0
21701104,1628418,LAL,DET,Thomas Bryant,3,0.4,1,-0.6,1,0,1,0,1
21701104,201229,DET,LAL,Anthony Tolliver,138,28.3166666666667,28,0.316666666666666,64,62,2,6,-4
21701104,201933,DET,LAL,Blake Griffin,112,23.8,24,-0.200000000000003,58,51,7,3,4
21701104,202397,DET,LAL,Ish Smith,98,20.5833333333333,20,0.583333333333336,53,47,6,6,0
21701104,202704,DET,LAL,Reggie Jackson,129,27.1833333333333,28,-0.816666666666666,59,59,0,1,-1
21701104,203083,DET,LAL,Andre Drummond,183,39.1333333333333,39,0.133333333333333,97,87,10,11,-1
21701104,203493,DET,LAL,Reggie Bullock,140,29.4166666666667,30,-0.583333333333332,65,62,3,5,-2
21701104,203516,DET,LAL,James Ennis III,89,17.9833333333333,18,-0.0166666666666657,49,47,2,-1,3
21701104,203961,DET,LAL,Eric Moreland,21,4.28333333333333,4,0.283333333333333,5,12,-7,-6,-1
21701104,1626169,DET,LAL,Stanley Johnson,138,29.7833333333333,30,-0.216666666666669,63,59,4,8,-4
21701104,1628379,DET,LAL,Luke Kennard,87,18.35,19,-0.649999999999999,47,44,3,2,1
21701105,2734,DEN,PHI,Devin Harris,109,20.55,21,-0.450000000000003,47,50,-3,-1,-2
21701105,200794,DEN,PHI,Paul Millsap,153,31.4,32,-0.600000000000001,67,74,-7,-9,2
21701105,201163,DEN,PHI,Wilson Chandler,171,34.9666666666667,35,-0.0333333333333314,74,80,-6,-7,1
21701105,203115,DEN,PHI,Will Barton,180,36.3833333333333,36,0.383333333333333,80,91,-11,-11,0
21701105,203486,DEN,PHI,Mason Plumlee,74,13.7333333333333,13,0.733333333333334,30,41,-11,-11,0
21701105,203999,DEN,PHI,Nikola Jokic,147,30.3833333333333,31,-0.616666666666667,68,71,-3,-6,3
21701105,1626168,DEN,PHI,Trey Lyles,61,11.6833333333333,12,-0.316666666666666,26,35,-9,-9,0
21701105,1627736,DEN,PHI,Malik Beasley,27,4.83333333333333,5,-0.166666666666667,13,16,-3,-3,0
21701105,1627750,DEN,PHI,Jamal Murray,177,35.2666666666667,36,-0.733333333333334,74,97,-23,-22,-1
21701105,1627823,DEN,PHI,Juancho Hernangomez,17,2.96666666666667,3,-0.0333333333333332,11,12,-1,-1,0
21701105,1628470,DEN,PHI,Torrey Craig,89,17.3333333333333,17,0.333333333333336,30,48,-18,-15,-3
21701105,101141,PHI,DEN,Ersan Ilyasova,124,23.8833333333333,24,-0.116666666666667,68,55,13,15,-2
21701105,101161,PHI,DEN,Amir Johnson,70,14.5166666666667,15,-0.483333333333334,28,36,-8,-10,2
21701105,200755,PHI,DEN,JJ Redick,145,26.9833333333333,27,-0.0166666666666657,79,61,18,19,-1
21701105,201158,PHI,DEN,Marco Belinelli,94,20.6,20,0.600000000000001,42,40,2,3,-1
21701105,203496,PHI,DEN,Robert Covington,175,33.7333333333333,34,-0.266666666666666,97,70,27,23,4
21701105,203954,PHI,DEN,Joel Embiid,139,27.0833333333333,27,0.0833333333333357,73,55,18,20,-2
21701105,203967,PHI,DEN,Dario Saric,141,28.8333333333333,29,-0.166666666666664,73,56,17,15,2
21701105,204456,PHI,DEN,T.J. McConnell,60,13,13,0,24,31,-7,-5,-2
21701105,1626158,PHI,DEN,Richaun Holmes,8,1.48333333333333,2,-0.516666666666667,4,6,-2,-2,0
21701105,1627732,PHI,DEN,Ben Simmons,167,33.7666666666667,34,-0.233333333333334,80,74,6,3,3
21701105,1627788,PHI,DEN,Furkan Korkmaz,8,1.48333333333333,2,-0.516666666666667,4,6,-2,-2,0
21701105,1628365,PHI,DEN,Markelle Fultz,74,14.1333333333333,14,0.133333333333333,43,30,13,16,-3
21701106,2037,MIN,MEM,Jamal Crawford,134,30.5666666666667,30,0.566666666666666,64,66,-2,2,-4
21701106,201952,MIN,MEM,Jeff Teague,186,42.55,42,0.549999999999997,82,79,3,1,2
21701106,201959,MIN,MEM,Taj Gibson,192,43.3666666666667,43,0.366666666666667,87,83,4,2,2
21701106,202357,MIN,MEM,Nemanja Bjelica,94,22.0333333333333,22,0.0333333333333314,35,53,-18,-12,-6
21701106,203476,MIN,MEM,Gorgui Dieng,64,13.85,14,-0.15,34,37,-3,-1,-2
21701106,203952,MIN,MEM,Andrew Wiggins,192,43.3666666666667,43,0.366666666666667,87,83,4,2,2
21701106,1626145,MIN,MEM,Tyus Jones,24,5.43333333333333,6,-0.566666666666666,11,22,-11,-5,-6
21701106,1626157,MIN,MEM,Karl-Anthony Towns,164,38.75,39,-0.25,65,82,-17,-9,-8
21701106,201188,MEM,MIN,Marc Gasol,150,34.3166666666667,34,0.316666666666663,71,66,5,5,0
21701106,201596,MEM,MIN,Mario Chalmers,66,14.1,14,0.0999999999999996,37,39,-2,-2,0
21701106,202718,MEM,MIN,Chandler Parsons,77,18.2,18,0.199999999999999,45,41,4,0,4
21701106,203210,MEM,MIN,JaMychal Green,172,39.6833333333333,40,-0.316666666666663,85,80,5,3,2
21701106,203463,MEM,MIN,Ben McLemore,35,7.65,8,-0.35,19,21,-2,0,-2
21701106,1626150,MEM,MIN,Andrew Harrison,144,33.8833333333333,34,-0.116666666666667,64,54,10,10,0
21701106,1626185,MEM,MIN,Jarell Martin,131,29.5333333333333,30,-0.466666666666669,52,44,8,10,-2
21701106,1627738,MEM,MIN,Deyonta Davis,60,13.6666666666667,14,-0.333333333333334,30,27,3,3,0
21701106,1627782,MEM,MIN,Wayne Selden,124,26.7833333333333,26,0.783333333333331,61,52,9,11,-2
21701106,1628415,MEM,MIN,Dillon Brooks,78,18.4833333333333,19,-0.516666666666666,32,30,2,2,0
21701106,1628424,MEM,MIN,Kobi Simmons,13,3.61666666666667,4,-0.383333333333333,9,11,-2,-2,0
21701107,201143,BOS,PHX,Al Horford,138,31.9333333333333,32,-0.06666666666667,77,64,13,11,2
21701107,202328,BOS,PHX,Greg Monroe,88,18.8333333333333,19,-0.166666666666664,36,41,-5,-7,2
21701107,202694,BOS,PHX,Marcus Morris,110,23.2,23,0.199999999999999,50,41,9,9,0
21701107,203382,BOS,PHX,Aron Baynes,78,18.2166666666667,18,0.216666666666669,40,26,14,16,-2
21701107,203499,BOS,PHX,Shane Larkin,100,21.25,21,0.25,38,49,-11,-11,0
21701107,1626179,BOS,PHX,Terry Rozier,135,31.3,31,0.299999999999997,72,59,13,13,0
21701107,1627759,BOS,PHX,Jaylen Brown,106,24.6333333333333,25,-0.366666666666667,44,44,0,5,-5
21701107,1627824,BOS,PHX,Guerschon Yabusele,2,0.216666666666667,0,0.216666666666667,2,3,-1,-1,0
21701107,1627846,BOS,PHX,Abdel Nader,79,16.6166666666667,17,-0.383333333333333,43,35,8,6,2
21701107,1628369,BOS,PHX,Jayson Tatum,136,32.2833333333333,32,0.283333333333331,70,62,8,7,1
21701107,1628400,BOS,PHX,Semi Ojeleye,89,20,20,0,34,40,-6,-6,0
21701107,1628443,BOS,PHX,Kadeem Allen,2,0.216666666666667,0,0.216666666666667,2,3,-1,-1,0
21701107,1628444,BOS,PHX,Jabari Bird,2,0.216666666666667,0,0.216666666666667,2,3,-1,-1,0
21701107,201162,PHX,BOS,Jared Dudley,37,7.2,7,0.2,13,19,-6,-6,0
21701107,203458,PHX,BOS,Alex Len,70,14.2166666666667,14,0.216666666666667,25,46,-21,-19,-2
21701107,203584,PHX,BOS,Troy Daniels,159,35.75,36,-0.25,73,84,-11,-11,0
21701107,203901,PHX,BOS,Elfrid Payton,59,14.2333333333333,15,-0.766666666666668,23,38,-15,-15,0
21701107,1626210,PHX,BOS,Alan Williams,70,15.7,16,-0.300000000000001,25,19,6,5,1
21701107,1627733,PHX,BOS,Dragan Bender,142,33.6666666666667,34,-0.333333333333329,64,58,6,3,3
21701107,1627737,PHX,BOS,Marquese Chriss,105,24.5166666666667,24,0.516666666666666,60,59,1,3,-2
21701107,1627755,PHX,BOS,Tyler Ulis,143,30.3,30,0.299999999999997,67,64,3,3,0
21701107,1627885,PHX,BOS,Shaquille Harrison,40,9.7,10,-0.300000000000001,15,6,9,7,2
21701107,1628367,PHX,BOS,Josh Jackson,168,39.1,39,0.100000000000001,78,85,-7,-7,0
21701107,1628432,PHX,BOS,Davon Reed,72,14.5333333333333,14,0.533333333333333,27,32,-5,-3,-2
21701108,1938,SAS,WAS,Manu Ginobili,55,11.4166666666667,11,0.416666666666668,24,21,3,3,0
21701108,2200,SAS,WAS,Pau Gasol,90,17.75,18,-0.25,33,46,-13,-12,-1
21701108,2225,SAS,WAS,Tony Parker,84,18.1833333333333,18,0.18333333333333,34,36,-2,-2,0
21701108,200746,SAS,WAS,LaMarcus Aldridge,73,17.5166666666667,18,-0.483333333333334,30,40,-10,-11,1
21701108,200752,SAS,WAS,Rudy Gay,74,16.1333333333333,16,0.133333333333333,32,33,-1,-1,0
21701108,201980,SAS,WAS,Danny Green,111,23.6666666666667,24,-0.333333333333336,44,67,-23,-23,0
21701108,201988,SAS,WAS,Patty Mills,114,25.9,26,-0.100000000000001,50,66,-16,-18,2
21701108,202722,SAS,WAS,Davis Bertans,93,19.1666666666667,19,0.166666666666668,52,45,7,7,0
21701108,203464,SAS,WAS,Brandon Paul,73,14.1333333333333,14,0.133333333333333,43,34,9,9,0
21701108,203530,SAS,WAS,Joffrey Lauvergne,79,16.0333333333333,16,0.0333333333333314,47,37,10,10,0
21701108,203937,SAS,WAS,Kyle Anderson,93,18.4666666666667,19,-0.533333333333335,51,50,1,3,-2
21701108,1627749,SAS,WAS,Dejounte Murray,103,23.0666666666667,23,0.0666666666666664,43,63,-20,-22,2
21701108,1627854,SAS,WAS,Bryn Forbes,88,17.9,18,-0.100000000000001,47,42,5,7,-2
21701108,101133,WAS,SAS,Ian Mahinmi,112,21.25,21,0.25,49,56,-7,-7,0
21701108,101162,WAS,SAS,Marcin Gortat,102,23.7166666666667,24,-0.283333333333331,57,44,13,13,0
21701108,201160,WAS,SAS,Jason Smith,37,6.36666666666667,7,-0.633333333333333,15,28,-13,-13,0
21701108,201196,WAS,SAS,Ramon Sessions,123,24.0833333333333,24,0.0833333333333357,60,62,-2,2,-4
21701108,201975,WAS,SAS,Jodie Meeks,109,20.4333333333333,20,0.433333333333334,53,53,0,-2,2
21701108,202693,WAS,SAS,Markieff Morris,70,16.3,17,-0.699999999999999,38,35,3,3,0
21701108,203078,WAS,SAS,Bradley Beal,117,27.4333333333333,28,-0.566666666666666,63,53,10,12,-2
21701108,203107,WAS,SAS,Tomas Satoransky,103,23.7833333333333,24,-0.216666666666669,56,44,12,8,4
21701108,203118,WAS,SAS,Mike Scott,103,21.5666666666667,21,0.566666666666666,53,38,15,15,0
21701108,203490,WAS,SAS,Otto Porter Jr.,98,22.8166666666667,23,-0.183333333333334,58,43,15,13,2
21701108,204025,WAS,SAS,Tim Frazier,21,3.58333333333333,4,-0.416666666666667,6,17,-11,-10,-1
21701108,1626162,WAS,SAS,Kelly Oubre Jr.,135,28,28,0,72,57,15,16,-1
21701109,2734,DEN,TOR,Devin Harris,102,23.0833333333333,23,0.0833333333333357,53,60,-7,-7,0
21701109,200794,DEN,TOR,Paul Millsap,138,30.1666666666667,30,0.166666666666664,65,76,-11,-11,0
21701109,201163,DEN,TOR,Wilson Chandler,151,32.4833333333333,33,-0.516666666666666,68,79,-11,-8,-3
21701109,203115,DEN,TOR,Will Barton,149,32.9666666666667,33,-0.0333333333333314,76,81,-5,-5,0
21701109,203486,DEN,TOR,Mason Plumlee,59,12.2833333333333,12,0.283333333333333,29,28,1,1,0
21701109,203999,DEN,TOR,Nikola Jokic,182,39.75,40,-0.25,91,87,4,4,0
21701109,1626168,DEN,TOR,Trey Lyles,54,13.6,14,-0.4,35,37,-2,-2,0
21701109,1627750,DEN,TOR,Jamal Murray,183,39.9166666666667,40,-0.0833333333333286,91,87,4,4,0
21701109,1628470,DEN,TOR,Torrey Craig,67,15.6666666666667,15,0.666666666666668,42,35,7,4,3
21701109,101139,TOR,DEN,CJ Miles,85,18.8166666666667,19,-0.183333333333334,51,38,13,13,0
21701109,200768,TOR,DEN,Kyle Lowry,154,33.3333333333333,33,0.333333333333329,75,74,1,1,0
21701109,201586,TOR,DEN,Serge Ibaka,115,24.7666666666667,25,-0.233333333333334,59,49,10,10,0
21701109,201942,TOR,DEN,DeMar DeRozan,144,30.5666666666667,30,0.566666666666666,68,67,1,1,0
21701109,202685,TOR,DEN,Jonas Valanciunas,103,22.0833333333333,23,-0.916666666666664,52,50,2,1,1
21701109,203512,TOR,DEN,Lucas Nogueira,33,7.55,7,0.55,13,18,-5,-4,-1
21701109,1626153,TOR,DEN,Delon Wright,73,17.4166666666667,18,-0.583333333333332,46,43,3,3,0
21701109,1626181,TOR,DEN,Norman Powell,14,3.26666666666667,3,0.266666666666667,11,4,7,5,2
21701109,1627751,TOR,DEN,Jakob Poeltl,81,18.35,18,0.350000000000001,49,42,7,7,0
21701109,1627783,TOR,DEN,Pascal Siakam,101,23.1833333333333,23,0.183333333333334,54,61,-7,-7,0
21701109,1627832,TOR,DEN,Fred VanVleet,106,24.4333333333333,25,-0.566666666666666,61,68,-7,-5,-2
21701109,1628384,TOR,DEN,OG Anunoby,76,16.15,16,0.149999999999999,31,36,-5,-5,0
21701110,2544,CLE,MIA,LeBron James,172,37.9,38,-0.0999999999999943,63,82,-19,-19,0
21701110,2747,CLE,MIA,JR Smith,69,16.1666666666667,16,0.166666666666664,20,35,-15,-15,0
21701110,101181,CLE,MIA,Jose Calderon,114,24.8166666666667,26,-1.18333333333333,44,44,0,1,-1
21701110,201145,CLE,MIA,Jeff Green,141,30.7333333333333,31,-0.266666666666666,50,58,-8,-7,-1
21701110,201567,CLE,MIA,Kevin Love,31,6.96666666666667,7,-0.0333333333333332,5,15,-10,-11,1
21701110,201588,CLE,MIA,George Hill,116,26.0833333333333,26,0.0833333333333322,47,52,-5,-5,0
21701110,202684,CLE,MIA,Tristan Thompson,82,17.25,17,0.25,31,31,0,0,0
21701110,203903,CLE,MIA,Jordan Clarkson,122,27.1666666666667,27,0.166666666666664,43,59,-16,-17,1
21701110,203918,CLE,MIA,Rodney Hood,115,25.2333333333333,26,-0.766666666666666,43,60,-17,-17,0
21701110,204066,CLE,MIA,John Holland,12,2.26666666666667,3,-0.733333333333333,6,4,2,2,0
21701110,1626204,CLE,MIA,Larry Nance Jr.,82,18.2166666666667,18,0.216666666666669,31,42,-11,-11,0
21701110,1627790,CLE,MIA,Ante Zizic,12,2.26666666666667,3,-0.733333333333333,6,4,2,2,0
21701110,1628506,CLE,MIA,London Perrantes,12,2.26666666666667,3,-0.733333333333333,6,4,2,2,0
21701110,2548,MIA,CLE,Dwyane Wade,77,17.85,17,0.850000000000001,43,21,22,22,0
21701110,201609,MIA,CLE,Goran Dragic,132,28.85,29,-0.149999999999999,58,54,4,4,0
21701110,201949,MIA,CLE,James Johnson,147,32.3333333333333,33,-0.666666666666664,73,55,18,16,2
21701110,201961,MIA,CLE,Wayne Ellington,100,22.1666666666667,22,0.166666666666668,40,36,4,4,0
21701110,202337,MIA,CLE,Luke Babbitt,7,1.13333333333333,2,-0.866666666666667,2,4,-2,0,-2
21701110,203482,MIA,CLE,Kelly Olynyk,113,25.5833333333333,25,0.583333333333332,56,35,21,19,2
21701110,203585,MIA,CLE,Rodney McGruder,7,1.13333333333333,2,-0.866666666666667,2,4,-2,0,-2
21701110,204020,MIA,CLE,Tyler Johnson,136,29.25,29,0.25,54,54,0,-2,2
21701110,1626159,MIA,CLE,Justise Winslow,115,25.3833333333333,26,-0.616666666666667,51,36,15,15,0
21701110,1626175,MIA,CLE,Jordan Mickey,103,21.8833333333333,23,-1.11666666666667,42,44,-2,0,-2
21701110,1626196,MIA,CLE,Josh Richardson,136,30.6333333333333,30,0.633333333333333,67,48,19,17,2
21701110,1627884,MIA,CLE,Derrick Jones Jr.,7,1.13333333333333,2,-0.866666666666667,2,4,-2,0,-2
21701111,203200,CHI,HOU,Justin Holiday,109,23.8666666666667,24,-0.133333333333333,34,69,-35,-36,1
21701111,203930,CHI,HOU,Sean Kilpatrick,91,17.7,18,-0.299999999999997,38,42,-4,-4,0
21701111,203943,CHI,HOU,Noah Vonleh,130,25.8,26,-0.199999999999999,53,56,-3,-4,1
21701111,1626166,CHI,HOU,Cameron Payne,108,22.9666666666667,23,-0.0333333333333314,29,67,-38,-38,0
21701111,1626170,CHI,HOU,Jerian Grant,85,17.8,18,-0.200000000000003,38,34,4,2,2
21701111,1626171,CHI,HOU,Bobby Portis,128,25.8333333333333,26,-0.166666666666664,45,59,-14,-14,0
21701111,1626245,CHI,HOU,Cristiano Felicio,54,11.2833333333333,11,0.283333333333333,19,31,-12,-10,-2
21701111,1627756,CHI,HOU,Denzel Valentine,149,28.9,29,-0.100000000000001,63,61,2,4,-2
21701111,1627853,CHI,HOU,Ryan Arcidiacono,40,6.86666666666667,7,-0.133333333333333,19,17,2,4,-2
21701111,1628021,CHI,HOU,David Nwaba,145,29.45,30,-0.550000000000001,51,73,-22,-23,1
21701111,1628374,CHI,HOU,Lauri Markkanen,126,27.7,28,-0.300000000000001,41,81,-40,-41,1
21701111,2207,HOU,CHI,Joe Johnson,144,28.5,29,-0.5,64,61,3,5,-2
21701111,2403,HOU,CHI,Nene,96,20.5166666666667,21,-0.483333333333334,59,25,34,32,2
21701111,2772,HOU,CHI,Trevor Ariza,120,26.2166666666667,26,0.216666666666669,72,36,36,36,0
21701111,101108,HOU,CHI,Chris Paul,134,27.85,28,-0.149999999999999,68,47,21,20,1
21701111,101123,HOU,CHI,Gerald Green,151,29.8333333333333,30,-0.166666666666668,65,63,2,2,0
21701111,200782,HOU,CHI,PJ Tucker,126,26.65,27,-0.350000000000001,64,39,25,25,0
21701111,201569,HOU,CHI,Eric Gordon,121,26.2166666666667,26,0.216666666666665,78,38,40,39,1
21701111,201583,HOU,CHI,Ryan Anderson,115,23.3666666666667,23,0.366666666666667,51,47,4,4,0
21701111,204028,HOU,CHI,Tarik Black,61,11.6333333333333,12,-0.366666666666667,31,29,2,2,0
21701111,1626154,HOU,CHI,RJ Hunter,53,9.66666666666667,10,-0.333333333333332,21,24,-3,-3,0
21701111,1627753,HOU,CHI,Zhou Qi,44,7.71666666666667,8,-0.283333333333333,17,21,-4,-2,-2
21701112,2731,NOP,POR,Emeka Okafor,77,15.4,15,0.4,32,21,11,11,0
21701112,201950,NOP,POR,Jrue Holiday,203,40.0666666666667,40,0.0666666666666629,88,85,3,5,-2
21701112,202703,NOP,POR,Nikola Mirotic,94,19.3833333333333,20,-0.616666666666667,38,50,-12,-12,0
21701112,202734,NOP,POR,E'Twaun Moore,162,32.3333333333333,32,0.333333333333329,70,63,7,7,0
21701112,203076,NOP,POR,Anthony Davis,193,38.7,39,-0.299999999999997,87,82,5,5,0
21701112,203121,NOP,POR,Darius Miller,148,29.9166666666667,30,-0.0833333333333357,63,78,-15,-17,2
21701112,203524,NOP,POR,Solomon Hill,110,20.85,21,-0.149999999999999,48,56,-8,-8,0
21701112,203546,NOP,POR,Ian Clark,134,28.0833333333333,29,-0.916666666666664,57,55,2,4,-2
21701112,203580,NOP,POR,Larry Drew II,3,0.433333333333333,0,0.433333333333333,2,2,0,-2,2
21701112,1627767,NOP,POR,Cheick Diallo,71,14.8333333333333,15,-0.166666666666668,30,43,-13,-13,0
21701112,202323,POR,NOP,Evan Turner,185,36.1833333333333,36,0.18333333333333,75,80,-5,-7,2
21701112,202329,POR,NOP,Al-Farouq Aminu,179,35.4666666666667,35,0.466666666666669,75,79,-4,-4,0
21701112,202334,POR,NOP,Ed Davis,87,17.55,18,-0.449999999999999,46,37,9,9,0
21701112,203081,POR,NOP,Damian Lillard,208,42.1166666666667,42,0.116666666666667,97,91,6,8,-2
21701112,203086,POR,NOP,Meyers Leonard,3,0.433333333333333,0,0.433333333333333,2,2,0,2,-2
21701112,203468,POR,NOP,CJ McCollum,189,36.8,37,-0.200000000000003,76,83,-7,-7,0
21701112,203894,POR,NOP,Shabazz Napier,82,17.8666666666667,18,-0.133333333333333,43,34,9,10,-1
21701112,203994,POR,NOP,Jusuf Nurkic,145,29.6,30,-0.399999999999999,59,62,-3,-7,4
21701112,1626192,POR,NOP,Pat Connaughton,57,11.45,11,0.449999999999999,30,23,7,8,-1
21701112,1628380,POR,NOP,Zach Collins,60,12.5333333333333,13,-0.466666666666667,32,24,8,8,0
21701113,1717,DAL,SAC,Dirk Nowitzki,88,19.5833333333333,20,-0.416666666666664,40,29,11,11,0
21701113,203084,DAL,SAC,Harrison Barnes,153,33.6833333333333,34,-0.316666666666663,73,63,10,8,2
21701113,203926,DAL,SAC,Doug McDermott,99,22.4833333333333,23,-0.516666666666666,47,44,3,3,0
21701113,1626151,DAL,SAC,Aaron Harrison,115,24.9,25,-0.100000000000001,56,56,0,0,0
21701113,1626257,DAL,SAC,Salah Mejri,91,19.85,20,-0.149999999999999,38,37,1,1,0
21701113,1627812,DAL,SAC,Yogi Ferrell,86,19.3,19,0.300000000000001,39,37,2,2,0
21701113,1627858,DAL,SAC,Kyle Collinsworth,121,25.7166666666667,26,-0.283333333333331,52,58,-6,-6,0
21701113,1627883,DAL,SAC,Jalen Jones,25,4.66666666666667,5,-0.333333333333334,7,17,-10,-10,0
21701113,1628372,DAL,SAC,Dennis Smith Jr.,109,24.5333333333333,25,-0.466666666666669,57,43,14,14,0
21701113,1628405,DAL,SAC,Johnathan Motley,57,11.7,11,0.699999999999999,29,33,-4,-4,0
21701113,1628467,DAL,SAC,Maxi Kleber,146,32.8333333333333,33,-0.166666666666671,77,68,9,11,-2
21701113,1713,SAC,DAL,Vince Carter,28,5.86666666666667,6,-0.133333333333333,9,10,-1,-1,0
21701113,201585,SAC,DAL,Kosta Koufos,69,14.2,14,0.199999999999999,29,36,-7,-5,-2
21701113,203960,SAC,DAL,JaKarr Sampson,84,18.0833333333333,18,0.0833333333333357,41,38,3,3,0
21701113,203992,SAC,DAL,Bogdan Bogdanovic,124,27.1166666666667,27,0.116666666666667,54,64,-10,-8,-2
21701113,203998,SAC,DAL,Bruno Caboclo,54,11.85,12,-0.15,27,28,-1,-1,0
21701113,1626161,SAC,DAL,Willie Cauley-Stein,106,24.8833333333333,25,-0.116666666666667,45,47,-2,-4,2
21701113,1627741,SAC,DAL,Buddy Hield,114,24.9,25,-0.100000000000001,52,47,5,3,2
21701113,1627746,SAC,DAL,Skal Labissiere,141,30.15,30,0.149999999999999,66,69,-3,-1,-2
21701113,1628368,SAC,DAL,De'Aaron Fox,109,25.0666666666667,25,0.0666666666666664,48,54,-6,-4,-2
21701113,1628382,SAC,DAL,Justin Jackson,139,31.0666666666667,31,0.0666666666666664,58,69,-11,-11,0
21701113,1628412,SAC,DAL,Frank Mason,122,26.0666666666667,26,0.0666666666666629,56,53,3,-1,4
21701114,2561,GSW,IND,David West,63,15.4833333333333,16,-0.516666666666668,23,30,-7,-7,0
21701114,2585,GSW,IND,Zaza Pachulia,51,11.8666666666667,12,-0.133333333333333,23,29,-6,-6,0
21701114,2733,GSW,IND,Shaun Livingston,80,18.6833333333333,19,-0.316666666666666,32,32,0,0,0
21701114,2738,GSW,IND,Andre Iguodala,112,25.4833333333333,26,-0.516666666666666,37,42,-5,-7,2
21701114,201156,GSW,IND,Nick Young,134,30.7666666666667,31,-0.233333333333334,53,67,-14,-14,0
21701114,201580,GSW,IND,JaVale McGee,54,11.6333333333333,12,-0.366666666666667,23,20,3,2,1
21701114,1626172,GSW,IND,Kevon Looney,121,27.7833333333333,28,-0.216666666666669,44,45,-1,0,-1
21701114,1626188,GSW,IND,Quinn Cook,159,36.3666666666667,36,0.366666666666667,64,70,-6,-6,0
21701114,1627745,GSW,IND,Damian Jones,21,4.8,5,-0.2,6,9,-3,-2,-1
21701114,1627775,GSW,IND,Patrick McCaw,140,32.2166666666667,33,-0.783333333333331,57,67,-10,-8,-2
21701114,1628395,GSW,IND,Jordan Bell,100,22.8333333333333,23,-0.166666666666664,43,49,-6,-7,1
21701114,201152,IND,GSW,Thaddeus Young,146,32.9833333333333,34,-1.01666666666667,69,59,10,10,0
21701114,201954,IND,GSW,Darren Collison,110,24.1,24,0.100000000000001,53,45,8,9,-1
21701114,202344,IND,GSW,Trevor Booker,6,1.71666666666667,2,-0.283333333333333,4,2,2,2,0
21701114,202362,IND,GSW,Lance Stephenson,86,20.6833333333333,21,-0.316666666666666,38,32,6,6,0
21701114,202709,IND,GSW,Cory Joseph,112,26.9666666666667,27,-0.033333333333335,46,40,6,4,2
21701114,202711,IND,GSW,Bojan Bogdanovic,129,29.8833333333333,31,-1.11666666666667,63,49,14,16,-2
21701114,203506,IND,GSW,Victor Oladipo,143,32.6,33,-0.399999999999999,67,60,7,7,0
21701114,203922,IND,GSW,Glenn Robinson III,67,15.75,16,-0.25,23,26,-3,-3,0
21701114,1626167,IND,GSW,Myles Turner,137,29.7,30,-0.299999999999997,58,59,-1,-1,0
21701114,1627734,IND,GSW,Domantas Sabonis,99,23.5333333333333,24,-0.466666666666669,39,33,6,5,1
21701115,101150,LAC,MIL,Lou Williams,177,37.2333333333333,37,0.233333333333334,76,70,6,6,0
21701115,201599,LAC,MIL,DeAndre Jordan,157,32.7833333333333,33,-0.216666666666669,76,74,2,2,0
21701115,202325,LAC,MIL,Wesley Johnson,108,22.95,23,-0.0499999999999972,64,53,11,13,-2
21701115,202699,LAC,MIL,Tobias Harris,176,36.8333333333333,37,-0.166666666666671,80,83,-3,-1,-2
21701115,203085,LAC,MIL,Austin Rivers,162,34.5833333333333,35,-0.416666666666664,76,83,-7,-7,0
21701115,1626149,LAC,MIL,Montrezl Harrell,68,14.9333333333333,15,-0.0666666666666664,29,24,5,5,0
21701115,1626155,LAC,MIL,Sam Dekker,34,7.15,7,0.15,20,11,9,9,0
21701115,1626246,LAC,MIL,Boban Marjanovic,18,4.16666666666667,4,0.166666666666666,5,6,-1,-1,0
21701115,1627820,LAC,MIL,Tyrone Wallace,59,13.0166666666667,13,0.0166666666666657,18,19,-1,-3,2
21701115,1628393,LAC,MIL,Jawun Evans,8,1.9,2,-0.1,3,0,3,3,0
21701115,1628414,LAC,MIL,Sindarius Thornwell,78,16.6166666666667,16,0.616666666666667,28,28,0,0,0
21701115,1628462,LAC,MIL,Milos Teodosic,80,16.4166666666667,16,0.416666666666668,50,39,11,9,2
21701115,1891,MIL,LAC,Jason Terry,152,31.3333333333333,32,-0.666666666666668,67,75,-8,-8,0
21701115,201943,MIL,LAC,Brandon Jennings,52,11.7,12,-0.300000000000001,17,21,-4,-6,2
21701115,202339,MIL,LAC,Eric Bledsoe,160,33.0833333333333,34,-0.916666666666671,75,80,-5,-3,-2
21701115,203089,MIL,LAC,John Henson,164,34.35,34,0.350000000000001,79,80,-1,-1,0
21701115,203092,MIL,LAC,Tyler Zeller,61,13.3666666666667,14,-0.633333333333333,19,25,-6,-6,0
21701115,203114,MIL,LAC,Khris Middleton,169,35.2666666666667,36,-0.733333333333334,79,84,-5,-5,0
21701115,203498,MIL,LAC,Shabazz Muhammad,25,4.91666666666667,5,-0.0833333333333339,8,11,-3,-3,0
21701115,203503,MIL,LAC,Tony Snell,33,6.98333333333333,7,-0.0166666666666666,12,16,-4,-4,0
21701115,203507,MIL,LAC,Giannis Antetokounmpo,182,39.0666666666667,40,-0.933333333333337,86,90,-4,-4,0
21701115,203953,MIL,LAC,Jabari Parker,87,19.1166666666667,19,0.116666666666667,29,29,0,0,0
21701115,1628425,MIL,LAC,Sterling Brown,40,9.4,9,0.4,19,14,5,5,0
21701116,2544,CLE,CHA,LeBron James,168,36.9333333333333,37,-0.0666666666666629,95,73,22,21,1
21701116,2747,CLE,CHA,JR Smith,133,30.9,31,-0.100000000000001,74,70,4,10,-6
21701116,101181,CLE,CHA,Jose Calderon,65,14.0833333333333,14,0.0833333333333322,28,41,-13,-10,-3
21701116,201145,CLE,CHA,Jeff Green,137,31.4333333333333,32,-0.566666666666666,76,67,9,13,-4
21701116,201588,CLE,CHA,George Hill,150,34.35,35,-0.649999999999999,95,64,31,29,2
21701116,202684,CLE,CHA,Tristan Thompson,70,15.2166666666667,16,-0.783333333333333,40,32,8,9,-1
21701116,203903,CLE,CHA,Jordan Clarkson,82,19.1166666666667,19,0.116666666666667,38,44,-6,-9,3
21701116,203918,CLE,CHA,Rodney Hood,120,26.55,27,-0.450000000000003,74,51,23,19,4
21701116,204066,CLE,CHA,John Holland,5,1.25,2,-0.75,3,7,-4,-4,0
21701116,1626204,CLE,CHA,Larry Nance Jr.,87,20.1833333333333,20,0.183333333333334,41,38,3,-1,4
21701116,1626224,CLE,CHA,Cedi Osman,28,5.98333333333333,6,-0.0166666666666675,20,24,-4,-4,0
21701116,1627790,CLE,CHA,Ante Zizic,5,1.25,2,-0.75,3,7,-4,-4,0
21701116,1628506,CLE,CHA,London Perrantes,5,1.25,2,-0.75,3,7,-4,-4,0
21701116,2730,CHA,CLE,Dwight Howard,130,28.6,29,-0.399999999999999,61,67,-6,-6,0
21701116,101107,CHA,CLE,Marvin Williams,173,38.1833333333333,38,0.18333333333333,80,98,-18,-17,-1
21701116,201587,CHA,CLE,Nicolas Batum,117,25.7666666666667,26,-0.233333333333334,49,73,-24,-20,-4
21701116,202689,CHA,CLE,Kemba Walker,150,32.5333333333333,33,-0.466666666666669,67,84,-17,-14,-3
21701116,203077,CHA,CLE,Michael Kidd-Gilchrist,96,21.1,21,0.100000000000001,42,59,-17,-14,-3
21701116,203087,CHA,CLE,Jeremy Lamb,108,24.9666666666667,25,-0.0333333333333314,61,55,6,1,5
21701116,1626163,CHA,CLE,Frank Kaminsky,73,17.6166666666667,18,-0.383333333333333,42,44,-2,-4,2
21701116,1626195,CHA,CLE,Willy Hernangomez,8,1.48333333333333,1,0.483333333333333,2,7,-5,-3,-2
21701116,1626203,CHA,CLE,Treveon Graham,38,9.51666666666667,10,-0.483333333333334,25,20,5,4,1
21701116,1628370,CHA,CLE,Malik Monk,61,15.1666666666667,15,0.166666666666666,38,34,4,1,3
21701116,1628407,CHA,CLE,Dwayne Bacon,101,23.5666666666667,24,-0.433333333333334,58,49,9,7,2
21701117,201960,BKN,ORL,DeMarre Carroll,130,29.7666666666667,30,-0.233333333333334,71,56,15,17,-2
21701117,201967,BKN,ORL,Dante Cunningham,94,19.3166666666667,19,0.316666666666666,44,39,5,5,0
21701117,203459,BKN,ORL,Allen Crabbe,136,29.45,30,-0.550000000000001,70,69,1,3,-2
21701117,203915,BKN,ORL,Spencer Dinwiddie,83,18.85,19,-0.149999999999999,39,40,-1,-1,0
21701117,203925,BKN,ORL,Joe Harris,125,27.25,27,0.25,56,55,1,-2,3
21701117,1626156,BKN,ORL,D'Angelo Russell,138,30.2,30,0.199999999999999,73,66,7,11,-4
21701117,1626178,BKN,ORL,Rondae Hollis-Jefferson,151,32.7666666666667,33,-0.233333333333334,82,83,-1,-3,2
21701117,1627747,BKN,ORL,Caris LeVert,105,24.45,25,-0.549999999999997,53,50,3,0,3
21701117,1628386,BKN,ORL,Jarrett Allen,118,27.6166666666667,28,-0.383333333333333,67,62,5,5,0
21701117,201167,ORL,BKN,Arron Afflalo,40,10.0833333333333,10,0.0833333333333322,16,22,-6,-6,0
21701117,201571,ORL,BKN,D.J. Augustin,146,31.7166666666667,32,-0.283333333333335,72,77,-5,-5,0
21701117,202687,ORL,BKN,Bismack Biyombo,51,12,12,0,16,27,-11,-13,2
21701117,202696,ORL,BKN,Nikola Vucevic,143,31.0666666666667,31,0.0666666666666664,72,77,-5,-3,-2
21701117,202714,ORL,BKN,Shelvin Mack,131,29.2833333333333,29,0.283333333333331,69,64,5,7,-2
21701117,203920,ORL,BKN,Khem Birch,42,9.81666666666667,10,-0.183333333333334,27,14,13,16,-3
21701117,203932,ORL,BKN,Aaron Gordon,150,31.25,32,-0.75,70,84,-14,-17,3
21701117,1626209,ORL,BKN,Mario Hezonja,162,35.9166666666667,36,-0.0833333333333357,73,84,-11,-12,1
21701117,1628503,ORL,BKN,Jamel Artis,109,24.9,25,-0.100000000000001,61,46,15,14,1
21701117,1628681,ORL,BKN,Rodney Purvis,106,23.6333333333333,24,-0.366666666666667,44,60,-16,-16,0
21701118,201563,NYK,PHI,Michael Beasley,184,34.8166666666667,35,-0.183333333333337,83,85,-2,-2,0
21701118,202498,NYK,PHI,Lance Thomas,95,18.3833333333333,19,-0.616666666666667,42,54,-12,-12,0
21701118,202683,NYK,PHI,Enes Kanter,162,30.35,31,-0.649999999999999,74,73,1,-1,2
21701118,203501,NYK,PHI,Tim Hardaway Jr.,170,33.0333333333333,33,0.0333333333333314,64,89,-25,-23,-2
21701118,203504,NYK,PHI,Trey Burke,141,27.8666666666667,28,-0.133333333333333,55,75,-20,-18,-2
21701118,1626144,NYK,PHI,Emmanuel Mudiay,128,24.6166666666667,25,-0.383333333333333,56,57,-1,-1,0
21701118,1627786,NYK,PHI,Troy Williams,115,22.05,22,0.0500000000000007,51,48,3,0,3
21701118,1628373,NYK,PHI,Frank Ntilikina,130,24.7666666666667,24,0.766666666666666,47,50,-3,-4,1
21701118,1628436,NYK,PHI,Luke Kornet,90,18.25,18,0.25,26,39,-13,-13,0
21701118,1628439,NYK,PHI,Isaiah Hicks,25,5.03333333333333,5,0.0333333333333332,7,20,-13,-11,-2
21701118,101141,PHI,NYK,Ersan Ilyasova,135,25.95,26,-0.0499999999999972,55,54,1,5,-4
21701118,200755,PHI,NYK,JJ Redick,159,30.9833333333333,31,-0.0166666666666657,75,68,7,9,-2
21701118,201158,PHI,NYK,Marco Belinelli,128,24.7,25,-0.300000000000001,66,55,11,9,2
21701118,203496,PHI,NYK,Robert Covington,176,33.4166666666667,33,0.416666666666664,80,67,13,10,3
21701118,203954,PHI,NYK,Joel Embiid,42,8.38333333333333,9,-0.616666666666667,28,21,7,7,0
21701118,203967,PHI,NYK,Dario Saric,185,35.2833333333333,36,-0.716666666666669,93,79,14,13,1
21701118,204456,PHI,NYK,T.J. McConnell,50,10.3833333333333,10,0.383333333333333,27,19,8,9,-1
21701118,1626158,PHI,NYK,Richaun Holmes,117,22.2333333333333,22,0.233333333333334,48,41,7,6,1
21701118,1627732,PHI,NYK,Ben Simmons,179,34.15,34,0.149999999999999,88,79,9,9,0
21701118,1628365,PHI,NYK,Markelle Fultz,69,13.6833333333333,14,-0.316666666666666,30,22,8,8,0
21701119,202323,POR,MEM,Evan Turner,129,29.2166666666667,30,-0.783333333333335,54,75,-21,-21,0
21701119,202329,POR,MEM,Al-Farouq Aminu,129,28.5166666666667,28,0.516666666666666,54,61,-7,-6,-1
21701119,202334,POR,MEM,Ed Davis,84,19.05,19,0.0499999999999972,49,47,2,1,1
21701119,203468,POR,MEM,CJ McCollum,167,36.9,37,-0.100000000000001,82,81,1,1,0
21701119,203894,POR,MEM,Shabazz Napier,126,27.2833333333333,27,0.283333333333331,54,57,-3,-1,-2
21701119,203994,POR,MEM,Jusuf Nurkic,124,27.9666666666667,28,-0.033333333333335,50,57,-7,-6,-1
21701119,1626192,POR,MEM,Pat Connaughton,130,28.05,28,0.0499999999999972,67,62,5,3,2
21701119,1627735,POR,MEM,Wade Baldwin IV,92,20.5666666666667,21,-0.433333333333334,49,47,2,-2,4
21701119,1628380,POR,MEM,Zach Collins,104,22.1166666666667,22,0.116666666666667,56,53,3,6,-3
21701119,201188,MEM,POR,Marc Gasol,94,21.1833333333333,21,0.18333333333333,42,43,-1,1,-2
21701119,201596,MEM,POR,Mario Chalmers,81,19.1833333333333,20,-0.816666666666666,45,31,14,14,0
21701119,202705,MEM,POR,MarShon Brooks,99,21.0666666666667,21,0.0666666666666664,58,50,8,8,0
21701119,202718,MEM,POR,Chandler Parsons,83,18.95,19,-0.0500000000000007,42,51,-9,-9,0
21701119,203210,MEM,POR,JaMychal Green,134,28.9833333333333,29,-0.0166666666666657,66,52,14,14,0
21701119,1626185,MEM,POR,Jarell Martin,139,30,30,0,66,57,9,9,0
21701119,1627738,MEM,POR,Deyonta Davis,83,18.6666666666667,19,-0.333333333333336,42,46,-4,-6,2
21701119,1627782,MEM,POR,Wayne Selden,101,22.8,23,-0.200000000000003,55,59,-4,-1,-3
21701119,1628415,MEM,POR,Dillon Brooks,135,30.0833333333333,30,0.0833333333333322,61,54,7,4,3
21701119,1628424,MEM,POR,Kobi Simmons,136,28.75,28,0.75,63,72,-9,-9,0
21701120,203473,ATL,MIN,Dewayne Dedmon,139,29.3333333333333,30,-0.666666666666664,63,76,-13,-13,0
21701120,203488,ATL,MIN,Mike Muscala,123,25.4333333333333,25,0.43333333333333,70,69,1,6,-5
21701120,203705,ATL,MIN,Josh Magette,122,26.25,26,0.25,66,63,3,9,-6
21701120,1627752,ATL,MIN,Taurean Prince,159,33.65,34,-0.349999999999994,93,97,-4,-4,0
21701120,1627814,ATL,MIN,Damion Lee,144,29.9833333333333,30,-0.0166666666666657,66,70,-4,-6,2
21701120,1627819,ATL,MIN,Isaiah Taylor,139,28.3166666666667,29,-0.683333333333334,66,75,-9,-9,0
21701120,1628381,ATL,MIN,John Collins,113,23.8166666666667,24,-0.183333333333334,49,63,-14,-8,-6
21701120,1628416,ATL,MIN,Tyler Dorsey,88,18.1833333333333,18,0.183333333333334,46,56,-10,-2,-8
21701120,1628463,ATL,MIN,Tyler Cavanaugh,81,16.65,17,-0.350000000000001,46,44,2,3,-1
21701120,1628510,ATL,MIN,Andrew White III,32,6.46666666666667,6,0.466666666666667,5,17,-12,-6,-6
21701120,2037,MIN,ATL,Jamal Crawford,125,25.4833333333333,26,-0.516666666666666,59,54,5,5,0
21701120,201952,MIN,ATL,Jeff Teague,140,29.9,30,-0.100000000000001,85,81,4,4,0
21701120,201959,MIN,ATL,Taj Gibson,137,29.4666666666667,30,-0.533333333333331,86,81,5,1,4
21701120,202357,MIN,ATL,Nemanja Bjelica,178,37.0666666666667,37,0.0666666666666629,96,83,13,15,-2
21701120,203476,MIN,ATL,Gorgui Dieng,86,17.75,18,-0.25,43,32,11,13,-2
21701120,203952,MIN,ATL,Andrew Wiggins,176,36.9166666666667,37,-0.0833333333333357,102,100,2,4,-2
21701120,1626145,MIN,ATL,Tyus Jones,104,20.9333333333333,21,-0.06666666666667,52,43,9,11,-2
21701120,1626157,MIN,ATL,Karl-Anthony Towns,194,40.5666666666667,41,-0.433333333333337,107,96,11,7,4
21701121,202328,BOS,UTA,Greg Monroe,108,23.65,23,0.649999999999999,42,40,2,4,-2
21701121,203382,BOS,UTA,Aron Baynes,120,27,28,-1,52,50,2,-2,4
21701121,203499,BOS,UTA,Shane Larkin,148,33.5666666666667,34,-0.43333333333333,73,48,25,25,0
21701121,1626179,BOS,UTA,Terry Rozier,141,30.5333333333333,30,0.533333333333331,60,74,-14,-12,-2
21701121,1627759,BOS,UTA,Jaylen Brown,136,30,30,0,69,66,3,5,-2
21701121,1627824,BOS,UTA,Guerschon Yabusele,66,14.8,15,-0.199999999999999,34,42,-8,-8,0
21701121,1627846,BOS,UTA,Abdel Nader,72,16.0333333333333,16,0.0333333333333314,27,31,-4,-4,0
21701121,1628369,BOS,UTA,Jayson Tatum,145,31.9166666666667,32,-0.0833333333333322,63,61,2,0,2
21701121,1628400,BOS,UTA,Semi Ojeleye,144,32.5,32,0.5,65,58,7,7,0
21701121,201937,UTA,BOS,Ricky Rubio,161,35.9166666666667,36,-0.0833333333333357,80,77,3,1,2
21701121,201973,UTA,BOS,Jonas Jerebko,49,11.1833333333333,11,0.183333333333334,12,23,-11,-11,0
21701121,202324,UTA,BOS,Derrick Favors,105,23.5666666666667,24,-0.433333333333334,51,36,15,15,0
21701121,203109,UTA,BOS,Jae Crowder,135,29.3166666666667,30,-0.683333333333334,51,61,-10,-8,-2
21701121,203497,UTA,BOS,Rudy Gobert,178,40.0833333333333,40,0.0833333333333286,82,87,-5,-7,2
21701121,203957,UTA,BOS,Dante Exum,41,8.75,9,-0.25,18,21,-3,-3,0
21701121,204060,UTA,BOS,Joe Ingles,150,32.9333333333333,33,-0.06666666666667,66,64,2,2,0
21701121,1626220,UTA,BOS,Royce O'Neale,84,18.5166666666667,18,0.516666666666666,30,34,-4,-4,0
21701121,1628378,UTA,BOS,Donovan Mitchell,177,39.7333333333333,40,-0.266666666666666,80,82,-2,0,-2
21701122,101150,LAC,PHX,Lou Williams,127,27.1166666666667,27,0.116666666666667,71,57,14,12,2
21701122,201599,LAC,PHX,DeAndre Jordan,133,27.35,27,0.350000000000001,67,66,1,1,0
21701122,202325,LAC,PHX,Wesley Johnson,105,21.45,22,-0.550000000000001,40,43,-3,-3,0
21701122,202699,LAC,PHX,Tobias Harris,145,30.1333333333333,30,0.133333333333333,73,72,1,1,0
21701122,203085,LAC,PHX,Austin Rivers,153,32.9166666666667,33,-0.0833333333333286,87,62,25,25,0
21701122,203710,LAC,PHX,C.J. Williams,76,16.4666666666667,17,-0.533333333333331,38,22,16,16,0
21701122,1626149,LAC,PHX,Montrezl Harrell,83,17.8333333333333,18,-0.166666666666668,42,25,17,17,0
21701122,1626155,LAC,PHX,Sam Dekker,41,7.48333333333333,7,0.483333333333333,8,17,-9,-10,1
21701122,1626246,LAC,PHX,Boban Marjanovic,13,2.65,3,-0.35,2,8,-6,-6,0
21701122,1627820,LAC,PHX,Tyrone Wallace,171,33.5833333333333,34,-0.416666666666664,79,76,3,4,-1
21701122,1628414,LAC,PHX,Sindarius Thornwell,98,22.1833333333333,22,0.183333333333334,48,47,1,3,-2
21701122,201162,PHX,LAC,Jared Dudley,31,5.36666666666667,5,0.366666666666667,10,8,2,0,2
21701122,203584,PHX,LAC,Troy Daniels,153,32.2333333333333,32,0.233333333333334,67,78,-11,-11,0
21701122,1626210,PHX,LAC,Alan Williams,85,19.1333333333333,19,0.133333333333333,41,34,7,8,-1
21701122,1627733,PHX,LAC,Dragan Bender,86,18.7666666666667,19,-0.233333333333334,32,50,-18,-18,0
21701122,1627737,PHX,LAC,Marquese Chriss,149,30.0666666666667,30,0.0666666666666664,64,70,-6,-9,3
21701122,1627755,PHX,LAC,Tyler Ulis,177,37.3333333333333,37,0.333333333333329,87,83,4,4,0
21701122,1627863,PHX,LAC,Danuel House Jr.,17,2.86666666666667,3,-0.133333333333333,5,6,-1,-3,2
21701122,1627885,PHX,LAC,Shaquille Harrison,147,30.3833333333333,31,-0.616666666666667,69,69,0,4,-4
21701122,1628367,PHX,LAC,Josh Jackson,163,35.1333333333333,35,0.133333333333333,74,86,-12,-13,1
21701122,1628409,PHX,LAC,Alec Peters,69,14.05,14,0.0500000000000007,27,36,-9,-6,-3
21701122,1628432,PHX,LAC,Davon Reed,68,13.8333333333333,14,-0.166666666666666,19,35,-16,-16,0
21701123,1717,DAL,LAL,Dirk Nowitzki,106,21.8666666666667,22,-0.133333333333333,57,44,13,13,0
21701123,203084,DAL,LAL,Harrison Barnes,112,24.2666666666667,24,0.266666666666666,58,55,3,3,0
21701123,203457,DAL,LAL,Nerlens Noel,90,20.5666666666667,20,0.566666666666666,29,44,-15,-15,0
21701123,203926,DAL,LAL,Doug McDermott,83,18.4333333333333,18,0.433333333333334,28,37,-9,-9,0
21701123,203939,DAL,LAL,Dwight Powell,96,19.7166666666667,20,-0.283333333333331,54,43,11,11,0
21701123,1626151,DAL,LAL,Aaron Harrison,95,21.8833333333333,22,-0.116666666666667,35,50,-15,-16,1
21701123,1627812,DAL,LAL,Yogi Ferrell,90,20.35,20,0.350000000000001,31,45,-14,-15,1
21701123,1627827,DAL,LAL,Dorian Finney-Smith,97,20.8333333333333,21,-0.166666666666664,55,43,12,13,-1
21701123,1627858,DAL,LAL,Kyle Collinsworth,43,10.55,10,0.550000000000001,10,21,-11,-11,0
21701123,1627883,DAL,LAL,Jalen Jones,20,5.28333333333333,5,0.283333333333333,7,11,-4,-4,0
21701123,1628372,DAL,LAL,Dennis Smith Jr.,105,22.35,22,0.350000000000001,55,47,8,9,-1
21701123,1628405,DAL,LAL,Johnathan Motley,29,7.7,8,-0.3,10,16,-6,-6,0
21701123,1628467,DAL,LAL,Maxi Kleber,109,26.1166666666667,26,0.116666666666667,36,59,-23,-23,0
21701123,201572,LAL,DAL,Brook Lopez,172,38.5166666666667,39,-0.483333333333334,90,84,6,4,2
21701123,203484,LAL,DAL,Kentavious Caldwell-Pope,157,35.5,35,0.5,80,74,6,6,0
21701123,203898,LAL,DAL,Tyler Ennis,49,11.55,11,0.550000000000001,24,17,7,8,-1
21701123,203944,LAL,DAL,Julius Randle,151,33.0666666666667,33,0.0666666666666629,75,74,1,0,1
21701123,204037,LAL,DAL,Travis Wear,68,15.6833333333333,15,0.683333333333334,29,21,8,11,-3
21701123,1627742,LAL,DAL,Brandon Ingram,104,22.75,23,-0.25,45,50,-5,-7,2
21701123,1627826,LAL,DAL,Ivica Zubac,39,8.7,9,-0.300000000000001,12,7,5,5,0
21701123,1627936,LAL,DAL,Alex Caruso,72,15.8333333333333,16,-0.166666666666668,34,25,9,11,-2
21701123,1628366,LAL,DAL,Lonzo Ball,114,23.9166666666667,24,-0.0833333333333357,50,60,-10,-11,1
21701123,1628398,LAL,DAL,Kyle Kuzma,149,34.4,34,0.399999999999999,76,53,23,23,0
21701124,101133,WAS,DET,Ian Mahinmi,48,9.61666666666667,9,0.616666666666667,16,20,-4,-4,0
21701124,101162,WAS,DET,Marcin Gortat,126,27.45,28,-0.550000000000001,50,61,-11,-11,0
21701124,201196,WAS,DET,Ramon Sessions,75,15.4,15,0.399999999999999,30,36,-6,-5,-1
21701124,201975,WAS,DET,Jodie Meeks,69,14.2,14,0.199999999999999,33,32,1,3,-2
21701124,202693,WAS,DET,Markieff Morris,166,35.4166666666667,36,-0.583333333333329,74,73,1,0,1
21701124,203078,WAS,DET,Bradley Beal,165,35.1666666666667,36,-0.833333333333336,61,79,-18,-17,-1
21701124,203107,WAS,DET,Tomas Satoransky,159,33.9166666666667,35,-1.08333333333334,69,69,0,-2,2
21701124,203118,WAS,DET,Mike Scott,92,18.4333333333333,19,-0.566666666666666,35,42,-7,-8,1
21701124,203490,WAS,DET,Otto Porter Jr.,70,15.8,16,-0.199999999999999,33,32,1,2,-1
21701124,1626162,WAS,DET,Kelly Oubre Jr.,155,31.6,32,-0.399999999999999,59,71,-12,-13,1
21701124,201229,DET,WAS,Anthony Tolliver,148,31.4,32,-0.600000000000001,69,62,7,7,0
21701124,202397,DET,WAS,Ish Smith,97,19.9666666666667,20,-0.0333333333333314,43,40,3,5,-2
21701124,202704,DET,WAS,Reggie Jackson,128,27.4333333333333,28,-0.566666666666666,60,52,8,6,2
21701124,203083,DET,WAS,Andre Drummond,178,37.1666666666667,38,-0.833333333333329,88,69,19,19,0
21701124,203493,DET,WAS,Reggie Bullock,133,28.9666666666667,29,-0.0333333333333314,66,55,11,9,2
21701124,203516,DET,WAS,James Ennis III,56,11.3,11,0.300000000000001,22,29,-7,-7,0
21701124,203961,DET,WAS,Eric Moreland,47,10.2333333333333,10,0.233333333333334,15,23,-8,-8,0
21701124,1626169,DET,WAS,Stanley Johnson,169,36.1,37,-0.899999999999999,81,63,18,18,0
21701124,1627740,DET,WAS,Henry Ellenson,77,16,16,0,34,30,4,4,0
21701124,1628379,DET,WAS,Luke Kennard,92,18.4333333333333,19,-0.566666666666666,37,37,0,2,-2
21701125,201577,CHI,MIA,Robin Lopez,146,30.7166666666667,31,-0.283333333333335,59,68,-9,-10,1
21701125,203200,CHI,MIA,Justin Holiday,107,21.5166666666667,22,-0.483333333333334,48,45,3,1,2
21701125,203930,CHI,MIA,Sean Kilpatrick,76,14.9833333333333,15,-0.0166666666666657,24,35,-11,-11,0
21701125,203943,CHI,MIA,Noah Vonleh,162,32.5666666666667,33,-0.43333333333333,64,71,-7,-6,-1
21701125,1626166,CHI,MIA,Cameron Payne,142,29.6166666666667,30,-0.383333333333333,56,65,-9,-7,-2
21701125,1626170,CHI,MIA,Jerian Grant,57,11.8,12,-0.199999999999999,21,28,-7,-9,2
21701125,1626171,CHI,MIA,Bobby Portis,162,32.5833333333333,32,0.583333333333329,61,65,-4,-6,2
21701125,1627756,CHI,MIA,Denzel Valentine,118,24.0666666666667,24,0.06666666666667,40,51,-11,-10,-1
21701125,1627853,CHI,MIA,Ryan Arcidiacono,36,6.51666666666667,7,-0.483333333333333,15,9,6,5,1
21701125,1628021,CHI,MIA,David Nwaba,169,35.3,35,0.299999999999997,72,73,-1,-2,1
21701125,2548,MIA,CHI,Dwyane Wade,94,18.7,18,0.699999999999999,41,33,8,8,0
21701125,201609,MIA,CHI,Goran Dragic,157,32.8666666666667,33,-0.133333333333333,68,63,5,4,1
21701125,201949,MIA,CHI,James Johnson,145,29.9,30,-0.100000000000001,65,59,6,7,-1
21701125,201961,MIA,CHI,Wayne Ellington,133,27.2,27,0.200000000000003,54,54,0,1,-1
21701125,202355,MIA,CHI,Hassan Whiteside,94,19.1333333333333,19,0.133333333333333,41,43,-2,-2,0
21701125,203482,MIA,CHI,Kelly Olynyk,81,16.8333333333333,17,-0.166666666666664,34,29,5,3,2
21701125,203585,MIA,CHI,Rodney McGruder,59,12.1666666666667,12,0.166666666666668,26,25,1,1,0
21701125,204020,MIA,CHI,Tyler Johnson,60,11.8666666666667,12,-0.133333333333333,28,24,4,5,-1
21701125,1626159,MIA,CHI,Justise Winslow,127,26.2333333333333,26,0.233333333333334,53,50,3,3,0
21701125,1626196,MIA,CHI,Josh Richardson,165,32.8,33,-0.200000000000003,73,60,13,15,-2
21701125,1628389,MIA,CHI,Bam Adebayo,60,11.9666666666667,12,-0.0333333333333332,27,20,7,10,-3
21701126,1938,SAS,OKC,Manu Ginobili,68,14.4,15,-0.6,39,30,9,11,-2
21701126,2200,SAS,OKC,Pau Gasol,114,25.15,25,0.149999999999999,58,36,22,17,5
21701126,2225,SAS,OKC,Tony Parker,81,17.8166666666667,18,-0.183333333333334,39,42,-3,-3,0
21701126,200746,SAS,OKC,LaMarcus Aldridge,169,34.0833333333333,34,0.0833333333333357,69,78,-9,-8,-1
21701126,200752,SAS,OKC,Rudy Gay,113,24.8166666666667,24,0.816666666666666,47,64,-17,-13,-4
21701126,201980,SAS,OKC,Danny Green,128,27.15,27,0.149999999999999,59,61,-2,-4,2
21701126,201988,SAS,OKC,Patty Mills,162,33.7,33,0.700000000000003,66,69,-3,-3,0
21701126,202722,SAS,OKC,Davis Bertans,45,9.48333333333333,10,-0.516666666666668,25,12,13,13,0
21701126,203937,SAS,OKC,Kyle Anderson,115,23.2666666666667,23,0.266666666666666,51,46,5,7,-2
21701126,1627749,SAS,OKC,Dejounte Murray,145,30.05,30,0.0499999999999972,62,57,5,3,2
21701126,2546,OKC,SAS,Carmelo Anthony,159,31.6333333333333,32,-0.366666666666667,77,65,12,12,0
21701126,101109,OKC,SAS,Raymond Felton,67,15.7,16,-0.300000000000001,20,38,-18,-16,-2
21701126,201147,OKC,SAS,Corey Brewer,141,28.6833333333333,29,-0.316666666666666,65,57,8,6,2
21701126,201566,OKC,SAS,Russell Westbrook,183,37.4833333333333,38,-0.516666666666666,84,75,9,7,2
21701126,202331,OKC,SAS,Paul George,190,38.9,39,-0.100000000000001,90,85,5,5,0
21701126,202335,OKC,SAS,Patrick Patterson,54,12.5833333333333,12,0.583333333333332,15,33,-18,-17,-1
21701126,203500,OKC,SAS,Steven Adams,182,37.1833333333333,37,0.18333333333333,86,77,9,10,-1
21701126,203518,OKC,SAS,Alex Abrines,40,9.2,9,0.199999999999999,9,20,-11,-9,-2
21701126,203924,OKC,SAS,Jerami Grant,61,14.5666666666667,14,0.566666666666666,20,31,-11,-13,2
21701126,1628390,OKC,SAS,Terrance Ferguson,63,13.9833333333333,14,-0.0166666666666657,29,34,-5,-5,0
21701127,201152,IND,SAC,Thaddeus Young,149,34.0833333333333,34,0.0833333333333286,83,78,5,5,0
21701127,201954,IND,SAC,Darren Collison,131,30.5833333333333,30,0.583333333333332,75,61,14,14,0
21701127,202362,IND,SAC,Lance Stephenson,57,14.2833333333333,14,0.283333333333333,25,35,-10,-10,0
21701127,202709,IND,SAC,Cory Joseph,86,20.05,20,0.0500000000000007,38,49,-11,-13,2
21701127,202711,IND,SAC,Bojan Bogdanovic,151,35.9333333333333,36,-0.0666666666666629,82,69,13,16,-3
21701127,203506,IND,SAC,Victor Oladipo,158,35.7833333333333,36,-0.216666666666669,86,76,10,10,0
21701127,203922,IND,SAC,Glenn Robinson III,56,13.8333333333333,14,-0.166666666666668,22,27,-5,-5,0
21701127,1626167,IND,SAC,Myles Turner,123,27.45,27,0.449999999999999,72,61,11,11,0
21701127,1627734,IND,SAC,Domantas Sabonis,100,24.3333333333333,24,0.333333333333332,41,48,-7,-7,0
21701127,1628388,IND,SAC,TJ Leaf,14,3.66666666666667,4,-0.333333333333334,6,11,-5,-6,1
21701127,1713,SAC,IND,Vince Carter,91,21.65,22,-0.350000000000001,47,47,0,2,-2
21701127,201585,SAC,IND,Kosta Koufos,88,21.6833333333333,21,0.68333333333333,48,45,3,3,0
21701127,203960,SAC,IND,JaKarr Sampson,12,2.8,3,-0.2,2,4,-2,-2,0
21701127,203992,SAC,IND,Bogdan Bogdanovic,169,39.8333333333333,40,-0.166666666666671,86,84,2,2,0
21701127,1626161,SAC,IND,Willie Cauley-Stein,117,26.3166666666667,27,-0.683333333333334,55,61,-6,-6,0
21701127,1627741,SAC,IND,Buddy Hield,140,30.9333333333333,31,-0.0666666666666664,68,76,-8,-7,-1
21701127,1627746,SAC,IND,Skal Labissiere,114,26.35,26,0.350000000000001,56,59,-3,-5,2
21701127,1628368,SAC,IND,De'Aaron Fox,123,28.1,28,0.100000000000001,63,67,-4,-3,-1
21701127,1628382,SAC,IND,Justin Jackson,89,22.4333333333333,23,-0.56666666666667,50,48,2,1,1
21701127,1628412,SAC,IND,Frank Mason,82,19.9,20,-0.100000000000001,40,39,1,0,1
21701128,2561,GSW,MIL,David West,52,12.1166666666667,12,0.116666666666667,26,21,5,4,1
21701128,2585,GSW,MIL,Zaza Pachulia,18,3.75,4,-0.25,4,8,-4,-4,0
21701128,2733,GSW,MIL,Shaun Livingston,74,16.2,16,0.199999999999999,36,33,3,1,2
21701128,2738,GSW,MIL,Andre Iguodala,94,20.6666666666667,21,-0.333333333333336,39,49,-10,-8,-2
21701128,201142,GSW,MIL,Kevin Durant,77,17.1333333333333,17,0.133333333333333,34,49,-15,-15,0
21701128,201156,GSW,MIL,Nick Young,104,23.1833333333333,23,0.183333333333334,52,57,-5,-5,0
21701128,201580,GSW,MIL,JaVale McGee,57,14.2833333333333,15,-0.716666666666667,33,39,-6,-8,2
21701128,203110,GSW,MIL,Draymond Green,113,27.7,28,-0.300000000000001,59,64,-5,-6,1
21701128,1626172,GSW,MIL,Kevon Looney,113,23.6166666666667,23,0.616666666666667,55,63,-8,-5,-3
21701128,1626188,GSW,MIL,Quinn Cook,140,32.0333333333333,32,0.0333333333333314,77,79,-2,-2,0
21701128,1627745,GSW,MIL,Damian Jones,22,5.03333333333333,5,0.0333333333333332,18,9,9,9,0
21701128,1627775,GSW,MIL,Patrick McCaw,154,35.1666666666667,35,0.166666666666664,81,86,-5,-5,0
21701128,1628395,GSW,MIL,Jordan Bell,42,8.53333333333333,8,0.533333333333333,21,23,-2,-1,-1
21701128,1891,MIL,GSW,Jason Terry,96,21.4833333333333,21,0.483333333333334,50,44,6,5,1
21701128,201943,MIL,GSW,Brandon Jennings,67,14.5166666666667,15,-0.483333333333334,24,37,-13,-13,0
21701128,202339,MIL,GSW,Eric Bledsoe,134,30.85,31,-0.149999999999999,83,66,17,15,2
21701128,203089,MIL,GSW,John Henson,109,25.1166666666667,25,0.116666666666667,72,51,21,19,2
21701128,203092,MIL,GSW,Tyler Zeller,103,22.7666666666667,23,-0.233333333333334,44,56,-12,-10,-2
21701128,203114,MIL,GSW,Khris Middleton,165,37.8666666666667,38,-0.133333333333333,93,85,8,10,-2
21701128,203503,MIL,GSW,Tony Snell,116,26.4,27,-0.600000000000001,66,63,3,4,-1
21701128,203507,MIL,GSW,Giannis Antetokounmpo,151,34.8333333333333,35,-0.166666666666671,95,74,21,23,-2
21701128,203953,MIL,GSW,Jabari Parker,119,25.5833333333333,25,0.583333333333336,53,59,-6,-8,2
21701129,203200,CHI,ORL,Justin Holiday,75,15.15,15,0.149999999999999,40,25,15,17,-2
21701129,203930,CHI,ORL,Sean Kilpatrick,123,26.25,26,0.25,47,46,1,4,-3
21701129,203943,CHI,ORL,Noah Vonleh,109,24.0833333333333,24,0.0833333333333322,43,41,2,2,0
21701129,1626166,CHI,ORL,Cameron Payne,105,21.5333333333333,22,-0.466666666666669,44,38,6,6,0
21701129,1626170,CHI,ORL,Jerian Grant,123,26.4666666666667,26,0.466666666666669,45,44,1,2,-1
21701129,1626171,CHI,ORL,Bobby Portis,97,20.25,20,0.25,34,35,-1,0,-1
21701129,1626245,CHI,ORL,Cristiano Felicio,129,27.3833333333333,27,0.383333333333333,55,49,6,8,-2
21701129,1627756,CHI,ORL,Denzel Valentine,90,18.95,19,-0.0500000000000007,21,41,-20,-21,1
21701129,1627853,CHI,ORL,Ryan Arcidiacono,70,15.2,15,0.199999999999999,28,18,10,10,0
21701129,1628021,CHI,ORL,David Nwaba,98,20.45,21,-0.549999999999997,42,34,8,6,2
21701129,1628374,CHI,ORL,Lauri Markkanen,121,24.2833333333333,24,0.283333333333331,46,39,7,6,1
21701129,201571,ORL,CHI,D.J. Augustin,154,31.75,32,-0.25,60,57,3,4,-1
21701129,202687,ORL,CHI,Bismack Biyombo,67,15.5833333333333,15,0.583333333333332,27,35,-8,-10,2
21701129,202696,ORL,CHI,Nikola Vucevic,155,31.1833333333333,31,0.183333333333334,50,54,-4,-3,-1
21701129,202714,ORL,CHI,Shelvin Mack,122,26.1166666666667,26,0.116666666666667,44,45,-1,-4,3
21701129,203920,ORL,CHI,Khem Birch,45,10.6166666666667,11,-0.383333333333333,19,24,-5,-5,0
21701129,203932,ORL,CHI,Aaron Gordon,183,37.3833333333333,37,0.383333333333333,63,65,-2,-3,1
21701129,1626209,ORL,CHI,Mario Hezonja,128,27.1333333333333,27,0.133333333333333,46,48,-2,-3,1
21701129,1628371,ORL,CHI,Jonathan Isaac,100,20.8666666666667,21,-0.133333333333333,36,41,-5,-5,0
21701129,1628503,ORL,CHI,Jamel Artis,76,16.6,17,-0.400000000000002,24,32,-8,-10,2
21701129,1628681,ORL,CHI,Rodney Purvis,110,22.7666666666667,23,-0.233333333333334,41,44,-3,-1,-2
21701130,203101,ATL,PHI,Miles Plumlee,97,18.5333333333333,18,0.533333333333331,36,32,4,4,0
21701130,203473,ATL,PHI,Dewayne Dedmon,146,29.3333333333333,29,0.333333333333336,55,69,-14,-14,0
21701130,203488,ATL,PHI,Mike Muscala,138,27.8333333333333,28,-0.166666666666664,60,60,0,1,-1
21701130,1627752,ATL,PHI,Taurean Prince,124,24.1166666666667,24,0.116666666666667,39,65,-26,-26,0
21701130,1627814,ATL,PHI,Damion Lee,164,32.1166666666667,32,0.116666666666667,58,71,-13,-13,0
21701130,1627819,ATL,PHI,Isaiah Taylor,157,30.4166666666667,30,0.416666666666664,55,59,-4,-5,1
21701130,1628381,ATL,PHI,John Collins,150,29.6,30,-0.399999999999999,59,52,7,6,1
21701130,1628416,ATL,PHI,Tyler Dorsey,143,28.2,28,0.199999999999999,58,63,-5,-4,-1
21701130,1628510,ATL,PHI,Andrew White III,101,19.85,20,-0.149999999999999,35,34,1,1,0
21701130,101141,PHI,ATL,Ersan Ilyasova,149,29.5166666666667,30,-0.483333333333334,57,66,-9,-10,1
21701130,101161,PHI,ATL,Amir Johnson,89,17.4,17,0.399999999999999,41,22,19,20,-1
21701130,200755,PHI,ATL,JJ Redick,133,25.25,25,0.25,52,43,9,10,-1
21701130,201158,PHI,ATL,Marco Belinelli,139,27.3333333333333,27,0.333333333333332,64,53,11,10,1
21701130,203496,PHI,ATL,Robert Covington,133,25.8333333333333,26,-0.166666666666668,58,42,16,19,-3
21701130,203967,PHI,ATL,Dario Saric,135,25.5333333333333,26,-0.466666666666669,53,36,17,19,-2
21701130,204456,PHI,ATL,T.J. McConnell,72,15.1333333333333,15,0.133333333333333,26,39,-13,-16,3
21701130,1626158,PHI,ATL,Richaun Holmes,115,23.55,24,-0.449999999999999,51,58,-7,-9,2
21701130,1627732,PHI,ATL,Ben Simmons,134,26.4166666666667,27,-0.583333333333336,67,46,21,21,0
21701130,1627788,PHI,ATL,Furkan Korkmaz,21,4.83333333333333,5,-0.166666666666666,4,16,-12,-12,0
21701130,1628365,PHI,ATL,Markelle Fultz,100,19.2,19,0.200000000000003,32,34,-2,-2,0
21701131,2544,CLE,NOP,LeBron James,189,41.6833333333333,42,-0.316666666666663,103,87,16,16,0
21701131,2747,CLE,NOP,JR Smith,84,20.2,20,0.199999999999999,37,44,-7,-7,0
21701131,101181,CLE,NOP,Jose Calderon,58,13.85,14,-0.149999999999999,38,23,15,15,0
21701131,201145,CLE,NOP,Jeff Green,105,24.1166666666667,24,0.116666666666667,40,51,-11,-11,0
21701131,201567,CLE,NOP,Kevin Love,103,23.1333333333333,24,-0.866666666666667,47,49,-2,-4,2
21701131,201588,CLE,NOP,George Hill,102,22.2166666666667,22,0.216666666666669,49,52,-3,-3,0
21701131,202684,CLE,NOP,Tristan Thompson,93,21.25,21,0.25,50,43,7,9,-2
21701131,203903,CLE,NOP,Jordan Clarkson,129,29.8666666666667,30,-0.133333333333333,62,65,-3,-1,-2
21701131,203918,CLE,NOP,Rodney Hood,129,28.5333333333333,28,0.533333333333331,67,60,7,5,2
21701131,1626204,CLE,NOP,Larry Nance Jr.,68,14.7333333333333,15,-0.266666666666666,42,36,6,6,0
21701131,2731,NOP,CLE,Emeka Okafor,19,3.31666666666667,3,0.316666666666666,6,9,-3,-3,0
21701131,200765,NOP,CLE,Rajon Rondo,111,24.5166666666667,25,-0.483333333333334,51,57,-6,-6,0
21701131,201950,NOP,CLE,Jrue Holiday,148,33.1,33,0.100000000000001,71,79,-8,-8,0
21701131,202703,NOP,CLE,Nikola Mirotic,120,28.6333333333333,29,-0.366666666666667,61,61,0,2,-2
21701131,202734,NOP,CLE,E'Twaun Moore,129,29.3833333333333,29,0.383333333333333,66,68,-2,0,-2
21701131,203076,NOP,CLE,Anthony Davis,167,36.7666666666667,37,-0.233333333333334,77,97,-20,-20,0
21701131,203121,NOP,CLE,Darius Miller,130,30.0166666666667,30,0.0166666666666657,64,59,5,2,3
21701131,203524,NOP,CLE,Solomon Hill,101,21.6,22,-0.399999999999999,46,54,-8,-7,-1
21701131,203546,NOP,CLE,Ian Clark,90,21.1,21,0.100000000000001,43,41,2,0,2
21701131,1627767,NOP,CLE,Cheick Diallo,45,11.15,11,0.15,25,10,15,15,0
21701132,2207,HOU,PHX,Joe Johnson,98,21.2666666666667,21,0.266666666666666,49,42,7,8,-1
21701132,2772,HOU,PHX,Trevor Ariza,144,32.9666666666667,33,-0.0333333333333314,73,70,3,2,1
21701132,101123,HOU,PHX,Gerald Green,126,28.2333333333333,28,0.233333333333334,60,65,-5,-3,-2
21701132,200782,HOU,PHX,PJ Tucker,147,33.4833333333333,34,-0.516666666666666,73,70,3,2,1
21701132,201583,HOU,PHX,Ryan Anderson,81,17.2333333333333,17,0.233333333333334,35,35,0,2,-2
21701132,201601,HOU,PHX,Luc Mbah a Moute,119,24.9333333333333,25,-0.0666666666666664,50,59,-9,-9,0
21701132,201935,HOU,PHX,James Harden,167,38.3333333333333,38,0.333333333333329,81,84,-3,-2,-1
21701132,203991,HOU,PHX,Clint Capela,147,33.6833333333333,34,-0.316666666666663,77,72,5,6,-1
21701132,204028,HOU,PHX,Tarik Black,46,9.86666666666667,10,-0.133333333333333,17,18,-1,-1,0
21701132,203584,PHX,HOU,Troy Daniels,149,35.5333333333333,36,-0.466666666666669,73,76,-3,-2,-1
21701132,1626210,PHX,HOU,Alan Williams,69,14.6666666666667,15,-0.333333333333332,29,33,-4,-6,2
21701132,1627733,PHX,HOU,Dragan Bender,76,17.8166666666667,18,-0.183333333333334,38,42,-4,-4,0
21701132,1627737,PHX,HOU,Marquese Chriss,146,33.3333333333333,33,0.333333333333336,74,70,4,5,-1
21701132,1627755,PHX,HOU,Tyler Ulis,162,36.7166666666667,37,-0.283333333333331,80,74,6,7,-1
21701132,1627863,PHX,HOU,Danuel House Jr.,112,24.9,25,-0.100000000000001,51,49,2,1,1
21701132,1627885,PHX,HOU,Shaquille Harrison,75,15.2,15,0.199999999999999,29,42,-13,-15,2
21701132,1628367,PHX,HOU,Josh Jackson,163,35.3833333333333,35,0.383333333333333,85,78,7,6,1
21701132,1628409,PHX,HOU,Alec Peters,123,26.45,27,-0.550000000000001,56,51,5,3,2
21701133,2734,DEN,OKC,Devin Harris,158,33.4333333333333,34,-0.566666666666663,74,77,-3,-3,0
21701133,200794,DEN,OKC,Paul Millsap,195,39.5166666666667,40,-0.483333333333334,97,98,-1,1,-2
21701133,201163,DEN,OKC,Wilson Chandler,113,22.5666666666667,23,-0.433333333333334,58,58,0,0,0
21701133,203115,DEN,OKC,Will Barton,200,40.8833333333333,41,-0.116666666666667,103,101,2,4,-2
21701133,203486,DEN,OKC,Mason Plumlee,78,14.6333333333333,14,0.633333333333333,33,33,0,-10,10
21701133,203999,DEN,OKC,Nikola Jokic,186,41.05,41,0.0499999999999972,98,95,3,11,-8
21701133,1626168,DEN,OKC,Trey Lyles,49,10.7666666666667,11,-0.233333333333334,24,24,0,0,0
21701133,1627750,DEN,OKC,Jamal Murray,214,45.2666666666667,45,0.266666666666666,105,102,3,6,-3
21701133,1628470,DEN,OKC,Torrey Craig,77,16.8,16,0.800000000000001,38,37,1,-4,5
21701133,2546,OKC,DEN,Carmelo Anthony,162,32.9833333333333,33,-0.0166666666666657,78,80,-2,0,-2
21701133,101109,OKC,DEN,Raymond Felton,79,18.3666666666667,18,0.366666666666667,39,39,0,1,-1
21701133,201147,OKC,DEN,Corey Brewer,168,34,34,0,81,85,-4,-7,3
21701133,201566,OKC,DEN,Russell Westbrook,215,43.75,44,-0.25,110,105,5,2,3
21701133,202331,OKC,DEN,Paul George,198,41.45,41,0.450000000000003,92,105,-13,-12,-1
21701133,202335,OKC,DEN,Patrick Patterson,67,14.5833333333333,14,0.583333333333332,35,31,4,2,2
21701133,203500,OKC,DEN,Steven Adams,170,34.0333333333333,34,0.0333333333333314,80,90,-10,-8,-2
21701133,203518,OKC,DEN,Alex Abrines,75,15.6833333333333,15,0.683333333333334,46,28,18,21,-3
21701133,203924,OKC,DEN,Jerami Grant,109,24.3666666666667,24,0.366666666666667,57,51,6,4,2
21701133,1628390,OKC,DEN,Terrance Ferguson,27,5.7,6,-0.3,7,16,-9,-8,-1
21701134,1717,DAL,MIN,Dirk Nowitzki,115,25.9,26,-0.100000000000001,43,50,-7,-10,3
21701134,203084,DAL,MIN,Harrison Barnes,147,34.1166666666667,34,0.116666666666667,60,71,-11,-11,0
21701134,203457,DAL,MIN,Nerlens Noel,102,25.7333333333333,25,0.733333333333334,50,52,-2,-1,-1
21701134,203926,DAL,MIN,Doug McDermott,58,13.8666666666667,14,-0.133333333333333,32,22,10,10,0
21701134,203939,DAL,MIN,Dwight Powell,91,20.5166666666667,21,-0.483333333333334,37,32,5,2,3
21701134,1626151,DAL,MIN,Aaron Harrison,57,14.9666666666667,15,-0.033333333333335,26,33,-7,-8,1
21701134,1627812,DAL,MIN,Yogi Ferrell,120,28.9,29,-0.100000000000001,63,61,2,2,0
21701134,1627827,DAL,MIN,Dorian Finney-Smith,118,25.9333333333333,26,-0.06666666666667,47,49,-2,-1,-1
21701134,1628372,DAL,MIN,Dennis Smith Jr.,115,26.1666666666667,26,0.166666666666664,48,43,5,5,0
21701134,1628467,DAL,MIN,Maxi Kleber,102,23.8166666666667,24,-0.183333333333334,54,52,2,7,-5
21701134,2037,MIN,DAL,Jamal Crawford,127,30.7,31,-0.299999999999997,71,65,6,6,0
21701134,201952,MIN,DAL,Jeff Teague,82,19.1333333333333,20,-0.866666666666667,36,33,3,3,0
21701134,201959,MIN,DAL,Taj Gibson,140,31.1666666666667,31,0.166666666666668,59,62,-3,-3,0
21701134,202357,MIN,DAL,Nemanja Bjelica,147,35.0333333333333,35,0.0333333333333314,56,63,-7,-7,0
21701134,203476,MIN,DAL,Gorgui Dieng,35,8.41666666666667,8,0.416666666666666,13,12,1,0,1
21701134,203952,MIN,DAL,Andrew Wiggins,183,42.6333333333333,43,-0.366666666666667,87,81,6,6,0
21701134,1626145,MIN,DAL,Tyus Jones,123,28.85,28,0.850000000000001,57,59,-2,-2,0
21701134,1626157,MIN,DAL,Karl-Anthony Towns,188,43.9833333333333,44,-0.0166666666666657,86,85,1,2,-1
21701135,201973,UTA,MEM,Jonas Jerebko,20,5.11666666666667,5,0.116666666666667,8,15,-7,-7,0
21701135,202324,UTA,MEM,Derrick Favors,133,31.75,32,-0.25,72,64,8,9,-1
21701135,202692,UTA,MEM,Alec Burks,67,13.7833333333333,14,-0.216666666666667,33,36,-3,-5,2
21701135,203109,UTA,MEM,Jae Crowder,96,21.25,21,0.25,52,47,5,4,1
21701135,203497,UTA,MEM,Rudy Gobert,122,28.9666666666667,29,-0.0333333333333314,61,58,3,1,2
21701135,203957,UTA,MEM,Dante Exum,115,26.2666666666667,27,-0.733333333333334,63,51,12,14,-2
21701135,204060,UTA,MEM,Joe Ingles,159,37.4333333333333,38,-0.566666666666663,81,79,2,2,0
21701135,1626220,UTA,MEM,Royce O'Neale,151,35.4833333333333,36,-0.516666666666666,78,64,14,16,-2
21701135,1628378,UTA,MEM,Donovan Mitchell,162,38.2,38,0.200000000000003,87,71,16,16,0
21701135,201188,MEM,UTA,Marc Gasol,88,23.0666666666667,23,0.0666666666666664,50,48,2,4,-2
21701135,202705,MEM,UTA,MarShon Brooks,86,18.3666666666667,18,0.366666666666667,50,48,2,2,0
21701135,203104,MEM,UTA,Marquis Teague,112,25.65,25,0.649999999999999,46,61,-15,-17,2
21701135,203210,MEM,UTA,JaMychal Green,78,19.9333333333333,20,-0.0666666666666664,31,40,-9,-9,0
21701135,203463,MEM,UTA,Ben McLemore,108,23.95,23,0.950000000000003,52,62,-10,-10,0
21701135,1626185,MEM,UTA,Jarell Martin,117,29.2166666666667,30,-0.783333333333331,58,62,-4,-2,-2
21701135,1627738,MEM,UTA,Deyonta Davis,55,12.3,12,0.300000000000001,20,31,-11,-11,0
21701135,1627782,MEM,UTA,Wayne Selden,110,23.45,24,-0.549999999999997,49,55,-6,-6,0
21701135,1628397,MEM,UTA,Ivan Rabb,62,12.2833333333333,13,-0.716666666666667,27,28,-1,-3,2
21701135,1628415,MEM,UTA,Dillon Brooks,105,25.3666666666667,26,-0.633333333333333,45,49,-4,-4,0
21701135,1628424,MEM,UTA,Kobi Simmons,104,24.6666666666667,25,-0.333333333333336,57,51,6,6,0
21701136,101112,LAL,MIL,Channing Frye,76,15,15,0,39,29,10,10,0
21701136,201572,LAL,MIL,Brook Lopez,131,27.5,28,-0.5,68,75,-7,-6,-1
21701136,203484,LAL,MIL,Kentavious Caldwell-Pope,79,16.3333333333333,16,0.333333333333332,42,47,-5,-10,5
21701136,203898,LAL,MIL,Tyler Ennis,79,14.9166666666667,15,-0.0833333333333322,41,30,11,12,-1
21701136,203944,LAL,MIL,Julius Randle,190,40.3,40,0.299999999999997,84,103,-19,-19,0
21701136,1627742,LAL,MIL,Brandon Ingram,120,26.8833333333333,27,-0.116666666666667,52,66,-14,-11,-3
21701136,1627826,LAL,MIL,Ivica Zubac,60,11.9833333333333,12,-0.0166666666666675,35,21,14,15,-1
21701136,1627936,LAL,MIL,Alex Caruso,146,30.7666666666667,31,-0.233333333333334,71,62,9,9,0
21701136,1628398,LAL,MIL,Kyle Kuzma,216,46.2166666666667,46,0.216666666666669,105,111,-6,-5,-1
21701136,1628404,LAL,MIL,Josh Hart,168,35.1,35,0.0999999999999943,68,76,-8,-5,-3
21701136,1891,MIL,LAL,Jason Terry,143,29.9,30,-0.100000000000001,59,64,-5,-5,0
21701136,201943,MIL,LAL,Brandon Jennings,73,14.8166666666667,15,-0.183333333333334,30,30,0,2,-2
21701136,202339,MIL,LAL,Eric Bledsoe,158,33.9666666666667,34,-0.0333333333333314,86,81,5,4,1
21701136,203092,MIL,LAL,Tyler Zeller,138,28.3333333333333,28,0.333333333333332,82,71,11,12,-1
21701136,203114,MIL,LAL,Khris Middleton,185,40.05,40,0.0499999999999972,102,87,15,12,3
21701136,203498,MIL,LAL,Shabazz Muhammad,51,10.0166666666667,10,0.0166666666666657,15,28,-13,-11,-2
21701136,203503,MIL,LAL,Tony Snell,130,29.2333333333333,30,-0.766666666666666,73,61,12,9,3
21701136,203507,MIL,LAL,Giannis Antetokounmpo,203,42.4833333333333,43,-0.516666666666666,86,101,-15,-16,1
21701136,203953,MIL,LAL,Jabari Parker,128,25.5166666666667,25,0.516666666666666,63,59,4,6,-2
21701136,1627850,MIL,LAL,Marshall Plumlee,34,6.46666666666667,7,-0.533333333333333,16,13,3,1,2
21701136,1628425,MIL,LAL,Sterling Brown,22,4.21666666666667,4,0.216666666666667,8,10,-2,-4,2
21701137,101150,LAC,POR,Lou Williams,155,31.8333333333333,32,-0.166666666666668,64,76,-12,-10,-2
21701137,201568,LAC,POR,Danilo Gallinari,121,24.3166666666667,25,-0.683333333333334,45,64,-19,-19,0
21701137,201599,LAC,POR,DeAndre Jordan,114,23.2166666666667,24,-0.783333333333331,43,57,-14,-13,-1
21701137,202325,LAC,POR,Wesley Johnson,26,5.85,6,-0.15,17,10,7,6,1
21701137,202699,LAC,POR,Tobias Harris,177,35.8666666666667,36,-0.133333333333333,67,75,-8,-8,0
21701137,203085,LAC,POR,Austin Rivers,140,29.4166666666667,30,-0.583333333333332,54,69,-15,-15,0
21701137,203710,LAC,POR,C.J. Williams,27,5.75,6,-0.25,17,15,2,0,2
21701137,1626149,LAC,POR,Montrezl Harrell,116,23.4,23,0.399999999999999,45,45,0,-1,1
21701137,1626155,LAC,POR,Sam Dekker,15,3.16666666666667,4,-0.833333333333333,12,5,7,7,0
21701137,1626246,LAC,POR,Boban Marjanovic,59,11.6,12,-0.4,30,18,12,12,0
21701137,1627820,LAC,POR,Tyrone Wallace,176,35.2166666666667,35,0.216666666666669,67,73,-6,-5,-1
21701137,1628414,LAC,POR,Sindarius Thornwell,44,8.36666666666667,9,-0.633333333333333,19,18,1,1,0
21701137,202323,POR,LAC,Evan Turner,155,32.1666666666667,32,0.166666666666664,69,60,9,10,-1
21701137,202329,POR,LAC,Al-Farouq Aminu,129,26.4,27,-0.600000000000001,51,46,5,6,-1
21701137,202334,POR,LAC,Ed Davis,58,12.35,12,0.350000000000001,26,23,3,2,1
21701137,203081,POR,LAC,Damian Lillard,184,38.1166666666667,38,0.116666666666667,80,71,9,9,0
21701137,203468,POR,LAC,CJ McCollum,181,36.25,37,-0.75,74,70,4,5,-1
21701137,203894,POR,LAC,Shabazz Napier,74,14.3333333333333,14,0.333333333333332,33,31,2,1,1
21701137,203994,POR,LAC,Jusuf Nurkic,142,29.25,30,-0.75,65,54,11,12,-1
21701137,1626192,POR,LAC,Pat Connaughton,101,20.2666666666667,20,0.266666666666666,54,48,6,7,-1
21701137,1627735,POR,LAC,Wade Baldwin IV,5,1.1,1,0.1,3,5,-2,-2,0
21701137,1627774,POR,LAC,Jake Layman,5,1.1,1,0.1,3,5,-2,-2,0
21701137,1628380,POR,LAC,Zach Collins,102,20.6666666666667,21,-0.333333333333336,53,48,5,2,3
21701137,1628403,POR,LAC,Caleb Swanigan,34,6,6,0,14,19,-5,-5,0
21701138,101133,WAS,CHA,Ian Mahinmi,83,17.6666666666667,18,-0.333333333333336,36,39,-3,0,-3
21701138,101162,WAS,CHA,Marcin Gortat,121,26.2833333333333,27,-0.716666666666669,64,48,16,13,3
21701138,201196,WAS,CHA,Ramon Sessions,5,1.4,2,-0.6,2,2,0,0,0
21701138,201975,WAS,CHA,Jodie Meeks,5,1.4,2,-0.6,2,2,0,0,0
21701138,202322,WAS,CHA,John Wall,153,33.3,33,0.299999999999997,74,59,15,16,-1
21701138,202693,WAS,CHA,Markieff Morris,48,9.55,10,-0.449999999999999,22,21,1,1,0
21701138,203078,WAS,CHA,Bradley Beal,169,36.5333333333333,36,0.533333333333331,87,74,13,11,2
21701138,203107,WAS,CHA,Tomas Satoransky,112,25.2666666666667,26,-0.733333333333334,53,54,-1,0,-1
21701138,203118,WAS,CHA,Mike Scott,98,22.3166666666667,23,-0.683333333333334,59,44,15,15,0
21701138,203490,WAS,CHA,Otto Porter Jr.,171,37.55,38,-0.450000000000003,80,70,10,8,2
21701138,1626162,WAS,CHA,Kelly Oubre Jr.,125,26.9833333333333,27,-0.0166666666666657,56,52,4,6,-2
21701138,2730,CHA,WAS,Dwight Howard,144,31.0833333333333,31,0.0833333333333357,57,74,-17,-17,0
21701138,101107,CHA,WAS,Marvin Williams,110,24.1833333333333,24,0.183333333333334,46,59,-13,-11,-2
21701138,201587,CHA,WAS,Nicolas Batum,144,31.0833333333333,31,0.0833333333333357,57,74,-17,-17,0
21701138,202689,CHA,WAS,Kemba Walker,151,32.05,32,0.0499999999999972,59,70,-11,-11,0
21701138,202933,CHA,WAS,Julyan Stone,5,1.4,2,-0.6,2,2,0,0,0
21701138,203077,CHA,WAS,Michael Kidd-Gilchrist,95,21.0666666666667,21,0.0666666666666629,41,53,-12,-13,1
21701138,1626163,CHA,WAS,Frank Kaminsky,108,23.4666666666667,24,-0.533333333333331,47,48,-1,-3,2
21701138,1626195,CHA,WAS,Willy Hernangomez,74,16.5666666666667,17,-0.433333333333334,36,33,3,3,0
21701138,1626203,CHA,WAS,Treveon Graham,71,15.9166666666667,16,-0.0833333333333322,34,33,1,1,0
21701138,1628370,CHA,WAS,Malik Monk,107,23.5166666666667,24,-0.483333333333334,46,50,-4,-4,0
21701138,1628407,CHA,WAS,Dwayne Bacon,81,17.9166666666667,18,-0.0833333333333357,40,39,1,2,-1
21701139,201563,NYK,DET,Michael Beasley,131,28.65,29,-0.350000000000001,74,71,3,1,2
21701139,202498,NYK,DET,Lance Thomas,61,14.15,14,0.149999999999999,22,36,-14,-12,-2
21701139,203124,NYK,DET,Kyle O'Quinn,147,32.1666666666667,32,0.166666666666664,84,77,7,8,-1
21701139,203501,NYK,DET,Tim Hardaway Jr.,162,35.75,36,-0.25,92,83,9,10,-1
21701139,203504,NYK,DET,Trey Burke,175,38.0833333333333,38,0.0833333333333286,95,94,1,-1,2
21701139,1626144,NYK,DET,Emmanuel Mudiay,90,20.15,20,0.149999999999999,31,48,-17,-16,-1
21701139,1627786,NYK,DET,Troy Williams,147,32.3166666666667,33,-0.68333333333333,81,73,8,6,2
21701139,1628422,NYK,DET,Damyean Dotson,80,17.65,17,0.649999999999999,28,47,-19,-17,-2
21701139,1628436,NYK,DET,Luke Kornet,71,15.8166666666667,16,-0.183333333333334,25,38,-13,-14,1
21701139,1628439,NYK,DET,Isaiah Hicks,26,5.18333333333333,5,0.183333333333334,13,8,5,5,0
21701139,201229,DET,NYK,Anthony Tolliver,146,30.9,31,-0.100000000000001,76,80,-4,-3,-1
21701139,202397,DET,NYK,Ish Smith,106,23.3333333333333,23,0.333333333333332,55,57,-2,-1,-1
21701139,202704,DET,NYK,Reggie Jackson,111,24.5333333333333,25,-0.466666666666669,60,52,8,7,1
21701139,203083,DET,NYK,Andre Drummond,167,37.1666666666667,37,0.166666666666671,83,90,-7,-6,-1
21701139,203493,DET,NYK,Reggie Bullock,148,33.35,33,0.350000000000001,82,81,1,-1,2
21701139,203516,DET,NYK,James Ennis III,97,21.7166666666667,21,0.716666666666669,55,40,15,15,0
21701139,203961,DET,NYK,Eric Moreland,51,10.8166666666667,11,-0.183333333333334,32,19,13,12,1
21701139,1626169,DET,NYK,Stanley Johnson,108,23.2,23,0.199999999999999,51,61,-10,-12,2
21701139,1627740,DET,NYK,Henry Ellenson,72,17.0833333333333,17,0.0833333333333322,39,29,10,9,1
21701139,1628379,DET,NYK,Luke Kennard,84,17.8166666666667,18,-0.183333333333334,42,36,6,10,-4
21701140,201143,BOS,TOR,Al Horford,150,31.5666666666667,31,0.566666666666666,75,69,6,10,-4
21701140,202328,BOS,TOR,Greg Monroe,72,16.7166666666667,17,-0.283333333333331,32,33,-1,1,-2
21701140,202694,BOS,TOR,Marcus Morris,154,35.2,35,0.200000000000003,87,68,19,21,-2
21701140,202918,BOS,TOR,Xavier Silas,2,0.133333333333333,0,0.133333333333333,0,0,0,0,0
21701140,203382,BOS,TOR,Aron Baynes,107,23.2333333333333,24,-0.766666666666666,54,52,2,-2,4
21701140,1626179,BOS,TOR,Terry Rozier,172,36.9833333333333,37,-0.0166666666666657,90,77,13,11,2
21701140,1627759,BOS,TOR,Jaylen Brown,139,30,30,0,65,65,0,0,0
21701140,1627846,BOS,TOR,Abdel Nader,34,7.28333333333333,7,0.283333333333333,21,17,4,4,0
21701140,1628369,BOS,TOR,Jayson Tatum,158,33.7,33,0.700000000000003,81,74,7,7,0
21701140,1628400,BOS,TOR,Semi Ojeleye,74,17.2666666666667,18,-0.733333333333334,31,27,4,2,2
21701140,1628443,BOS,TOR,Kadeem Allen,35,7.61666666666667,8,-0.383333333333333,14,13,1,1,0
21701140,1628444,BOS,TOR,Jabari Bird,3,0.133333333333333,0,0.133333333333333,0,0,0,0,0
21701140,101139,TOR,BOS,CJ Miles,92,19.9333333333333,20,-0.0666666666666664,36,46,-10,-9,-1
21701140,200768,TOR,BOS,Kyle Lowry,159,33.9333333333333,34,-0.0666666666666629,70,82,-12,-10,-2
21701140,201586,TOR,BOS,Serge Ibaka,150,32.6333333333333,32,0.633333333333333,72,74,-2,-2,0
21701140,201942,TOR,BOS,DeMar DeRozan,170,36.6,36,0.599999999999994,80,88,-8,-8,0
21701140,202685,TOR,BOS,Jonas Valanciunas,121,25.2833333333333,25,0.283333333333331,61,63,-2,-3,1
21701140,1626153,TOR,BOS,Delon Wright,50,11.3666666666667,12,-0.633333333333333,19,22,-3,-3,0
21701140,1626181,TOR,BOS,Norman Powell,35,7.9,8,-0.0999999999999996,16,16,0,-3,3
21701140,1627751,TOR,BOS,Jakob Poeltl,85,19.7166666666667,20,-0.283333333333331,35,40,-5,-4,-1
21701140,1627783,TOR,BOS,Pascal Siakam,70,15.25,16,-0.75,27,36,-9,-11,2
21701140,1627832,TOR,BOS,Fred VanVleet,78,18.1166666666667,18,0.116666666666667,33,34,-1,0,-1
21701140,1628384,TOR,BOS,OG Anunoby,90,19.1,19,0.100000000000001,46,49,-3,-2,-1
21701141,2548,MIA,BKN,Dwyane Wade,136,28.6166666666667,28,0.616666666666667,56,58,-2,1,-3
21701141,201609,MIA,BKN,Goran Dragic,183,38.9666666666667,39,-0.0333333333333314,84,74,10,11,-1
21701141,201949,MIA,BKN,James Johnson,168,35.2833333333333,36,-0.716666666666669,77,68,9,8,1
21701141,201961,MIA,BKN,Wayne Ellington,105,21.7166666666667,22,-0.283333333333331,46,54,-8,-10,2
21701141,202355,MIA,BKN,Hassan Whiteside,95,19.9166666666667,20,-0.0833333333333357,41,43,-2,-1,-1
21701141,203482,MIA,BKN,Kelly Olynyk,88,18.4333333333333,18,0.43333333333333,38,44,-6,-7,1
21701141,204020,MIA,BKN,Tyler Johnson,132,28.4,29,-0.600000000000001,63,60,3,3,0
21701141,1626159,MIA,BKN,Justise Winslow,155,33.9666666666667,34,-0.0333333333333314,64,69,-5,-4,-1
21701141,1626196,MIA,BKN,Josh Richardson,188,39.6166666666667,40,-0.38333333333334,76,80,-4,-6,2
21701141,201960,BKN,MIA,DeMarre Carroll,176,36.6166666666667,37,-0.38333333333334,77,68,9,9,0
21701141,201967,BKN,MIA,Dante Cunningham,87,18.2833333333333,18,0.283333333333331,43,43,0,0,0
21701141,203112,BKN,MIA,Quincy Acy,69,14.9166666666667,14,0.916666666666666,37,34,3,2,1
21701141,203459,BKN,MIA,Allen Crabbe,160,33.2833333333333,34,-0.716666666666669,65,69,-4,-3,-1
21701141,203915,BKN,MIA,Spencer Dinwiddie,163,34.7166666666667,35,-0.283333333333331,65,71,-6,-1,-5
21701141,203925,BKN,MIA,Joe Harris,126,27.2666666666667,27,0.266666666666666,65,50,15,12,3
21701141,1626156,BKN,MIA,D'Angelo Russell,32,6.55,7,-0.45,11,16,-5,-5,0
21701141,1626178,BKN,MIA,Rondae Hollis-Jefferson,185,38.9333333333333,39,-0.0666666666666629,76,85,-9,-10,1
21701141,1627747,BKN,MIA,Caris LeVert,160,34.9666666666667,35,-0.0333333333333314,69,75,-6,-7,1
21701141,1628386,BKN,MIA,Jarrett Allen,92,19.3833333333333,19,0.383333333333333,42,34,8,8,0
21701142,2561,GSW,SAC,David West,69,14.45,15,-0.550000000000001,30,29,1,-1,2
21701142,2733,GSW,SAC,Shaun Livingston,72,15.5666666666667,16,-0.433333333333334,32,30,2,2,0
21701142,201142,GSW,SAC,Kevin Durant,149,30.5,31,-0.5,82,62,20,20,0
21701142,201156,GSW,SAC,Nick Young,94,20.6333333333333,21,-0.366666666666667,49,40,9,7,2
21701142,201580,GSW,SAC,JaVale McGee,48,11.1166666666667,11,0.116666666666667,22,23,-1,-1,0
21701142,202691,GSW,SAC,Klay Thompson,155,31.7333333333333,32,-0.266666666666666,70,71,-1,3,-4
21701142,203110,GSW,SAC,Draymond Green,161,33.1833333333333,34,-0.816666666666663,76,74,2,4,-2
21701142,1626172,GSW,SAC,Kevon Looney,125,25.5666666666667,26,-0.433333333333334,71,52,19,19,0
21701142,1626188,GSW,SAC,Quinn Cook,123,26.4666666666667,27,-0.533333333333331,63,58,5,2,3
21701142,1627745,GSW,SAC,Damian Jones,15,4.51666666666667,5,-0.483333333333333,5,9,-4,-2,-2
21701142,1627775,GSW,SAC,Patrick McCaw,77,16.1166666666667,16,0.116666666666667,40,25,15,16,-1
21701142,1628395,GSW,SAC,Jordan Bell,37,8.23333333333333,8,0.233333333333334,20,7,13,11,2
21701142,1713,SAC,GSW,Vince Carter,71,14.8,15,-0.199999999999999,21,42,-21,-21,0
21701142,203960,SAC,GSW,JaKarr Sampson,56,12.1,12,0.100000000000001,15,25,-10,-8,-2
21701142,203992,SAC,GSW,Bogdan Bogdanovic,122,24.9666666666667,25,-0.0333333333333314,60,64,-4,-4,0
21701142,203998,SAC,GSW,Bruno Caboclo,67,15.0166666666667,15,0.0166666666666657,29,31,-2,-2,0
21701142,204022,SAC,GSW,Jack Cooley,94,18.2333333333333,18,0.233333333333334,40,48,-8,-6,-2
21701142,1626161,SAC,GSW,Willie Cauley-Stein,110,24.1,24,0.100000000000001,45,54,-9,-9,0
21701142,1627741,SAC,GSW,Buddy Hield,134,29.1,29,0.100000000000001,53,71,-18,-17,-1
21701142,1627746,SAC,GSW,Skal Labissiere,129,29.0166666666667,29,0.0166666666666657,65,59,6,4,2
21701142,1628368,SAC,GSW,De'Aaron Fox,132,27.1666666666667,27,0.166666666666664,60,68,-8,-9,1
21701142,1628382,SAC,GSW,Justin Jackson,124,25.25,26,-0.75,59,59,0,-3,3
21701142,1628412,SAC,GSW,Frank Mason,86,18.3333333333333,19,-0.666666666666664,33,39,-6,-5,-1
21701143,101141,PHI,CHA,Ersan Ilyasova,131,27.4833333333333,27,0.483333333333334,62,57,5,6,-1
21701143,101161,PHI,CHA,Amir Johnson,149,30.7,31,-0.300000000000001,78,64,14,13,1
21701143,200755,PHI,CHA,JJ Redick,139,28.5,28,0.5,64,67,-3,0,-3
21701143,201158,PHI,CHA,Marco Belinelli,148,30.7,31,-0.299999999999997,89,67,22,23,-1
21701143,203496,PHI,CHA,Robert Covington,169,33.2833333333333,33,0.283333333333331,82,72,10,9,1
21701143,204456,PHI,CHA,T.J. McConnell,85,17.45,18,-0.549999999999997,52,34,18,14,4
21701143,1626147,PHI,CHA,Justin Anderson,14,2.93333333333333,3,-0.0666666666666664,4,5,-1,-1,0
21701143,1626158,PHI,CHA,Richaun Holmes,83,16.95,17,-0.0500000000000007,41,37,4,5,-1
21701143,1627732,PHI,CHA,Ben Simmons,156,31.3666666666667,32,-0.633333333333333,86,65,21,21,0
21701143,1627788,PHI,CHA,Furkan Korkmaz,14,2.93333333333333,3,-0.0666666666666664,4,5,-1,-1,0
21701143,1628365,PHI,CHA,Markelle Fultz,77,16.3666666666667,16,0.366666666666667,33,37,-4,-4,0
21701143,2730,CHA,PHI,Dwight Howard,128,25.5833333333333,26,-0.416666666666668,56,65,-9,-13,4
21701143,101107,CHA,PHI,Marvin Williams,111,21.9833333333333,22,-0.0166666666666657,46,58,-12,-11,-1
21701143,201587,CHA,PHI,Nicolas Batum,112,22.0166666666667,22,0.0166666666666657,48,58,-10,-11,1
21701143,202689,CHA,PHI,Kemba Walker,128,25.9666666666667,26,-0.0333333333333314,53,65,-12,-12,0
21701143,202933,CHA,PHI,Julyan Stone,74,15.6333333333333,16,-0.366666666666667,36,33,3,4,-1
21701143,203077,CHA,PHI,Michael Kidd-Gilchrist,159,32.1,32,0.0999999999999943,66,86,-20,-21,1
21701143,203087,CHA,PHI,Jeremy Lamb,112,23.5166666666667,24,-0.483333333333334,50,54,-4,-5,1
21701143,1626163,CHA,PHI,Frank Kaminsky,122,25.75,26,-0.25,56,61,-5,-6,1
21701143,1626195,CHA,PHI,Willy Hernangomez,105,22.15,22,0.149999999999999,46,54,-8,-4,-4
21701143,1628370,CHA,PHI,Malik Monk,114,23.9666666666667,24,-0.0333333333333314,53,61,-8,-6,-2
21701144,201577,CHI,WAS,Robin Lopez,71,16.5666666666667,17,-0.433333333333334,48,35,13,15,-2
21701144,203200,CHI,WAS,Justin Holiday,76,17.1166666666667,17,0.116666666666667,52,40,12,14,-2
21701144,203930,CHI,WAS,Sean Kilpatrick,102,22.9666666666667,23,-0.0333333333333314,46,42,4,2,2
21701144,203943,CHI,WAS,Noah Vonleh,75,17.1666666666667,18,-0.833333333333332,40,35,5,3,2
21701144,1626166,CHI,WAS,Cameron Payne,116,24.75,25,-0.25,55,53,2,2,0
21701144,1626170,CHI,WAS,Jerian Grant,111,25.3833333333333,26,-0.616666666666667,60,43,17,17,0
21701144,1626171,CHI,WAS,Bobby Portis,71,15.6666666666667,16,-0.333333333333334,44,32,12,12,0
21701144,1626245,CHI,WAS,Cristiano Felicio,97,21.15,21,0.149999999999999,39,33,6,6,0
21701144,1627756,CHI,WAS,Denzel Valentine,84,18.4,18,0.399999999999999,50,39,11,10,1
21701144,1627853,CHI,WAS,Ryan Arcidiacono,63,14.5,15,-0.5,28,21,7,7,0
21701144,1628021,CHI,WAS,David Nwaba,93,19.8333333333333,20,-0.166666666666668,48,44,4,5,-1
21701144,1628374,CHI,WAS,Lauri Markkanen,116,24.75,25,-0.25,55,53,2,2,0
21701144,101162,WAS,CHI,Marcin Gortat,110,24.2,24,0.200000000000003,50,57,-7,-7,0
21701144,201160,WAS,CHI,Jason Smith,76,17.2833333333333,18,-0.716666666666669,33,48,-15,-15,0
21701144,201196,WAS,CHI,Ramon Sessions,52,11.6666666666667,12,-0.333333333333334,28,37,-9,-9,0
21701144,201975,WAS,CHI,Jodie Meeks,82,18.3833333333333,19,-0.616666666666667,35,47,-12,-12,0
21701144,202693,WAS,CHI,Markieff Morris,139,30.3666666666667,30,0.366666666666667,61,65,-4,-4,0
21701144,203078,WAS,CHI,Bradley Beal,133,29.2666666666667,29,0.266666666666666,59,66,-7,-7,0
21701144,203107,WAS,CHI,Tomas Satoransky,145,32.1166666666667,32,0.116666666666667,61,68,-7,-7,0
21701144,203118,WAS,CHI,Mike Scott,92,20.75,21,-0.25,37,52,-15,-15,0
21701144,203490,WAS,CHI,Otto Porter Jr.,139,30.3666666666667,30,0.366666666666667,61,65,-4,-4,0
21701144,204025,WAS,CHI,Tim Frazier,36,7.91666666666667,8,-0.0833333333333339,13,18,-5,-5,0
21701144,1626162,WAS,CHI,Kelly Oubre Jr.,71,15.9333333333333,16,-0.0666666666666664,32,42,-10,-10,0
21701145,2207,HOU,SAS,Joe Johnson,70,16.4166666666667,16,0.416666666666664,29,39,-10,-9,-1
21701145,2772,HOU,SAS,Trevor Ariza,116,27.4833333333333,27,0.483333333333334,48,53,-5,-6,1
21701145,101123,HOU,SAS,Gerald Green,117,29.0666666666667,29,0.0666666666666664,46,58,-12,-12,0
21701145,200782,HOU,SAS,PJ Tucker,117,27.9,28,-0.100000000000001,47,56,-9,-10,1
21701145,201569,HOU,SAS,Eric Gordon,130,28.7333333333333,29,-0.266666666666666,51,57,-6,-6,0
21701145,201583,HOU,SAS,Ryan Anderson,76,18,18,0,30,38,-8,-8,0
21701145,201601,HOU,SAS,Luc Mbah a Moute,92,21.9666666666667,22,-0.0333333333333314,38,51,-13,-12,-1
21701145,201935,HOU,SAS,James Harden,148,35.9666666666667,36,-0.0333333333333314,65,84,-19,-19,0
21701145,203991,HOU,SAS,Clint Capela,120,28.55,28,0.549999999999997,50,58,-8,-8,0
21701145,204028,HOU,SAS,Tarik Black,15,3.68333333333333,4,-0.316666666666667,7,5,2,2,0
21701145,1627817,HOU,SAS,Tim Quarterman,9,2.23333333333333,2,0.233333333333333,4,1,3,3,0
21701145,1938,SAS,HOU,Manu Ginobili,88,20.4833333333333,20,0.483333333333334,56,40,16,18,-2
21701145,2200,SAS,HOU,Pau Gasol,45,10.7333333333333,11,-0.266666666666666,13,21,-8,0,-8
21701145,2225,SAS,HOU,Tony Parker,57,12.9833333333333,13,-0.0166666666666657,33,25,8,9,-1
21701145,200746,SAS,HOU,LaMarcus Aldridge,148,35.8166666666667,36,-0.183333333333337,79,63,16,16,0
21701145,200752,SAS,HOU,Rudy Gay,99,23.5166666666667,24,-0.483333333333334,58,39,19,20,-1
21701145,201980,SAS,HOU,Danny Green,127,29.85,30,-0.150000000000002,56,42,14,12,2
21701145,201988,SAS,HOU,Patty Mills,154,37.55,37,0.549999999999997,78,63,15,20,-5
21701145,202722,SAS,HOU,Davis Bertans,9,2.23333333333333,2,0.233333333333333,1,4,-3,-3,0
21701145,203464,SAS,HOU,Brandon Paul,9,2.23333333333333,2,0.233333333333333,1,4,-3,-3,0
21701145,203530,SAS,HOU,Joffrey Lauvergne,9,2.23333333333333,2,0.233333333333333,1,4,-3,-3,0
21701145,203937,SAS,HOU,Kyle Anderson,108,25.5,26,-0.5,58,42,16,6,10
21701145,1627749,SAS,HOU,Dejounte Murray,107,24.7666666666667,25,-0.233333333333334,47,43,4,2,2
21701145,1627854,SAS,HOU,Bryn Forbes,50,12.1,12,0.0999999999999996,19,25,-6,-9,3
21701146,101150,LAC,IND,Lou Williams,143,32.2333333333333,32,0.233333333333334,77,74,3,2,1
21701146,201568,LAC,IND,Danilo Gallinari,132,31.0666666666667,32,-0.93333333333333,56,60,-4,-7,3
21701146,201599,LAC,IND,DeAndre Jordan,124,27.7166666666667,28,-0.283333333333331,51,68,-17,-18,1
21701146,202699,LAC,IND,Tobias Harris,168,37.8666666666667,37,0.866666666666667,81,92,-11,-14,3
21701146,203085,LAC,IND,Austin Rivers,160,36.2333333333333,37,-0.766666666666666,76,86,-10,-11,1
21701146,203710,LAC,IND,C.J. Williams,2,0.416666666666667,0,0.416666666666667,3,2,1,1,0
21701146,1626149,LAC,IND,Montrezl Harrell,94,22.0333333333333,21,1.03333333333333,55,49,6,6,0
21701146,1627820,LAC,IND,Tyrone Wallace,162,36.4333333333333,37,-0.566666666666663,87,85,2,4,-2
21701146,1628414,LAC,IND,Sindarius Thornwell,65,15.3333333333333,15,0.333333333333332,34,34,0,2,-2
21701146,201152,IND,LAC,Thaddeus Young,169,38.6166666666667,39,-0.38333333333334,99,75,24,25,-1
21701146,201954,IND,LAC,Darren Collison,132,29.85,30,-0.149999999999999,70,61,9,10,-1
21701146,202344,IND,LAC,Trevor Booker,18,3.76666666666667,4,-0.233333333333333,4,12,-8,-7,-1
21701146,202362,IND,LAC,Lance Stephenson,91,20.9166666666667,20,0.916666666666664,49,44,5,5,0
21701146,202709,IND,LAC,Cory Joseph,92,21.5333333333333,21,0.533333333333331,47,57,-10,-10,0
21701146,202711,IND,LAC,Bojan Bogdanovic,143,33.1666666666667,34,-0.833333333333336,71,66,5,6,-1
21701146,203506,IND,LAC,Victor Oladipo,168,38.2,38,0.200000000000003,94,80,14,14,0
21701146,203922,IND,LAC,Glenn Robinson III,11,2.13333333333333,2,0.133333333333333,2,8,-6,-5,-1
21701146,1626167,IND,LAC,Myles Turner,142,31.7166666666667,32,-0.283333333333331,74,67,7,7,0
21701146,1627734,IND,LAC,Domantas Sabonis,84,19.4333333333333,19,0.433333333333334,40,50,-10,-10,0
21701147,203101,ATL,ORL,Miles Plumlee,66,15.1,15,0.100000000000001,31,26,5,5,0
21701147,203473,ATL,ORL,Dewayne Dedmon,145,33.4833333333333,34,-0.516666666666666,68,65,3,1,2
21701147,203488,ATL,ORL,Mike Muscala,104,24.6166666666667,25,-0.383333333333333,55,44,11,11,0
21701147,203705,ATL,ORL,Josh Magette,83,18.9666666666667,19,-0.0333333333333314,42,33,9,11,-2
21701147,1627752,ATL,ORL,Taurean Prince,118,26.8,27,-0.200000000000003,47,51,-4,-4,0
21701147,1627761,ATL,ORL,DeAndre' Bembry,66,13.9666666666667,14,-0.0333333333333332,30,23,7,7,0
21701147,1627814,ATL,ORL,Damion Lee,102,23.2166666666667,23,0.216666666666665,30,43,-13,-13,0
21701147,1627819,ATL,ORL,Isaiah Taylor,127,29.0333333333333,29,0.0333333333333314,52,55,-3,-5,2
21701147,1628381,ATL,ORL,John Collins,144,32.9,33,-0.0999999999999943,63,62,1,1,0
21701147,1628416,ATL,ORL,Tyler Dorsey,95,21.9166666666667,22,-0.0833333333333357,52,38,14,16,-2
21701147,201571,ORL,ATL,D.J. Augustin,166,37.05,37,0.0499999999999972,62,61,1,1,0
21701147,202687,ORL,ATL,Bismack Biyombo,72,16.6166666666667,17,-0.383333333333333,35,48,-13,-15,2
21701147,202696,ORL,ATL,Nikola Vucevic,138,31.3833333333333,31,0.383333333333333,53,46,7,9,-2
21701147,202714,ORL,ATL,Shelvin Mack,106,24,24,0,47,60,-13,-13,0
21701147,203920,ORL,ATL,Khem Birch,26,6.63333333333333,7,-0.366666666666666,16,23,-7,-7,0
21701147,203932,ORL,ATL,Aaron Gordon,166,37.05,37,0.0499999999999972,62,61,1,1,0
21701147,1626209,ORL,ATL,Mario Hezonja,123,27.7666666666667,28,-0.233333333333334,48,61,-13,-13,0
21701147,1628371,ORL,ATL,Jonathan Isaac,87,20.2333333333333,20,0.233333333333334,40,33,7,7,0
21701147,1628411,ORL,ATL,Wes Iwundu,122,28.3166666666667,28,0.316666666666666,51,44,7,7,0
21701147,1628681,ORL,ATL,Rodney Purvis,44,10.95,11,-0.0500000000000007,26,33,-7,-7,0
21701148,201960,BKN,DET,DeMarre Carroll,113,24.9,25,-0.100000000000001,46,48,-2,-1,-1
21701148,201967,BKN,DET,Dante Cunningham,79,17.2666666666667,18,-0.733333333333334,35,49,-14,-17,3
21701148,203112,BKN,DET,Quincy Acy,21,4.46666666666667,4,0.466666666666667,9,4,5,5,0
21701148,203459,BKN,DET,Allen Crabbe,97,21.1166666666667,21,0.116666666666667,45,53,-8,-8,0
21701148,203915,BKN,DET,Spencer Dinwiddie,53,12.1666666666667,12,0.166666666666666,22,26,-4,-5,1
21701148,203917,BKN,DET,Nik Stauskas,45,10.25,10,0.25,19,10,9,10,-1
21701148,203925,BKN,DET,Joe Harris,134,28.75,29,-0.25,54,61,-7,-9,2
21701148,1626156,BKN,DET,D'Angelo Russell,133,27.4666666666667,28,-0.533333333333331,59,76,-17,-20,3
21701148,1626178,BKN,DET,Rondae Hollis-Jefferson,142,30,30,0,65,81,-16,-18,2
21701148,1627747,BKN,DET,Caris LeVert,138,30.75,31,-0.25,63,63,0,-1,1
21701148,1628386,BKN,DET,Jarrett Allen,145,30.45,30,0.449999999999999,63,59,4,4,0
21701148,201229,DET,BKN,Anthony Tolliver,153,32.6333333333333,33,-0.366666666666667,78,66,12,13,-1
21701148,202397,DET,BKN,Ish Smith,79,16.8833333333333,17,-0.116666666666667,45,40,5,7,-2
21701148,202704,DET,BKN,Reggie Jackson,150,31.3333333333333,32,-0.666666666666664,67,60,7,8,-1
21701148,203083,DET,BKN,Andre Drummond,118,24.7666666666667,25,-0.233333333333334,56,51,5,6,-1
21701148,203493,DET,BKN,Reggie Bullock,161,35.7,35,0.700000000000003,74,71,3,3,0
21701148,203961,DET,BKN,Eric Moreland,100,22.4833333333333,23,-0.516666666666666,48,43,5,4,1
21701148,1626169,DET,BKN,Stanley Johnson,163,33.8166666666667,35,-1.18333333333334,90,76,14,16,-2
21701148,1627740,DET,BKN,Henry Ellenson,69,15.15,15,0.15,30,32,-2,1,-3
21701148,1628379,DET,BKN,Luke Kennard,107,24.8166666666667,25,-0.183333333333334,42,41,1,2,-1
21701149,2544,CLE,DAL,LeBron James,173,38.65,39,-0.350000000000001,76,69,7,7,0
21701149,2747,CLE,DAL,JR Smith,118,26.1833333333333,26,0.18333333333333,57,42,15,16,-1
21701149,101181,CLE,DAL,Jose Calderon,92,21.5833333333333,22,-0.416666666666664,44,47,-3,-3,0
21701149,201145,CLE,DAL,Jeff Green,83,17.8,17,0.799999999999997,37,34,3,5,-2
21701149,201567,CLE,DAL,Kevin Love,156,35.8333333333333,36,-0.166666666666671,77,62,15,13,2
21701149,202684,CLE,DAL,Tristan Thompson,86,19.3,20,-0.699999999999999,40,40,0,0,0
21701149,203903,CLE,DAL,Jordan Clarkson,117,25.3166666666667,25,0.316666666666666,53,38,15,16,-1
21701149,203918,CLE,DAL,Rodney Hood,107,24.5,24,0.5,46,52,-6,-6,0
21701149,1626204,CLE,DAL,Larry Nance Jr.,93,21.4666666666667,22,-0.533333333333331,39,34,5,5,0
21701149,1626224,CLE,DAL,Cedi Osman,31,6.91666666666667,7,-0.0833333333333339,16,13,3,6,-3
21701149,1627790,CLE,DAL,Ante Zizic,2,0.433333333333333,1,-0.566666666666667,0,2,-2,-2,0
21701149,1628506,CLE,DAL,London Perrantes,2,0.433333333333333,1,-0.566666666666667,0,2,-2,-2,0
21701149,1717,DAL,CLE,Dirk Nowitzki,88,20.6666666666667,21,-0.333333333333332,42,42,0,2,-2
21701149,203084,DAL,CLE,Harrison Barnes,156,36.0166666666667,36,0.0166666666666657,71,70,1,0,1
21701149,203457,DAL,CLE,Nerlens Noel,84,17.3666666666667,17,0.366666666666667,32,38,-6,-7,1
21701149,203926,DAL,CLE,Doug McDermott,90,20.3666666666667,20,0.366666666666667,29,41,-12,-14,2
21701149,203939,DAL,CLE,Dwight Powell,89,21.7,23,-1.3,36,43,-7,-5,-2
21701149,1626151,DAL,CLE,Aaron Harrison,73,15.6833333333333,16,-0.316666666666666,30,34,-4,-4,0
21701149,1627812,DAL,CLE,Yogi Ferrell,81,17.5166666666667,18,-0.483333333333334,29,39,-10,-10,0
21701149,1627827,DAL,CLE,Dorian Finney-Smith,129,29.6666666666667,30,-0.333333333333336,55,61,-6,-7,1
21701149,1628372,DAL,CLE,Dennis Smith Jr.,141,32.5,33,-0.5,60,60,0,-1,1
21701149,1628467,DAL,CLE,Maxi Kleber,129,26.9333333333333,27,-0.0666666666666664,51,57,-6,-9,3
21701150,2731,NOP,OKC,Emeka Okafor,73,13.4166666666667,13,0.416666666666666,24,24,0,0,0
21701150,200765,NOP,OKC,Rajon Rondo,174,33.6666666666667,34,-0.333333333333336,73,71,2,4,-2
21701150,201950,NOP,OKC,Jrue Holiday,176,33.9,34,-0.100000000000001,73,83,-10,-10,0
21701150,202703,NOP,OKC,Nikola Mirotic,96,18.9833333333333,19,-0.0166666666666657,41,46,-5,-5,0
21701150,202734,NOP,OKC,E'Twaun Moore,161,30.5666666666667,31,-0.433333333333334,63,66,-3,-1,-2
21701150,203076,NOP,OKC,Anthony Davis,205,39.4666666666667,40,-0.533333333333331,82,92,-10,-10,0
21701150,203121,NOP,OKC,Darius Miller,139,27.4833333333333,27,0.483333333333334,63,76,-13,-13,0
21701150,203524,NOP,OKC,Solomon Hill,68,13.5,13,0.5,31,18,13,13,0
21701150,203546,NOP,OKC,Ian Clark,106,21.4166666666667,21,0.416666666666668,49,52,-3,-7,4
21701150,1627767,NOP,OKC,Cheick Diallo,37,7.43333333333333,7,0.433333333333334,21,17,4,4,0
21701150,2546,OKC,NOP,Carmelo Anthony,148,28.6833333333333,29,-0.316666666666666,67,62,5,3,2
21701150,101109,OKC,NOP,Raymond Felton,92,19.0833333333333,19,0.0833333333333322,42,46,-4,-2,-2
21701150,201147,OKC,NOP,Corey Brewer,150,28.6666666666667,29,-0.333333333333336,63,60,3,3,0
21701150,201566,OKC,NOP,Russell Westbrook,196,36.65,37,-0.350000000000001,86,69,17,15,2
21701150,202331,OKC,NOP,Paul George,187,36.3333333333333,37,-0.666666666666671,76,89,-13,-10,-3
21701150,202335,OKC,NOP,Patrick Patterson,73,14.2333333333333,14,0.233333333333334,39,33,6,8,-2
21701150,203500,OKC,NOP,Steven Adams,187,36.3333333333333,36,0.333333333333336,72,76,-4,-3,-1
21701150,203518,OKC,NOP,Alex Abrines,116,23.1666666666667,23,0.166666666666664,60,48,12,9,3
21701150,203924,OKC,NOP,Jerami Grant,86,16.6833333333333,17,-0.316666666666666,40,37,3,2,1
21701151,2037,MIN,UTA,Jamal Crawford,124,27.1166666666667,27,0.116666666666667,49,71,-22,-24,2
21701151,201166,MIN,UTA,Aaron Brooks,70,15.65,16,-0.350000000000001,28,42,-14,-16,2
21701151,201959,MIN,UTA,Taj Gibson,157,34.15,34,0.149999999999999,74,81,-7,-5,-2
21701151,202357,MIN,UTA,Nemanja Bjelica,107,25.65,26,-0.350000000000001,47,68,-21,-21,0
21701151,203476,MIN,UTA,Gorgui Dieng,82,18.2833333333333,19,-0.716666666666669,33,52,-19,-19,0
21701151,203952,MIN,UTA,Andrew Wiggins,166,36.15,36,0.149999999999999,76,83,-7,-7,0
21701151,1626145,MIN,UTA,Tyus Jones,152,33.2833333333333,33,0.283333333333331,69,83,-14,-12,-2
21701151,1626148,MIN,UTA,Anthony Brown,19,3.4,4,-0.6,12,9,3,3,0
21701151,1626157,MIN,UTA,Karl-Anthony Towns,159,35.8833333333333,36,-0.116666666666667,73,94,-21,-21,0
21701151,1627875,MIN,UTA,Marcus Georges-Hunt,25,4.78333333333333,5,-0.216666666666667,12,13,-1,-1,0
21701151,1628383,MIN,UTA,Justin Patton,19,3.4,4,-0.6,12,9,3,3,0
21701151,201937,UTA,MIN,Ricky Rubio,126,27.5,27,0.5,63,54,9,11,-2
21701151,201973,UTA,MIN,Jonas Jerebko,72,16.0166666666667,16,0.0166666666666657,44,35,9,13,-4
21701151,202324,UTA,MIN,Derrick Favors,139,31.4,32,-0.600000000000001,78,63,15,16,-1
21701151,202327,UTA,MIN,Ekpe Udoh,19,3.4,4,-0.6,9,12,-3,-3,0
21701151,202692,UTA,MIN,Alec Burks,19,3.4,4,-0.6,9,12,-3,-3,0
21701151,203109,UTA,MIN,Jae Crowder,102,22.7,23,-0.299999999999997,57,46,11,9,2
21701151,203497,UTA,MIN,Rudy Gobert,148,32.2833333333333,32,0.283333333333331,79,59,20,22,-2
21701151,203957,UTA,MIN,Dante Exum,72,17.0333333333333,17,0.0333333333333314,50,31,19,17,2
21701151,204060,UTA,MIN,Joe Ingles,116,27.1666666666667,28,-0.833333333333336,72,53,19,21,-2
21701151,204065,UTA,MIN,David Stockton,18,3.01666666666667,3,0.0166666666666666,8,12,-4,-4,0
21701151,1626220,UTA,MIN,Royce O'Neale,86,18.9,18,0.899999999999999,50,34,16,13,3
21701151,1627777,UTA,MIN,Georges Niang,19,3.4,4,-0.6,9,12,-3,-3,0
21701151,1628378,UTA,MIN,Donovan Mitchell,144,31.5333333333333,32,-0.466666666666669,77,62,15,11,4
21701152,2734,DEN,MIL,Devin Harris,115,23.1833333333333,23,0.183333333333334,46,64,-18,-16,-2
21701152,200794,DEN,MIL,Paul Millsap,197,39.2333333333333,39,0.233333333333334,93,91,2,0,2
21701152,203115,DEN,MIL,Will Barton,201,39.3833333333333,39,0.383333333333333,98,90,8,7,1
21701152,203486,DEN,MIL,Mason Plumlee,11,2.85,3,-0.15,1,8,-7,-8,1
21701152,203999,DEN,MIL,Nikola Jokic,201,43.0833333333333,44,-0.916666666666671,101,97,4,5,-1
21701152,1626168,DEN,MIL,Trey Lyles,103,21.85,22,-0.149999999999999,57,52,5,11,-6
21701152,1627736,DEN,MIL,Malik Beasley,16,1.95,2,-0.0499999999999998,7,13,-6,-6,0
21701152,1627750,DEN,MIL,Jamal Murray,168,35.7833333333333,36,-0.216666666666669,98,74,24,26,-2
21701152,1627823,DEN,MIL,Juancho Hernangomez,102,21.1166666666667,21,0.116666666666667,52,57,-5,-6,1
21701152,1628470,DEN,MIL,Torrey Craig,171,36.4,36,0.399999999999999,87,79,8,2,6
21701152,1891,MIL,DEN,Jason Terry,86,18.4,18,0.399999999999999,52,41,11,8,3
21701152,201943,MIL,DEN,Brandon Jennings,16,3.63333333333333,4,-0.366666666666666,4,13,-9,-9,0
21701152,202339,MIL,DEN,Eric Bledsoe,208,42.25,42,0.25,108,100,8,10,-2
21701152,203089,MIL,DEN,John Henson,125,26.3666666666667,27,-0.633333333333333,56,59,-3,-5,2
21701152,203092,MIL,DEN,Tyler Zeller,109,22.0666666666667,22,0.0666666666666664,51,57,-6,-1,-5
21701152,203114,MIL,DEN,Khris Middleton,204,40.7,40,0.700000000000003,98,99,-1,3,-4
21701152,203503,MIL,DEN,Tony Snell,163,32.85,33,-0.149999999999999,72,84,-12,-15,3
21701152,203507,MIL,DEN,Giannis Antetokounmpo,149,32.1833333333333,33,-0.81666666666667,79,68,11,8,3
21701152,203953,MIL,DEN,Jabari Parker,192,39.3,39,0.299999999999997,92,104,-12,-9,-3
21701152,1628425,MIL,DEN,Sterling Brown,33,7.08333333333333,8,-0.916666666666667,13,15,-2,-5,3
21701153,2561,GSW,PHX,David West,51,11.3333333333333,11,0.333333333333332,18,33,-15,-17,2
21701153,2585,GSW,PHX,Zaza Pachulia,27,5.6,6,-0.4,17,8,9,9,0
21701153,2733,GSW,PHX,Shaun Livingston,67,15.3,15,0.300000000000001,25,43,-18,-18,0
21701153,201142,GSW,PHX,Kevin Durant,166,34.6666666666667,35,-0.333333333333336,95,66,29,29,0
21701153,201156,GSW,PHX,Nick Young,118,25.2833333333333,25,0.283333333333331,58,64,-6,-4,-2
21701153,201580,GSW,PHX,JaVale McGee,17,4.21666666666667,4,0.216666666666667,9,10,-1,-1,0
21701153,202691,GSW,PHX,Klay Thompson,155,32.8666666666667,33,-0.133333333333333,77,74,3,1,2
21701153,203110,GSW,PHX,Draymond Green,167,33.8,34,-0.200000000000003,82,68,14,10,4
21701153,1626172,GSW,PHX,Kevon Looney,116,24.2166666666667,24,0.216666666666669,59,51,8,10,-2
21701153,1626188,GSW,PHX,Quinn Cook,165,33.75,34,-0.25,92,66,26,24,2
21701153,1627745,GSW,PHX,Damian Jones,10,1.93333333333333,2,-0.0666666666666667,4,8,-4,-2,-2
21701153,1628395,GSW,PHX,Jordan Bell,76,16.7,16,0.699999999999999,49,44,5,9,-4
21701153,203584,PHX,GSW,Troy Daniels,84,17.9833333333333,18,-0.0166666666666657,33,39,-6,-7,1
21701153,1626210,PHX,GSW,Alan Williams,86,17.4,18,-0.600000000000001,35,35,0,-1,1
21701153,1627733,PHX,GSW,Dragan Bender,179,35.8666666666667,36,-0.133333333333333,73,88,-15,-15,0
21701153,1627737,PHX,GSW,Marquese Chriss,141,30.5333333333333,31,-0.466666666666669,72,82,-10,-9,-1
21701153,1627755,PHX,GSW,Tyler Ulis,200,41.2166666666667,42,-0.783333333333331,91,101,-10,-8,-2
21701153,1627863,PHX,GSW,Danuel House Jr.,160,34.1666666666667,34,0.166666666666671,84,87,-3,-2,-1
21701153,1627885,PHX,GSW,Shaquille Harrison,66,14.7166666666667,15,-0.283333333333335,38,38,0,-3,3
21701153,1628367,PHX,GSW,Josh Jackson,171,35.7166666666667,36,-0.283333333333331,75,86,-11,-10,-1
21701153,1628409,PHX,GSW,Alec Peters,48,12.0666666666667,12,0.0666666666666664,34,29,5,5,0
21701154,202323,POR,MEM,Evan Turner,101,21.9666666666667,22,-0.0333333333333314,63,29,34,34,0
21701154,202329,POR,MEM,Al-Farouq Aminu,115,25.1166666666667,26,-0.883333333333333,69,38,31,35,-4
21701154,203081,POR,MEM,Damian Lillard,151,32.4833333333333,33,-0.516666666666666,95,58,37,37,0
21701154,203086,POR,MEM,Meyers Leonard,89,19.0833333333333,19,0.0833333333333357,43,44,-1,-1,0
21701154,203468,POR,MEM,CJ McCollum,171,36.8666666666667,37,-0.133333333333333,88,60,28,30,-2
21701154,203894,POR,MEM,Shabazz Napier,111,22.7166666666667,22,0.716666666666665,47,60,-13,-15,2
21701154,203994,POR,MEM,Jusuf Nurkic,108,22.95,23,-0.0499999999999972,59,34,25,28,-3
21701154,1626192,POR,MEM,Pat Connaughton,122,25.0333333333333,25,0.0333333333333314,46,70,-24,-24,0
21701154,1627735,POR,MEM,Wade Baldwin IV,15,3.73333333333333,4,-0.266666666666667,0,14,-14,-14,0
21701154,1627774,POR,MEM,Jake Layman,4,1.2,1,0.2,0,3,-3,-3,0
21701154,1628380,POR,MEM,Zach Collins,93,19.8,19,0.799999999999997,38,53,-15,-20,5
21701154,1628403,POR,MEM,Caleb Swanigan,45,9.05,9,0.0500000000000007,17,27,-10,-12,2
21701154,201188,MEM,POR,Marc Gasol,93,19.85,20,-0.149999999999999,31,54,-23,-25,2
21701154,203104,MEM,POR,Marquis Teague,128,27.5833333333333,27,0.583333333333332,58,64,-6,-6,0
21701154,203463,MEM,POR,Ben McLemore,137,29.0333333333333,29,0.0333333333333314,60,63,-3,-6,3
21701154,1626185,MEM,POR,Jarell Martin,136,30.7166666666667,31,-0.283333333333331,54,74,-20,-18,-2
21701154,1627738,MEM,POR,Deyonta Davis,107,21.3,21,0.299999999999997,51,49,2,4,-2
21701154,1627782,MEM,POR,Wayne Selden,137,29.4166666666667,29,0.416666666666668,57,75,-18,-15,-3
21701154,1628397,MEM,POR,Ivan Rabb,114,24.1333333333333,24,0.133333333333333,60,49,11,9,2
21701154,1628415,MEM,POR,Dillon Brooks,176,37.55,38,-0.450000000000003,79,88,-9,-9,0
21701154,1628424,MEM,POR,Kobi Simmons,97,20.4166666666667,21,-0.583333333333336,40,49,-9,-9,0
21701155,101112,LAL,SAC,Channing Frye,94,22.1,22,0.100000000000001,31,31,0,0,0
21701155,201572,LAL,SAC,Brook Lopez,123,26.2,26,0.199999999999999,45,51,-6,-6,0
21701155,203484,LAL,SAC,Kentavious Caldwell-Pope,183,39.4833333333333,39,0.483333333333334,73,72,1,1,0
21701155,203898,LAL,SAC,Tyler Ennis,67,15.65,16,-0.35,29,18,11,11,0
21701155,203944,LAL,SAC,Julius Randle,115,24.2666666666667,24,0.266666666666666,45,48,-3,-4,1
21701155,1627826,LAL,SAC,Ivica Zubac,79,18.1333333333333,18,0.133333333333333,30,26,4,4,0
21701155,1627936,LAL,SAC,Alex Caruso,136,29.5833333333333,30,-0.416666666666664,47,61,-14,-13,-1
21701155,1628398,LAL,SAC,Kyle Kuzma,177,38.4,39,-0.600000000000001,67,70,-3,-2,-1
21701155,1628404,LAL,SAC,Josh Hart,116,26.0166666666667,26,0.0166666666666657,48,43,5,4,1
21701155,1713,SAC,LAL,Vince Carter,53,12.45,12,0.449999999999999,13,22,-9,-10,1
21701155,203960,SAC,LAL,JaKarr Sampson,81,16.45,17,-0.550000000000001,29,29,0,0,0
21701155,203992,SAC,LAL,Bogdan Bogdanovic,145,30.3666666666667,31,-0.633333333333333,58,54,4,2,2
21701155,204022,SAC,LAL,Jack Cooley,77,16.6833333333333,16,0.683333333333334,29,27,2,7,-5
21701155,1626161,SAC,LAL,Willie Cauley-Stein,90,19.0833333333333,20,-0.916666666666668,43,36,7,4,3
21701155,1627741,SAC,LAL,Buddy Hield,147,32.8333333333333,32,0.833333333333329,58,54,4,4,0
21701155,1627746,SAC,LAL,Skal Labissiere,72,17.1166666666667,17,0.116666666666667,21,32,-11,-11,0
21701155,1628368,SAC,LAL,De'Aaron Fox,149,31.0666666666667,31,0.0666666666666629,67,54,13,13,0
21701155,1628382,SAC,LAL,Justin Jackson,112,24.9333333333333,25,-0.06666666666667,46,42,4,5,-1
21701155,1628412,SAC,LAL,Frank Mason,69,16.9,17,-0.100000000000001,17,29,-12,-12,0
21701155,1628502,SAC,LAL,Nigel Hayes,95,21.95,22,-0.0500000000000007,39,36,3,3,0
21701156,2544,CLE,TOR,LeBron James,171,37.4,37,0.399999999999999,90,80,10,12,-2
21701156,2594,CLE,TOR,Kyle Korver,63,14.25,14,0.25,25,29,-4,-6,2
21701156,2747,CLE,TOR,JR Smith,115,25.3166666666667,25,0.316666666666666,51,59,-8,-4,-4
21701156,101181,CLE,TOR,Jose Calderon,120,25.8,26,-0.200000000000003,81,54,27,27,0
21701156,201145,CLE,TOR,Jeff Green,114,24.8833333333333,25,-0.116666666666667,60,52,8,8,0
21701156,201567,CLE,TOR,Kevin Love,135,30.1333333333333,30,0.133333333333333,83,63,20,18,2
21701156,202684,CLE,TOR,Tristan Thompson,62,14,14,0,28,32,-4,-4,0
21701156,203903,CLE,TOR,Jordan Clarkson,81,18.6666666666667,19,-0.333333333333336,27,40,-13,-15,2
21701156,203918,CLE,TOR,Rodney Hood,135,28.9166666666667,29,-0.0833333333333357,78,61,17,17,0
21701156,204066,CLE,TOR,John Holland,8,1.36666666666667,1,0.366666666666667,0,8,-8,-8,0
21701156,1626204,CLE,TOR,Larry Nance Jr.,70,16.3666666666667,16,0.366666666666667,37,36,1,1,0
21701156,1626224,CLE,TOR,Cedi Osman,8,1.36666666666667,1,0.366666666666667,0,8,-8,-8,0
21701156,1627790,CLE,TOR,Ante Zizic,8,1.36666666666667,1,0.366666666666667,0,8,-8,-8,0
21701156,101139,TOR,CLE,CJ Miles,105,22.5833333333333,23,-0.416666666666668,56,56,0,0,0
21701156,200768,TOR,CLE,Kyle Lowry,128,28.55,29,-0.450000000000003,60,69,-9,-9,0
21701156,201586,TOR,CLE,Serge Ibaka,129,29.2833333333333,29,0.283333333333331,58,69,-11,-13,2
21701156,201942,TOR,CLE,DeMar DeRozan,146,33.0833333333333,33,0.0833333333333286,68,76,-8,-10,2
21701156,202685,TOR,CLE,Jonas Valanciunas,102,22.45,22,0.449999999999999,48,58,-10,-10,0
21701156,203512,TOR,CLE,Lucas Nogueira,17,2.25,2,0.25,14,8,6,8,-2
21701156,1626153,TOR,CLE,Delon Wright,72,14.8833333333333,15,-0.116666666666667,38,36,2,4,-2
21701156,1626181,TOR,CLE,Norman Powell,17,2.25,2,0.25,14,8,6,8,-2
21701156,1627751,TOR,CLE,Jakob Poeltl,74,17.1166666666667,17,0.116666666666667,34,35,-1,-1,0
21701156,1627783,TOR,CLE,Pascal Siakam,109,23.3,23,0.299999999999997,52,52,0,0,0
21701156,1627832,TOR,CLE,Fred VanVleet,98,22.75,23,-0.25,38,46,-8,-10,2
21701156,1628384,TOR,CLE,OG Anunoby,93,21.3333333333333,21,0.333333333333336,50,47,3,3,0
21701157,201960,BKN,PHI,DeMarre Carroll,85,18.0666666666667,18,0.0666666666666664,28,46,-18,-18,0
21701157,201967,BKN,PHI,Dante Cunningham,74,16,16,0,28,47,-19,-19,0
21701157,203112,BKN,PHI,Quincy Acy,101,22.2666666666667,22,0.266666666666666,46,58,-12,-14,2
21701157,203915,BKN,PHI,Spencer Dinwiddie,157,32.75,33,-0.25,69,82,-13,-14,1
21701157,203917,BKN,PHI,Nik Stauskas,97,20.7666666666667,21,-0.233333333333334,47,50,-3,-3,0
21701157,203925,BKN,PHI,Joe Harris,102,21.45,22,-0.550000000000001,37,55,-18,-16,-2
21701157,1626143,BKN,PHI,Jahlil Okafor,75,16.25,16,0.25,33,36,-3,-3,0
21701157,1626156,BKN,PHI,D'Angelo Russell,88,19.0833333333333,19,0.0833333333333322,37,48,-11,-12,1
21701157,1626178,BKN,PHI,Rondae Hollis-Jefferson,82,16.75,17,-0.25,30,47,-17,-15,-2
21701157,1627747,BKN,PHI,Caris LeVert,117,24.3,24,0.299999999999997,52,63,-11,-11,0
21701157,1628386,BKN,PHI,Jarrett Allen,92,19.65,20,-0.350000000000001,44,45,-1,-1,0
21701157,1628495,BKN,PHI,Milton Doyle,50,11.8333333333333,12,-0.166666666666668,24,28,-4,-4,0
21701157,101141,PHI,BKN,Ersan Ilyasova,132,28.1333333333333,28,0.133333333333333,71,49,22,23,-1
21701157,101161,PHI,BKN,Amir Johnson,94,21.1,21,0.100000000000001,49,42,7,6,1
21701157,200755,PHI,BKN,JJ Redick,116,23.2166666666667,23,0.216666666666669,55,32,23,23,0
21701157,201158,PHI,BKN,Marco Belinelli,130,27.3,27,0.299999999999997,68,63,5,3,2
21701157,203496,PHI,BKN,Robert Covington,118,25.9,26,-0.100000000000001,67,47,20,22,-2
21701157,204456,PHI,BKN,T.J. McConnell,83,19.1333333333333,19,0.133333333333333,44,47,-3,-3,0
21701157,1626147,PHI,BKN,Justin Anderson,61,13.3833333333333,13,0.383333333333333,29,27,2,2,0
21701157,1626158,PHI,BKN,Richaun Holmes,130,26.7333333333333,27,-0.266666666666666,72,53,19,20,-1
21701157,1627732,PHI,BKN,Ben Simmons,119,25.2333333333333,25,0.233333333333334,74,53,21,21,0
21701157,1627743,PHI,BKN,Demetrius Jackson,13,2.73333333333333,3,-0.266666666666667,12,8,4,4,0
21701157,1627788,PHI,BKN,Furkan Korkmaz,25,5.46666666666667,5,0.466666666666667,16,12,4,4,0
21701157,1628365,PHI,BKN,Markelle Fultz,99,20.8333333333333,21,-0.166666666666664,48,42,6,5,1
21701158,203101,ATL,MIA,Miles Plumlee,157,33.4333333333333,34,-0.566666666666663,61,67,-6,-2,-4
21701158,203488,ATL,MIA,Mike Muscala,151,32.4166666666667,33,-0.583333333333329,69,67,2,4,-2
21701158,1627752,ATL,MIA,Taurean Prince,53,9.86666666666667,10,-0.133333333333333,20,25,-5,-5,0
21701158,1627761,ATL,MIA,DeAndre' Bembry,80,17.8666666666667,17,0.866666666666667,33,31,2,0,2
21701158,1627814,ATL,MIA,Damion Lee,179,37.2,37,0.200000000000003,74,81,-7,-7,0
21701158,1627819,ATL,MIA,Isaiah Taylor,173,37.9833333333333,38,-0.0166666666666657,84,83,1,-3,4
21701158,1628381,ATL,MIA,John Collins,151,32.7166666666667,33,-0.283333333333331,70,65,5,5,0
21701158,1628416,ATL,MIA,Tyler Dorsey,181,38.5166666666667,38,0.516666666666666,79,86,-7,-7,0
21701158,2548,MIA,ATL,Dwyane Wade,109,23.9,24,-0.100000000000001,43,57,-14,-14,0
21701158,201609,MIA,ATL,Goran Dragic,136,28.75,29,-0.25,67,47,20,21,-1
21701158,201949,MIA,ATL,James Johnson,142,29.55,30,-0.450000000000003,66,49,17,17,0
21701158,201961,MIA,ATL,Wayne Ellington,104,22.5833333333333,23,-0.416666666666664,42,58,-16,-17,1
21701158,202355,MIA,ATL,Hassan Whiteside,130,27.6833333333333,28,-0.316666666666666,67,45,22,20,2
21701158,203482,MIA,ATL,Kelly Olynyk,93,20.3,20,0.300000000000001,32,53,-21,-19,-2
21701158,204020,MIA,ATL,Tyler Johnson,152,30.9333333333333,31,-0.06666666666667,73,56,17,17,0
21701158,1626159,MIA,ATL,Justise Winslow,96,21,21,0,41,54,-13,-15,2
21701158,1626196,MIA,ATL,Josh Richardson,163,35.3,36,-0.700000000000003,74,71,3,5,-2
21701159,201584,NYK,ORL,Courtney Lee,104,23.55,24,-0.450000000000003,40,52,-12,-12,0
21701159,202498,NYK,ORL,Lance Thomas,115,26.3833333333333,27,-0.616666666666667,45,57,-12,-12,0
21701159,203124,NYK,ORL,Kyle O'Quinn,129,28.55,29,-0.449999999999999,50,55,-5,-7,2
21701159,203501,NYK,ORL,Tim Hardaway Jr.,151,34.3166666666667,35,-0.683333333333337,52,72,-20,-20,0
21701159,203504,NYK,ORL,Trey Burke,141,31.3833333333333,32,-0.616666666666667,50,69,-19,-19,0
21701159,1626144,NYK,ORL,Emmanuel Mudiay,82,18.5333333333333,18,0.533333333333331,27,34,-7,-7,0
21701159,1628373,NYK,ORL,Frank Ntilikina,127,27.8333333333333,28,-0.166666666666664,36,48,-12,-14,2
21701159,1628422,NYK,ORL,Damyean Dotson,53,11.4166666666667,12,-0.583333333333332,18,27,-9,-9,0
21701159,1628436,NYK,ORL,Luke Kornet,81,19.05,19,0.0499999999999972,21,40,-19,-15,-4
21701159,1628439,NYK,ORL,Isaiah Hicks,82,17.7333333333333,17,0.733333333333334,26,31,-5,-5,0
21701159,201571,ORL,NYK,D.J. Augustin,89,20.1166666666667,20,0.116666666666667,36,33,3,3,0
21701159,202687,ORL,NYK,Bismack Biyombo,30,6.31666666666667,6,0.316666666666666,10,11,-1,-1,0
21701159,202696,ORL,NYK,Nikola Vucevic,89,19.9833333333333,20,-0.0166666666666657,40,33,7,7,0
21701159,202714,ORL,NYK,Shelvin Mack,124,27.6333333333333,28,-0.366666666666667,61,40,21,21,0
21701159,203920,ORL,NYK,Khem Birch,94,21.45,22,-0.550000000000001,47,29,18,18,0
21701159,203932,ORL,NYK,Aaron Gordon,120,27.75,28,-0.25,53,44,9,7,2
21701159,1626209,ORL,NYK,Mario Hezonja,159,34.7666666666667,36,-1.23333333333333,72,56,16,20,-4
21701159,1628411,ORL,NYK,Wes Iwundu,102,22.7333333333333,23,-0.266666666666666,42,37,5,5,0
21701159,1628503,ORL,NYK,Jamel Artis,144,32.4666666666667,32,0.466666666666669,67,44,23,21,2
21701159,1628681,ORL,NYK,Rodney Purvis,114,25.5333333333333,26,-0.466666666666669,57,38,19,19,0
21701160,203200,CHI,CHA,Justin Holiday,139,27.2333333333333,28,-0.766666666666666,76,70,6,3,3
21701160,203930,CHI,CHA,Sean Kilpatrick,142,28.7833333333333,29,-0.216666666666669,70,76,-6,-6,0
21701160,203943,CHI,CHA,Noah Vonleh,39,7.21666666666667,7,0.216666666666667,16,12,4,4,0
21701160,1626166,CHI,CHA,Cameron Payne,119,24.0666666666667,24,0.0666666666666664,64,54,10,10,0
21701160,1626170,CHI,CHA,Jerian Grant,121,24.4166666666667,24,0.416666666666664,59,57,2,3,-1
21701160,1626171,CHI,CHA,Bobby Portis,114,23.1666666666667,23,0.166666666666664,57,63,-6,-4,-2
21701160,1626245,CHI,CHA,Cristiano Felicio,124,24.75,25,-0.25,63,51,12,10,2
21701160,1627853,CHI,CHA,Ryan Arcidiacono,119,23.85,24,-0.149999999999999,56,60,-4,-4,0
21701160,1628021,CHI,CHA,David Nwaba,152,31.6,32,-0.399999999999999,81,73,8,10,-2
21701160,1628374,CHI,CHA,Lauri Markkanen,121,24.5,24,0.5,58,54,4,4,0
21701160,2730,CHA,CHI,Dwight Howard,159,32.1333333333333,32,0.133333333333333,74,82,-8,-8,0
21701160,101107,CHA,CHI,Marvin Williams,131,27.55,28,-0.450000000000003,61,68,-7,-8,1
21701160,201587,CHA,CHI,Nicolas Batum,133,27.3,28,-0.700000000000003,62,73,-11,-13,2
21701160,202689,CHA,CHI,Kemba Walker,150,30.7,31,-0.300000000000001,70,81,-11,-11,0
21701160,202933,CHA,CHI,Julyan Stone,79,15.1666666666667,15,0.166666666666666,39,36,3,3,0
21701160,203077,CHA,CHI,Michael Kidd-Gilchrist,129,26.2666666666667,26,0.266666666666666,59,67,-8,-8,0
21701160,203087,CHA,CHI,Jeremy Lamb,101,20.2666666666667,20,0.266666666666666,52,44,8,10,-2
21701160,1626163,CHA,CHI,Frank Kaminsky,106,20.2166666666667,20,0.216666666666669,53,52,1,2,-1
21701160,1626195,CHA,CHI,Willy Hernangomez,79,15.7833333333333,16,-0.216666666666667,40,38,2,2,0
21701160,1628370,CHA,CHI,Malik Monk,123,24.2,24,0.200000000000003,60,59,1,1,0
21701161,2207,HOU,WAS,Joe Johnson,55,13.1333333333333,13,0.133333333333333,27,34,-7,-7,0
21701161,2403,HOU,WAS,Nene,70,15.3,15,0.300000000000001,36,29,7,7,0
21701161,101108,HOU,WAS,Chris Paul,136,32.15,33,-0.850000000000001,82,70,12,11,1
21701161,101123,HOU,WAS,Gerald Green,98,22.6333333333333,23,-0.366666666666667,44,50,-6,-6,0
21701161,200782,HOU,WAS,PJ Tucker,131,29.6166666666667,29,0.616666666666667,80,62,18,20,-2
21701161,201569,HOU,WAS,Eric Gordon,120,26.5333333333333,26,0.533333333333331,71,57,14,13,1
21701161,201583,HOU,WAS,Ryan Anderson,24,5.21666666666667,5,0.216666666666667,13,8,5,3,2
21701161,201601,HOU,WAS,Luc Mbah a Moute,128,28.8833333333333,28,0.883333333333333,80,61,19,19,0
21701161,201935,HOU,WAS,James Harden,149,34.0666666666667,34,0.0666666666666629,94,76,18,17,1
21701161,203991,HOU,WAS,Clint Capela,107,25.2,26,-0.800000000000001,65,59,6,9,-3
21701161,204028,HOU,WAS,Tarik Black,16,3.55,4,-0.45,4,7,-3,-3,0
21701161,1627817,HOU,WAS,Tim Quarterman,16,3.55,4,-0.45,4,7,-3,-3,0
21701161,101133,WAS,HOU,Ian Mahinmi,20,4.46666666666667,4,0.466666666666667,6,7,-1,-3,2
21701161,101162,WAS,HOU,Marcin Gortat,67,14.45,14,0.449999999999999,32,37,-5,-5,0
21701161,201196,WAS,HOU,Ramon Sessions,16,3.55,4,-0.45,7,4,3,3,0
21701161,201975,WAS,HOU,Jodie Meeks,38,8.76666666666667,9,-0.233333333333333,13,11,2,0,2
21701161,202322,WAS,HOU,John Wall,146,32.6833333333333,33,-0.31666666666667,73,93,-20,-18,-2
21701161,202693,WAS,HOU,Markieff Morris,121,27.0166666666667,27,0.0166666666666657,55,78,-23,-21,-2
21701161,203078,WAS,HOU,Bradley Beal,126,28.7833333333333,29,-0.216666666666669,73,83,-10,-12,2
21701161,203107,WAS,HOU,Tomas Satoransky,116,27.35,27,0.350000000000001,55,60,-5,-4,-1
21701161,203118,WAS,HOU,Mike Scott,102,24.2666666666667,24,0.266666666666666,53,51,2,0,2
21701161,203490,WAS,HOU,Otto Porter Jr.,112,24.8333333333333,25,-0.166666666666668,56,74,-18,-15,-3
21701161,204025,WAS,HOU,Tim Frazier,41,9.86666666666667,10,-0.133333333333333,25,19,6,6,0
21701161,1626162,WAS,HOU,Kelly Oubre Jr.,145,33.8,34,-0.200000000000003,72,83,-11,-11,0
21701162,201143,BOS,MIL,Al Horford,159,36.3166666666667,36,0.316666666666663,85,79,6,9,-3
21701162,202328,BOS,MIL,Greg Monroe,110,23.6,23,0.600000000000001,41,50,-9,-7,-2
21701162,202694,BOS,MIL,Marcus Morris,158,33.4166666666667,33,0.416666666666671,68,81,-13,-11,-2
21701162,203382,BOS,MIL,Aron Baynes,96,21.9833333333333,22,-0.0166666666666657,46,52,-6,-2,-4
21701162,1627759,BOS,MIL,Jaylen Brown,165,36.45,36,0.450000000000003,78,82,-4,0,-4
21701162,1627824,BOS,MIL,Guerschon Yabusele,22,4.75,5,-0.25,10,11,-1,-1,0
21701162,1627846,BOS,MIL,Abdel Nader,51,10.9666666666667,11,-0.0333333333333332,19,24,-5,-5,0
21701162,1628369,BOS,MIL,Jayson Tatum,149,32.0666666666667,33,-0.933333333333337,78,63,15,11,4
21701162,1628400,BOS,MIL,Semi Ojeleye,88,18.5666666666667,18,0.566666666666666,40,42,-2,-7,5
21701162,1628443,BOS,MIL,Kadeem Allen,97,21.8833333333333,23,-1.11666666666667,45,46,-1,-7,6
21701162,1891,MIL,BOS,Jason Terry,87,17.9833333333333,18,-0.0166666666666657,43,37,6,6,0
21701162,202339,MIL,BOS,Eric Bledsoe,168,36.7166666666667,37,-0.283333333333331,83,76,7,6,1
21701162,203089,MIL,BOS,John Henson,125,28.15,28,0.149999999999999,61,57,4,7,-3
21701162,203092,MIL,BOS,Tyler Zeller,77,16.7833333333333,17,-0.216666666666669,36,36,0,-3,3
21701162,203114,MIL,BOS,Khris Middleton,168,36.7166666666667,37,-0.283333333333331,83,76,7,6,1
21701162,203498,MIL,BOS,Shabazz Muhammad,22,4.91666666666667,5,-0.083333333333333,9,14,-5,-4,-1
21701162,203503,MIL,BOS,Tony Snell,71,16.6666666666667,17,-0.333333333333336,32,38,-6,-8,2
21701162,203507,MIL,BOS,Giannis Antetokounmpo,168,36.75,36,0.75,73,87,-14,-11,-3
21701162,203953,MIL,BOS,Jabari Parker,147,30.8,31,-0.200000000000003,76,61,15,13,2
21701162,1628425,MIL,BOS,Sterling Brown,62,14.5166666666667,15,-0.483333333333334,34,28,6,8,-2
21701163,2561,GSW,OKC,David West,68,14.0333333333333,15,-0.966666666666667,33,22,11,11,0
21701163,2585,GSW,OKC,Zaza Pachulia,56,12,12,0,21,32,-11,-9,-2
21701163,201142,GSW,OKC,Kevin Durant,179,35.7833333333333,36,-0.216666666666669,83,87,-4,-4,0
21701163,201156,GSW,OKC,Nick Young,127,26.4166666666667,26,0.416666666666664,63,50,13,13,0
21701163,201580,GSW,OKC,JaVale McGee,50,9.76666666666667,10,-0.233333333333334,23,27,-4,-4,0
21701163,202691,GSW,OKC,Klay Thompson,178,34.6833333333333,35,-0.316666666666663,78,79,-1,-1,0
21701163,203110,GSW,OKC,Draymond Green,184,36.45,36,0.450000000000003,83,76,7,5,2
21701163,1626188,GSW,OKC,Quinn Cook,190,37.85,37,0.850000000000001,90,99,-9,-9,0
21701163,1627745,GSW,OKC,Damian Jones,70,13.8166666666667,14,-0.183333333333334,35,28,7,9,-2
21701163,1628395,GSW,OKC,Jordan Bell,93,19.1166666666667,19,0.116666666666667,46,35,11,9,2
21701163,2546,OKC,GSW,Carmelo Anthony,184,36.2333333333333,36,0.233333333333334,91,83,8,6,2
21701163,101109,OKC,GSW,Raymond Felton,59,12.4666666666667,12,0.466666666666665,15,29,-14,-11,-3
21701163,201147,OKC,GSW,Corey Brewer,122,24.3,25,-0.699999999999999,63,53,10,9,1
21701163,201566,OKC,GSW,Russell Westbrook,207,40.45,41,-0.549999999999997,101,96,5,3,2
21701163,202331,OKC,GSW,Paul George,185,37.2666666666667,37,0.266666666666666,77,88,-11,-5,-6
21701163,202335,OKC,GSW,Patrick Patterson,53,11.4666666666667,12,-0.533333333333335,16,28,-12,-12,0
21701163,203500,OKC,GSW,Steven Adams,169,33.0166666666667,33,0.0166666666666657,89,76,13,11,2
21701163,203518,OKC,GSW,Alex Abrines,90,18.75,18,0.75,35,44,-9,-9,0
21701163,203924,OKC,GSW,Jerami Grant,72,15.25,15,0.25,18,35,-17,-13,-4
21701163,203962,OKC,GSW,Josh Huestis,54,10.7166666666667,11,-0.283333333333333,30,23,7,1,6
21701164,1717,DAL,POR,Dirk Nowitzki,107,24.2166666666667,25,-0.783333333333335,57,52,5,3,2
21701164,200826,DAL,POR,J.J. Barea,90,20.6333333333333,21,-0.366666666666667,49,50,-1,-1,0
21701164,203084,DAL,POR,Harrison Barnes,150,33.65,34,-0.349999999999994,74,72,2,2,0
21701164,203926,DAL,POR,Doug McDermott,71,14.3333333333333,14,0.333333333333332,41,37,4,4,0
21701164,203939,DAL,POR,Dwight Powell,81,18.3,19,-0.699999999999999,44,38,6,4,2
21701164,1626151,DAL,POR,Aaron Harrison,125,26.1,26,0.0999999999999979,64,59,5,5,0
21701164,1626257,DAL,POR,Salah Mejri,106,22.0333333333333,22,0.0333333333333314,55,53,2,4,-2
21701164,1627812,DAL,POR,Yogi Ferrell,80,18.45,18,0.449999999999999,41,32,9,9,0
21701164,1627858,DAL,POR,Kyle Collinsworth,10,2.21666666666667,2,0.216666666666667,4,2,2,2,0
21701164,1628372,DAL,POR,Dennis Smith Jr.,137,28.5666666666667,29,-0.433333333333334,72,75,-3,-3,0
21701164,1628467,DAL,POR,Maxi Kleber,148,31.4166666666667,31,0.416666666666664,74,75,-1,1,-2
21701164,202323,POR,DAL,Evan Turner,117,25.4166666666667,25,0.416666666666664,58,63,-5,-4,-1
21701164,202329,POR,DAL,Al-Farouq Aminu,149,31.8666666666667,32,-0.133333333333333,73,74,-1,1,-2
21701164,203081,POR,DAL,Damian Lillard,167,35.0666666666667,35,0.0666666666666629,85,89,-4,-4,0
21701164,203086,POR,DAL,Meyers Leonard,64,14.25,14,0.25,31,31,0,-2,2
21701164,203468,POR,DAL,CJ McCollum,173,37.5,38,-0.5,86,94,-8,-8,0
21701164,203894,POR,DAL,Shabazz Napier,115,24.2333333333333,24,0.233333333333334,58,58,0,0,0
21701164,203994,POR,DAL,Jusuf Nurkic,121,27.2,27,0.199999999999999,64,63,1,1,0
21701164,1626192,POR,DAL,Pat Connaughton,85,19.15,19,0.149999999999999,44,44,0,-4,4
21701164,1628380,POR,DAL,Zach Collins,104,23.0166666666667,23,0.0166666666666657,44,55,-11,-8,-3
21701164,1628403,POR,DAL,Caleb Swanigan,10,2.21666666666667,2,0.216666666666667,2,4,-2,-2,0
21701165,2734,DEN,IND,Devin Harris,91,19.9333333333333,20,-0.0666666666666664,33,42,-9,-13,4
21701165,200794,DEN,IND,Paul Millsap,154,32.7166666666667,33,-0.283333333333331,86,71,15,13,2
21701165,201163,DEN,IND,Wilson Chandler,146,31.4,31,0.399999999999999,76,67,9,11,-2
21701165,203115,DEN,IND,Will Barton,168,36.8333333333333,37,-0.166666666666671,89,71,18,16,2
21701165,203486,DEN,IND,Mason Plumlee,52,10.3166666666667,10,0.316666666666666,16,26,-10,-10,0
21701165,203999,DEN,IND,Nikola Jokic,167,38.0333333333333,38,0.0333333333333314,83,76,7,9,-2
21701165,1626168,DEN,IND,Trey Lyles,64,14.5166666666667,15,-0.483333333333334,24,25,-1,-1,0
21701165,1627750,DEN,IND,Jamal Murray,180,38.4,38,0.399999999999999,87,93,-6,0,-6
21701165,1628470,DEN,IND,Torrey Craig,88,17.85,18,-0.149999999999999,41,49,-8,-10,2
21701165,201152,IND,DEN,Thaddeus Young,134,29.8,30,-0.199999999999999,57,75,-18,-18,0
21701165,201954,IND,DEN,Darren Collison,133,27.9333333333333,28,-0.06666666666667,65,74,-9,-7,-2
21701165,202344,IND,DEN,Trevor Booker,73,16.1166666666667,16,0.116666666666667,35,26,9,7,2
21701165,202362,IND,DEN,Lance Stephenson,99,21.2333333333333,21,0.233333333333334,53,40,13,15,-2
21701165,202709,IND,DEN,Cory Joseph,89,20.0666666666667,20,0.0666666666666664,39,33,6,4,2
21701165,202711,IND,DEN,Bojan Bogdanovic,149,32.2666666666667,32,0.266666666666666,68,78,-10,-12,2
21701165,203506,IND,DEN,Victor Oladipo,168,35.4666666666667,36,-0.533333333333331,79,90,-11,-11,0
21701165,203922,IND,DEN,Glenn Robinson III,35,7.45,8,-0.550000000000001,18,11,7,7,0
21701165,1626167,IND,DEN,Myles Turner,163,35.75,35,0.75,73,88,-15,-13,-2
21701165,1627734,IND,DEN,Domantas Sabonis,67,13.9166666666667,14,-0.0833333333333322,33,20,13,13,0
21701166,101112,LAL,UTA,Channing Frye,85,17.0166666666667,17,0.0166666666666657,49,38,11,10,1
21701166,201572,LAL,UTA,Brook Lopez,124,27.0833333333333,27,0.0833333333333357,54,74,-20,-18,-2
21701166,203484,LAL,UTA,Kentavious Caldwell-Pope,193,40.0666666666667,40,0.0666666666666629,91,104,-13,-16,3
21701166,203898,LAL,UTA,Tyler Ennis,103,22,22,0,55,45,10,10,0
21701166,203944,LAL,UTA,Julius Randle,165,35.5833333333333,36,-0.416666666666664,76,93,-17,-16,-1
21701166,1627826,LAL,UTA,Ivica Zubac,54,11.0666666666667,11,0.0666666666666664,32,19,13,12,1
21701166,1627936,LAL,UTA,Alex Caruso,70,15.25,15,0.25,35,42,-7,-9,2
21701166,1628398,LAL,UTA,Kyle Kuzma,166,36.4166666666667,36,0.416666666666664,74,91,-17,-13,-4
21701166,1628404,LAL,UTA,Josh Hart,170,35.2666666666667,35,0.266666666666666,84,79,5,5,0
21701166,201937,UTA,LAL,Ricky Rubio,156,33.4,33,0.399999999999999,88,74,14,16,-2
21701166,201973,UTA,LAL,Jonas Jerebko,47,9.66666666666667,10,-0.333333333333334,19,28,-9,-7,-2
21701166,202324,UTA,LAL,Derrick Favors,141,29.5666666666667,29,0.566666666666666,74,74,0,1,-1
21701166,203109,UTA,LAL,Jae Crowder,136,29.15,30,-0.850000000000001,65,62,3,-1,4
21701166,203497,UTA,LAL,Rudy Gobert,171,36.5333333333333,36,0.533333333333331,95,78,17,17,0
21701166,203957,UTA,LAL,Dante Exum,70,14.55,15,-0.449999999999999,29,36,-7,-9,2
21701166,204060,UTA,LAL,Joe Ingles,160,33.3833333333333,34,-0.616666666666667,84,79,5,6,-1
21701166,1626220,UTA,LAL,Royce O'Neale,82,17.4166666666667,17,0.416666666666664,38,45,-7,-5,-2
21701166,1628378,UTA,LAL,Donovan Mitchell,167,36.0833333333333,36,0.0833333333333286,93,74,19,17,2
21701167,203458,PHX,SAC,Alex Len,144,32.2666666666667,32,0.266666666666666,71,60,11,9,2
21701167,203584,PHX,SAC,Troy Daniels,39,8.75,9,-0.25,11,22,-11,-10,-1
21701167,1626210,PHX,SAC,Alan Williams,13,3.18333333333333,3,0.183333333333334,2,9,-7,-5,-2
21701167,1627733,PHX,SAC,Dragan Bender,106,21.2666666666667,21,0.266666666666666,44,40,4,4,0
21701167,1627737,PHX,SAC,Marquese Chriss,128,27.2,27,0.199999999999999,51,55,-4,-4,0
21701167,1627755,PHX,SAC,Tyler Ulis,176,36.4166666666667,36,0.416666666666664,71,78,-7,-6,-1
21701167,1627863,PHX,SAC,Danuel House Jr.,130,28.35,28,0.350000000000001,66,55,11,12,-1
21701167,1627885,PHX,SAC,Shaquille Harrison,102,22.8333333333333,23,-0.166666666666664,47,50,-3,-3,0
21701167,1628367,PHX,SAC,Josh Jackson,177,38.0333333333333,39,-0.966666666666669,79,74,5,2,3
21701167,1628409,PHX,SAC,Alec Peters,46,11.6666666666667,11,0.666666666666668,23,18,5,5,0
21701167,1628432,PHX,SAC,Davon Reed,49,10.0333333333333,10,0.0333333333333332,20,9,11,11,0
21701167,1713,SAC,PHX,Vince Carter,97,20.7166666666667,21,-0.283333333333331,44,40,4,4,0
21701167,203992,SAC,PHX,Bogdan Bogdanovic,176,37.0166666666667,37,0.0166666666666657,77,74,3,3,0
21701167,203998,SAC,PHX,Bruno Caboclo,18,4.48333333333333,5,-0.516666666666667,6,9,-3,-1,-2
21701167,1626161,SAC,PHX,Willie Cauley-Stein,175,37.1166666666667,37,0.116666666666667,73,72,1,1,0
21701167,1627741,SAC,PHX,Buddy Hield,115,25.45,25,0.449999999999999,48,56,-8,-9,1
21701167,1628368,SAC,PHX,De'Aaron Fox,184,38.6166666666667,39,-0.383333333333333,84,78,6,6,0
21701167,1628382,SAC,PHX,Justin Jackson,196,41.6833333333333,42,-0.316666666666663,86,81,5,3,2
21701167,1628412,SAC,PHX,Frank Mason,55,13.1333333333333,13,0.133333333333333,19,29,-10,-10,0
21701167,1628502,SAC,PHX,Nigel Hayes,94,21.7833333333333,22,-0.216666666666669,33,46,-13,-12,-1
21701168,101150,LAC,SAS,Lou Williams,186,37.1,37,0.0999999999999943,96,86,10,15,-5
21701168,201599,LAC,SAS,DeAndre Jordan,141,29.5666666666667,30,-0.433333333333337,62,61,1,3,-2
21701168,202325,LAC,SAS,Wesley Johnson,8,0.95,1,-0.05,1,4,-3,-3,0
21701168,202699,LAC,SAS,Tobias Harris,172,34.7333333333333,35,-0.266666666666666,78,77,1,1,0
21701168,203085,LAC,SAS,Austin Rivers,184,38.45,39,-0.549999999999997,91,89,2,4,-2
21701168,203710,LAC,SAS,C.J. Williams,56,12.3,12,0.300000000000001,20,29,-9,-11,2
21701168,1626149,LAC,SAS,Montrezl Harrell,130,26.7833333333333,26,0.783333333333331,75,68,7,5,2
21701168,1626246,LAC,SAS,Boban Marjanovic,54,10.7333333333333,11,-0.266666666666668,29,26,3,3,0
21701168,1627820,LAC,SAS,Tyrone Wallace,154,31.5,31,0.5,71,74,-3,-4,1
21701168,1628414,LAC,SAS,Sindarius Thornwell,90,17.8833333333333,18,-0.116666666666667,42,36,6,2,4
21701168,1938,SAS,LAC,Manu Ginobili,131,26.1,26,0.100000000000001,64,74,-10,-12,2
21701168,2200,SAS,LAC,Pau Gasol,53,10.55,11,-0.449999999999999,22,25,-3,-3,0
21701168,2225,SAS,LAC,Tony Parker,79,15.5833333333333,16,-0.416666666666666,39,39,0,0,0
21701168,200746,SAS,LAC,LaMarcus Aldridge,182,37.45,37,0.450000000000003,88,88,0,0,0
21701168,200752,SAS,LAC,Rudy Gay,87,17.7,18,-0.299999999999997,41,46,-5,-7,2
21701168,201980,SAS,LAC,Danny Green,147,30.3,30,0.300000000000001,71,66,5,7,-2
21701168,201988,SAS,LAC,Patty Mills,152,31.55,31,0.549999999999997,65,80,-15,-19,4
21701168,203937,SAS,LAC,Kyle Anderson,145,29.4833333333333,29,0.483333333333334,67,67,0,2,-2
21701168,1627749,SAS,LAC,Dejounte Murray,116,24.8333333333333,25,-0.166666666666664,48,47,1,1,0
21701168,1627854,SAS,LAC,Bryn Forbes,83,16.45,17,-0.550000000000001,45,33,12,16,-4
21701169,101141,PHI,DET,Ersan Ilyasova,156,33.6666666666667,33,0.666666666666671,73,64,9,9,0
21701169,101161,PHI,DET,Amir Johnson,139,29.0333333333333,29,0.0333333333333314,65,65,0,1,-1
21701169,200755,PHI,DET,JJ Redick,164,34,34,0,78,79,-1,-2,1
21701169,201158,PHI,DET,Marco Belinelli,151,30.5333333333333,30,0.533333333333331,79,70,9,10,-1
21701169,203496,PHI,DET,Robert Covington,143,29.4166666666667,30,-0.583333333333336,66,69,-3,-5,2
21701169,204456,PHI,DET,T.J. McConnell,68,12.7166666666667,13,-0.283333333333333,38,34,4,6,-2
21701169,1626147,PHI,DET,Justin Anderson,19,3.61666666666667,4,-0.383333333333333,13,12,1,1,0
21701169,1626158,PHI,DET,Richaun Holmes,88,18.55,19,-0.450000000000003,48,39,9,8,1
21701169,1627732,PHI,DET,Ben Simmons,158,32.0166666666667,32,0.0166666666666657,79,81,-2,-2,0
21701169,1628365,PHI,DET,Markelle Fultz,74,15.8666666666667,16,-0.133333333333335,36,27,9,9,0
21701169,201229,DET,PHI,Anthony Tolliver,176,36.0333333333333,36,0.0333333333333314,89,88,1,2,-1
21701169,202397,DET,PHI,Ish Smith,134,27.85,28,-0.149999999999999,69,72,-3,-2,-1
21701169,202704,DET,PHI,Reggie Jackson,98,20.0333333333333,20,0.0333333333333314,39,43,-4,-5,1
21701169,203083,DET,PHI,Andre Drummond,185,37.4166666666667,38,-0.583333333333336,85,96,-11,-11,0
21701169,203493,DET,PHI,Reggie Bullock,153,30.7833333333333,31,-0.216666666666669,75,70,5,3,2
21701169,203516,DET,PHI,James Ennis III,33,6.95,7,-0.0500000000000007,12,15,-3,-5,2
21701169,203961,DET,PHI,Eric Moreland,40,8.86666666666667,9,-0.133333333333333,18,17,1,1,0
21701169,1626169,DET,PHI,Stanley Johnson,163,33.65,33,0.650000000000006,79,82,-3,-1,-2
21701169,1627740,DET,PHI,Henry Ellenson,63,13.45,13,0.449999999999999,24,29,-5,-6,1
21701169,1628379,DET,PHI,Luke Kennard,115,24.3833333333333,25,-0.616666666666667,50,63,-13,-11,-2
21701170,200826,DAL,ORL,J.J. Barea,50,9.66666666666667,10,-0.333333333333334,18,19,-1,-3,2
21701170,203926,DAL,ORL,Doug McDermott,100,20.1666666666667,20,0.166666666666664,36,46,-10,-10,0
21701170,1626151,DAL,ORL,Aaron Harrison,201,41.95,42,-0.0499999999999972,84,91,-7,-9,2
21701170,1626257,DAL,ORL,Salah Mejri,2,0.5,1,-0.5,0,2,-2,-2,0
21701170,1627812,DAL,ORL,Yogi Ferrell,75,17.15,17,0.149999999999999,41,37,4,7,-3
21701170,1627827,DAL,ORL,Dorian Finney-Smith,171,35.2166666666667,35,0.216666666666669,73,70,3,3,0
21701170,1627858,DAL,ORL,Kyle Collinsworth,163,35.1,35,0.0999999999999943,75,79,-4,-3,-1
21701170,1627883,DAL,ORL,Jalen Jones,119,26.8833333333333,27,-0.116666666666667,61,63,-2,-2,0
21701170,1628405,DAL,ORL,Johnathan Motley,195,41.2,41,0.200000000000003,79,94,-15,-15,0
21701170,1628467,DAL,ORL,Maxi Kleber,49,11.9166666666667,12,-0.0833333333333339,33,24,9,9,0
21701170,201571,ORL,DAL,D.J. Augustin,91,18.4166666666667,18,0.416666666666664,40,30,10,10,0
21701170,202687,ORL,DAL,Bismack Biyombo,111,22.3,22,0.299999999999997,49,38,11,11,0
21701170,202714,ORL,DAL,Shelvin Mack,119,26.6333333333333,27,-0.366666666666667,63,62,1,1,0
21701170,203920,ORL,DAL,Khem Birch,114,25.65,26,-0.350000000000001,56,62,-6,-6,0
21701170,203932,ORL,DAL,Aaron Gordon,127,25.65,26,-0.350000000000001,58,44,14,14,0
21701170,1626209,ORL,DAL,Mario Hezonja,158,34.6166666666667,35,-0.383333333333333,79,64,15,13,2
21701170,1628411,ORL,DAL,Wes Iwundu,157,31.85,32,-0.150000000000002,65,65,0,0,0
21701170,1628503,ORL,DAL,Jamel Artis,146,31.5833333333333,32,-0.416666666666664,66,77,-11,-9,-2
21701170,1628681,ORL,DAL,Rodney Purvis,102,23.05,23,0.0500000000000007,49,58,-9,-9,0
21701171,201143,BOS,TOR,Al Horford,134,30.55,31,-0.450000000000003,49,60,-11,-8,-3
21701171,202328,BOS,TOR,Greg Monroe,105,23.6666666666667,23,0.666666666666664,46,49,-3,-5,2
21701171,202694,BOS,TOR,Marcus Morris,157,34.4666666666667,34,0.466666666666669,63,69,-6,-6,0
21701171,202918,BOS,TOR,Xavier Silas,37,7.05,7,0.0499999999999998,18,17,1,1,0
21701171,203382,BOS,TOR,Aron Baynes,62,14.2833333333333,14,0.283333333333333,15,25,-10,-9,-1
21701171,1626179,BOS,TOR,Terry Rozier,121,27.65,28,-0.350000000000001,42,52,-10,-9,-1
21701171,1627759,BOS,TOR,Jaylen Brown,121,28.4333333333333,28,0.433333333333334,48,55,-7,-9,2
21701171,1627824,BOS,TOR,Guerschon Yabusele,13,2.26666666666667,2,0.266666666666667,3,5,-2,-2,0
21701171,1627846,BOS,TOR,Abdel Nader,26,5.13333333333333,5,0.133333333333333,6,16,-10,-10,0
21701171,1628369,BOS,TOR,Jayson Tatum,124,27.6666666666667,28,-0.333333333333336,38,51,-13,-11,-2
21701171,1628400,BOS,TOR,Semi Ojeleye,81,18.0166666666667,18,0.0166666666666657,26,43,-17,-19,2
21701171,1628443,BOS,TOR,Kadeem Allen,81,17.2166666666667,17,0.216666666666669,33,33,0,-1,1
21701171,1628444,BOS,TOR,Jabari Bird,13,2.26666666666667,2,0.266666666666667,3,5,-2,-2,0
21701171,101139,TOR,BOS,CJ Miles,72,15.3333333333333,15,0.333333333333332,32,24,8,8,0
21701171,200768,TOR,BOS,Kyle Lowry,146,32.3166666666667,32,0.31666666666667,67,47,20,20,0
21701171,201586,TOR,BOS,Serge Ibaka,129,29.2833333333333,29,0.283333333333331,58,45,13,14,-1
21701171,201942,TOR,BOS,DeMar DeRozan,115,26.75,27,-0.25,49,44,5,5,0
21701171,202685,TOR,BOS,Jonas Valanciunas,56,13.3666666666667,13,0.366666666666667,18,19,-1,-1,0
21701171,203512,TOR,BOS,Lucas Nogueira,81,18.05,18,0.0499999999999972,45,28,17,19,-2
21701171,1626153,TOR,BOS,Delon Wright,123,26.5166666666667,27,-0.483333333333334,65,45,20,19,1
21701171,1626181,TOR,BOS,Norman Powell,49,10.7,11,-0.300000000000001,18,18,0,1,-1
21701171,1627751,TOR,BOS,Jakob Poeltl,78,16.3166666666667,17,-0.683333333333334,33,31,2,0,2
21701171,1627783,TOR,BOS,Pascal Siakam,72,15.9166666666667,16,-0.0833333333333357,31,33,-2,-3,1
21701171,1627832,TOR,BOS,Fred VanVleet,111,23.6,24,-0.399999999999999,51,41,10,10,0
21701171,1628384,TOR,BOS,OG Anunoby,43,10.5166666666667,11,-0.483333333333334,13,15,-2,-2,0
21701172,202379,ATL,MIA,Jeremy Evans,30,5.31666666666667,5,0.316666666666666,12,17,-5,-4,-1
21701172,203101,ATL,MIA,Miles Plumlee,113,22.15,22,0.149999999999999,41,49,-8,-8,0
21701172,203473,ATL,MIA,Dewayne Dedmon,100,22.25,22,0.25,41,57,-16,-16,0
21701172,203488,ATL,MIA,Mike Muscala,99,20.2,20,0.199999999999999,35,44,-9,-9,0
21701172,203705,ATL,MIA,Josh Magette,90,19.2,19,0.199999999999999,36,42,-6,-7,1
21701172,1627752,ATL,MIA,Taurean Prince,112,24.2,24,0.199999999999999,48,61,-13,-12,-1
21701172,1627814,ATL,MIA,Damion Lee,103,22.25,23,-0.75,45,50,-5,-6,1
21701172,1627819,ATL,MIA,Isaiah Taylor,85,18.85,19,-0.149999999999999,34,49,-15,-15,0
21701172,1628381,ATL,MIA,John Collins,122,27.0166666666667,27,0.0166666666666657,50,69,-19,-18,-1
21701172,1628416,ATL,MIA,Tyler Dorsey,132,26.3166666666667,26,0.316666666666666,40,71,-31,-30,-1
21701172,1628463,ATL,MIA,Tyler Cavanaugh,51,9.58333333333333,10,-0.416666666666666,15,24,-9,-9,0
21701172,1628499,ATL,MIA,Antonius Cleveland,62,12.25,12,0.25,18,18,0,-2,2
21701172,1628510,ATL,MIA,Andrew White III,51,9.58333333333333,10,-0.416666666666666,15,24,-9,-9,0
21701172,2617,MIA,ATL,Udonis Haslem,30,5.31666666666667,5,0.316666666666666,17,12,5,4,1
21701172,201961,MIA,ATL,Wayne Ellington,113,23.4833333333333,24,-0.516666666666666,51,39,12,12,0
21701172,202337,MIA,ATL,Luke Babbitt,118,25.1833333333333,25,0.183333333333334,57,53,4,5,-1
21701172,202355,MIA,ATL,Hassan Whiteside,95,21.1166666666667,21,0.116666666666667,46,45,1,1,0
21701172,203482,MIA,ATL,Kelly Olynyk,109,22.1833333333333,23,-0.81666666666667,57,31,26,26,0
21701172,203585,MIA,ATL,Rodney McGruder,92,20.3833333333333,21,-0.616666666666667,59,36,23,21,2
21701172,204020,MIA,ATL,Tyler Johnson,108,23.0833333333333,23,0.0833333333333357,53,48,5,4,1
21701172,1626159,MIA,ATL,Justise Winslow,133,27.4166666666667,27,0.416666666666664,67,43,24,24,0
21701172,1626175,MIA,ATL,Jordan Mickey,39,7.06666666666667,7,0.0666666666666664,17,15,2,2,0
21701172,1626196,MIA,ATL,Josh Richardson,126,27.0166666666667,27,0.0166666666666657,60,48,12,14,-2
21701172,1627884,MIA,ATL,Derrick Jones Jr.,61,11.95,12,-0.0500000000000007,22,22,0,2,-2
21701172,1628389,MIA,ATL,Bam Adebayo,96,19.65,20,-0.350000000000001,52,26,26,26,0
21701172,1628476,MIA,ATL,Derrick Walton Jr.,30,5.31666666666667,5,0.316666666666666,17,12,5,4,1
21701173,2731,NOP,MEM,Emeka Okafor,23,4.08333333333333,4,0.083333333333333,4,5,-1,-1,0
21701173,200765,NOP,MEM,Rajon Rondo,144,28.3833333333333,28,0.383333333333333,85,56,29,30,-1
21701173,201950,NOP,MEM,Jrue Holiday,150,28.8666666666667,29,-0.133333333333333,82,57,25,27,-2
21701173,202703,NOP,MEM,Nikola Mirotic,134,26.7333333333333,27,-0.266666666666666,79,58,21,23,-2
21701173,202732,NOP,MEM,DeAndre Liggins,23,4.08333333333333,4,0.083333333333333,4,5,-1,-1,0
21701173,202734,NOP,MEM,E'Twaun Moore,143,28.9833333333333,29,-0.0166666666666657,93,51,42,41,1
21701173,203076,NOP,MEM,Anthony Davis,151,31.35,31,0.350000000000001,95,54,41,38,3
21701173,203121,NOP,MEM,Darius Miller,112,23.9333333333333,24,-0.0666666666666664,59,51,8,8,0
21701173,203524,NOP,MEM,Solomon Hill,115,23.4,23,0.399999999999999,41,50,-9,-9,0
21701173,203546,NOP,MEM,Ian Clark,55,11.3833333333333,11,0.383333333333333,22,25,-3,-5,2
21701173,203580,NOP,MEM,Larry Drew II,28,5.31666666666667,5,0.316666666666666,7,10,-3,-3,0
21701173,1627767,NOP,MEM,Cheick Diallo,117,23.4833333333333,23,0.483333333333334,44,53,-9,-8,-1
21701173,201188,MEM,NOP,Marc Gasol,101,19.9166666666667,20,-0.0833333333333357,39,57,-18,-18,0
21701173,202705,MEM,NOP,MarShon Brooks,184,36.3333333333333,36,0.333333333333329,75,93,-18,-16,-2
21701173,203104,MEM,NOP,Marquis Teague,102,20.8,21,-0.199999999999999,43,46,-3,-1,-2
21701173,203463,MEM,NOP,Ben McLemore,140,26.6166666666667,27,-0.383333333333333,54,72,-18,-16,-2
21701173,1626185,MEM,NOP,Jarell Martin,97,21.8166666666667,22,-0.183333333333334,41,54,-13,-19,6
21701173,1627738,MEM,NOP,Deyonta Davis,111,21.9333333333333,22,-0.0666666666666664,42,50,-8,-8,0
21701173,1627988,MEM,NOP,Myke Henry,112,22.3666666666667,23,-0.633333333333333,43,48,-5,-5,0
21701173,1628397,MEM,NOP,Ivan Rabb,138,27.3833333333333,27,0.383333333333333,57,74,-17,-13,-4
21701173,1628415,MEM,NOP,Dillon Brooks,69,15.1666666666667,16,-0.833333333333334,29,41,-12,-14,2
21701173,1628424,MEM,NOP,Kobi Simmons,141,27.6666666666667,28,-0.333333333333332,52,80,-28,-30,2
21701174,101112,LAL,SAS,Channing Frye,112,26.4333333333333,26,0.43333333333333,64,51,13,11,2
21701174,201572,LAL,SAS,Brook Lopez,107,22.5166666666667,23,-0.483333333333334,50,54,-4,-6,2
21701174,203484,LAL,SAS,Kentavious Caldwell-Pope,163,37.1333333333333,37,0.133333333333333,85,76,9,9,0
21701174,203898,LAL,SAS,Tyler Ennis,132,31.4,32,-0.600000000000001,74,60,14,16,-2
21701174,203944,LAL,SAS,Julius Randle,104,22.9,23,-0.100000000000001,47,59,-12,-10,-2
21701174,1627826,LAL,SAS,Ivica Zubac,117,28.6,28,0.600000000000001,67,56,11,13,-2
21701174,1627936,LAL,SAS,Alex Caruso,87,18.2,19,-0.800000000000001,40,40,0,-3,3
21701174,1628398,LAL,SAS,Kyle Kuzma,195,43.0833333333333,43,0.0833333333333286,99,98,1,1,0
21701174,1628404,LAL,SAS,Josh Hart,143,33.4833333333333,34,-0.516666666666666,84,66,18,19,-1
21701174,2200,SAS,LAL,Pau Gasol,133,29.0666666666667,29,0.0666666666666664,58,72,-14,-12,-2
21701174,2225,SAS,LAL,Tony Parker,67,15.5666666666667,16,-0.433333333333334,24,33,-9,-8,-1
21701174,200746,SAS,LAL,LaMarcus Aldridge,193,43.5166666666667,44,-0.483333333333334,103,96,7,7,0
21701174,200752,SAS,LAL,Rudy Gay,108,25.6333333333333,26,-0.366666666666667,50,58,-8,-7,-1
21701174,201980,SAS,LAL,Danny Green,98,22.1833333333333,22,0.18333333333333,46,51,-5,-4,-1
21701174,201988,SAS,LAL,Patty Mills,159,35.8833333333333,36,-0.116666666666667,74,82,-8,-11,3
21701174,202722,SAS,LAL,Davis Bertans,19,4.56666666666667,4,0.566666666666666,13,11,2,0,2
21701174,203937,SAS,LAL,Kyle Anderson,144,33.0333333333333,33,0.0333333333333314,70,83,-13,-14,1
21701174,1627749,SAS,LAL,Dejounte Murray,165,37.1833333333333,37,0.183333333333337,88,89,-1,-2,1
21701174,1627854,SAS,LAL,Bryn Forbes,74,17.1166666666667,17,0.116666666666667,34,35,-1,1,-2
21701175,2561,GSW,IND,David West,58,10.9,11,-0.0999999999999996,25,28,-3,-3,0
21701175,2585,GSW,IND,Zaza Pachulia,28,6.95,7,-0.0500000000000007,18,17,1,1,0
21701175,2733,GSW,IND,Shaun Livingston,81,15.0166666666667,15,0.0166666666666657,34,45,-11,-12,1
21701175,201142,GSW,IND,Kevin Durant,162,33.0333333333333,33,0.0333333333333314,71,87,-16,-17,1
21701175,201156,GSW,IND,Nick Young,94,20.6166666666667,21,-0.383333333333333,49,53,-4,-1,-3
21701175,201580,GSW,IND,JaVale McGee,57,11.7666666666667,12,-0.233333333333334,22,32,-10,-8,-2
21701175,202691,GSW,IND,Klay Thompson,144,29.75,30,-0.25,61,76,-15,-14,-1
21701175,203110,GSW,IND,Draymond Green,143,29.15,29,0.149999999999999,59,75,-16,-16,0
21701175,1626172,GSW,IND,Kevon Looney,103,22.4833333333333,23,-0.516666666666666,52,58,-6,-6,0
21701175,1626188,GSW,IND,Quinn Cook,167,35.8666666666667,36,-0.133333333333333,82,95,-13,-15,2
21701175,1627745,GSW,IND,Damian Jones,58,12.2,12,0.199999999999999,30,30,0,-2,2
21701175,1628395,GSW,IND,Jordan Bell,50,10.85,11,-0.149999999999999,27,34,-7,-7,0
21701175,201152,IND,GSW,Thaddeus Young,138,28.7166666666667,29,-0.283333333333331,85,53,32,34,-2
21701175,201954,IND,GSW,Darren Collison,111,23.7333333333333,24,-0.266666666666666,66,48,18,17,1
21701175,202344,IND,GSW,Trevor Booker,71,14.5,15,-0.5,34,39,-5,-7,2
21701175,202362,IND,GSW,Lance Stephenson,82,16.05,16,0.0500000000000007,36,44,-8,-5,-3
21701175,202709,IND,GSW,Cory Joseph,118,23.9833333333333,24,-0.0166666666666657,60,58,2,3,-1
21701175,202711,IND,GSW,Bojan Bogdanovic,145,30.1666666666667,30,0.166666666666664,91,57,34,30,4
21701175,203506,IND,GSW,Victor Oladipo,154,32.8833333333333,33,-0.116666666666667,92,63,29,27,2
21701175,203922,IND,GSW,Glenn Robinson III,61,12.45,12,0.449999999999999,26,36,-10,-7,-3
21701175,1626167,IND,GSW,Myles Turner,119,25.5,25,0.5,68,54,14,14,0
21701175,1626202,IND,GSW,Joe Young,16,3.88333333333333,4,-0.116666666666667,7,12,-5,-5,0
21701175,1627734,IND,GSW,Domantas Sabonis,118,23.9,24,-0.100000000000001,58,57,1,1,0
21701175,1628388,IND,GSW,TJ Leaf,12,2.81666666666667,3,-0.183333333333334,7,9,-2,-2,0
21701176,2544,CLE,WAS,LeBron James,186,38.8,39,-0.200000000000003,107,96,11,13,-2
21701176,2594,CLE,WAS,Kyle Korver,109,22.3666666666667,22,0.366666666666667,59,47,12,11,1
21701176,2747,CLE,WAS,JR Smith,117,23.95,24,-0.0499999999999972,48,62,-14,-11,-3
21701176,201145,CLE,WAS,Jeff Green,146,31.55,32,-0.450000000000003,87,73,14,13,1
21701176,201567,CLE,WAS,Kevin Love,140,30.5833333333333,31,-0.416666666666664,84,74,10,8,2
21701176,202684,CLE,WAS,Tristan Thompson,45,10.2333333333333,10,0.233333333333334,13,22,-9,-9,0
21701176,203903,CLE,WAS,Jordan Clarkson,104,22.25,22,0.25,43,54,-11,-9,-2
21701176,203918,CLE,WAS,Rodney Hood,125,26.9666666666667,27,-0.0333333333333314,82,60,22,21,1
21701176,1626204,CLE,WAS,Larry Nance Jr.,85,17.85,18,-0.149999999999999,30,45,-15,-13,-2
21701176,1626224,CLE,WAS,Cedi Osman,73,15.45,15,0.449999999999999,37,42,-5,-4,-1
21701176,101133,WAS,CLE,Ian Mahinmi,50,11.4166666666667,11,0.416666666666666,26,20,6,6,0
21701176,101162,WAS,CLE,Marcin Gortat,113,24.7833333333333,25,-0.216666666666669,64,58,6,7,-1
21701176,201975,WAS,CLE,Jodie Meeks,17,2.88333333333333,3,-0.116666666666667,8,12,-4,-6,2
21701176,202322,WAS,CLE,John Wall,184,38.2833333333333,38,0.283333333333331,95,105,-10,-12,2
21701176,202693,WAS,CLE,Markieff Morris,142,30.0333333333333,30,0.0333333333333314,77,74,3,0,3
21701176,203078,WAS,CLE,Bradley Beal,196,42.5333333333333,43,-0.466666666666669,99,100,-1,0,-1
21701176,203107,WAS,CLE,Tomas Satoransky,76,15.9,16,-0.0999999999999996,36,34,2,3,-1
21701176,203118,WAS,CLE,Mike Scott,100,20.7,21,-0.299999999999997,45,51,-6,-8,2
21701176,203490,WAS,CLE,Otto Porter Jr.,140,30.0666666666667,30,0.0666666666666664,73,79,-6,-5,-1
21701176,1626162,WAS,CLE,Kelly Oubre Jr.,112,23.4,23,0.399999999999999,52,57,-5,-5,0
21701177,2207,HOU,POR,Joe Johnson,79,17.4333333333333,18,-0.566666666666666,29,32,-3,-5,2
21701177,2772,HOU,POR,Trevor Ariza,121,27.2,27,0.199999999999999,54,58,-4,-2,-2
21701177,101108,HOU,POR,Chris Paul,140,31.2333333333333,31,0.233333333333334,66,63,3,1,2
21701177,101123,HOU,POR,Gerald Green,119,26.2,26,0.199999999999999,45,52,-7,-7,0
21701177,200782,HOU,POR,PJ Tucker,137,31.5333333333333,31,0.533333333333331,65,62,3,5,-2
21701177,201601,HOU,POR,Luc Mbah a Moute,108,24.8666666666667,25,-0.133333333333333,54,43,11,9,2
21701177,201935,HOU,POR,James Harden,152,34.6,34,0.599999999999994,71,66,5,7,-2
21701177,203991,HOU,POR,Clint Capela,139,31.95,32,-0.0500000000000043,74,62,12,12,0
21701177,204028,HOU,POR,Tarik Black,70,14.9833333333333,15,-0.0166666666666657,22,32,-10,-10,0
21701177,202323,POR,HOU,Evan Turner,113,25.15,26,-0.850000000000001,55,59,-4,-7,3
21701177,202329,POR,HOU,Al-Farouq Aminu,108,24.8166666666667,25,-0.183333333333334,44,58,-14,-14,0
21701177,203086,POR,HOU,Meyers Leonard,14,3.48333333333333,3,0.483333333333333,5,11,-6,-6,0
21701177,203468,POR,HOU,CJ McCollum,149,33.5333333333333,33,0.533333333333331,59,80,-21,-21,0
21701177,203894,POR,HOU,Shabazz Napier,123,28.4666666666667,29,-0.533333333333335,51,60,-9,-9,0
21701177,203994,POR,HOU,Jusuf Nurkic,144,33.65,33,0.649999999999999,60,75,-15,-15,0
21701177,1626192,POR,HOU,Pat Connaughton,87,19.05,19,0.0499999999999972,36,27,9,9,0
21701177,1627735,POR,HOU,Wade Baldwin IV,140,32,32,0,66,55,11,14,-3
21701177,1627774,POR,HOU,Jake Layman,22,3.95,4,-0.0499999999999998,17,2,15,15,0
21701177,1627834,POR,HOU,Georgios Papagiannis,18,3.43333333333333,4,-0.566666666666667,15,0,15,15,0
21701177,1628380,POR,HOU,Zach Collins,64,15.1833333333333,15,0.183333333333334,17,30,-13,-13,0
21701177,1628403,POR,HOU,Caleb Swanigan,83,17.2833333333333,18,-0.716666666666665,45,23,22,22,0
21701178,1891,MIL,BKN,Jason Terry,63,13.4833333333333,14,-0.516666666666666,31,27,4,1,3
21701178,202339,MIL,BKN,Eric Bledsoe,166,36.0666666666667,36,0.0666666666666629,85,97,-12,-10,-2
21701178,203089,MIL,BKN,John Henson,128,26.8166666666667,27,-0.183333333333334,58,69,-11,-9,-2
21701178,203092,MIL,BKN,Tyler Zeller,94,21.0666666666667,21,0.0666666666666664,53,50,3,1,2
21701178,203114,MIL,BKN,Khris Middleton,166,36.0666666666667,36,0.0666666666666629,85,97,-12,-10,-2
21701178,203498,MIL,BKN,Shabazz Muhammad,42,8.7,9,-0.300000000000001,15,11,4,4,0
21701178,203503,MIL,BKN,Tony Snell,76,16.2833333333333,16,0.283333333333331,31,45,-14,-13,-1
21701178,203507,MIL,BKN,Giannis Antetokounmpo,168,36.1666666666667,36,0.166666666666664,78,91,-13,-11,-2
21701178,203953,MIL,BKN,Jabari Parker,146,31.25,32,-0.75,75,73,2,0,2
21701178,1628425,MIL,BKN,Sterling Brown,61,13.5166666666667,14,-0.483333333333334,44,35,9,7,2
21701178,202389,BKN,MIL,Timofey Mozgov,22,5.13333333333333,5,0.133333333333333,17,18,-1,2,-3
21701178,203112,BKN,MIL,Quincy Acy,100,21.9,23,-1.1,54,56,-2,2,-4
21701178,203459,BKN,MIL,Allen Crabbe,146,30.7,30,0.699999999999999,73,65,8,6,2
21701178,203915,BKN,MIL,Spencer Dinwiddie,110,24.3333333333333,25,-0.666666666666664,50,63,-13,-11,-2
21701178,203917,BKN,MIL,Nik Stauskas,7,1.08333333333333,1,0.0833333333333335,2,3,-1,-1,0
21701178,203925,BKN,MIL,Joe Harris,138,29,29,0,90,71,19,24,-5
21701178,1626156,BKN,MIL,D'Angelo Russell,130,28.8666666666667,29,-0.133333333333333,69,61,8,11,-3
21701178,1626178,BKN,MIL,Rondae Hollis-Jefferson,176,37.2666666666667,37,0.266666666666666,91,79,12,10,2
21701178,1627747,BKN,MIL,Caris LeVert,136,29.85,30,-0.149999999999999,73,70,3,-5,8
21701178,1628386,BKN,MIL,Jarrett Allen,145,31.2833333333333,31,0.283333333333331,76,69,7,2,5
21701179,101150,LAC,UTA,Lou Williams,146,30.5833333333333,30,0.583333333333336,56,75,-19,-17,-2
21701179,201599,LAC,UTA,DeAndre Jordan,99,20.8,21,-0.199999999999999,42,54,-12,-10,-2
21701179,202325,LAC,UTA,Wesley Johnson,43,8.85,9,-0.15,21,20,1,3,-2
21701179,202699,LAC,UTA,Tobias Harris,151,32.2,32,0.200000000000003,61,84,-23,-23,0
21701179,203085,LAC,UTA,Austin Rivers,153,32.4166666666667,32,0.416666666666671,59,80,-21,-21,0
21701179,203710,LAC,UTA,C.J. Williams,76,16.95,17,-0.0500000000000007,40,40,0,0,0
21701179,1626149,LAC,UTA,Montrezl Harrell,110,25.1333333333333,25,0.133333333333333,46,57,-11,-13,2
21701179,1626155,LAC,UTA,Sam Dekker,60,13.9166666666667,14,-0.0833333333333322,33,29,4,4,0
21701179,1626246,LAC,UTA,Boban Marjanovic,63,14.7833333333333,15,-0.216666666666667,34,33,1,1,0
21701179,1627820,LAC,UTA,Tyrone Wallace,119,26.5833333333333,26,0.583333333333336,58,74,-16,-16,0
21701179,1628414,LAC,UTA,Sindarius Thornwell,70,15.5333333333333,16,-0.466666666666669,25,39,-14,-18,4
21701179,201937,UTA,LAC,Ricky Rubio,37,7.98333333333333,8,-0.0166666666666675,25,18,7,7,0
21701179,201973,UTA,LAC,Jonas Jerebko,105,22.9166666666667,24,-1.08333333333333,52,47,5,7,-2
21701179,202324,UTA,LAC,Derrick Favors,118,27.4,28,-0.600000000000001,68,56,12,12,0
21701179,202327,UTA,LAC,Ekpe Udoh,39,8.3,8,0.299999999999999,18,18,0,0,0
21701179,202692,UTA,LAC,Alec Burks,74,16.5666666666667,17,-0.433333333333334,37,39,-2,0,-2
21701179,203109,UTA,LAC,Jae Crowder,25,4.66666666666667,5,-0.333333333333334,15,10,5,1,4
21701179,203497,UTA,LAC,Rudy Gobert,129,27.6666666666667,28,-0.333333333333336,72,50,22,22,0
21701179,203957,UTA,LAC,Dante Exum,120,24.7,24,0.699999999999999,64,49,15,14,1
21701179,204060,UTA,LAC,Joe Ingles,138,31.7666666666667,32,-0.233333333333334,75,61,14,15,-1
21701179,204065,UTA,LAC,David Stockton,11,2.41666666666667,3,-0.583333333333334,3,5,-2,-2,0
21701179,1626220,UTA,LAC,Royce O'Neale,148,31.8333333333333,32,-0.166666666666664,74,64,10,10,0
21701179,1627777,UTA,LAC,Georges Niang,14,3.15,4,-0.85,6,5,1,1,0
21701179,1628378,UTA,LAC,Donovan Mitchell,132,28.3833333333333,28,0.383333333333333,76,53,23,23,0
21701180,2734,DEN,MIN,Devin Harris,92,20.05,20,0.0500000000000007,37,41,-4,-4,0
21701180,200794,DEN,MIN,Paul Millsap,154,33.6333333333333,33,0.633333333333333,66,69,-3,-1,-2
21701180,201163,DEN,MIN,Wilson Chandler,151,33.1166666666667,33,0.116666666666667,66,65,1,1,0
21701180,203115,DEN,MIN,Will Barton,190,41.0166666666667,40,1.01666666666667,79,80,-1,-3,2
21701180,203486,DEN,MIN,Mason Plumlee,100,22.25,22,0.25,46,45,1,1,0
21701180,203999,DEN,MIN,Nikola Jokic,161,34.9666666666667,36,-1.03333333333333,69,69,0,1,-1
21701180,1626168,DEN,MIN,Trey Lyles,19,4.15,4,0.15,15,7,8,8,0
21701180,1627750,DEN,MIN,Jamal Murray,158,34.9333333333333,36,-1.06666666666666,84,71,13,15,-2
21701180,1628470,DEN,MIN,Torrey Craig,75,15.8833333333333,16,-0.116666666666667,38,33,5,2,3
21701180,2037,MIN,DEN,Jamal Crawford,95,20.2666666666667,20,0.266666666666666,39,42,-3,-2,-1
21701180,201565,MIN,DEN,Derrick Rose,70,14.8666666666667,15,-0.133333333333333,30,21,9,11,-2
21701180,201952,MIN,DEN,Jeff Teague,161,35.6166666666667,36,-0.38333333333334,67,69,-2,-3,1
21701180,201959,MIN,DEN,Taj Gibson,167,37.05,37,0.0499999999999972,74,81,-7,-9,2
21701180,202357,MIN,DEN,Nemanja Bjelica,157,34.9166666666667,35,-0.0833333333333357,70,68,2,2,0
21701180,203476,MIN,DEN,Gorgui Dieng,74,14.6833333333333,15,-0.316666666666666,25,39,-14,-15,1
21701180,203952,MIN,DEN,Andrew Wiggins,147,32.5833333333333,33,-0.416666666666664,66,79,-13,-13,0
21701180,1626145,MIN,DEN,Tyus Jones,59,12.3833333333333,12,0.383333333333333,29,31,-2,-1,-1
21701180,1626157,MIN,DEN,Karl-Anthony Towns,170,37.6333333333333,38,-0.366666666666667,80,70,10,10,0
21701181,203084,DAL,DET,Harrison Barnes,135,31.1166666666667,31,0.116666666666667,64,64,0,0,0
21701181,203926,DAL,DET,Doug McDermott,85,18.7833333333333,19,-0.216666666666669,43,39,4,5,-1
21701181,203939,DAL,DET,Dwight Powell,119,27.7833333333333,28,-0.216666666666669,56,59,-3,-3,0
21701181,1626151,DAL,DET,Aaron Harrison,85,20.6666666666667,21,-0.333333333333336,36,50,-14,-13,-1
21701181,1627812,DAL,DET,Yogi Ferrell,50,11.1666666666667,11,0.166666666666668,24,25,-1,-1,0
21701181,1627827,DAL,DET,Dorian Finney-Smith,153,36.9333333333333,37,-0.0666666666666629,68,78,-10,-12,2
21701181,1627858,DAL,DET,Kyle Collinsworth,79,18.7333333333333,19,-0.266666666666666,40,40,0,-2,2
21701181,1627883,DAL,DET,Jalen Jones,50,12.3,12,0.300000000000001,21,28,-7,-5,-2
21701181,1628372,DAL,DET,Dennis Smith Jr.,135,31.1166666666667,31,0.116666666666667,64,64,0,0,0
21701181,1628405,DAL,DET,Johnathan Motley,171,40.25,40,0.25,73,84,-11,-9,-2
21701181,1628467,DAL,DET,Maxi Kleber,73,16.15,16,0.149999999999999,41,34,7,5,2
21701181,201229,DET,DAL,Anthony Tolliver,144,34.4,35,-0.600000000000001,74,66,8,5,3
21701181,202397,DET,DAL,Ish Smith,87,18.2833333333333,18,0.283333333333331,36,45,-9,-5,-4
21701181,202704,DET,DAL,Reggie Jackson,140,34.7166666666667,35,-0.283333333333331,77,61,16,12,4
21701181,203083,DET,DAL,Andre Drummond,178,42.45,42,0.450000000000003,94,83,11,9,2
21701181,203516,DET,DAL,James Ennis III,58,13.4166666666667,14,-0.583333333333334,32,28,4,4,0
21701181,203961,DET,DAL,Eric Moreland,49,10.55,11,-0.449999999999999,19,23,-4,-2,-2
21701181,204038,DET,DAL,Langston Galloway,115,25.9666666666667,26,-0.0333333333333314,58,49,9,9,0
21701181,1626169,DET,DAL,Stanley Johnson,168,39.4,39,0.399999999999999,81,78,3,3,0
21701181,1627740,DET,DAL,Henry Ellenson,83,18.6,18,0.600000000000001,39,40,-1,2,-3
21701181,1628379,DET,DAL,Luke Kennard,113,27.2166666666667,27,0.216666666666665,55,57,-2,-2,0
21701182,201167,ORL,CHA,Arron Afflalo,33,7.66666666666667,8,-0.333333333333334,11,21,-10,-10,0
21701182,201571,ORL,CHA,D.J. Augustin,86,18.2333333333333,18,0.233333333333334,35,54,-19,-18,-1
21701182,201578,ORL,CHA,Marreese Speights,110,24.2166666666667,25,-0.783333333333335,53,67,-14,-16,2
21701182,202687,ORL,CHA,Bismack Biyombo,93,20.55,21,-0.449999999999999,40,50,-10,-12,2
21701182,202714,ORL,CHA,Shelvin Mack,97,21.15,21,0.149999999999999,42,64,-22,-23,1
21701182,203920,ORL,CHA,Khem Birch,127,27.1666666666667,27,0.166666666666664,60,87,-27,-25,-2
21701182,1626209,ORL,CHA,Mario Hezonja,107,22.6833333333333,23,-0.316666666666666,44,59,-15,-17,2
21701182,1628411,ORL,CHA,Wes Iwundu,172,37.2833333333333,37,0.283333333333331,83,106,-23,-23,0
21701182,1628503,ORL,CHA,Jamel Artis,153,33,33,0,70,96,-26,-24,-2
21701182,1628681,ORL,CHA,Rodney Purvis,122,26.6333333333333,27,-0.366666666666667,62,81,-19,-17,-2
21701182,2730,CHA,ORL,Dwight Howard,133,28.3166666666667,28,0.316666666666666,85,60,25,23,2
21701182,101107,CHA,ORL,Marvin Williams,100,21.45,22,-0.550000000000001,58,40,18,18,0
21701182,201587,CHA,ORL,Nicolas Batum,93,19.95,20,-0.0500000000000007,52,40,12,12,0
21701182,202689,CHA,ORL,Kemba Walker,106,22.85,23,-0.149999999999999,60,44,16,20,-4
21701182,202933,CHA,ORL,Julyan Stone,116,25.25,25,0.25,79,58,21,17,4
21701182,203077,CHA,ORL,Michael Kidd-Gilchrist,104,22.4666666666667,23,-0.533333333333331,58,42,16,20,-4
21701182,203087,CHA,ORL,Jeremy Lamb,96,20.0833333333333,20,0.0833333333333322,66,39,27,27,0
21701182,1626163,CHA,ORL,Frank Kaminsky,120,26.2666666666667,26,0.266666666666666,79,60,19,19,0
21701182,1626195,CHA,ORL,Willy Hernangomez,87,19.4,20,-0.600000000000001,52,40,12,14,-2
21701182,1627779,CHA,ORL,Marcus Paige,24,6.18333333333333,6,0.183333333333334,13,21,-8,-8,0
21701182,1628370,CHA,ORL,Malik Monk,121,26.3666666666667,26,0.366666666666667,83,56,27,23,4
21701183,2544,CLE,PHI,LeBron James,210,40.4,40,0.399999999999999,114,105,9,7,2
21701183,2594,CLE,PHI,Kyle Korver,96,19.35,19,0.350000000000001,50,55,-5,-2,-3
21701183,2747,CLE,PHI,JR Smith,156,30.3,30,0.299999999999997,81,83,-2,-2,0
21701183,201145,CLE,PHI,Jeff Green,202,41.0166666666667,41,0.0166666666666657,109,110,-1,3,-4
21701183,201567,CLE,PHI,Kevin Love,170,32.7833333333333,33,-0.216666666666669,98,86,12,12,0
21701183,202684,CLE,PHI,Tristan Thompson,36,6.23333333333333,6,0.233333333333333,18,19,-1,-3,2
21701183,203903,CLE,PHI,Jordan Clarkson,89,18.0333333333333,18,0.0333333333333314,44,54,-10,-8,-2
21701183,203918,CLE,PHI,Rodney Hood,64,12.2333333333333,12,0.233333333333334,28,45,-17,-19,2
21701183,1626204,CLE,PHI,Larry Nance Jr.,34,6.6,7,-0.4,10,24,-14,-15,1
21701183,1626224,CLE,PHI,Cedi Osman,163,32.9666666666667,33,-0.0333333333333314,98,79,19,17,2
21701183,101141,PHI,CLE,Ersan Ilyasova,142,28.95,29,-0.0500000000000007,78,71,7,4,3
21701183,101161,PHI,CLE,Amir Johnson,104,19.4333333333333,19,0.433333333333334,56,58,-2,-1,-1
21701183,200755,PHI,CLE,JJ Redick,166,31.85,32,-0.150000000000002,89,98,-9,-10,1
21701183,201158,PHI,CLE,Marco Belinelli,145,29.6333333333333,30,-0.366666666666667,81,76,5,2,3
21701183,203496,PHI,CLE,Robert Covington,184,35.8666666666667,36,-0.133333333333333,95,93,2,4,-2
21701183,203967,PHI,CLE,Dario Saric,130,25.15,25,0.149999999999999,68,70,-2,5,-7
21701183,204456,PHI,CLE,T.J. McConnell,28,5.7,5,0.699999999999999,19,11,8,2,6
21701183,1626158,PHI,CLE,Richaun Holmes,77,15.35,15,0.35,42,43,-1,2,-3
21701183,1627732,PHI,CLE,Ben Simmons,184,36.0833333333333,36,0.0833333333333286,95,98,-3,-3,0
21701183,1628365,PHI,CLE,Markelle Fultz,60,11.9,12,-0.100000000000001,37,32,5,5,0
21701184,203101,ATL,WAS,Miles Plumlee,47,9.75,9,0.75,23,22,1,-1,2
21701184,203473,ATL,WAS,Dewayne Dedmon,145,31.6666666666667,32,-0.333333333333336,66,57,9,13,-4
21701184,203488,ATL,WAS,Mike Muscala,117,24.5666666666667,24,0.566666666666666,58,52,6,6,0
21701184,1627752,ATL,WAS,Taurean Prince,150,34.0833333333333,34,0.0833333333333357,64,67,-3,-8,5
21701184,1627761,ATL,WAS,DeAndre' Bembry,76,16.6,17,-0.399999999999999,32,34,-2,-4,2
21701184,1627814,ATL,WAS,Damion Lee,124,25.9,26,-0.100000000000001,58,55,3,3,0
21701184,1627819,ATL,WAS,Isaiah Taylor,117,25.25,25,0.25,50,52,-2,2,-4
21701184,1628381,ATL,WAS,John Collins,139,29.8833333333333,31,-1.11666666666667,59,63,-4,-6,2
21701184,1628416,ATL,WAS,Tyler Dorsey,155,32.4333333333333,32,0.433333333333337,79,61,18,20,-2
21701184,1628499,ATL,WAS,Antonius Cleveland,50,9.53333333333333,9,0.533333333333333,26,22,4,5,-1
21701184,101162,WAS,ATL,Marcin Gortat,176,39.2166666666667,39,0.216666666666669,77,78,-1,1,-2
21701184,201160,WAS,ATL,Jason Smith,39,7.36666666666667,8,-0.633333333333333,16,23,-7,-7,0
21701184,201975,WAS,ATL,Jodie Meeks,48,9.65,10,-0.350000000000001,23,25,-2,-3,1
21701184,202693,WAS,ATL,Markieff Morris,34,7.7,8,-0.300000000000001,12,11,1,-1,2
21701184,203078,WAS,ATL,Bradley Beal,185,40.5,40,0.5,84,84,0,1,-1
21701184,203107,WAS,ATL,Tomas Satoransky,140,29.5,29,0.5,55,66,-11,-10,-1
21701184,203118,WAS,ATL,Mike Scott,109,22.0833333333333,22,0.0833333333333322,46,45,1,2,-1
21701184,203490,WAS,ATL,Otto Porter Jr.,153,33.8666666666667,34,-0.133333333333333,69,66,3,2,1
21701184,204025,WAS,ATL,Tim Frazier,84,18.4333333333333,19,-0.566666666666666,42,37,5,4,1
21701184,1626162,WAS,ATL,Kelly Oubre Jr.,152,31.35,31,0.349999999999998,61,80,-19,-19,0
21701185,202328,BOS,CHI,Greg Monroe,122,27.65,28,-0.350000000000001,60,57,3,4,-1
21701185,202694,BOS,CHI,Marcus Morris,120,25.4166666666667,26,-0.583333333333336,60,51,9,9,0
21701185,203382,BOS,CHI,Aron Baynes,87,17.9666666666667,18,-0.0333333333333314,42,41,1,0,1
21701185,203499,BOS,CHI,Shane Larkin,94,20.95,21,-0.0500000000000007,42,50,-8,-8,0
21701185,1626179,BOS,CHI,Terry Rozier,140,29.0166666666667,29,0.0166666666666657,73,58,15,15,0
21701185,1626780,BOS,CHI,Jonathan Gibson,38,9.05,9,0.0500000000000007,23,22,1,1,0
21701185,1627759,BOS,CHI,Jaylen Brown,142,29.7,30,-0.300000000000001,73,64,9,9,0
21701185,1627824,BOS,CHI,Guerschon Yabusele,123,24.3666666666667,25,-0.633333333333333,64,51,13,12,1
21701185,1627846,BOS,CHI,Abdel Nader,29,6.6,7,-0.4,10,19,-9,-9,0
21701185,1628400,BOS,CHI,Semi Ojeleye,109,23.5666666666667,24,-0.433333333333334,50,55,-5,-5,0
21701185,1628443,BOS,CHI,Kadeem Allen,2,0.133333333333333,0,0.133333333333333,,1,,-1,
21701185,1628444,BOS,CHI,Jabari Bird,114,24.1666666666667,24,0.166666666666664,58,51,7,8,-1
21701185,201600,CHI,BOS,Omer Asik,69,16.1,16,0.100000000000001,34,35,-1,-4,3
21701185,203200,CHI,BOS,Justin Holiday,144,29.8666666666667,30,-0.133333333333333,63,77,-14,-14,0
21701185,203930,CHI,BOS,Sean Kilpatrick,114,24.7166666666667,25,-0.283333333333335,57,54,3,3,0
21701185,1626166,CHI,BOS,Cameron Payne,105,22.1333333333333,22,0.133333333333333,43,57,-14,-14,0
21701185,1626170,CHI,BOS,Jerian Grant,133,28.5166666666667,28,0.516666666666666,62,65,-3,-3,0
21701185,1626171,CHI,BOS,Bobby Portis,62,14.2,14,0.199999999999999,33,27,6,6,0
21701185,1626245,CHI,BOS,Cristiano Felicio,137,28.5,29,-0.5,59,70,-11,-8,-3
21701185,1627853,CHI,BOS,Ryan Arcidiacono,119,25.5833333333333,26,-0.416666666666664,61,54,7,7,0
21701185,1628021,CHI,BOS,David Nwaba,122,25.7833333333333,26,-0.216666666666669,56,63,-7,-7,0
21701185,1628374,CHI,BOS,Lauri Markkanen,115,23.1833333333333,23,0.183333333333334,52,53,-1,-1,0
21701186,2548,MIA,NYK,Dwyane Wade,83,19.1833333333333,19,0.183333333333334,35,53,-18,-15,-3
21701186,201609,MIA,NYK,Goran Dragic,121,23.4,24,-0.600000000000001,54,67,-13,-13,0
21701186,201949,MIA,NYK,James Johnson,120,23.2,23,0.199999999999999,51,59,-8,-11,3
21701186,201961,MIA,NYK,Wayne Ellington,128,28.35,29,-0.649999999999999,51,64,-13,-13,0
21701186,202337,MIA,NYK,Luke Babbitt,28,6.36666666666667,7,-0.633333333333333,12,6,6,4,2
21701186,202355,MIA,NYK,Hassan Whiteside,85,17.15,18,-0.850000000000001,38,48,-10,-10,0
21701186,203482,MIA,NYK,Kelly Olynyk,82,18.1166666666667,18,0.116666666666667,34,50,-16,-12,-4
21701186,203585,MIA,NYK,Rodney McGruder,100,22.05,22,0.0499999999999972,42,54,-12,-12,0
21701186,204020,MIA,NYK,Tyler Johnson,128,26.1833333333333,27,-0.81666666666667,55,62,-7,-5,-2
21701186,1626159,MIA,NYK,Justise Winslow,98,22.1833333333333,22,0.183333333333334,44,62,-18,-17,-1
21701186,1626196,MIA,NYK,Josh Richardson,98,19.75,19,0.75,48,61,-13,-14,1
21701186,1628389,MIA,NYK,Bam Adebayo,59,12.4,12,0.399999999999999,26,24,2,-2,4
21701186,101127,NYK,MIA,Jarrett Jack,49,11.6666666666667,12,-0.333333333333334,26,20,6,6,0
21701186,201584,NYK,MIA,Courtney Lee,130,29.25,29,0.25,69,58,11,12,-1
21701186,203124,NYK,MIA,Kyle O'Quinn,113,21.7333333333333,22,-0.266666666666666,61,49,12,10,2
21701186,203501,NYK,MIA,Tim Hardaway Jr.,145,29.6,29,0.600000000000001,83,61,22,24,-2
21701186,203504,NYK,MIA,Trey Burke,150,30.0166666666667,30,0.0166666666666657,77,69,8,8,0
21701186,1626144,NYK,MIA,Emmanuel Mudiay,34,7.68333333333333,8,-0.316666666666666,21,13,8,8,0
21701186,1628373,NYK,MIA,Frank Ntilikina,156,31.9833333333333,32,-0.0166666666666657,82,67,15,12,3
21701186,1628422,NYK,MIA,Damyean Dotson,169,35.6333333333333,36,-0.366666666666667,90,71,19,21,-2
21701186,1628436,NYK,MIA,Luke Kornet,94,21.8,22,-0.200000000000003,59,41,18,20,-2
21701186,1628439,NYK,MIA,Isaiah Hicks,90,18.9666666666667,19,-0.0333333333333314,42,41,1,-1,2
21701187,2744,IND,TOR,Al Jefferson,35,7.98333333333333,8,-0.0166666666666666,14,16,-2,0,-2
21701187,201152,IND,TOR,Thaddeus Young,84,17.0333333333333,17,0.033333333333335,18,32,-14,-14,0
21701187,201954,IND,TOR,Darren Collison,121,24.5666666666667,25,-0.433333333333334,30,42,-12,-12,0
21701187,202344,IND,TOR,Trevor Booker,92,20.6333333333333,21,-0.366666666666667,39,35,4,4,0
21701187,202362,IND,TOR,Lance Stephenson,122,25.8333333333333,27,-1.16666666666667,47,54,-7,-5,-2
21701187,202709,IND,TOR,Cory Joseph,104,23.0333333333333,23,0.0333333333333314,41,43,-2,-2,0
21701187,202711,IND,TOR,Bojan Bogdanovic,82,16.9666666666667,17,-0.0333333333333314,16,32,-16,-16,0
21701187,203506,IND,TOR,Victor Oladipo,104,20.9833333333333,21,-0.0166666666666657,20,43,-23,-23,0
21701187,203922,IND,TOR,Glenn Robinson III,85,19.9166666666667,20,-0.0833333333333357,41,42,-1,-3,2
21701187,1626167,IND,TOR,Myles Turner,109,22.1666666666667,22,0.166666666666664,21,48,-27,-27,0
21701187,1626202,IND,TOR,Joe Young,54,11.65,12,-0.35,24,20,4,4,0
21701187,1627734,IND,TOR,Domantas Sabonis,100,21.45,21,0.449999999999999,40,39,1,-1,2
21701187,1628388,IND,TOR,TJ Leaf,28,6.03333333333333,6,0.0333333333333332,14,14,0,0,0
21701187,101139,TOR,IND,CJ Miles,84,18.2666666666667,19,-0.733333333333334,26,37,-11,-11,0
21701187,200768,TOR,IND,Kyle Lowry,133,28.1833333333333,28,0.18333333333333,58,33,25,25,0
21701187,201586,TOR,IND,Serge Ibaka,126,26.8666666666667,27,-0.133333333333333,56,31,25,25,0
21701187,201942,TOR,IND,DeMar DeRozan,131,27.7833333333333,28,-0.216666666666669,62,28,34,32,2
21701187,202685,TOR,IND,Jonas Valanciunas,104,21.45,22,-0.550000000000001,40,24,16,16,0
21701187,203512,TOR,IND,Lucas Nogueira,35,7.98333333333333,8,-0.0166666666666666,16,14,2,0,2
21701187,1626153,TOR,IND,Delon Wright,98,21.05,21,0.0499999999999972,35,46,-11,-9,-2
21701187,1626181,TOR,IND,Norman Powell,62,13.4833333333333,14,-0.516666666666666,32,29,3,3,0
21701187,1627751,TOR,IND,Jakob Poeltl,85,18.2166666666667,18,0.216666666666669,36,35,1,3,-2
21701187,1627783,TOR,IND,Pascal Siakam,98,20.7833333333333,21,-0.216666666666669,36,42,-6,-6,0
21701187,1627832,TOR,IND,Fred VanVleet,67,14.5166666666667,14,0.516666666666666,22,28,-6,-6,0
21701187,1628384,TOR,IND,OG Anunoby,97,19.6666666666667,20,-0.333333333333332,41,18,23,23,0
21701188,1713,SAC,MEM,Vince Carter,60,13.3166666666667,13,0.316666666666666,24,27,-3,-1,-2
21701188,203960,SAC,MEM,JaKarr Sampson,113,24.9,25,-0.100000000000001,47,36,11,11,0
21701188,203992,SAC,MEM,Bogdan Bogdanovic,126,29.5833333333333,30,-0.416666666666664,55,56,-1,-4,3
21701188,204022,SAC,MEM,Jack Cooley,71,14.9833333333333,15,-0.0166666666666657,33,35,-2,-1,-1
21701188,1626161,SAC,MEM,Willie Cauley-Stein,147,33.0166666666667,33,0.0166666666666657,61,58,3,2,1
21701188,1627741,SAC,MEM,Buddy Hield,165,34.4166666666667,34,0.416666666666671,71,75,-4,-4,0
21701188,1628368,SAC,MEM,De'Aaron Fox,151,33.2833333333333,33,0.283333333333331,61,63,-2,-2,0
21701188,1628382,SAC,MEM,Justin Jackson,128,29.8166666666667,30,-0.183333333333334,63,56,7,5,2
21701188,1628412,SAC,MEM,Frank Mason,56,11.4166666666667,12,-0.583333333333334,24,24,0,3,-3
21701188,1628502,SAC,MEM,Nigel Hayes,73,15.2666666666667,16,-0.733333333333334,31,35,-4,-4,0
21701188,201596,MEM,SAC,Mario Chalmers,91,17.9666666666667,18,-0.0333333333333314,41,34,7,4,3
21701188,202705,MEM,SAC,MarShon Brooks,162,36.7,37,-0.299999999999997,72,67,5,5,0
21701188,203463,MEM,SAC,Ben McLemore,124,27,27,0,42,60,-18,-18,0
21701188,204179,MEM,SAC,Omari Johnson,74,16.1333333333333,16,0.133333333333333,27,33,-6,-7,1
21701188,1627738,MEM,SAC,Deyonta Davis,128,27.2166666666667,27,0.216666666666665,50,56,-6,-8,2
21701188,1627988,MEM,SAC,Myke Henry,105,22.4666666666667,22,0.466666666666665,47,46,1,3,-2
21701188,1628397,MEM,SAC,Ivan Rabb,142,31.5333333333333,31,0.533333333333335,72,59,13,14,-1
21701188,1628415,MEM,SAC,Dillon Brooks,148,34.4333333333333,35,-0.566666666666663,69,62,7,7,0
21701188,1628424,MEM,SAC,Kobi Simmons,116,26.55,27,-0.450000000000003,45,53,-8,-5,-3
21701189,2731,NOP,PHX,Emeka Okafor,32,5.71666666666667,6,-0.283333333333333,20,20,0,0,0
21701189,200765,NOP,PHX,Rajon Rondo,119,24.5833333333333,25,-0.416666666666664,45,46,-1,-3,2
21701189,201950,NOP,PHX,Jrue Holiday,167,31.7666666666667,32,-0.233333333333334,88,57,31,33,-2
21701189,202348,NOP,PHX,Jordan Crawford,54,9,9,0,32,30,2,0,2
21701189,202703,NOP,PHX,Nikola Mirotic,184,34.75,35,-0.25,98,69,29,27,2
21701189,202732,NOP,PHX,DeAndre Liggins,32,6.45,7,-0.55,13,23,-10,-9,-1
21701189,202734,NOP,PHX,E'Twaun Moore,121,24.1166666666667,25,-0.883333333333333,51,37,14,16,-2
21701189,203076,NOP,PHX,Anthony Davis,179,34.15,34,0.149999999999999,90,58,32,28,4
21701189,203121,NOP,PHX,Darius Miller,164,31.8,31,0.799999999999997,84,73,11,14,-3
21701189,203524,NOP,PHX,Solomon Hill,85,16.3166666666667,16,0.316666666666666,47,41,6,4,2
21701189,1627767,NOP,PHX,Cheick Diallo,85,17.1166666666667,17,0.116666666666667,34,48,-14,-10,-4
21701189,1628429,NOP,PHX,Charles Cooke,18,3.31666666666667,4,-0.683333333333334,8,13,-5,-5,0
21701189,201162,PHX,NOP,Jared Dudley,28,6.11666666666667,6,0.116666666666667,13,10,3,3,0
21701189,203458,PHX,NOP,Alex Len,107,19.5166666666667,19,0.516666666666666,49,64,-15,-17,2
21701189,1627733,PHX,NOP,Dragan Bender,162,32.3833333333333,33,-0.616666666666667,60,75,-15,-13,-2
21701189,1627737,PHX,NOP,Marquese Chriss,137,26.15,26,0.149999999999999,47,62,-15,-13,-2
21701189,1627755,PHX,NOP,Tyler Ulis,158,30.15,30,0.149999999999999,55,81,-26,-28,2
21701189,1627863,PHX,NOP,Danuel House Jr.,181,35.2166666666667,35,0.216666666666669,74,92,-18,-21,3
21701189,1627885,PHX,NOP,Shaquille Harrison,153,29.65,30,-0.350000000000001,78,78,0,1,-1
21701189,1628367,PHX,NOP,Josh Jackson,158,29.8,30,-0.199999999999999,57,75,-18,-17,-1
21701189,1628409,PHX,NOP,Alec Peters,62,11.4666666666667,11,0.466666666666667,37,33,4,2,2
21701189,1628432,PHX,NOP,Davon Reed,94,18.6333333333333,19,-0.366666666666667,45,40,5,8,-3
21701190,101112,LAL,MIN,Channing Frye,76,14.3333333333333,15,-0.666666666666668,27,34,-7,-7,0
21701190,201572,LAL,MIN,Brook Lopez,122,24.3666666666667,24,0.366666666666667,48,60,-12,-14,2
21701190,203484,LAL,MIN,Kentavious Caldwell-Pope,173,34.8666666666667,35,-0.133333333333333,69,87,-18,-19,1
21701190,203898,LAL,MIN,Tyler Ennis,121,23.8666666666667,24,-0.133333333333333,47,50,-3,-1,-2
21701190,203944,LAL,MIN,Julius Randle,161,32.7,33,-0.299999999999997,67,81,-14,-14,0
21701190,204037,LAL,MIN,Travis Wear,37,7.93333333333333,8,-0.0666666666666664,14,21,-7,-7,0
21701190,1627780,LAL,MIN,Gary Payton II,64,12,12,0,30,30,0,0,0
21701190,1627826,LAL,MIN,Ivica Zubac,109,21.55,22,-0.449999999999999,43,46,-3,-1,-2
21701190,1627936,LAL,MIN,Alex Caruso,64,14.4,14,0.399999999999999,25,37,-12,-12,0
21701190,1628398,LAL,MIN,Kyle Kuzma,90,18.0333333333333,18,0.0333333333333314,36,40,-4,-2,-2
21701190,1628404,LAL,MIN,Josh Hart,168,31.95,32,-0.0500000000000007,67,74,-7,-10,3
21701190,1628418,LAL,MIN,Thomas Bryant,10,2.41666666666667,3,-0.583333333333334,7,5,2,2,0
21701190,2037,MIN,LAL,Jamal Crawford,141,26.35,27,-0.649999999999999,58,62,-4,-4,0
21701190,201565,MIN,LAL,Derrick Rose,34,5.73333333333333,6,-0.266666666666668,8,15,-7,-7,0
21701190,201952,MIN,LAL,Jeff Teague,163,33.4333333333333,33,0.43333333333333,83,68,15,15,0
21701190,201959,MIN,LAL,Taj Gibson,161,33.3,33,0.299999999999997,85,66,19,19,0
21701190,202332,MIN,LAL,Cole Aldrich,6,1.18333333333333,1,0.183333333333333,3,5,-2,-2,0
21701190,202357,MIN,LAL,Nemanja Bjelica,94,19.5666666666667,19,0.566666666666666,47,30,17,17,0
21701190,202710,MIN,LAL,Jimmy Butler,109,22.05,23,-0.950000000000003,54,42,12,10,2
21701190,203476,MIN,LAL,Gorgui Dieng,78,13.35,13,0.35,24,35,-11,-11,0
21701190,203952,MIN,LAL,Andrew Wiggins,178,36.05,36,0.0499999999999972,87,73,14,16,-2
21701190,1626145,MIN,LAL,Tyus Jones,76,14.25,15,-0.75,30,28,2,2,0
21701190,1626157,MIN,LAL,Karl-Anthony Towns,155,33.15,33,0.149999999999999,86,56,30,30,0
21701191,2734,DEN,LAC,Devin Harris,113,22.7,23,-0.300000000000001,66,63,3,3,0
21701191,200794,DEN,LAC,Paul Millsap,138,29.7833333333333,30,-0.216666666666669,81,70,11,13,-2
21701191,201163,DEN,LAC,Wilson Chandler,133,30.7166666666667,31,-0.283333333333335,81,64,17,18,-1
21701191,203115,DEN,LAC,Will Barton,142,31.5166666666667,32,-0.483333333333334,86,74,12,10,2
21701191,203486,DEN,LAC,Mason Plumlee,76,14.45,15,-0.550000000000001,44,39,5,5,0
21701191,203999,DEN,LAC,Nikola Jokic,157,34.5166666666667,34,0.516666666666666,95,84,11,11,0
21701191,1626168,DEN,LAC,Trey Lyles,73,16.2166666666667,17,-0.783333333333331,48,35,13,9,4
21701191,1627736,DEN,LAC,Malik Beasley,6,1.23333333333333,2,-0.766666666666667,3,2,1,1,0
21701191,1627750,DEN,LAC,Jamal Murray,185,39.95,40,-0.0499999999999972,113,91,22,24,-2
21701191,1627823,DEN,LAC,Juancho Hernangomez,6,1.23333333333333,2,-0.766666666666667,3,2,1,1,0
21701191,1628470,DEN,LAC,Torrey Craig,81,15.1,15,0.0999999999999996,50,46,4,0,4
21701191,101150,LAC,DEN,Lou Williams,152,31.6666666666667,31,0.666666666666664,83,88,-5,-7,2
21701191,201599,LAC,DEN,DeAndre Jordan,160,35.95,36,-0.0499999999999972,78,98,-20,-17,-3
21701191,202325,LAC,DEN,Wesley Johnson,71,16.8666666666667,17,-0.133333333333333,31,42,-11,-11,0
21701191,202699,LAC,DEN,Tobias Harris,171,36.45,37,-0.549999999999997,85,106,-21,-20,-1
21701191,203085,LAC,DEN,Austin Rivers,180,39.7166666666667,39,0.716666666666669,92,113,-21,-19,-2
21701191,203710,LAC,DEN,C.J. Williams,18,3.51666666666667,4,-0.483333333333333,10,10,0,1,-1
21701191,1626149,LAC,DEN,Montrezl Harrell,93,19.8166666666667,20,-0.183333333333334,54,54,0,-6,6
21701191,1626155,LAC,DEN,Sam Dekker,18,3.51666666666667,4,-0.483333333333333,10,10,0,1,-1
21701191,1626246,LAC,DEN,Boban Marjanovic,48,9.08333333333333,10,-0.916666666666668,27,29,-2,-1,-1
21701191,1627820,LAC,DEN,Tyrone Wallace,128,27.4833333333333,28,-0.516666666666666,62,80,-18,-13,-5
21701191,1628414,LAC,DEN,Sindarius Thornwell,71,13.35,14,-0.649999999999999,38,40,-2,-3,1
21701192,1891,MIL,NYK,Jason Terry,104,21.8,22,-0.200000000000003,54,40,14,14,0
21701192,201943,MIL,NYK,Brandon Jennings,77,16.6833333333333,17,-0.316666666666666,36,37,-1,-2,1
21701192,202339,MIL,NYK,Eric Bledsoe,145,31.1166666666667,31,0.116666666666667,79,65,14,15,-1
21701192,203089,MIL,NYK,John Henson,142,30.7333333333333,31,-0.266666666666666,74,68,6,6,0
21701192,203092,MIL,NYK,Tyler Zeller,80,17.0666666666667,17,0.0666666666666664,41,34,7,7,0
21701192,203114,MIL,NYK,Khris Middleton,171,35.7,36,-0.299999999999997,92,75,17,17,0
21701192,203503,MIL,NYK,Tony Snell,144,31.0833333333333,31,0.0833333333333357,73,70,3,3,0
21701192,203953,MIL,NYK,Jabari Parker,168,37.3333333333333,38,-0.666666666666671,91,76,15,13,2
21701192,1627748,MIL,NYK,Thon Maker,79,17.4833333333333,17,0.483333333333334,35,45,-10,-8,-2
21701192,101127,NYK,MIL,Jarrett Jack,120,25.7,26,-0.300000000000001,57,55,2,0,2
21701192,201563,NYK,MIL,Michael Beasley,108,22.8166666666667,23,-0.183333333333334,47,63,-16,-18,2
21701192,201584,NYK,MIL,Courtney Lee,128,27.25,27,0.25,51,72,-21,-19,-2
21701192,202498,NYK,MIL,Lance Thomas,42,8.88333333333333,9,-0.116666666666667,21,15,6,6,0
21701192,203124,NYK,MIL,Kyle O'Quinn,135,29.0666666666667,30,-0.933333333333334,62,73,-11,-12,1
21701192,203504,NYK,MIL,Trey Burke,140,30.6166666666667,31,-0.383333333333333,69,81,-12,-12,0
21701192,1628373,NYK,MIL,Frank Ntilikina,139,30.0666666666667,30,0.0666666666666664,66,72,-6,-6,0
21701192,1628422,NYK,MIL,Damyean Dotson,139,29.7666666666667,30,-0.233333333333334,63,65,-2,-2,0
21701192,1628436,NYK,MIL,Luke Kornet,87,18.7333333333333,18,0.733333333333334,40,42,-2,-1,-1
21701192,1628439,NYK,MIL,Isaiah Hicks,72,16.1,16,0.100000000000001,34,37,-3,-1,-2
21701193,201600,CHI,BKN,Omer Asik,63,13.1,13,0.0999999999999996,30,39,-9,-10,1
21701193,203200,CHI,BKN,Justin Holiday,153,32.1,32,0.100000000000001,64,82,-18,-20,2
21701193,203930,CHI,BKN,Sean Kilpatrick,101,22.3,22,0.299999999999997,43,54,-11,-9,-2
21701193,1626166,CHI,BKN,Cameron Payne,124,25.6666666666667,26,-0.333333333333336,62,68,-6,-8,2
21701193,1626170,CHI,BKN,Jerian Grant,139,28.35,28,0.350000000000001,58,76,-18,-18,0
21701193,1626171,CHI,BKN,Bobby Portis,142,30.5833333333333,31,-0.416666666666664,61,75,-14,-15,1
21701193,1626245,CHI,BKN,Cristiano Felicio,163,34.6333333333333,35,-0.366666666666667,66,85,-19,-18,-1
21701193,1627853,CHI,BKN,Ryan Arcidiacono,102,22.0666666666667,22,0.0666666666666629,34,56,-22,-20,-2
21701193,1628021,CHI,BKN,David Nwaba,143,29.8666666666667,30,-0.133333333333333,62,85,-23,-22,-1
21701193,201967,BKN,CHI,Dante Cunningham,103,22.3833333333333,22,0.383333333333333,56,46,10,10,0
21701193,202389,BKN,CHI,Timofey Mozgov,31,6.48333333333333,7,-0.516666666666667,15,7,8,8,0
21701193,203112,BKN,CHI,Quincy Acy,110,23.1166666666667,23,0.116666666666667,58,45,13,11,2
21701193,203459,BKN,CHI,Allen Crabbe,105,21.3833333333333,22,-0.616666666666667,62,46,16,16,0
21701193,203915,BKN,CHI,Spencer Dinwiddie,127,28.8,29,-0.200000000000003,65,63,2,1,1
21701193,203917,BKN,CHI,Nik Stauskas,45,8.38333333333333,8,0.383333333333333,22,14,8,8,0
21701193,203925,BKN,CHI,Joe Harris,137,29,29,0,80,58,22,22,0
21701193,1626156,BKN,CHI,D'Angelo Russell,109,22.9333333333333,23,-0.0666666666666664,61,49,12,14,-2
21701193,1626178,BKN,CHI,Rondae Hollis-Jefferson,108,22.65,23,-0.350000000000001,61,49,12,14,-2
21701193,1627747,BKN,CHI,Caris LeVert,115,24.3833333333333,24,0.383333333333333,64,43,21,18,3
21701193,1628386,BKN,CHI,Jarrett Allen,100,20.8333333333333,21,-0.166666666666668,58,45,13,13,0
21701193,1628495,BKN,CHI,Milton Doyle,40,8.31666666666667,8,0.316666666666666,18,15,3,5,-2
21701194,2207,HOU,OKC,Joe Johnson,71,15.8666666666667,16,-0.133333333333333,29,40,-11,-11,0
21701194,2403,HOU,OKC,Nene,58,13.3666666666667,14,-0.633333333333333,29,26,3,1,2
21701194,2772,HOU,OKC,Trevor Ariza,158,31.9333333333333,32,-0.06666666666667,73,68,5,5,0
21701194,101108,HOU,OKC,Chris Paul,167,34.75,35,-0.25,78,77,1,3,-2
21701194,101123,HOU,OKC,Gerald Green,125,27.8166666666667,28,-0.18333333333333,54,71,-17,-19,2
21701194,200782,HOU,OKC,PJ Tucker,137,27.8333333333333,28,-0.166666666666664,61,60,1,3,-2
21701194,201601,HOU,OKC,Luc Mbah a Moute,117,24.8166666666667,25,-0.183333333333334,53,63,-10,-9,-1
21701194,201935,HOU,OKC,James Harden,177,36.2166666666667,36,0.216666666666669,79,77,2,2,0
21701194,203991,HOU,OKC,Clint Capela,135,26.4,26,0.399999999999999,54,58,-4,-5,1
21701194,2546,OKC,HOU,Carmelo Anthony,171,34.4,35,-0.600000000000001,71,78,-7,-7,0
21701194,101109,OKC,HOU,Raymond Felton,65,14.6833333333333,15,-0.316666666666666,44,32,12,13,-1
21701194,201147,OKC,HOU,Corey Brewer,116,22.55,23,-0.450000000000003,49,51,-2,-5,3
21701194,201566,OKC,HOU,Russell Westbrook,184,37.9,38,-0.100000000000001,84,79,5,3,2
21701194,202331,OKC,HOU,Paul George,195,40.7166666666667,41,-0.283333333333331,88,89,-1,3,-4
21701194,202335,OKC,HOU,Patrick Patterson,54,13.0333333333333,13,0.0333333333333332,35,21,14,14,0
21701194,203500,OKC,HOU,Steven Adams,136,28.6,29,-0.399999999999999,58,63,-5,-4,-1
21701194,203518,OKC,HOU,Alex Abrines,127,27.55,27,0.549999999999997,59,55,4,6,-2
21701194,203924,OKC,HOU,Jerami Grant,97,19.5666666666667,20,-0.433333333333334,52,42,10,7,3
21701195,200765,NOP,GSW,Rajon Rondo,148,32.1833333333333,32,0.18333333333333,96,75,21,21,0
21701195,201950,NOP,GSW,Jrue Holiday,185,40.35,40,0.350000000000001,107,104,3,3,0
21701195,202703,NOP,GSW,Nikola Mirotic,188,39.7833333333333,40,-0.216666666666669,111,104,7,7,0
21701195,202734,NOP,GSW,E'Twaun Moore,165,36.5166666666667,37,-0.483333333333334,93,97,-4,-5,1
21701195,203076,NOP,GSW,Anthony Davis,185,39.9,40,-0.0999999999999943,103,101,2,2,0
21701195,203121,NOP,GSW,Darius Miller,119,24.9666666666667,25,-0.0333333333333314,61,57,4,5,-1
21701195,203524,NOP,GSW,Solomon Hill,72,15.5333333333333,15,0.533333333333333,29,39,-10,-10,0
21701195,1627767,NOP,GSW,Cheick Diallo,48,10.5166666666667,11,-0.483333333333334,30,23,7,7,0
21701195,2561,GSW,NOP,David West,64,13.1833333333333,13,0.183333333333334,32,41,-9,-9,0
21701195,2738,GSW,NOP,Andre Iguodala,99,21.55,22,-0.449999999999999,47,41,6,5,1
21701195,201142,GSW,NOP,Kevin Durant,163,35.9166666666667,36,-0.0833333333333286,91,90,1,1,0
21701195,201156,GSW,NOP,Nick Young,99,20.4333333333333,21,-0.56666666666667,44,61,-17,-21,4
21701195,202691,GSW,NOP,Klay Thompson,172,37.4166666666667,37,0.416666666666671,99,99,0,4,-4
21701195,203110,GSW,NOP,Draymond Green,170,37.05,37,0.0499999999999972,98,103,-5,-4,-1
21701195,1626172,GSW,NOP,Kevon Looney,119,27.3333333333333,28,-0.666666666666664,72,75,-3,-2,-1
21701195,1626188,GSW,NOP,Quinn Cook,178,37.1666666666667,37,0.166666666666671,100,102,-2,-2,0
21701195,1627745,GSW,NOP,Damian Jones,23,4.73333333333333,5,-0.266666666666667,11,6,5,5,0
21701195,1628395,GSW,NOP,Jordan Bell,23,4.96666666666667,5,-0.0333333333333332,6,12,-6,-7,1
21701196,202323,POR,SAS,Evan Turner,142,31.4833333333333,32,-0.516666666666666,68,80,-12,-11,-1
21701196,202329,POR,SAS,Al-Farouq Aminu,148,33.5333333333333,33,0.533333333333331,72,83,-11,-9,-2
21701196,203081,POR,SAS,Damian Lillard,157,35.0166666666667,35,0.0166666666666657,78,93,-15,-18,3
21701196,203086,POR,SAS,Meyers Leonard,55,11.85,13,-1.15,28,27,1,2,-1
21701196,203468,POR,SAS,CJ McCollum,168,36.3666666666667,37,-0.633333333333333,77,86,-9,-11,2
21701196,203894,POR,SAS,Shabazz Napier,90,21.3166666666667,21,0.316666666666666,45,46,-1,0,-1
21701196,203994,POR,SAS,Jusuf Nurkic,134,29.8833333333333,30,-0.116666666666667,61,76,-15,-14,-1
21701196,1626192,POR,SAS,Pat Connaughton,52,12.6166666666667,13,-0.383333333333333,32,31,1,4,-3
21701196,1627735,POR,SAS,Wade Baldwin IV,31,7.03333333333333,7,0.0333333333333332,19,12,7,5,2
21701196,1628380,POR,SAS,Zach Collins,83,18.9833333333333,20,-1.01666666666667,45,46,-1,-3,2
21701196,1938,SAS,POR,Manu Ginobili,85,19.2833333333333,19,0.283333333333331,43,42,1,3,-2
21701196,2200,SAS,POR,Pau Gasol,119,25.6,26,-0.399999999999999,53,59,-6,-9,3
21701196,2225,SAS,POR,Tony Parker,49,11.9166666666667,12,-0.0833333333333339,24,28,-4,-3,-1
21701196,200746,SAS,POR,LaMarcus Aldridge,168,37.55,38,-0.450000000000003,97,80,17,18,-1
21701196,200752,SAS,POR,Rudy Gay,114,26.6333333333333,27,-0.366666666666667,68,56,12,16,-4
21701196,201980,SAS,POR,Danny Green,59,13.6,13,0.6,32,30,2,1,1
21701196,201988,SAS,POR,Patty Mills,147,32.1166666666667,32,0.116666666666667,86,69,17,16,1
21701196,202722,SAS,POR,Davis Bertans,4,0.733333333333333,1,-0.266666666666667,5,4,1,-1,2
21701196,203464,SAS,POR,Brandon Paul,4,0.733333333333333,1,-0.266666666666667,5,4,1,-1,2
21701196,203530,SAS,POR,Joffrey Lauvergne,2,0.5,1,-0.5,3,2,1,1,0
21701196,203937,SAS,POR,Kyle Anderson,130,28.2,28,0.200000000000003,70,60,10,12,-2
21701196,1627749,SAS,POR,Dejounte Murray,125,28.4,29,-0.600000000000001,71,58,13,11,2
21701196,1627854,SAS,POR,Bryn Forbes,54,12.8166666666667,13,-0.183333333333334,23,33,-10,-9,-1
21701197,201152,IND,CHA,Thaddeus Young,81,17.1833333333333,17,0.183333333333334,37,37,0,0,0
21701197,201954,IND,CHA,Darren Collison,100,20.3833333333333,21,-0.616666666666667,49,46,3,3,0
21701197,202344,IND,CHA,Trevor Booker,88,19.05,19,0.0499999999999972,58,41,17,19,-2
21701197,202362,IND,CHA,Lance Stephenson,135,27.3833333333333,27,0.383333333333333,75,66,9,9,0
21701197,202709,IND,CHA,Cory Joseph,143,28.8166666666667,29,-0.183333333333334,78,73,5,5,0
21701197,202711,IND,CHA,Bojan Bogdanovic,162,31.2833333333333,31,0.283333333333331,74,84,-10,-8,-2
21701197,203506,IND,CHA,Victor Oladipo,138,27.3,27,0.299999999999997,70,71,-1,2,-3
21701197,203922,IND,CHA,Glenn Robinson III,118,23.95,24,-0.0500000000000007,63,59,4,1,3
21701197,1626167,IND,CHA,Myles Turner,35,6.6,7,-0.4,15,16,-1,-4,3
21701197,1627734,IND,CHA,Domantas Sabonis,185,37.9666666666667,38,-0.0333333333333314,96,92,4,3,1
21701197,2730,CHA,IND,Dwight Howard,114,23.0166666666667,23,0.0166666666666657,53,56,-3,-3,0
21701197,101107,CHA,IND,Marvin Williams,109,22.0833333333333,22,0.0833333333333357,53,53,0,-1,1
21701197,201587,CHA,IND,Nicolas Batum,110,22.2666666666667,22,0.266666666666666,55,53,2,2,0
21701197,202689,CHA,IND,Kemba Walker,125,25.55,25,0.549999999999997,59,66,-7,-9,2
21701197,202933,CHA,IND,Julyan Stone,100,19.7333333333333,20,-0.266666666666666,54,51,3,5,-2
21701197,203077,CHA,IND,Michael Kidd-Gilchrist,129,26.5333333333333,27,-0.466666666666669,61,66,-5,-5,0
21701197,203087,CHA,IND,Jeremy Lamb,105,22.3,22,0.300000000000001,45,63,-18,-18,0
21701197,1626163,CHA,IND,Frank Kaminsky,131,26.7166666666667,26,0.716666666666665,66,72,-6,-7,1
21701197,1626195,CHA,IND,Willy Hernangomez,120,24.15,24,0.149999999999999,62,65,-3,-1,-2
21701197,1627779,CHA,IND,Marcus Paige,22,3.41666666666667,3,0.416666666666667,17,7,10,10,0
21701197,1628370,CHA,IND,Malik Monk,120,24.15,24,0.149999999999999,60,63,-3,-3,0
21701198,203084,DAL,PHI,Harrison Barnes,189,42.6333333333333,43,-0.366666666666667,89,90,-1,0,-1
21701198,203926,DAL,PHI,Doug McDermott,120,25.6833333333333,26,-0.316666666666666,54,66,-12,-12,0
21701198,203939,DAL,PHI,Dwight Powell,158,35.35,35,0.350000000000001,78,75,3,4,-1
21701198,1627812,DAL,PHI,Yogi Ferrell,120,24.75,25,-0.25,53,64,-11,-10,-1
21701198,1627827,DAL,PHI,Dorian Finney-Smith,123,26.3,26,0.299999999999997,45,55,-10,-10,0
21701198,1627858,DAL,PHI,Kyle Collinsworth,43,7.93333333333333,8,-0.0666666666666664,16,20,-4,-4,0
21701198,1628372,DAL,PHI,Dennis Smith Jr.,179,39.85,40,-0.149999999999999,80,89,-9,-8,-1
21701198,1628405,DAL,PHI,Johnathan Motley,73,16.3833333333333,16,0.383333333333333,29,30,-1,-1,0
21701198,1628467,DAL,PHI,Maxi Kleber,105,20.0333333333333,20,0.0333333333333314,36,56,-20,-19,-1
21701198,101141,PHI,DAL,Ersan Ilyasova,122,24.2666666666667,24,0.266666666666666,55,52,3,1,2
21701198,101161,PHI,DAL,Amir Johnson,75,16.5833333333333,17,-0.416666666666664,40,27,13,14,-1
21701198,200755,PHI,DAL,JJ Redick,140,30.7666666666667,31,-0.233333333333334,74,67,7,8,-1
21701198,201158,PHI,DAL,Marco Belinelli,130,27.3666666666667,27,0.366666666666667,67,55,12,9,3
21701198,203496,PHI,DAL,Robert Covington,158,33.95,34,-0.0500000000000043,73,50,23,23,0
21701198,203967,PHI,DAL,Dario Saric,115,26.2166666666667,27,-0.783333333333331,59,45,14,15,-1
21701198,204456,PHI,DAL,T.J. McConnell,8,2.21666666666667,2,0.216666666666667,3,9,-6,-6,0
21701198,1626147,PHI,DAL,Justin Anderson,8,2.21666666666667,2,0.216666666666667,3,9,-6,-6,0
21701198,1626158,PHI,DAL,Richaun Holmes,107,21.5666666666667,21,0.566666666666666,50,51,-1,-3,2
21701198,1627732,PHI,DAL,Ben Simmons,133,30.55,31,-0.450000000000003,68,54,14,15,-1
21701198,1627788,PHI,DAL,Furkan Korkmaz,8,2.21666666666667,2,0.216666666666667,3,9,-6,-6,0
21701198,1628365,PHI,DAL,Markelle Fultz,106,21,21,0,50,52,-2,-4,2
21701199,201188,MEM,DET,Marc Gasol,163,34.1333333333333,35,-0.866666666666667,88,94,-6,-4,-2
21701199,201596,MEM,DET,Mario Chalmers,80,16.4,16,0.399999999999999,36,43,-7,-7,0
21701199,202705,MEM,DET,MarShon Brooks,115,25.25,26,-0.75,79,55,24,24,0
21701199,203463,MEM,DET,Ben McLemore,111,22.4833333333333,22,0.483333333333334,51,61,-10,-11,1
21701199,204179,MEM,DET,Omari Johnson,67,16.1166666666667,16,0.116666666666667,48,33,15,16,-1
21701199,1627738,MEM,DET,Deyonta Davis,108,22.8666666666667,23,-0.133333333333333,69,48,21,20,1
21701199,1627988,MEM,DET,Myke Henry,73,16,16,0,47,40,7,7,0
21701199,1628397,MEM,DET,Ivan Rabb,114,22.35,22,0.350000000000001,55,57,-2,-6,4
21701199,1628415,MEM,DET,Dillon Brooks,153,31.7333333333333,32,-0.266666666666666,83,76,7,6,1
21701199,1628424,MEM,DET,Kobi Simmons,146,31.3333333333333,32,-0.666666666666668,94,73,21,20,1
21701199,201229,DET,MEM,Anthony Tolliver,144,30,30,0,76,73,3,5,-2
21701199,202397,DET,MEM,Ish Smith,136,27.7166666666667,28,-0.283333333333331,75,76,-1,0,-1
21701199,202704,DET,MEM,Reggie Jackson,90,20.0166666666667,20,0.0166666666666657,41,54,-13,-13,0
21701199,203083,DET,MEM,Andre Drummond,196,41.0166666666667,41,0.0166666666666657,101,103,-2,-1,-1
21701199,203516,DET,MEM,James Ennis III,71,15.85,16,-0.149999999999999,34,43,-9,-9,0
21701199,203961,DET,MEM,Eric Moreland,30,6.71666666666667,7,-0.283333333333333,15,27,-12,-12,0
21701199,204038,DET,MEM,Langston Galloway,73,16.1166666666667,16,0.116666666666667,33,46,-13,-12,-1
21701199,1626169,DET,MEM,Stanley Johnson,155,31.8833333333333,32,-0.116666666666667,82,87,-5,-4,-1
21701199,1627740,DET,MEM,Henry Ellenson,82,17.7333333333333,18,-0.266666666666666,40,57,-17,-18,1
21701199,1628379,DET,MEM,Luke Kennard,153,31.6166666666667,32,-0.383333333333333,83,84,-1,-1,0
21701200,201571,ORL,TOR,D.J. Augustin,99,21.05,21,0.0500000000000007,48,47,1,2,-1
21701200,202687,ORL,TOR,Bismack Biyombo,79,18.1166666666667,18,0.116666666666667,27,49,-22,-21,-1
21701200,202696,ORL,TOR,Nikola Vucevic,110,22.9833333333333,23,-0.0166666666666657,53,52,1,1,0
21701200,202714,ORL,TOR,Shelvin Mack,99,22.0666666666667,22,0.0666666666666664,36,59,-23,-22,-1
21701200,203082,ORL,TOR,Terrence Ross,40,9.85,10,-0.149999999999999,11,26,-15,-13,-2
21701200,203920,ORL,TOR,Khem Birch,97,20.8166666666667,21,-0.183333333333334,46,46,0,0,0
21701200,203932,ORL,TOR,Aaron Gordon,124,26.9333333333333,27,-0.0666666666666664,54,66,-12,-11,-1
21701200,1626209,ORL,TOR,Mario Hezonja,134,27.8,28,-0.200000000000003,60,61,-1,-2,1
21701200,1628411,ORL,TOR,Wes Iwundu,120,26.0166666666667,26,0.0166666666666657,68,55,13,13,0
21701200,1628503,ORL,TOR,Jamel Artis,119,26.6,27,-0.399999999999999,60,62,-2,0,-2
21701200,1628681,ORL,TOR,Rodney Purvis,84,16.5166666666667,17,-0.483333333333334,37,37,0,-2,2
21701200,101139,TOR,ORL,CJ Miles,107,23.85,24,-0.149999999999999,65,42,23,22,1
21701200,200768,TOR,ORL,Kyle Lowry,142,30.4666666666667,31,-0.533333333333335,69,71,-2,0,-2
21701200,201586,TOR,ORL,Serge Ibaka,150,31.2,31,0.199999999999999,74,52,22,22,0
21701200,203512,TOR,ORL,Lucas Nogueira,28,6.11666666666667,6,0.116666666666667,12,11,1,1,0
21701200,1626153,TOR,ORL,Delon Wright,127,27.4666666666667,27,0.466666666666669,65,55,10,9,1
21701200,1626181,TOR,ORL,Norman Powell,115,24.0833333333333,24,0.0833333333333357,49,50,-1,-3,2
21701200,1627751,TOR,ORL,Jakob Poeltl,109,23.8,24,-0.199999999999999,56,61,-5,-6,1
21701200,1627783,TOR,ORL,Pascal Siakam,129,29.1833333333333,29,0.183333333333334,70,64,6,5,1
21701200,1627832,TOR,ORL,Fred VanVleet,39,8.81666666666667,9,-0.183333333333334,24,17,7,6,1
21701200,1628384,TOR,ORL,OG Anunoby,159,33.7666666666667,34,-0.233333333333334,76,77,-1,-1,0
21701201,101112,LAL,UTA,Channing Frye,115,22.8833333333333,23,-0.116666666666667,49,54,-5,-4,-1
21701201,201572,LAL,UTA,Brook Lopez,100,20.5333333333333,21,-0.466666666666669,38,49,-11,-11,0
21701201,203484,LAL,UTA,Kentavious Caldwell-Pope,120,23.3166666666667,23,0.316666666666666,42,57,-15,-15,0
21701201,203898,LAL,UTA,Tyler Ennis,140,29.0166666666667,29,0.0166666666666657,66,61,5,5,0
21701201,203944,LAL,UTA,Julius Randle,121,24.5166666666667,25,-0.483333333333334,51,61,-10,-13,3
21701201,204037,LAL,UTA,Travis Wear,76,17.4,18,-0.600000000000001,35,43,-8,-7,-1
21701201,1627780,LAL,UTA,Gary Payton II,104,21.5333333333333,21,0.533333333333331,49,49,0,-2,2
21701201,1627826,LAL,UTA,Ivica Zubac,68,13.95,14,-0.0500000000000007,22,33,-11,-8,-3
21701201,1627936,LAL,UTA,Alex Caruso,80,16,16,0,27,44,-17,-17,0
21701201,1628404,LAL,UTA,Josh Hart,197,41.05,41,0.0499999999999972,82,91,-9,-9,0
21701201,1628418,LAL,UTA,Thomas Bryant,44,9.46666666666667,9,0.466666666666667,24,18,6,6,0
21701201,201937,UTA,LAL,Ricky Rubio,84,18.45,18,0.450000000000003,44,28,16,16,0
21701201,201973,UTA,LAL,Jonas Jerebko,54,11.0333333333333,11,0.0333333333333332,24,24,0,-1,1
21701201,202324,UTA,LAL,Derrick Favors,157,33.05,33,0.0499999999999972,83,56,27,30,-3
21701201,202327,UTA,LAL,Ekpe Udoh,15,3.31666666666667,3,0.316666666666666,9,6,3,1,2
21701201,203109,UTA,LAL,Jae Crowder,148,29.85,30,-0.149999999999999,71,68,3,4,-1
21701201,203497,UTA,LAL,Rudy Gobert,128,25.7833333333333,26,-0.216666666666669,56,53,3,2,1
21701201,203957,UTA,LAL,Dante Exum,118,22.5833333333333,23,-0.416666666666668,52,54,-2,-3,1
21701201,204060,UTA,LAL,Joe Ingles,155,33.1333333333333,33,0.133333333333333,75,68,7,7,0
21701201,1626220,UTA,LAL,Royce O'Neale,119,24.45,24,0.449999999999999,57,48,9,10,-1
21701201,1628378,UTA,LAL,Donovan Mitchell,187,38.0166666666667,38,0.0166666666666657,89,80,9,9,0
21701202,203101,ATL,BOS,Miles Plumlee,12,3.38333333333333,3,0.383333333333333,10,10,0,0,0
21701202,203473,ATL,BOS,Dewayne Dedmon,121,26.7666666666667,27,-0.233333333333334,56,54,2,1,1
21701202,203488,ATL,BOS,Mike Muscala,124,28.3333333333333,29,-0.666666666666664,78,64,14,15,-1
21701202,1627752,ATL,BOS,Taurean Prince,172,39.2333333333333,39,0.233333333333334,93,85,8,6,2
21701202,1627761,ATL,BOS,DeAndre' Bembry,90,19.9666666666667,20,-0.0333333333333314,48,39,9,8,1
21701202,1627814,ATL,BOS,Damion Lee,128,28.8,29,-0.199999999999999,61,57,4,3,1
21701202,1627819,ATL,BOS,Isaiah Taylor,123,27.9833333333333,28,-0.0166666666666657,66,67,-1,-2,1
21701202,1628381,ATL,BOS,John Collins,151,33.1833333333333,33,0.183333333333337,70,75,-5,-2,-3
21701202,1628416,ATL,BOS,Tyler Dorsey,105,25,24,1,60,64,-4,0,-4
21701202,1628499,ATL,BOS,Antonius Cleveland,34,7.01666666666667,7,0.0166666666666666,18,15,3,1,2
21701202,201143,BOS,ATL,Al Horford,115,26.6666666666667,27,-0.333333333333336,60,55,5,5,0
21701202,202328,BOS,ATL,Greg Monroe,98,22.4333333333333,22,0.433333333333334,52,59,-7,-7,0
21701202,203382,BOS,ATL,Aron Baynes,101,22.7333333333333,23,-0.266666666666666,45,45,0,2,-2
21701202,203499,BOS,ATL,Shane Larkin,94,20.9833333333333,21,-0.0166666666666657,44,59,-15,-15,0
21701202,1626179,BOS,ATL,Terry Rozier,118,26.95,27,-0.0499999999999972,62,53,9,9,0
21701202,1626780,BOS,ATL,Jonathan Gibson,16,3.01666666666667,3,0.0166666666666666,5,9,-4,-4,0
21701202,1627759,BOS,ATL,Jaylen Brown,125,28.7166666666667,28,0.716666666666669,66,59,7,7,0
21701202,1627846,BOS,ATL,Abdel Nader,49,10,10,0,21,29,-8,-7,-1
21701202,1628369,BOS,ATL,Jayson Tatum,128,28.9,29,-0.100000000000001,66,58,8,6,2
21701202,1628400,BOS,ATL,Semi Ojeleye,121,27.4,27,0.399999999999999,65,73,-8,-10,2
21701202,1628443,BOS,ATL,Kadeem Allen,1,0.0166666666666667,0,0.0166666666666667,,2,,-2,
21701202,1628444,BOS,ATL,Jabari Bird,94,21.85,22,-0.149999999999999,44,59,-15,-14,-1
21701203,2561,GSW,PHX,David West,59,13.4833333333333,14,-0.516666666666666,31,23,8,11,-3
21701203,2585,GSW,PHX,Zaza Pachulia,69,14.8333333333333,15,-0.166666666666668,40,34,6,6,0
21701203,2733,GSW,PHX,Shaun Livingston,78,17.2833333333333,17,0.283333333333331,38,30,8,8,0
21701203,201142,GSW,PHX,Kevin Durant,145,30.55,31,-0.450000000000003,76,62,14,15,-1
21701203,201156,GSW,PHX,Nick Young,91,20.1,20,0.100000000000001,47,42,5,8,-3
21701203,201580,GSW,PHX,JaVale McGee,41,8.56666666666667,9,-0.433333333333334,20,15,5,3,2
21701203,202691,GSW,PHX,Klay Thompson,160,34.7833333333333,34,0.783333333333331,84,71,13,14,-1
21701203,203110,GSW,PHX,Draymond Green,138,30.1,30,0.100000000000001,79,64,15,13,2
21701203,1626172,GSW,PHX,Kevon Looney,94,19.1666666666667,19,0.166666666666664,42,43,-1,2,-3
21701203,1626188,GSW,PHX,Quinn Cook,175,36.4,37,-0.600000000000001,91,80,11,11,0
21701203,1627745,GSW,PHX,Damian Jones,43,8.8,9,-0.199999999999999,20,19,1,-1,2
21701203,1628395,GSW,PHX,Jordan Bell,27,5.43333333333333,6,-0.566666666666666,12,17,-5,-5,0
21701203,201162,PHX,GSW,Jared Dudley,102,22.9333333333333,23,-0.0666666666666664,39,55,-16,-17,1
21701203,203458,PHX,GSW,Alex Len,120,25.25,25,0.25,56,59,-3,-4,1
21701203,203584,PHX,GSW,Troy Daniels,67,13.3,14,-0.699999999999999,22,46,-24,-22,-2
21701203,1627733,PHX,GSW,Dragan Bender,191,41.25,41,0.25,85,99,-14,-15,1
21701203,1627755,PHX,GSW,Tyler Ulis,177,37.2333333333333,37,0.233333333333334,82,92,-10,-11,1
21701203,1627863,PHX,GSW,Danuel House Jr.,206,44.55,45,-0.450000000000003,95,102,-7,-8,1
21701203,1627885,PHX,GSW,Shaquille Harrison,127,27.8333333333333,28,-0.166666666666668,65,61,4,4,0
21701203,1628409,PHX,GSW,Alec Peters,55,10.35,10,0.35,29,27,2,1,1
21701203,1628432,PHX,GSW,Davon Reed,75,16.8,17,-0.199999999999999,27,39,-12,-13,1
21701204,101139,TOR,DET,CJ Miles,70,18.1666666666667,18,0.166666666666668,37,37,0,0,0
21701204,200768,TOR,DET,Kyle Lowry,107,25.85,26,-0.149999999999999,67,48,19,19,0
21701204,201942,TOR,DET,DeMar DeRozan,113,28.2666666666667,28,0.266666666666666,71,55,16,14,2
21701204,202685,TOR,DET,Jonas Valanciunas,103,24.85,25,-0.149999999999999,67,46,21,21,0
21701204,203485,TOR,DET,Lorenzo Brown,101,24.4833333333333,25,-0.516666666666666,50,48,2,4,-2
21701204,1626153,TOR,DET,Delon Wright,86,21.6666666666667,22,-0.333333333333336,41,50,-9,-9,0
21701204,1626181,TOR,DET,Norman Powell,82,19.5166666666667,19,0.516666666666666,43,52,-9,-7,-2
21701204,1627751,TOR,DET,Jakob Poeltl,90,22.6666666666667,23,-0.333333333333336,41,52,-11,-11,0
21701204,1627783,TOR,DET,Pascal Siakam,116,28.5333333333333,29,-0.466666666666669,73,49,24,24,0
21701204,1628035,TOR,DET,Alfonzo McKinnie,20,4.5,5,-0.5,4,15,-11,-11,0
21701204,1628384,TOR,DET,OG Anunoby,77,19.0833333333333,19,0.0833333333333322,46,38,8,6,2
21701204,201229,DET,TOR,Anthony Tolliver,169,41.2833333333333,42,-0.716666666666669,84,92,-8,-8,0
21701204,202397,DET,TOR,Ish Smith,57,14.4833333333333,14,0.483333333333334,34,31,3,3,0
21701204,202704,DET,TOR,Reggie Jackson,136,33.0333333333333,34,-0.966666666666669,64,77,-13,-13,0
21701204,203516,DET,TOR,James Ennis III,53,13.25,13,0.25,34,29,5,5,0
21701204,203961,DET,TOR,Eric Moreland,126,31.4666666666667,32,-0.533333333333331,71,64,7,7,0
21701204,204038,DET,TOR,Langston Galloway,80,19.25,20,-0.75,43,37,6,4,2
21701204,1626169,DET,TOR,Stanley Johnson,117,28.35,28,0.350000000000001,52,73,-21,-21,0
21701204,1627740,DET,TOR,Henry Ellenson,91,22.2833333333333,22,0.283333333333331,41,60,-19,-19,0
21701204,1628379,DET,TOR,Luke Kennard,136,34.1833333333333,34,0.183333333333337,67,77,-10,-8,-2
21701205,201600,CHI,BKN,Omer Asik,62,14.2666666666667,14,0.266666666666666,29,30,-1,-1,0
21701205,203200,CHI,BKN,Justin Holiday,108,21.7833333333333,22,-0.216666666666669,49,51,-2,-2,0
21701205,203930,CHI,BKN,Sean Kilpatrick,114,26,26,0,56,63,-7,-7,0
21701205,1626166,CHI,BKN,Cameron Payne,117,23.7833333333333,24,-0.216666666666669,49,62,-13,-11,-2
21701205,1626170,CHI,BKN,Jerian Grant,103,23.7833333333333,24,-0.216666666666669,50,56,-6,-6,0
21701205,1626171,CHI,BKN,Bobby Portis,101,21.7166666666667,22,-0.283333333333335,53,51,2,2,0
21701205,1626245,CHI,BKN,Cristiano Felicio,128,27.3833333333333,28,-0.616666666666667,56,69,-13,-13,0
21701205,1627853,CHI,BKN,Ryan Arcidiacono,105,24,24,0,56,52,4,2,2
21701205,1628021,CHI,BKN,David Nwaba,146,30.4166666666667,30,0.416666666666664,66,70,-4,-4,0
21701205,1628374,CHI,BKN,Lauri Markkanen,126,25.7833333333333,26,-0.216666666666669,61,66,-5,-5,0
21701205,201967,BKN,CHI,Dante Cunningham,92,20.4,21,-0.600000000000001,51,45,6,6,0
21701205,203112,BKN,CHI,Quincy Acy,87,19.7,20,-0.300000000000001,45,43,2,2,0
21701205,203459,BKN,CHI,Allen Crabbe,160,33.4666666666667,34,-0.533333333333331,84,70,14,14,0
21701205,203915,BKN,CHI,Spencer Dinwiddie,161,35.25,35,0.25,80,80,0,0,0
21701205,203917,BKN,CHI,Nik Stauskas,89,19.5,19,0.5,46,41,5,5,0
21701205,1626156,BKN,CHI,D'Angelo Russell,167,35.25,36,-0.75,92,76,16,16,0
21701205,1626178,BKN,CHI,Rondae Hollis-Jefferson,148,31.3666666666667,32,-0.633333333333333,81,73,8,8,0
21701205,1628386,BKN,CHI,Jarrett Allen,135,28.2,28,0.199999999999999,63,60,3,3,0
21701205,1628495,BKN,CHI,Milton Doyle,71,15.7833333333333,16,-0.216666666666669,28,37,-9,-9,0
21701206,2548,MIA,OKC,Dwyane Wade,112,23.9166666666667,24,-0.0833333333333357,33,64,-31,-31,0
21701206,201609,MIA,OKC,Goran Dragic,141,29.9666666666667,30,-0.033333333333335,68,71,-3,-3,0
21701206,201949,MIA,OKC,James Johnson,103,21.7,22,-0.299999999999997,58,44,14,9,5
21701206,201961,MIA,OKC,Wayne Ellington,67,14.7333333333333,15,-0.266666666666668,23,38,-15,-13,-2
21701206,202355,MIA,OKC,Hassan Whiteside,94,20.55,21,-0.450000000000003,49,52,-3,-4,1
21701206,203482,MIA,OKC,Kelly Olynyk,57,12.3833333333333,12,0.383333333333333,16,33,-17,-17,0
21701206,203585,MIA,OKC,Rodney McGruder,4,1.01666666666667,1,0.0166666666666666,0,4,-4,-2,-2
21701206,204020,MIA,OKC,Tyler Johnson,155,32.5333333333333,32,0.533333333333331,74,71,3,-1,4
21701206,1626159,MIA,OKC,Justise Winslow,157,34.3333333333333,34,0.333333333333329,55,91,-36,-35,-1
21701206,1626196,MIA,OKC,Josh Richardson,157,33.1333333333333,34,-0.866666666666667,64,80,-16,-13,-3
21701206,1627884,MIA,OKC,Derrick Jones Jr.,1,0.3,1,-0.7,0,,,0,
21701206,1628389,MIA,OKC,Bam Adebayo,62,13.2666666666667,13,0.266666666666666,25,27,-2,0,-2
21701206,2546,OKC,MIA,Carmelo Anthony,145,30.3333333333333,30,0.333333333333332,72,66,6,9,-3
21701206,2555,OKC,MIA,Nick Collison,1,0.3,1,-0.7,,0,,0,
21701206,101109,OKC,MIA,Raymond Felton,58,12.9666666666667,14,-1.03333333333334,36,17,19,15,4
21701206,201147,OKC,MIA,Corey Brewer,159,33.4833333333333,33,0.483333333333334,83,71,12,15,-3
21701206,201566,OKC,MIA,Russell Westbrook,182,37.8833333333333,38,-0.116666666666667,90,80,10,12,-2
21701206,202331,OKC,MIA,Paul George,172,36.9833333333333,37,-0.0166666666666657,81,77,4,6,-2
21701206,202335,OKC,MIA,Patrick Patterson,51,11.3666666666667,11,0.366666666666667,28,19,9,10,-1
21701206,203500,OKC,MIA,Steven Adams,152,31.7333333333333,32,-0.266666666666666,70,71,-1,-1,0
21701206,203518,OKC,MIA,Alex Abrines,55,11.7,12,-0.300000000000001,32,21,11,10,1
21701206,203924,OKC,MIA,Jerami Grant,91,20.3833333333333,21,-0.616666666666667,56,30,26,24,2
21701206,203962,OKC,MIA,Josh Huestis,4,1.01666666666667,1,0.0166666666666666,4,0,4,2,2
21701206,1626177,OKC,MIA,Dakari Johnson,1,0.3,1,-0.7,,0,,0,
21701206,1628390,OKC,MIA,Terrance Ferguson,39,9.38333333333333,10,-0.616666666666667,23,13,10,8,2
21701207,2544,CLE,NYK,LeBron James,175,38.4,39,-0.600000000000001,100,89,11,16,-5
21701207,2594,CLE,NYK,Kyle Korver,78,16.35,16,0.350000000000001,44,43,1,1,0
21701207,2747,CLE,NYK,JR Smith,141,31.4666666666667,32,-0.533333333333335,79,66,13,15,-2
21701207,101181,CLE,NYK,Jose Calderon,92,20.0166666666667,20,0.0166666666666657,43,44,-1,1,-2
21701207,201145,CLE,NYK,Jeff Green,132,28.7666666666667,29,-0.233333333333334,75,76,-1,0,-1
21701207,201567,CLE,NYK,Kevin Love,143,31.1833333333333,31,0.18333333333333,84,78,6,10,-4
21701207,201588,CLE,NYK,George Hill,88,19.2166666666667,20,-0.783333333333331,51,43,8,7,1
21701207,202684,CLE,NYK,Tristan Thompson,41,9.16666666666667,9,0.166666666666668,22,17,5,5,0
21701207,203903,CLE,NYK,Jordan Clarkson,99,22.1,22,0.100000000000001,57,46,11,11,0
21701207,204066,CLE,NYK,John Holland,7,1.13333333333333,1,0.133333333333333,6,3,3,1,2
21701207,1626204,CLE,NYK,Larry Nance Jr.,85,19.0166666666667,19,0.0166666666666657,42,34,8,11,-3
21701207,1626224,CLE,NYK,Cedi Osman,7,1.13333333333333,1,0.133333333333333,6,3,3,1,2
21701207,1627790,CLE,NYK,Ante Zizic,7,1.13333333333333,1,0.133333333333333,6,3,3,1,2
21701207,101127,NYK,CLE,Jarrett Jack,38,8.06666666666667,8,0.0666666666666664,23,16,7,7,0
21701207,201563,NYK,CLE,Michael Beasley,127,26.9166666666667,27,-0.0833333333333357,63,67,-4,-4,0
21701207,201584,NYK,CLE,Courtney Lee,120,26.4166666666667,27,-0.583333333333336,53,71,-18,-20,2
21701207,202498,NYK,CLE,Lance Thomas,146,31.9833333333333,32,-0.0166666666666657,74,82,-8,-10,2
21701207,203124,NYK,CLE,Kyle O'Quinn,131,28.3,29,-0.699999999999999,79,77,2,1,1
21701207,203504,NYK,CLE,Trey Burke,159,33.6,34,-0.400000000000006,74,98,-24,-22,-2
21701207,1628373,NYK,CLE,Frank Ntilikina,182,39.8833333333333,40,-0.116666666666667,102,99,3,1,2
21701207,1628422,NYK,CLE,Damyean Dotson,84,19.3833333333333,19,0.383333333333333,40,44,-4,-6,2
21701207,1628436,NYK,CLE,Luke Kornet,88,19.5166666666667,19,0.516666666666666,30,46,-16,-17,1
21701207,1628439,NYK,CLE,Isaiah Hicks,20,5.01666666666667,5,0.0166666666666666,7,15,-8,-10,2
21701208,1891,MIL,ORL,Jason Terry,52,11.5833333333333,11,0.583333333333332,32,14,18,16,2
21701208,201943,MIL,ORL,Brandon Jennings,58,12.7333333333333,13,-0.266666666666666,23,25,-2,-4,2
21701208,202339,MIL,ORL,Eric Bledsoe,175,34.9833333333333,35,-0.0166666666666657,79,61,18,20,-2
21701208,203089,MIL,ORL,John Henson,127,24.6666666666667,25,-0.333333333333336,54,50,4,4,0
21701208,203092,MIL,ORL,Tyler Zeller,97,21.2166666666667,21,0.216666666666669,46,32,14,14,0
21701208,203114,MIL,ORL,Khris Middleton,181,36.8333333333333,37,-0.166666666666664,92,65,27,27,0
21701208,203498,MIL,ORL,Shabazz Muhammad,111,23.9833333333333,24,-0.0166666666666657,49,36,13,11,2
21701208,203503,MIL,ORL,Tony Snell,128,25.0333333333333,25,0.0333333333333314,49,58,-9,-6,-3
21701208,203953,MIL,ORL,Jabari Parker,141,28.2166666666667,29,-0.783333333333335,51,58,-7,-5,-2
21701208,1627748,MIL,ORL,Thon Maker,9,1.83333333333333,2,-0.166666666666667,2,4,-2,-2,0
21701208,1627763,MIL,ORL,Malcolm Brogdon,68,13.8333333333333,14,-0.166666666666668,29,19,10,9,1
21701208,1628391,MIL,ORL,D.J. Wilson,9,1.83333333333333,2,-0.166666666666667,2,4,-2,-2,0
21701208,1628425,MIL,ORL,Sterling Brown,9,1.83333333333333,2,-0.166666666666667,2,4,-2,-2,0
21701208,201571,ORL,MIL,D.J. Augustin,149,29.2833333333333,30,-0.716666666666669,59,65,-6,-7,1
21701208,202687,ORL,MIL,Bismack Biyombo,78,16.9833333333333,17,-0.0166666666666657,23,37,-14,-13,-1
21701208,202696,ORL,MIL,Nikola Vucevic,146,28.9,29,-0.100000000000001,59,63,-4,-5,1
21701208,202714,ORL,MIL,Shelvin Mack,87,19.5333333333333,19,0.533333333333331,27,42,-15,-16,1
21701208,203920,ORL,MIL,Khem Birch,73,16.5666666666667,16,0.566666666666666,24,22,2,2,0
21701208,203932,ORL,MIL,Aaron Gordon,161,31.35,32,-0.649999999999999,62,80,-18,-18,0
21701208,1626209,ORL,MIL,Mario Hezonja,153,30,30,0,56,72,-16,-16,0
21701208,1628411,ORL,MIL,Wes Iwundu,147,28.5666666666667,29,-0.433333333333337,59,62,-3,-2,-1
21701208,1628503,ORL,MIL,Jamel Artis,88,19.35,20,-0.649999999999999,34,32,2,2,0
21701208,1628681,ORL,MIL,Rodney Purvis,83,18.05,18,0.0500000000000007,27,35,-8,-7,-1
21701209,2037,MIN,MEM,Jamal Crawford,104,22.5,23,-0.5,56,40,16,17,-1
21701209,201166,MIN,MEM,Aaron Brooks,4,0.883333333333333,1,-0.116666666666667,3,3,0,0,0
21701209,201565,MIN,MEM,Derrick Rose,110,22.0833333333333,22,0.0833333333333322,60,49,11,12,-1
21701209,201952,MIN,MEM,Jeff Teague,167,33.7,33,0.700000000000003,73,71,2,2,0
21701209,201959,MIN,MEM,Taj Gibson,45,8.33333333333333,8,0.333333333333332,14,16,-2,-3,1
21701209,202332,MIN,MEM,Cole Aldrich,4,0.883333333333333,1,-0.116666666666667,3,3,0,0,0
21701209,202357,MIN,MEM,Nemanja Bjelica,98,19.7666666666667,20,-0.233333333333334,41,40,1,0,1
21701209,202710,MIN,MEM,Jimmy Butler,106,22.8666666666667,23,-0.133333333333333,60,39,21,21,0
21701209,203476,MIN,MEM,Gorgui Dieng,86,17.1833333333333,17,0.18333333333333,36,46,-10,-8,-2
21701209,203952,MIN,MEM,Andrew Wiggins,176,35.7833333333333,36,-0.216666666666669,75,72,3,3,0
21701209,1626145,MIN,MEM,Tyus Jones,114,24.4666666666667,25,-0.533333333333331,67,43,24,24,0
21701209,1626157,MIN,MEM,Karl-Anthony Towns,142,29.75,30,-0.25,74,45,29,27,2
21701209,1627875,MIN,MEM,Marcus Georges-Hunt,4,0.883333333333333,1,-0.116666666666667,3,3,0,0,0
21701209,201596,MEM,MIN,Mario Chalmers,76,14.1833333333333,14,0.183333333333334,36,32,4,6,-2
21701209,202705,MEM,MIN,MarShon Brooks,154,31.5833333333333,32,-0.416666666666664,62,76,-14,-9,-5
21701209,203463,MEM,MIN,Ben McLemore,194,41.5166666666667,42,-0.483333333333334,74,100,-26,-26,0
21701209,204179,MEM,MIN,Omari Johnson,87,17.6333333333333,18,-0.366666666666667,42,36,6,6,0
21701209,1627738,MEM,MIN,Deyonta Davis,107,22.6333333333333,23,-0.366666666666667,43,52,-9,-11,2
21701209,1627988,MEM,MIN,Myke Henry,117,25,25,0,53,63,-10,-8,-2
21701209,1628397,MEM,MIN,Ivan Rabb,142,28.7666666666667,29,-0.233333333333334,53,69,-16,-16,0
21701209,1628415,MEM,MIN,Dillon Brooks,152,30.1666666666667,30,0.166666666666664,59,69,-10,-13,3
21701209,1628424,MEM,MIN,Kobi Simmons,131,27.6,28,-0.399999999999999,48,68,-20,-24,4
21701210,1713,SAC,SAS,Vince Carter,77,17.4166666666667,17,0.416666666666668,34,35,-1,-1,0
21701210,203960,SAC,SAS,JaKarr Sampson,84,19.7,20,-0.300000000000001,36,41,-5,-5,0
21701210,203992,SAC,SAS,Bogdan Bogdanovic,112,25.3333333333333,26,-0.666666666666664,45,52,-7,-5,-2
21701210,203998,SAC,SAS,Bruno Caboclo,35,7.71666666666667,8,-0.283333333333333,14,19,-5,-3,-2
21701210,204022,SAC,SAS,Jack Cooley,42,10.2333333333333,10,0.233333333333334,8,25,-17,-16,-1
21701210,1626161,SAC,SAS,Willie Cauley-Stein,170,37.4166666666667,38,-0.583333333333336,77,73,4,3,1
21701210,1627741,SAC,SAS,Buddy Hield,139,31.7166666666667,32,-0.283333333333331,55,75,-20,-22,2
21701210,1628368,SAC,SAS,De'Aaron Fox,167,36.95,38,-1.05,68,75,-7,-9,2
21701210,1628382,SAC,SAS,Justin Jackson,146,32.2666666666667,32,0.266666666666666,57,63,-6,-4,-2
21701210,1628502,SAC,SAS,Nigel Hayes,88,19.5,19,0.5,31,32,-1,-3,2
21701210,1938,SAS,SAC,Manu Ginobili,117,27.2166666666667,27,0.216666666666669,62,45,17,17,0
21701210,2200,SAS,SAC,Pau Gasol,87,19.45,20,-0.549999999999997,43,38,5,7,-2
21701210,2225,SAS,SAC,Tony Parker,82,18.6,18,0.600000000000001,31,35,-4,0,-4
21701210,200746,SAS,SAC,LaMarcus Aldridge,144,32.2833333333333,33,-0.716666666666669,58,60,-2,-2,0
21701210,200752,SAS,SAC,Rudy Gay,93,20.7333333333333,21,-0.266666666666666,43,32,11,15,-4
21701210,201980,SAS,SAC,Danny Green,69,15.4166666666667,16,-0.583333333333332,24,36,-12,-12,0
21701210,201988,SAS,SAC,Patty Mills,163,36.4666666666667,37,-0.533333333333331,74,65,9,7,2
21701210,202722,SAS,SAC,Davis Bertans,34,7.18333333333333,7,0.183333333333334,18,16,2,0,2
21701210,203464,SAS,SAC,Brandon Paul,3,0.95,1,-0.05,4,0,4,2,2
21701210,203530,SAS,SAC,Joffrey Lauvergne,3,0.95,1,-0.05,4,0,4,2,2
21701210,203937,SAS,SAC,Kyle Anderson,118,25.8666666666667,26,-0.133333333333333,51,45,6,6,0
21701210,1627749,SAS,SAC,Dejounte Murray,70,14.8166666666667,15,-0.183333333333334,28,28,0,-2,2
21701210,1627854,SAS,SAC,Bryn Forbes,77,18.3166666666667,19,-0.683333333333334,50,25,25,25,0
21701211,2734,DEN,POR,Devin Harris,60,13.6833333333333,14,-0.316666666666666,20,22,-2,-2,0
21701211,200794,DEN,POR,Paul Millsap,177,35.5333333333333,36,-0.466666666666669,65,64,1,1,0
21701211,201163,DEN,POR,Wilson Chandler,171,34.4333333333333,34,0.433333333333337,68,58,10,8,2
21701211,203115,DEN,POR,Will Barton,192,39.05,39,0.0499999999999972,78,62,16,15,1
21701211,203486,DEN,POR,Mason Plumlee,91,17.7833333333333,17,0.783333333333331,35,34,1,-3,4
21701211,203914,DEN,POR,Gary Harris,81,17.6666666666667,18,-0.333333333333336,30,26,4,4,0
21701211,203999,DEN,POR,Nikola Jokic,172,37.55,38,-0.450000000000003,69,56,13,18,-5
21701211,1626168,DEN,POR,Trey Lyles,18,4.23333333333333,4,0.233333333333333,6,10,-4,-4,0
21701211,1627750,DEN,POR,Jamal Murray,165,33.05,33,0.0499999999999972,60,65,-5,-2,-3
21701211,1628470,DEN,POR,Torrey Craig,28,6.51666666666667,6,0.516666666666667,9,13,-4,-5,1
21701211,202323,POR,DEN,Evan Turner,185,37.75,38,-0.25,68,74,-6,-7,1
21701211,202329,POR,DEN,Al-Farouq Aminu,167,34,34,0,61,63,-2,-2,0
21701211,202334,POR,DEN,Ed Davis,63,14.2333333333333,15,-0.766666666666668,20,19,1,-1,2
21701211,203081,POR,DEN,Damian Lillard,199,40.3,40,0.299999999999997,70,80,-10,-9,-1
21701211,203086,POR,DEN,Meyers Leonard,4,0.3,0,0.3,2,4,-2,0,-2
21701211,203468,POR,DEN,CJ McCollum,180,37.7666666666667,38,-0.233333333333334,62,75,-13,-12,-1
21701211,203894,POR,DEN,Shabazz Napier,79,17.05,17,0.0500000000000007,28,21,7,5,2
21701211,203994,POR,DEN,Jusuf Nurkic,146,29.9833333333333,30,-0.0166666666666657,52,61,-9,-11,2
21701211,1626192,POR,DEN,Pat Connaughton,40,8.75,9,-0.25,14,11,3,3,0
21701211,1628380,POR,DEN,Zach Collins,61,13.4,13,0.399999999999999,22,22,0,1,-1
21701211,1628403,POR,DEN,Caleb Swanigan,31,5.96666666666667,6,-0.0333333333333332,11,10,1,3,-2
21701212,2731,NOP,LAC,Emeka Okafor,31,5.71666666666667,6,-0.283333333333333,6,15,-9,-11,2
21701212,200765,NOP,LAC,Rajon Rondo,129,25.3333333333333,25,0.333333333333332,62,48,14,14,0
21701212,201950,NOP,LAC,Jrue Holiday,168,33.0666666666667,33,0.0666666666666629,84,63,21,21,0
21701212,202348,NOP,LAC,Jordan Crawford,22,3.68333333333333,4,-0.316666666666666,5,13,-8,-8,0
21701212,202703,NOP,LAC,Nikola Mirotic,167,33.0333333333333,34,-0.966666666666669,81,61,20,20,0
21701212,202732,NOP,LAC,DeAndre Liggins,22,3.68333333333333,4,-0.316666666666666,5,13,-8,-8,0
21701212,202734,NOP,LAC,E'Twaun Moore,158,30.55,31,-0.450000000000003,85,54,31,32,-1
21701212,203076,NOP,LAC,Anthony Davis,180,35.5,35,0.5,92,67,25,28,-3
21701212,203121,NOP,LAC,Darius Miller,100,20.7,20,0.699999999999999,36,59,-23,-22,-1
21701212,203524,NOP,LAC,Solomon Hill,50,10.0666666666667,10,0.0666666666666664,23,24,-1,-1,0
21701212,203546,NOP,LAC,Ian Clark,138,28,28,0,66,52,14,12,2
21701212,1627767,NOP,LAC,Cheick Diallo,55,10.4166666666667,11,-0.583333333333332,20,31,-11,-12,1
21701212,201599,LAC,NOP,DeAndre Jordan,117,22.1833333333333,22,0.18333333333333,29,63,-34,-36,2
21701212,202325,LAC,NOP,Wesley Johnson,112,22.2666666666667,23,-0.733333333333334,48,52,-4,-2,-2
21701212,202699,LAC,NOP,Tobias Harris,130,25.7,26,-0.300000000000001,51,62,-11,-13,2
21701212,203710,LAC,NOP,C.J. Williams,160,30.35,30,0.350000000000001,56,68,-12,-13,1
21701212,1626149,LAC,NOP,Montrezl Harrell,168,33.6833333333333,33,0.683333333333337,79,81,-2,0,-2
21701212,1626155,LAC,NOP,Sam Dekker,113,23.3333333333333,23,0.333333333333336,61,43,18,19,-1
21701212,1626246,LAC,NOP,Boban Marjanovic,65,13.4333333333333,14,-0.566666666666666,28,30,-2,-2,0
21701212,1627820,LAC,NOP,Tyrone Wallace,192,36.3166666666667,37,-0.683333333333337,75,92,-17,-19,2
21701212,1628414,LAC,NOP,Sindarius Thornwell,163,32.4833333333333,32,0.483333333333334,73,74,-1,1,-2
21701213,2744,IND,CHA,Al Jefferson,60,13.3,13,0.300000000000001,32,35,-3,-3,0
21701213,201954,IND,CHA,Darren Collison,98,20.3333333333333,20,0.333333333333336,31,51,-20,-20,0
21701213,202344,IND,CHA,Trevor Booker,91,18.85,19,-0.149999999999999,37,40,-3,-5,2
21701213,202362,IND,CHA,Lance Stephenson,153,33.15,33,0.149999999999999,61,84,-23,-23,0
21701213,202709,IND,CHA,Cory Joseph,123,26.1333333333333,26,0.133333333333333,53,57,-4,-4,0
21701213,203922,IND,CHA,Glenn Robinson III,187,39.6166666666667,40,-0.383333333333333,81,103,-22,-22,0
21701213,1626167,IND,CHA,Myles Turner,96,20.55,21,-0.450000000000003,35,55,-20,-22,2
21701213,1626202,IND,CHA,Joe Young,101,21.5,22,-0.5,51,54,-3,-3,0
21701213,1627734,IND,CHA,Domantas Sabonis,78,16.2833333333333,16,0.283333333333335,30,31,-1,-1,0
21701213,1627816,IND,CHA,Alex Poythress,13,2.78333333333333,3,-0.216666666666667,4,11,-7,-7,0
21701213,1628387,IND,CHA,Ike Anigbogu,10,1.91666666666667,2,-0.0833333333333335,2,8,-6,-6,0
21701213,1628388,IND,CHA,TJ Leaf,100,21.4166666666667,22,-0.583333333333336,46,58,-12,-8,-4
21701213,1628410,IND,CHA,Edmond Sumner,10,1.91666666666667,2,-0.0833333333333335,2,8,-6,-6,0
21701213,2730,CHA,IND,Dwight Howard,129,27.3833333333333,27,0.383333333333333,64,47,17,19,-2
21701213,101107,CHA,IND,Marvin Williams,97,20.4166666666667,21,-0.583333333333332,54,39,15,15,0
21701213,201587,CHA,IND,Nicolas Batum,97,20.4166666666667,21,-0.583333333333332,54,39,15,15,0
21701213,202689,CHA,IND,Kemba Walker,121,24.9166666666667,25,-0.0833333333333357,66,46,20,21,-1
21701213,202933,CHA,IND,Julyan Stone,103,22.6333333333333,23,-0.366666666666667,53,47,6,5,1
21701213,203077,CHA,IND,Michael Kidd-Gilchrist,110,23.0166666666667,23,0.0166666666666657,60,41,19,19,0
21701213,203087,CHA,IND,Jeremy Lamb,114,24.35,24,0.350000000000001,54,50,4,4,0
21701213,1626163,CHA,IND,Frank Kaminsky,127,27.1333333333333,27,0.133333333333333,65,54,11,11,0
21701213,1626195,CHA,IND,Willy Hernangomez,95,20.1666666666667,21,-0.833333333333336,55,46,9,7,2
21701213,1627779,CHA,IND,Marcus Paige,13,2.78333333333333,3,-0.216666666666667,11,4,7,7,0
21701213,1628370,CHA,IND,Malik Monk,114,24.5333333333333,25,-0.466666666666669,59,52,7,7,0
21701214,203101,ATL,PHI,Miles Plumlee,84,16.7166666666667,17,-0.283333333333331,36,49,-13,-12,-1
21701214,203473,ATL,PHI,Dewayne Dedmon,131,25.2333333333333,25,0.233333333333334,63,57,6,4,2
21701214,203488,ATL,PHI,Mike Muscala,115,23.2333333333333,23,0.233333333333334,50,66,-16,-11,-5
21701214,1627752,ATL,PHI,Taurean Prince,162,31.1833333333333,31,0.18333333333333,79,73,6,6,0
21701214,1627761,ATL,PHI,DeAndre' Bembry,115,22.4,22,0.399999999999999,55,49,6,6,0
21701214,1627814,ATL,PHI,Damion Lee,151,28.7333333333333,29,-0.266666666666666,69,64,5,6,-1
21701214,1627819,ATL,PHI,Isaiah Taylor,137,27.7333333333333,28,-0.266666666666666,64,72,-8,-9,1
21701214,1628381,ATL,PHI,John Collins,160,30.6166666666667,31,-0.383333333333333,77,70,7,3,4
21701214,1628416,ATL,PHI,Tyler Dorsey,111,21.1666666666667,21,0.166666666666664,50,65,-15,-13,-2
21701214,1628499,ATL,PHI,Antonius Cleveland,59,12.4833333333333,13,-0.516666666666668,22,40,-18,-20,2
21701214,101141,PHI,ATL,Ersan Ilyasova,162,31.2,31,0.200000000000003,78,73,5,5,0
21701214,101161,PHI,ATL,Amir Johnson,124,24.5666666666667,25,-0.433333333333334,64,56,8,8,0
21701214,200755,PHI,ATL,JJ Redick,174,32.5666666666667,33,-0.433333333333337,79,78,1,0,1
21701214,201158,PHI,ATL,Marco Belinelli,161,32.3333333333333,32,0.333333333333336,85,74,11,11,0
21701214,203496,PHI,ATL,Robert Covington,194,36.6333333333333,36,0.633333333333333,92,84,8,8,0
21701214,204456,PHI,ATL,T.J. McConnell,92,19.3166666666667,19,0.316666666666666,53,47,6,7,-1
21701214,1626158,PHI,ATL,Richaun Holmes,73,14.9833333333333,14,0.983333333333333,33,40,-7,-7,0
21701214,1627732,PHI,ATL,Ben Simmons,153,28.9333333333333,29,-0.0666666666666664,68,71,-3,-4,1
21701214,1628365,PHI,ATL,Markelle Fultz,92,18.9666666666667,19,-0.0333333333333314,53,42,11,12,-1
21701215,201143,BOS,WAS,Al Horford,156,31.75,32,-0.25,62,70,-8,-4,-4
21701215,202328,BOS,WAS,Greg Monroe,89,18.4333333333333,19,-0.566666666666666,34,43,-9,-9,0
21701215,202694,BOS,WAS,Marcus Morris,114,23.5166666666667,23,0.516666666666666,44,52,-8,-8,0
21701215,203382,BOS,WAS,Aron Baynes,101,20.8333333333333,21,-0.166666666666668,41,47,-6,-5,-1
21701215,203499,BOS,WAS,Shane Larkin,98,20.6666666666667,21,-0.333333333333336,32,46,-14,-13,-1
21701215,1626179,BOS,WAS,Terry Rozier,161,32.6833333333333,33,-0.316666666666663,65,75,-10,-11,1
21701215,1626780,BOS,WAS,Jonathan Gibson,17,2.73333333333333,3,-0.266666666666667,16,11,5,5,0
21701215,1627759,BOS,WAS,Jaylen Brown,160,32.2833333333333,32,0.283333333333331,65,73,-8,-8,0
21701215,1627846,BOS,WAS,Abdel Nader,17,2.73333333333333,3,-0.266666666666667,16,11,5,5,0
21701215,1628369,BOS,WAS,Jayson Tatum,123,25.6,26,-0.399999999999999,48,57,-9,-11,2
21701215,1628400,BOS,WAS,Semi Ojeleye,110,21.9666666666667,22,-0.033333333333335,50,58,-8,-11,3
21701215,1628443,BOS,WAS,Kadeem Allen,17,2.73333333333333,3,-0.266666666666667,16,11,5,5,0
21701215,1628444,BOS,WAS,Jabari Bird,17,2.73333333333333,3,-0.266666666666667,16,11,5,5,0
21701215,101133,WAS,BOS,Ian Mahinmi,99,20.8333333333333,21,-0.166666666666668,44,32,12,11,1
21701215,101162,WAS,BOS,Marcin Gortat,107,21.4833333333333,21,0.483333333333334,49,42,7,5,2
21701215,201160,WAS,BOS,Jason Smith,10,1.38333333333333,2,-0.616666666666667,9,9,0,1,-1
21701215,201196,WAS,BOS,Ramon Sessions,10,1.38333333333333,2,-0.616666666666667,9,9,0,1,-1
21701215,202322,WAS,BOS,John Wall,180,36.3666666666667,36,0.366666666666667,82,78,4,3,1
21701215,202693,WAS,BOS,Markieff Morris,133,27.05,27,0.0499999999999972,62,62,0,1,-1
21701215,203078,WAS,BOS,Bradley Beal,186,37.8,38,-0.200000000000003,85,77,8,8,0
21701215,203107,WAS,BOS,Tomas Satoransky,101,20.5166666666667,20,0.516666666666666,49,41,8,10,-2
21701215,203118,WAS,BOS,Mike Scott,113,23.3333333333333,24,-0.666666666666668,53,48,5,5,0
21701215,203490,WAS,BOS,Otto Porter Jr.,90,18.1333333333333,18,0.133333333333333,44,42,2,2,0
21701215,204025,WAS,BOS,Tim Frazier,10,1.38333333333333,2,-0.616666666666667,9,9,0,1,-1
21701215,1626162,WAS,BOS,Kelly Oubre Jr.,141,29,29,0,70,56,14,12,2
21701216,203939,DAL,PHX,Dwight Powell,96,21.2166666666667,21,0.216666666666669,41,59,-18,-17,-1
21701216,1626151,DAL,PHX,Aaron Harrison,220,47.6166666666667,48,-0.383333333333333,97,124,-27,-27,0
21701216,1627812,DAL,PHX,Yogi Ferrell,33,7.3,7,0.3,16,19,-3,-3,0
21701216,1627827,DAL,PHX,Dorian Finney-Smith,187,40.3166666666667,41,-0.683333333333337,81,105,-24,-24,0
21701216,1627858,DAL,PHX,Kyle Collinsworth,206,44.1,44,0.100000000000001,89,114,-25,-25,0
21701216,1627883,DAL,PHX,Jalen Jones,162,34.6333333333333,35,-0.366666666666667,69,100,-31,-31,0
21701216,1628405,DAL,PHX,Johnathan Motley,133,28.1666666666667,28,0.166666666666664,59,67,-8,-9,1
21701216,1628467,DAL,PHX,Maxi Kleber,63,14.7333333333333,15,-0.266666666666668,33,32,1,1,0
21701216,201162,PHX,DAL,Jared Dudley,145,31.9666666666667,32,-0.033333333333335,87,66,21,19,2
21701216,203458,PHX,DAL,Alex Len,119,26.75,27,-0.25,59,56,3,3,0
21701216,1627733,PHX,DAL,Dragan Bender,173,37.3833333333333,38,-0.616666666666667,103,74,29,32,-3
21701216,1627755,PHX,DAL,Tyler Ulis,130,28.85,28,0.850000000000001,66,62,4,2,2
21701216,1627863,PHX,DAL,Danuel House Jr.,180,39.3833333333333,40,-0.616666666666667,106,75,31,30,1
21701216,1627885,PHX,DAL,Shaquille Harrison,169,34.6,36,-1.40000000000001,100,63,37,38,-1
21701216,1628409,PHX,DAL,Alec Peters,134,28.1166666666667,28,0.116666666666667,80,60,20,20,0
21701216,1628432,PHX,DAL,Davon Reed,50,11.0333333333333,11,0.0333333333333332,19,29,-10,-9,-1
21701217,2561,GSW,UTA,David West,63,13.0833333333333,13,0.0833333333333339,25,31,-6,-4,-2
21701217,2585,GSW,UTA,Zaza Pachulia,62,13,13,0,16,40,-24,-24,0
21701217,2733,GSW,UTA,Shaun Livingston,70,15.3,16,-0.699999999999999,29,38,-9,-6,-3
21701217,201142,GSW,UTA,Kevin Durant,135,29.3,29,0.300000000000001,42,77,-35,-35,0
21701217,201156,GSW,UTA,Nick Young,116,24.2833333333333,24,0.283333333333331,49,54,-5,-5,0
21701217,201580,GSW,UTA,JaVale McGee,49,10.9833333333333,11,-0.0166666666666657,23,24,-1,-1,0
21701217,202691,GSW,UTA,Klay Thompson,164,35.2166666666667,35,0.216666666666669,53,93,-40,-40,0
21701217,203110,GSW,UTA,Draymond Green,93,19.8333333333333,20,-0.166666666666664,26,54,-28,-29,1
21701217,1626172,GSW,UTA,Kevon Looney,103,21.2833333333333,21,0.283333333333331,35,49,-14,-13,-1
21701217,1626188,GSW,UTA,Quinn Cook,160,33.6833333333333,34,-0.316666666666663,53,83,-30,-30,0
21701217,1627745,GSW,UTA,Damian Jones,47,10.0666666666667,10,0.0666666666666664,12,24,-12,-14,2
21701217,1628395,GSW,UTA,Jordan Bell,63,13.4666666666667,13,0.466666666666667,32,28,4,1,3
21701217,201937,UTA,GSW,Ricky Rubio,91,19.5166666666667,20,-0.483333333333334,57,21,36,36,0
21701217,201973,UTA,GSW,Jonas Jerebko,97,20.6833333333333,21,-0.31666666666667,44,40,4,3,1
21701217,202324,UTA,GSW,Derrick Favors,103,21.5333333333333,21,0.533333333333331,51,35,16,18,-2
21701217,202327,UTA,GSW,Ekpe Udoh,60,11.9333333333333,12,-0.0666666666666664,26,23,3,3,0
21701217,202692,UTA,GSW,Alec Burks,60,11.9333333333333,12,-0.0666666666666664,26,23,3,3,0
21701217,203109,UTA,GSW,Jae Crowder,98,21.3166666666667,21,0.316666666666666,54,30,24,25,-1
21701217,203497,UTA,GSW,Rudy Gobert,131,28.4333333333333,28,0.433333333333334,80,43,37,36,1
21701217,203526,UTA,GSW,Raul Neto,47,9.58333333333333,10,-0.416666666666668,16,21,-5,-5,0
21701217,203957,UTA,GSW,Dante Exum,87,18.8,19,-0.199999999999999,46,37,9,9,0
21701217,204060,UTA,GSW,Joe Ingles,111,24.2,24,0.199999999999999,63,34,29,32,-3
21701217,1626220,UTA,GSW,Royce O'Neale,73,16.1,16,0.0999999999999979,43,32,11,8,3
21701217,1627777,UTA,GSW,Georges Niang,47,9.58333333333333,10,-0.416666666666668,16,21,-5,-5,0
21701217,1628378,UTA,GSW,Donovan Mitchell,120,25.8833333333333,26,-0.116666666666667,73,35,38,37,1
21701218,2207,HOU,LAL,Joe Johnson,62,13.3833333333333,14,-0.616666666666667,36,23,13,17,-4
21701218,2403,HOU,LAL,Nene,52,12.5,12,0.5,29,24,5,-1,6
21701218,2772,HOU,LAL,Trevor Ariza,156,30.4,31,-0.600000000000001,62,67,-5,-6,1
21701218,101108,HOU,LAL,Chris Paul,123,27.2833333333333,27,0.283333333333331,58,58,0,2,-2
21701218,101123,HOU,LAL,Gerald Green,115,23.7666666666667,24,-0.233333333333334,61,49,12,13,-1
21701218,200782,HOU,LAL,PJ Tucker,110,22.4,22,0.399999999999999,41,47,-6,-9,3
21701218,201569,HOU,LAL,Eric Gordon,122,27.1333333333333,27,0.133333333333333,69,47,22,24,-2
21701218,201601,HOU,LAL,Luc Mbah a Moute,34,8.03333333333333,8,0.0333333333333332,17,18,-1,-4,3
21701218,201935,HOU,LAL,James Harden,147,30.6833333333333,31,-0.316666666666666,68,64,4,0,4
21701218,203991,HOU,LAL,Clint Capela,103,21.2,21,0.200000000000003,45,44,1,7,-6
21701218,204028,HOU,LAL,Tarik Black,53,9.85,10,-0.15,21,22,-1,-1,0
21701218,1627753,HOU,LAL,Zhou Qi,33,5.16666666666667,5,0.166666666666666,9,13,-4,-2,-2
21701218,1627817,HOU,LAL,Tim Quarterman,40,6.61666666666667,7,-0.383333333333333,9,19,-10,-10,0
21701218,101112,LAL,HOU,Channing Frye,71,15.2833333333333,15,0.283333333333333,34,37,-3,4,-7
21701218,201281,LAL,HOU,Andre Ingram,143,29.3,29,0.300000000000001,65,71,-6,-3,-3
21701218,201572,LAL,HOU,Brook Lopez,77,16.05,16,0.0500000000000007,32,27,5,4,1
21701218,203484,LAL,HOU,Kentavious Caldwell-Pope,101,21,21,0,41,43,-2,-5,3
21701218,203898,LAL,HOU,Tyler Ennis,110,23.45,23,0.450000000000003,49,55,-6,-2,-4
21701218,203944,LAL,HOU,Julius Randle,84,17.4666666666667,18,-0.533333333333331,34,31,3,-3,6
21701218,204037,LAL,HOU,Travis Wear,69,14.4333333333333,15,-0.566666666666666,34,41,-7,-7,0
21701218,1627780,LAL,HOU,Gary Payton II,39,8.26666666666667,8,0.266666666666666,11,20,-9,-9,0
21701218,1627826,LAL,HOU,Ivica Zubac,90,19.7833333333333,20,-0.216666666666669,36,44,-8,-3,-5
21701218,1627936,LAL,HOU,Alex Caruso,133,26.1333333333333,27,-0.866666666666667,61,48,13,12,1
21701218,1628404,LAL,HOU,Josh Hart,190,39.1166666666667,40,-0.883333333333333,76,82,-6,-9,3
21701218,1628418,LAL,HOU,Thomas Bryant,43,8.13333333333333,8,0.133333333333333,22,26,-4,-9,5
21701219,202328,BOS,BKN,Greg Monroe,98,20.65,21,-0.350000000000001,43,48,-5,-7,2
21701219,203382,BOS,BKN,Aron Baynes,107,20.3833333333333,20,0.383333333333333,51,31,20,22,-2
21701219,203499,BOS,BKN,Shane Larkin,135,25.75,26,-0.25,65,45,20,22,-2
21701219,1626780,BOS,BKN,Jonathan Gibson,117,24.15,25,-0.850000000000001,56,55,1,-3,4
21701219,1627824,BOS,BKN,Guerschon Yabusele,151,28.6,28,0.600000000000001,68,58,10,9,1
21701219,1627846,BOS,BKN,Abdel Nader,197,38.3666666666667,39,-0.633333333333333,94,74,20,20,0
21701219,1628400,BOS,BKN,Semi Ojeleye,137,28.0333333333333,28,0.0333333333333314,66,57,9,10,-1
21701219,1628443,BOS,BKN,Kadeem Allen,118,24.4166666666667,24,0.416666666666664,47,59,-12,-12,0
21701219,1628444,BOS,BKN,Jabari Bird,145,28.15,29,-0.850000000000001,60,58,2,4,-2
21701219,201967,BKN,BOS,Dante Cunningham,105,20.0666666666667,20,0.0666666666666664,43,54,-11,-10,-1
21701219,202389,BKN,BOS,Timofey Mozgov,45,9.06666666666667,9,0.0666666666666664,25,19,6,6,0
21701219,203112,BKN,BOS,Quincy Acy,126,23.9166666666667,24,-0.0833333333333357,57,61,-4,-4,0
21701219,203459,BKN,BOS,Allen Crabbe,129,25.3833333333333,26,-0.616666666666667,49,59,-10,-10,0
21701219,203917,BKN,BOS,Nik Stauskas,173,34.4333333333333,35,-0.566666666666663,74,85,-11,-12,1
21701219,1626156,BKN,BOS,D'Angelo Russell,119,23.05,23,0.0499999999999972,37,54,-17,-14,-3
21701219,1626178,BKN,BOS,Rondae Hollis-Jefferson,87,17.8166666666667,18,-0.183333333333334,29,35,-6,-8,2
21701219,1627747,BKN,BOS,Caris LeVert,145,28.85,29,-0.149999999999999,58,62,-4,-6,2
21701219,1627821,BKN,BOS,James Webb III,57,11.75,12,-0.25,27,27,0,0,0
21701219,1628386,BKN,BOS,Jarrett Allen,96,19.2333333333333,19,0.233333333333334,29,39,-10,-11,1
21701219,1628495,BKN,BOS,Milton Doyle,123,24.9333333333333,25,-0.0666666666666664,57,55,2,4,-2
21701220,2544,CLE,NYK,LeBron James,58,10.5333333333333,11,-0.466666666666667,20,15,5,5,0
21701220,2570,CLE,NYK,Kendrick Perkins,68,14.4666666666667,15,-0.533333333333335,39,36,3,3,0
21701220,2747,CLE,NYK,JR Smith,31,6.08333333333333,6,0.0833333333333339,8,16,-8,-10,2
21701220,101181,CLE,NYK,Jose Calderon,33,6.73333333333333,6,0.733333333333333,6,16,-10,-10,0
21701220,201145,CLE,NYK,Jeff Green,58,10.5333333333333,11,-0.466666666666667,20,15,5,5,0
21701220,201588,CLE,NYK,George Hill,50,8.7,9,-0.300000000000001,16,11,5,5,0
21701220,202684,CLE,NYK,Tristan Thompson,138,29.65,30,-0.350000000000001,52,76,-24,-24,0
21701220,203903,CLE,NYK,Jordan Clarkson,30,6.2,6,0.199999999999999,5,16,-11,-11,0
21701220,204066,CLE,NYK,John Holland,175,37.4,37,0.399999999999999,78,95,-17,-17,0
21701220,1626204,CLE,NYK,Larry Nance Jr.,58,10.5333333333333,11,-0.466666666666667,20,15,5,5,0
21701220,1626224,CLE,NYK,Cedi Osman,193,39.2666666666667,39,0.266666666666666,86,87,-1,1,-2
21701220,1627790,CLE,NYK,Ante Zizic,123,27.0666666666667,27,0.0666666666666664,64,69,-5,-5,0
21701220,1628506,CLE,NYK,London Perrantes,150,32.5,33,-0.5,76,83,-7,-7,0
21701220,101127,NYK,CLE,Jarrett Jack,88,18.8666666666667,19,-0.133333333333333,52,33,19,17,2
21701220,201563,NYK,CLE,Michael Beasley,110,21.1333333333333,21,0.133333333333333,39,42,-3,-3,0
21701220,202498,NYK,CLE,Lance Thomas,58,10.5333333333333,11,-0.466666666666667,15,20,-5,-5,0
21701220,203124,NYK,CLE,Kyle O'Quinn,92,17.3833333333333,18,-0.616666666666667,38,38,0,-2,2
21701220,203504,NYK,CLE,Trey Burke,200,42.35,42,0.350000000000001,105,91,14,14,0
21701220,1628373,NYK,CLE,Frank Ntilikina,182,37.1333333333333,37,0.133333333333333,81,80,1,1,0
21701220,1628422,NYK,CLE,Damyean Dotson,164,33.4666666666667,33,0.466666666666669,72,70,2,4,-2
21701220,1628436,NYK,CLE,Luke Kornet,133,28.5333333333333,28,0.533333333333331,67,58,9,11,-2
21701220,1628439,NYK,CLE,Isaiah Hicks,138,30.2666666666667,30,0.266666666666666,81,58,23,23,0
21701221,2548,MIA,TOR,Dwyane Wade,77,16.7,17,-0.300000000000001,35,40,-5,-5,0
21701221,201949,MIA,TOR,James Johnson,119,25.0166666666667,26,-0.983333333333334,46,49,-3,-4,1
21701221,201961,MIA,TOR,Wayne Ellington,159,35.5,35,0.5,86,69,17,18,-1
21701221,202355,MIA,TOR,Hassan Whiteside,100,21.9666666666667,22,-0.0333333333333314,41,44,-3,-5,2
21701221,203482,MIA,TOR,Kelly Olynyk,130,28.4,28,0.399999999999999,71,63,8,10,-2
21701221,203585,MIA,TOR,Rodney McGruder,85,17.8666666666667,18,-0.133333333333333,37,42,-5,-5,0
21701221,204020,MIA,TOR,Tyler Johnson,134,28.8666666666667,29,-0.133333333333333,61,59,2,0,2
21701221,1626159,MIA,TOR,Justise Winslow,167,37.2833333333333,37,0.283333333333331,84,74,10,13,-3
21701221,1626196,MIA,TOR,Josh Richardson,162,34.4166666666667,35,-0.583333333333336,66,70,-4,-3,-1
21701221,1628389,MIA,TOR,Bam Adebayo,82,18.2333333333333,18,0.233333333333334,48,35,13,16,-3
21701221,101139,TOR,MIA,CJ Miles,113,24.8,25,-0.200000000000003,44,49,-5,-6,1
21701221,200768,TOR,MIA,Kyle Lowry,173,37.35,38,-0.649999999999999,79,77,2,-1,3
21701221,201586,TOR,MIA,Serge Ibaka,118,25.2,25,0.199999999999999,57,52,5,5,0
21701221,201942,TOR,MIA,DeMar DeRozan,178,38.3666666666667,38,0.366666666666667,82,78,4,1,3
21701221,202685,TOR,MIA,Jonas Valanciunas,109,23.65,24,-0.350000000000001,47,47,0,0,0
21701221,1626153,TOR,MIA,Delon Wright,104,22.8333333333333,23,-0.166666666666664,37,52,-15,-14,-1
21701221,1626181,TOR,MIA,Norman Powell,8,2.11666666666667,2,0.116666666666667,6,7,-1,-1,0
21701221,1627751,TOR,MIA,Jakob Poeltl,134,29.2,29,0.200000000000003,62,68,-6,-7,1
21701221,1627783,TOR,MIA,Pascal Siakam,105,23.15,23,0.149999999999999,46,56,-10,-10,0
21701221,1627832,TOR,MIA,Fred VanVleet,84,18.7166666666667,19,-0.283333333333331,41,50,-9,-7,-2
21701221,1628384,TOR,MIA,OG Anunoby,89,18.8666666666667,19,-0.133333333333333,44,39,5,5,0
21701222,201167,ORL,WAS,Arron Afflalo,89,17.3,17,0.300000000000001,36,33,3,4,-1
21701222,201571,ORL,WAS,D.J. Augustin,53,12,12,0,26,23,3,3,0
21701222,201578,ORL,WAS,Marreese Speights,16,3.3,3,0.3,2,4,-2,-2,0
21701222,202687,ORL,WAS,Bismack Biyombo,54,11.45,12,-0.550000000000001,26,20,6,4,2
21701222,202696,ORL,WAS,Nikola Vucevic,53,12,12,0,26,23,3,3,0
21701222,202714,ORL,WAS,Shelvin Mack,96,20.2166666666667,20,0.216666666666665,41,38,3,2,1
21701222,203082,ORL,WAS,Terrence Ross,73,14.5166666666667,14,0.516666666666666,22,34,-12,-11,-1
21701222,203920,ORL,WAS,Khem Birch,162,32.4333333333333,33,-0.56666666666667,66,64,2,2,0
21701222,203932,ORL,WAS,Aaron Gordon,53,12,12,0,26,23,3,3,0
21701222,1626209,ORL,WAS,Mario Hezonja,159,32.1666666666667,32,0.166666666666664,78,66,12,15,-3
21701222,1628411,ORL,WAS,Wes Iwundu,114,24.9333333333333,25,-0.06666666666667,58,40,18,16,2
21701222,1628503,ORL,WAS,Jamel Artis,110,21.8,22,-0.199999999999999,42,47,-5,-5,0
21701222,1628681,ORL,WAS,Rodney Purvis,128,25.05,25,0.0499999999999972,56,45,11,11,0
21701222,101133,WAS,ORL,Ian Mahinmi,82,17.4833333333333,17,0.483333333333334,33,28,5,5,0
21701222,101162,WAS,ORL,Marcin Gortat,109,22.3666666666667,23,-0.633333333333333,46,56,-10,-10,0
21701222,201975,WAS,ORL,Jodie Meeks,98,19.2,19,0.199999999999999,34,40,-6,-6,0
21701222,202693,WAS,ORL,Markieff Morris,152,31.3833333333333,31,0.383333333333333,60,71,-11,-11,0
21701222,203078,WAS,ORL,Bradley Beal,170,36.1666666666667,36,0.166666666666664,65,81,-16,-16,0
21701222,203107,WAS,ORL,Tomas Satoransky,204,42.1666666666667,42,0.166666666666671,83,86,-3,-4,1
21701222,203118,WAS,ORL,Mike Scott,99,20.65,21,-0.350000000000001,42,37,5,5,0
21701222,204025,WAS,ORL,Tim Frazier,52,10.3,11,-0.699999999999999,21,25,-4,-3,-1
21701222,1626162,WAS,ORL,Kelly Oubre Jr.,125,26.3666666666667,27,-0.633333333333333,43,58,-15,-15,0
21701222,1628421,WAS,ORL,Devin Robinson,69,13.0833333333333,13,0.0833333333333322,33,23,10,10,0
21701223,1891,MIL,PHI,Jason Terry,28,4.76666666666667,5,-0.233333333333333,6,14,-8,-8,0
21701223,201943,MIL,PHI,Brandon Jennings,93,18.3166666666667,19,-0.683333333333334,37,41,-4,-4,0
21701223,202339,MIL,PHI,Eric Bledsoe,59,10.7333333333333,11,-0.266666666666666,23,27,-4,-4,0
21701223,203089,MIL,PHI,John Henson,91,17.7833333333333,18,-0.216666666666669,39,46,-7,-7,0
21701223,203092,MIL,PHI,Tyler Zeller,129,24.7833333333333,25,-0.216666666666669,48,63,-15,-15,0
21701223,203114,MIL,PHI,Khris Middleton,88,16.1,16,0.100000000000001,26,47,-21,-22,1
21701223,203503,MIL,PHI,Tony Snell,130,25.4,26,-0.600000000000001,48,67,-19,-18,-1
21701223,203507,MIL,PHI,Giannis Antetokounmpo,118,21.7333333333333,22,-0.266666666666666,43,69,-26,-26,0
21701223,203521,MIL,PHI,Matthew Dellavedova,50,10.7,10,0.699999999999999,23,33,-10,-10,0
21701223,203953,MIL,PHI,Jabari Parker,121,24.2333333333333,24,0.233333333333334,49,67,-18,-18,0
21701223,1627748,MIL,PHI,Thon Maker,64,12.7,13,-0.300000000000001,26,40,-14,-14,0
21701223,1627763,MIL,PHI,Malcolm Brogdon,96,18.6333333333333,18,0.633333333333333,36,52,-16,-14,-2
21701223,1628425,MIL,PHI,Sterling Brown,163,32.6166666666667,33,-0.383333333333333,71,84,-13,-15,2
21701223,101141,PHI,MIL,Ersan Ilyasova,96,18.05,18,0.0499999999999972,55,44,11,12,-1
21701223,101161,PHI,MIL,Amir Johnson,78,14.3166666666667,15,-0.683333333333334,39,24,15,15,0
21701223,201158,PHI,MIL,Marco Belinelli,108,20.05,20,0.0499999999999972,59,35,24,24,0
21701223,203496,PHI,MIL,Robert Covington,89,15.9166666666667,17,-1.08333333333333,50,32,18,17,1
21701223,203967,PHI,MIL,Dario Saric,143,28.4333333333333,28,0.433333333333334,73,46,27,27,0
21701223,204456,PHI,MIL,T.J. McConnell,143,28.5333333333333,28,0.533333333333331,75,62,13,15,-2
21701223,1626147,PHI,MIL,Justin Anderson,159,32.2166666666667,32,0.216666666666669,81,63,18,16,2
21701223,1626158,PHI,MIL,Richaun Holmes,135,26.6,27,-0.399999999999999,73,58,15,15,0
21701223,1627732,PHI,MIL,Ben Simmons,112,21.6,22,-0.399999999999999,56,43,13,15,-2
21701223,1627788,PHI,MIL,Furkan Korkmaz,38,7.56666666666667,8,-0.433333333333334,19,18,1,1,0
21701223,1628365,PHI,MIL,Markelle Fultz,129,25.2166666666667,25,0.216666666666665,70,50,20,18,2
21701224,201600,CHI,DET,Omer Asik,85,18.1,18,0.100000000000001,34,48,-14,-14,0
21701224,203930,CHI,DET,Sean Kilpatrick,126,28.8666666666667,29,-0.133333333333333,63,74,-11,-13,2
21701224,1626166,CHI,DET,Cameron Payne,150,32.9666666666667,33,-0.0333333333333314,64,83,-19,-19,0
21701224,1626170,CHI,DET,Jerian Grant,152,32.2333333333333,32,0.233333333333334,45,80,-35,-33,-2
21701224,1626171,CHI,DET,Bobby Portis,109,22.7333333333333,22,0.733333333333334,34,60,-26,-28,2
21701224,1626245,CHI,DET,Cristiano Felicio,136,29.8,30,-0.200000000000003,53,71,-18,-18,0
21701224,1627853,CHI,DET,Ryan Arcidiacono,113,23.8,24,-0.200000000000003,34,51,-17,-17,0
21701224,1628021,CHI,DET,David Nwaba,142,29.75,30,-0.25,58,76,-18,-18,0
21701224,1628374,CHI,DET,Lauri Markkanen,92,21.25,22,-0.75,50,52,-2,0,-2
21701224,201229,DET,CHI,Anthony Tolliver,121,26.9166666666667,27,-0.0833333333333322,74,58,16,16,0
21701224,202397,DET,CHI,Ish Smith,75,16.1833333333333,16,0.183333333333334,36,28,8,8,0
21701224,202704,DET,CHI,Reggie Jackson,129,28.6666666666667,29,-0.333333333333336,78,56,22,22,0
21701224,203516,DET,CHI,James Ennis III,100,21.4333333333333,21,0.433333333333334,51,36,15,19,-4
21701224,203687,DET,CHI,Reggie Hearn,17,3.05,3,0.0499999999999998,5,3,2,2,0
21701224,203961,DET,CHI,Eric Moreland,188,40.5833333333333,41,-0.416666666666671,96,72,24,24,0
21701224,204038,DET,CHI,Langston Galloway,90,19.5333333333333,20,-0.466666666666669,43,27,16,17,-1
21701224,1626169,DET,CHI,Stanley Johnson,90,20.7333333333333,21,-0.266666666666666,57,46,11,9,2
21701224,1627740,DET,CHI,Henry Ellenson,133,28.3,28,0.299999999999997,68,44,24,24,0
21701224,1627770,DET,CHI,Kay Felder,17,3.05,3,0.0499999999999998,5,3,2,2,0
21701224,1628379,DET,CHI,Luke Kennard,145,31.05,31,0.0499999999999972,82,62,20,17,3
21701225,2734,DEN,MIN,Devin Harris,42,10.2833333333333,10,0.283333333333333,21,20,1,1,0
21701225,200794,DEN,MIN,Paul Millsap,146,35.8833333333333,36,-0.116666666666667,78,78,0,0,0
21701225,201163,DEN,MIN,Wilson Chandler,198,48.4333333333333,48,0.43333333333333,101,100,1,1,0
21701225,203115,DEN,MIN,Will Barton,175,42.6166666666667,42,0.616666666666667,86,87,-1,-2,1
21701225,203486,DEN,MIN,Mason Plumlee,57,12.3,12,0.300000000000001,14,27,-13,-14,1
21701225,203914,DEN,MIN,Gary Harris,94,21.1333333333333,21,0.133333333333333,33,48,-15,-18,3
21701225,203999,DEN,MIN,Nikola Jokic,191,46.2,46,0.200000000000003,99,97,2,7,-5
21701225,1627750,DEN,MIN,Jamal Murray,177,42.6,43,-0.400000000000006,85,92,-7,-5,-2
21701225,1628470,DEN,MIN,Torrey Craig,20,4.8,5,-0.2,13,11,2,0,2
21701225,2037,MIN,DEN,Jamal Crawford,73,17.0333333333333,18,-0.966666666666669,36,28,8,13,-5
21701225,201565,MIN,DEN,Derrick Rose,46,11.25,11,0.25,26,19,7,7,0
21701225,201952,MIN,DEN,Jeff Teague,180,42.8,43,-0.200000000000003,91,89,2,-1,3
21701225,201959,MIN,DEN,Taj Gibson,145,35.3666666666667,35,0.366666666666667,74,76,-2,-5,3
21701225,202357,MIN,DEN,Nemanja Bjelica,49,10.7833333333333,11,-0.216666666666667,23,17,6,7,-1
21701225,202710,MIN,DEN,Jimmy Butler,170,41.95,42,-0.0499999999999972,89,89,0,-1,1
21701225,203476,MIN,DEN,Gorgui Dieng,27,6.21666666666667,6,0.216666666666667,12,9,3,5,-2
21701225,203952,MIN,DEN,Andrew Wiggins,177,42.1666666666667,42,0.166666666666664,88,89,-1,-3,2
21701225,1626145,MIN,DEN,Tyus Jones,40,10.05,10,0.0500000000000007,21,17,4,7,-3
21701225,1626157,MIN,DEN,Karl-Anthony Towns,193,46.6333333333333,47,-0.366666666666667,100,97,3,1,2
21701226,200765,NOP,SAS,Rajon Rondo,162,31.6333333333333,32,-0.366666666666667,80,59,21,23,-2
21701226,201950,NOP,SAS,Jrue Holiday,166,33.9666666666667,34,-0.0333333333333314,82,63,19,15,4
21701226,202348,NOP,SAS,Jordan Crawford,17,3,3,0,11,12,-1,1,-2
21701226,202703,NOP,SAS,Nikola Mirotic,177,34.3333333333333,34,0.333333333333329,88,67,21,21,0
21701226,202732,NOP,SAS,DeAndre Liggins,12,2.2,3,-0.8,11,6,5,5,0
21701226,202734,NOP,SAS,E'Twaun Moore,125,24.9333333333333,25,-0.0666666666666664,64,45,19,19,0
21701226,203076,NOP,SAS,Anthony Davis,171,35.2666666666667,35,0.266666666666666,80,65,15,14,1
21701226,203121,NOP,SAS,Darius Miller,105,20.3166666666667,21,-0.683333333333334,55,50,5,5,0
21701226,203524,NOP,SAS,Solomon Hill,97,19.3,19,0.300000000000001,49,44,5,6,-1
21701226,203546,NOP,SAS,Ian Clark,141,28.1833333333333,28,0.183333333333334,72,63,9,7,2
21701226,1627767,NOP,SAS,Cheick Diallo,23,4.1,4,0.0999999999999996,16,14,2,2,0
21701226,1628429,NOP,SAS,Charles Cooke,4,0.766666666666667,1,-0.233333333333333,2,2,0,2,-2
21701226,1938,SAS,NOP,Manu Ginobili,55,12.0333333333333,12,0.0333333333333332,25,32,-7,-7,0
21701226,2200,SAS,NOP,Pau Gasol,72,14.1,14,0.0999999999999996,26,29,-3,-2,-1
21701226,2225,SAS,NOP,Tony Parker,99,19.9833333333333,20,-0.0166666666666657,43,53,-10,-10,0
21701226,200746,SAS,NOP,LaMarcus Aldridge,111,22.55,23,-0.450000000000003,41,56,-15,-16,1
21701226,200752,SAS,NOP,Rudy Gay,121,23.9,24,-0.100000000000001,55,61,-6,-6,0
21701226,201980,SAS,NOP,Danny Green,98,19.4666666666667,20,-0.533333333333331,39,45,-6,-8,2
21701226,201988,SAS,NOP,Patty Mills,104,20.55,21,-0.449999999999999,33,51,-18,-18,0
21701226,202722,SAS,NOP,Davis Bertans,54,10.35,11,-0.65,26,32,-6,-6,0
21701226,203464,SAS,NOP,Brandon Paul,84,15.5333333333333,16,-0.466666666666667,36,43,-7,-9,2
21701226,203530,SAS,NOP,Joffrey Lauvergne,47,9.08333333333333,9,0.0833333333333322,22,29,-7,-7,0
21701226,203937,SAS,NOP,Kyle Anderson,90,17.9,18,-0.100000000000001,35,46,-11,-11,0
21701226,1627749,SAS,NOP,Dejounte Murray,146,28.8666666666667,29,-0.133333333333333,55,69,-14,-14,0
21701226,1627854,SAS,NOP,Bryn Forbes,119,23.6833333333333,24,-0.31666666666667,54,64,-10,-6,-4
21701227,2546,OKC,MEM,Carmelo Anthony,116,23.2333333333333,23,0.233333333333334,64,59,5,5,0
21701227,2555,OKC,MEM,Nick Collison,12,2.3,2,0.3,4,7,-3,-5,2
21701227,101109,OKC,MEM,Raymond Felton,53,11.5,12,-0.5,31,29,2,-1,3
21701227,201147,OKC,MEM,Corey Brewer,153,31.3833333333333,31,0.383333333333333,95,85,10,10,0
21701227,201566,OKC,MEM,Russell Westbrook,188,37.4833333333333,37,0.483333333333334,106,93,13,17,-4
21701227,202331,OKC,MEM,Paul George,172,34.0833333333333,34,0.0833333333333286,96,83,13,15,-2
21701227,202335,OKC,MEM,Patrick Patterson,53,11.3333333333333,12,-0.666666666666666,28,26,2,1,1
21701227,203500,OKC,MEM,Steven Adams,185,36.7166666666667,36,0.716666666666669,108,91,17,17,0
21701227,203924,OKC,MEM,Jerami Grant,106,21.7166666666667,22,-0.283333333333331,66,56,10,11,-1
21701227,203962,OKC,MEM,Josh Huestis,7,1.33333333333333,2,-0.666666666666667,4,7,-3,-3,0
21701227,1626177,OKC,MEM,Dakari Johnson,7,1.33333333333333,2,-0.666666666666667,4,7,-3,-3,0
21701227,1627772,OKC,MEM,Daniel Hamilton,7,1.33333333333333,2,-0.666666666666667,4,7,-3,-3,0
21701227,1628390,OKC,MEM,Terrance Ferguson,126,25.4166666666667,26,-0.583333333333332,75,65,10,9,1
21701227,201596,MEM,OKC,Mario Chalmers,99,20.5,20,0.5,46,52,-6,-4,-2
21701227,202705,MEM,OKC,MarShon Brooks,110,22.65,23,-0.350000000000001,63,68,-5,-4,-1
21701227,203463,MEM,OKC,Ben McLemore,160,31.75,32,-0.25,75,97,-22,-22,0
21701227,204179,MEM,OKC,Omari Johnson,118,24.6833333333333,25,-0.316666666666666,75,79,-4,-5,1
21701227,1627738,MEM,OKC,Deyonta Davis,146,29.3166666666667,29,0.316666666666666,71,77,-6,-5,-1
21701227,1627988,MEM,OKC,Myke Henry,61,12.8333333333333,13,-0.166666666666668,29,38,-9,-7,-2
21701227,1628397,MEM,OKC,Ivan Rabb,154,31.4833333333333,32,-0.516666666666669,77,91,-14,-14,0
21701227,1628415,MEM,OKC,Dillon Brooks,168,32.95,33,-0.0500000000000043,91,88,3,0,3
21701227,1628424,MEM,OKC,Kobi Simmons,169,33,33,0,88,95,-7,-9,2
21701228,201599,LAC,LAL,DeAndre Jordan,106,22.7833333333333,23,-0.216666666666669,49,61,-12,-15,3
21701228,202325,LAC,LAL,Wesley Johnson,77,15.95,16,-0.0500000000000007,42,43,-1,-1,0
21701228,202699,LAC,LAL,Tobias Harris,125,26.9666666666667,27,-0.0333333333333314,58,81,-23,-23,0
21701228,203085,LAC,LAL,Austin Rivers,89,19.5666666666667,20,-0.433333333333334,44,52,-8,-8,0
21701228,203710,LAC,LAL,C.J. Williams,144,29.3166666666667,29,0.316666666666666,58,67,-9,-9,0
21701228,1626149,LAC,LAL,Montrezl Harrell,123,25.1666666666667,25,0.166666666666664,51,54,-3,0,-3
21701228,1626155,LAC,LAL,Sam Dekker,120,24.35,24,0.350000000000001,48,39,9,9,0
21701228,1626246,LAC,LAL,Boban Marjanovic,64,12.65,13,-0.350000000000001,28,23,5,5,0
21701228,1627820,LAC,LAL,Tyrone Wallace,134,28.3,28,0.300000000000001,48,63,-15,-15,0
21701228,1628414,LAC,LAL,Sindarius Thornwell,163,34.7,35,-0.299999999999997,74,92,-18,-18,0
21701228,201281,LAL,LAC,Andre Ingram,165,34.9166666666667,35,-0.0833333333333357,90,67,23,23,0
21701228,201572,LAL,LAC,Brook Lopez,75,16.25,17,-0.75,47,39,8,8,0
21701228,203484,LAL,LAC,Kentavious Caldwell-Pope,8,1.98333333333333,2,-0.0166666666666666,4,8,-4,-4,0
21701228,203898,LAL,LAC,Tyler Ennis,112,23.1333333333333,23,0.133333333333333,38,43,-5,-7,2
21701228,203944,LAL,LAC,Julius Randle,75,16.25,17,-0.75,47,39,8,8,0
21701228,204037,LAL,LAC,Travis Wear,71,14.7,15,-0.300000000000001,26,28,-2,-2,0
21701228,1627780,LAL,LAC,Gary Payton II,150,30.8,30,0.800000000000001,80,60,20,22,-2
21701228,1627826,LAL,LAC,Ivica Zubac,90,18.7166666666667,18,0.716666666666669,38,36,2,2,0
21701228,1627936,LAL,LAC,Alex Caruso,137,28.8166666666667,29,-0.183333333333334,87,66,21,21,0
21701228,1628404,LAL,LAC,Josh Hart,169,35.95,36,-0.0499999999999972,84,75,9,9,0
21701228,1628418,LAL,LAC,Thomas Bryant,93,18.2333333333333,18,0.233333333333334,34,39,-5,-5,0
21701229,202323,POR,UTA,Evan Turner,140,27.7833333333333,28,-0.216666666666669,61,57,4,3,1
21701229,202329,POR,UTA,Al-Farouq Aminu,149,28.8833333333333,30,-1.11666666666667,64,66,-2,3,-5
21701229,202334,POR,UTA,Ed Davis,74,17.7666666666667,17,0.766666666666666,35,24,11,7,4
21701229,203081,POR,UTA,Damian Lillard,182,36.6333333333333,37,-0.366666666666667,83,72,11,10,1
21701229,203468,POR,UTA,CJ McCollum,167,34.8166666666667,35,-0.183333333333337,75,68,7,4,3
21701229,203894,POR,UTA,Shabazz Napier,59,13.7833333333333,14,-0.216666666666667,24,20,4,3,1
21701229,203994,POR,UTA,Jusuf Nurkic,149,28.8833333333333,30,-1.11666666666667,64,66,-2,3,-5
21701229,1626192,POR,UTA,Pat Connaughton,66,16.15,16,0.149999999999999,29,29,0,3,-3
21701229,1627735,POR,UTA,Wade Baldwin IV,63,12.9166666666667,13,-0.0833333333333322,31,30,1,5,-4
21701229,1627774,POR,UTA,Jake Layman,4,1.06666666666667,1,0.0666666666666667,3,3,0,-1,1
21701229,1628380,POR,UTA,Zach Collins,78,18.8333333333333,18,0.833333333333332,38,27,11,6,5
21701229,1628403,POR,UTA,Caleb Swanigan,4,1.06666666666667,1,0.0666666666666667,3,3,0,-1,1
21701229,201937,UTA,POR,Ricky Rubio,117,23.6333333333333,24,-0.366666666666667,44,54,-10,-10,0
21701229,201973,UTA,POR,Jonas Jerebko,44,9.4,10,-0.6,21,21,0,0,0
21701229,202324,UTA,POR,Derrick Favors,121,27.2166666666667,27,0.216666666666669,40,58,-18,-15,-3
21701229,202327,UTA,POR,Ekpe Udoh,14,2.81666666666667,3,-0.183333333333334,10,4,6,3,3
21701229,203109,UTA,POR,Jae Crowder,126,26.85,27,-0.149999999999999,54,58,-4,-6,2
21701229,203497,UTA,POR,Rudy Gobert,159,31.4166666666667,32,-0.583333333333336,63,71,-8,-6,-2
21701229,203526,UTA,POR,Raul Neto,49,10.5833333333333,11,-0.416666666666668,25,18,7,8,-1
21701229,203957,UTA,POR,Dante Exum,91,20.3666666666667,20,0.366666666666667,37,42,-5,-10,5
21701229,204060,UTA,POR,Joe Ingles,131,27.5,28,-0.5,54,59,-5,-3,-2
21701229,1626220,UTA,POR,Royce O'Neale,120,25.45,25,0.449999999999999,49,52,-3,-4,1
21701229,1628378,UTA,POR,Donovan Mitchell,163,33.35,34,-0.650000000000006,68,73,-5,-2,-3
21701230,2207,HOU,SAC,Joe Johnson,110,25.8,29,-3.2,44,57,-13,-17,4
21701230,101123,HOU,SAC,Gerald Green,88,19.45,26,-6.55,38,43,-5,-5,0
21701230,200782,HOU,SAC,PJ Tucker,130,29.4,29,0.399999999999999,54,62,-8,-8,0
21701230,204028,HOU,SAC,Tarik Black,163,37.85,38,-0.149999999999999,63,70,-7,-8,1
21701230,1626154,HOU,SAC,RJ Hunter,128,29.7333333333333,30,-0.266666666666666,56,57,-1,0,-1
21701230,1627753,HOU,SAC,Zhou Qi,136,31,32,-1,53,63,-10,-9,-1
21701230,1627778,HOU,SAC,Chinanu Onuaku,91,20.8666666666667,22,-1.13333333333333,32,40,-8,-8,0
21701230,1628935,HOU,SAC,Aaron Jackson,153,35.6333333333333,35,0.633333333333333,61,68,-7,-10,3
21701230,1713,SAC,HOU,Vince Carter,104,24.65,25,-0.350000000000001,52,36,16,14,2
21701230,203960,SAC,HOU,JaKarr Sampson,101,22.4333333333333,23,-0.56666666666667,44,44,0,0,0
21701230,203992,SAC,HOU,Bogdan Bogdanovic,133,29.75,31,-1.25,65,49,16,18,-2
21701230,204022,SAC,HOU,Jack Cooley,80,18.1333333333333,18,0.133333333333333,40,30,10,12,-2
21701230,1626161,SAC,HOU,Willie Cauley-Stein,130,30.25,30,0.25,56,55,1,3,-2
21701230,1627741,SAC,HOU,Buddy Hield,120,27.6833333333333,28,-0.31666666666667,57,49,8,6,2
21701230,1628368,SAC,HOU,De'Aaron Fox,120,27.4166666666667,27,0.416666666666664,59,53,6,6,0
21701230,1628382,SAC,HOU,Justin Jackson,134,30.9333333333333,31,-0.0666666666666664,53,60,-7,-7,0
21701230,1628502,SAC,HOU,Nigel Hayes,113,26.6666666666667,27,-0.333333333333336,54,39,15,13,2
21701230,1962937798,,,,36,8.18333333333333,,,14,20,-6,,
