name,id,orapm,drapm,rapm,orapm_rnk,drapm_rnk,rapm_rnk,gp_total,poss_o,poss_d,poss_total,mp_o,mp_d,mp_total,pts_o,pts_d,pm,pts_o_per100,pts_o_per36
Jordan Crawford,202348,6.54477103133177,8.91773662229967,15.4625076536314,5,1,1,5,108,120,228,25.7666666666667,28.1,53.8666666666667,138,160,-22,60.5263157894737,92.2277227722772
Omari Johnson,204179,6.55184674781855,3.57154168929402,10.1233884371126,4,11,2,4,144,150,294,35.7666666666667,38.3166666666667,74.0833333333333,193,176,17,65.6462585034014,93.7862767154106
Darrun Hilliard,1626199,4.49666847536162,4.2515458371654,8.74821431252702,8,9,3,14,180,185,365,46.15,46.35,92.5,218,221,-3,59.7260273972603,84.8432432432433
D.J. Wilson,1628391,-1.96014474680325,8.33351718058467,6.37337243378143,426,2,4,21,130,122,252,35.3666666666667,33.5166666666667,68.8833333333333,139,161,-22,55.1587301587302,72.6445681103315
MarShon Brooks,202705,5.91774124264991,-0.0560668749011334,5.86167436774878,7,249,5,7,368,397,765,94.05,98.0333333333333,192.083333333333,486,433,53,63.5294117647059,91.0854663774404
Meyers Leonard,203086,3.56167744578771,2.2750896107665,5.83676705655421,14,26,6,33,497,492,989,125.3,127.683333333333,252.983333333333,588,571,17,59.4539939332659,83.6734962777522
London Perrantes,1628506,1.0762542559367,4.67430019078343,5.75055444672012,86,7,7,14,130,119,249,31.9333333333333,31,62.9333333333333,147,154,-7,59.0361445783133,84.0889830508475
Georgios Papagiannis,1627834,2.69187262985628,2.90632619313248,5.59819882298877,23,18,8,17,240,246,486,58.55,62.4333333333333,120.983333333333,291,285,6,59.8765432098766,86.5904394544703
Thomas Bryant,1628418,3.93569712172611,1.47947011484117,5.41516723656728,11,54,9,15,139,140,279,33.1833333333333,38.3,71.4833333333334,163,161,2,58.4229390681004,82.0890650501282
Jalen Jones,1627883,0.857039387392233,4.53269273544407,5.3897321228363,107,8,10,14,362,356,718,88.0166666666667,92.1333333333333,180.15,391,438,-47,54.4568245125348,78.1348875936719
Alfonzo McKinnie,1628035,-2.64250229326371,7.99066797467573,5.34816568141202,447,3,11,13,120,99,219,28.35,23.3,51.65,121,132,-11,55.2511415525114,84.3368828654405
Stephen Curry,201939,1.57775472615493,3.48713178585762,5.06488651201255,52,13,12,51,3359,3432,6791,778.583333333333,835.983333333333,1614.56666666667,3930,4200,-270,57.8707112354587,87.6272271197638
Bobby Brown,201628,2.91729783308157,1.66434344282316,4.58164127590473,20,44,13,20,219,228,447,55.5666666666667,57.25,112.816666666667,261,256,5,58.3892617449665,83.2855665534052
Jabari Bird,1628444,8.46632584557945,-4.16535384817613,4.30097199740332,2,478,14,13,227,224,451,57.8833333333333,55.5333333333333,113.416666666667,287,226,61,63.6363636363636,91.0977222630419
Omer Asik,201600,2.95585825061268,1.34232826301525,4.29818651362793,19,66,15,18,340,363,703,85.6,95.4833333333333,181.083333333333,412,414,-2,58.6059743954481,81.907040957202
Andre Ingram,201281,-3.84912144659102,7.95823580995334,4.10911436336232,467,4,16,2,125,126,251,32.85,31.3666666666667,64.2166666666667,130,163,-33,51.792828685259,72.8782766675318
Chandler Parsons,202718,3.28340210566483,0.797866405181865,4.08126851084669,16,114,17,36,1324,1313,2637,337.383333333333,350.2,687.583333333333,1587,1472,115,60.1820250284414,83.0910192703915
Briante Weber,1627362,2.10768718155577,1.71015919591319,3.81784637746896,30,43,18,18,465,481,946,114.866666666667,120.583333333333,235.45,551,555,-4,58.2452431289641,84.2471862391166
Trey Burke,203504,1.71577571700122,1.982197890995,3.69797360799622,46,36,19,36,1580,1580,3160,394.266666666667,383.483333333333,777.75,1807,1840,-33,57.1835443037975,83.6412729026037
Rodney McGruder,203585,0.118948938812456,3.48994971914639,3.60889865795885,210,12,20,18,589,574,1163,149.733333333333,147.85,297.583333333333,650,684,-34,55.8899398108341,78.6334360123215
Wade Baldwin IV,1627735,0.21974740782828,3.19783104106194,3.41757844889022,190,16,21,7,149,151,300,39.45,40.5666666666667,80.0166666666667,165,181,-16,55,74.234534471985
Shaquille Harrison,1627885,-0.291534505512655,3.69745914950697,3.40592464399431,285,10,22,23,777,765,1542,190.366666666667,191.766666666667,382.133333333333,846,913,-67,54.863813229572,79.6999302163294
Aaron Brooks,201166,0.637632835757704,2.69622280353707,3.33385563929478,134,21,23,31,369,361,730,89.2833333333333,96.6333333333333,185.916666666667,426,430,-4,58.3561643835617,82.4885701479157
Boban Marjanovic,1626246,2.06120468774804,1.26135457108275,3.32255925883079,32,71,24,37,668,669,1337,166.05,169.35,335.4,778,759,19,58.1899775617053,83.5062611806798
LeBron James,2544,1.70770792004935,1.59896558925961,3.30667350930897,47,47,25,82,5971,6034,12005,1495.13333333333,1501.43333333333,2996.56666666667,7070,7050,20,58.8921282798834,84.9372059134343
Ante Zizic,1627790,1.01111164544109,2.17845628167378,3.18956792711487,90,28,26,32,422,425,847,102.1,106.933333333333,209.033333333333,492,509,-17,58.0873671782763,84.7328974645192
Jamal Murray,1627750,2.14016648683175,0.979820936815869,3.11998742364762,29,95,27,81,4963,5014,9977,1250.2,1274.46666666667,2524.66666666667,5909,5729,180,59.2262203067054,84.2582519144442
Kelly Olynyk,203482,1.54005071024246,1.51920364824342,3.05925435848588,54,50,28,76,3416,3282,6698,894.75,871.683333333333,1766.43333333333,3905,3742,163,58.3009853687668,79.5840960126809
Lou Williams,101150,1.09861280084347,1.88231159643515,2.98092439727863,84,39,29,79,5310,5282,10592,1284.9,1294.15,2579.05,6088,6112,-24,57.4773413897281,84.9801283418313
Larry Drew II,203580,4.19434622429767,-1.30106137458621,2.89328484971146,9,409,30,10,129,138,267,31.5333333333333,37,68.5333333333333,155,150,5,58.0524344569288,81.420233463035
Troy Williams,1627786,6.16556444665358,-3.27895168268527,2.88661276396831,6,469,31,21,613,631,1244,150.033333333333,154.6,304.633333333333,764,662,102,61.4147909967846,90.2855892329577
James Harden,201935,1.88856811694621,0.875606718212551,2.76417483515876,41,102,32,72,4943,4991,9934,1239.76666666667,1277.7,2517.46666666667,5862,5728,134,59.0094624521844,83.8271278004343
Darrell Arthur,201589,0.215323903552142,2.50173425102576,2.7170581545779,191,23,33,18,273,280,553,68.85,70.2,139.05,313,326,-13,56.6003616636528,81.0355987055016
Kevin Love,201567,2.25406931348471,0.439634739194169,2.69370405267888,25,160,34,59,3181,3247,6428,809.666666666667,814.533333333333,1624.2,3812,3757,55,59.3030491599253,84.4920576283709
Chris Paul,101108,1.98985179299971,0.661055815610832,2.65090760861054,36,135,35,58,3582,3581,7163,907.466666666667,910.833333333333,1818.3,4250,4102,148,59.332681837219,84.1445306055107
Thon Maker,1627748,1.23648995612707,1.35858231250694,2.595072268634,75,64,36,74,2314,2386,4700,603.966666666667,628.533333333333,1232.5,2704,2758,-54,57.531914893617,78.9809330628803
Channing Frye,101112,2.76187895047546,-0.171694731680605,2.59018421879486,22,272,37,53,1344,1394,2738,339.1,352.916666666667,692.016666666667,1609,1531,78,58.7655222790358,83.7031863394427
Furkan Korkmaz,1627788,8.90044323120672,-6.31145467685718,2.58898855434953,1,484,38,14,166,166,332,38.6166666666667,39.8666666666667,78.4833333333334,217,157,60,65.3614457831325,99.5370566999363
Shabazz Muhammad,203498,0.790170439399999,1.74983709506846,2.54000753446846,113,42,39,43,817,818,1635,204.466666666667,207.633333333333,412.1,944,948,-4,57.737003058104,82.4654210143169
Derrick Walton Jr.,1628476,1.64250400401366,0.890399259465989,2.53290326347965,51,101,40,16,274,284,558,72.8166666666667,73.75,146.566666666667,309,321,-12,55.3763440860215,75.8972026381624
Kevin Durant,201142,1.20428446862688,1.31851657904752,2.52280104767439,77,68,41,68,4657,4840,9497,1105.81666666667,1198.91666666667,2304.73333333333,5415,5669,-254,57.0180056860061,84.5824535014897
John Holland,204066,1.29119190029108,1.21600770497195,2.50719960526302,70,75,42,24,333,362,695,81.1166666666667,91.3833333333333,172.5,386,426,-40,55.5395683453238,80.5565217391304
Tony Snell,203503,0.650503639580479,1.78410194976029,2.43460558934077,131,41,43,75,3942,3936,7878,1005.46666666667,1018.4,2023.86666666667,4613,4545,68,58.5554709317086,82.054812569998
Kobi Simmons,1628424,3.68212324510991,-1.26222253033151,2.4199007147784,12,403,44,32,1241,1264,2505,313.316666666667,323.15,636.466666666667,1530,1340,190,61.0778443113773,86.5402744317587
Isaiah Thomas,202738,-0.663957881919588,3.03872302994133,2.37476514802174,339,17,45,32,1755,1816,3571,417.283333333333,439.266666666667,856.55,1956,2175,-219,54.7745729487539,82.2088611289475
Marcus Georges-Hunt,1627875,2.83925987274807,-0.48699960863937,2.3522602641087,21,328,46,40,450,459,909,106.866666666667,115.966666666667,222.833333333333,542,514,28,59.6259625962596,87.5632011967091
Darren Collison,201954,0.945842828320412,1.32323064023862,2.26907346855904,95,67,47,69,3895,3894,7789,983.816666666667,1001.65,1985.46666666667,4389,4511,-122,56.3486968802157,79.5802833926533
Derrick Rose,201565,1.1672268341979,0.996563269661072,2.16379010385898,80,94,48,25,834,859,1693,199.716666666667,213.5,413.216666666667,989,998,-9,58.4170112226816,86.1630298874682
Jamal Crawford,2037,0.711254798329098,1.43646140995736,2.14771620828646,118,57,49,80,3222,3243,6465,809.016666666667,844.333333333333,1653.35,3699,3766,-67,57.215777262181,80.5419300208667
Jordan Mickey,1626175,2.05004653108537,0.0660677615286188,2.11611429261398,34,221,50,23,525,544,1069,137.95,144.366666666667,282.316666666667,604,605,-1,56.5014031805426,77.0198949170553
J.J. Barea,200826,1.37930319164376,0.732726141258383,2.11202933290215,64,120,51,69,3080,3074,6154,821.9,774.066666666667,1595.96666666667,3519,3494,25,57.182320441989,79.3775976941874
Xavier Rathan-Mayes,1628504,6.58540815705901,-4.5022271487525,2.08318100830651,3,479,52,5,224,229,453,57.8,60.7333333333333,118.533333333333,290,224,66,64.0176600441501,88.0764904386952
Zach LaVine,203897,0.0707473422949955,2.00018794427728,2.07093528657227,219,34,53,24,1312,1289,2601,315.966666666667,326.233333333333,642.2,1443,1522,-79,55.4786620530565,80.8906882591093
Myke Henry,1627988,1.26947205737847,0.801256867663242,2.07072892504171,73,112,54,20,718,741,1459,182.45,193.083333333333,375.533333333333,852,818,34,58.3961617546265,81.67583880703
Jason Terry,1891,1.46247010345982,0.59634678407438,2.0588168875342,60,144,55,49,1541,1564,3105,398.983333333333,406.883333333333,805.866666666667,1806,1755,51,58.1642512077295,80.6783587028458
Khris Middleton,203114,1.24959464614881,0.798603550897725,2.04819819704653,74,113,56,82,5723,5738,11461,1468,1475.23333333333,2943.23333333333,6739,6529,210,58.7994066835355,82.4277155509247
Greg Monroe,202328,1.14949845365884,0.872091962977999,2.02159041663684,82,103,57,51,2014,2054,4068,516.683333333333,518,1034.68333333333,2302,2298,4,56.5880039331367,80.0940706496352
Gian Clavell,1628492,2.0749670022542,-0.0544890906829246,2.02047791157128,31,248,58,7,129,120,249,34.45,31.8833333333333,66.3333333333333,150,133,17,60.2409638554217,81.4070351758794
Cedi Osman,1626224,1.33527824540433,0.674463599314244,2.00974184471857,65,131,59,59,1334,1330,2664,326.3,334.033333333333,660.333333333333,1564,1525,39,58.7087087087087,85.2660272589601
Frank Kaminsky,1626163,2.18129900353149,-0.176328300112043,2.00497070341944,28,273,60,79,3530,3736,7266,882.45,952.633333333333,1835.08333333333,4179,4077,102,57.514450867052,81.9821079878298
DeMarcus Cousins,202326,-0.551248643612398,2.53735691112955,1.98610826751715,322,22,61,48,3318,3416,6734,826.816666666667,875.1,1701.91666666667,3689,4035,-346,54.7817047817048,78.0320227194829
JR Smith,2747,0.427899357833357,1.5381478284234,1.96604718625676,154,48,62,80,4406,4457,8863,1107.41666666667,1106.68333333333,2214.1,5114,5250,-136,57.7005528602054,83.150715866492
Dirk Nowitzki,1717,1.08522717803804,0.855612223976955,1.94083940201499,85,104,63,77,3632,3645,7277,959.8,899.35,1859.15,4112,4172,-60,56.506802253676,79.6234838501466
Willie Reed,203186,-0.0762987795655715,2.01358053334379,1.93728175377822,247,33,64,41,868,833,1701,215.533333333333,208.383333333333,423.916666666667,973,968,5,57.201646090535,82.6294476115589
Juancho Hernangomez,1627823,1.6733065035214,0.250513293624296,1.9238197971457,49,188,65,25,535,542,1077,135.35,135.8,271.15,632,604,28,58.6815227483751,83.9092753088696
Bobby Portis,1626171,0.394157603188623,1.51936951404707,1.91352711723569,160,49,66,73,3369,3237,6606,811.616666666667,830.983333333333,1642.6,3697,3785,-88,55.9642749016046,81.0252039449653
Austin Rivers,203085,0.889760762112158,1.02304755209596,1.91280831420812,104,93,67,61,4027,4090,8117,1006.2,1014.68333333333,2020.88333333333,4598,4671,-73,56.6465442897622,81.90873627869
Alex Poythress,1627816,0.429064819874158,1.47898601694238,1.90805083681654,153,55,68,25,213,210,423,50.45,52.2833333333333,102.733333333333,235,242,-7,55.5555555555556,82.3491239454899
Jose Calderon,101181,1.94229851322906,-0.0463451319467279,1.89595338128233,40,246,69,57,1723,1734,3457,453.683333333333,434.533333333333,888.216666666667,2058,1986,72,59.5313855944461,83.4120803857918
Abdel Nader,1627846,0.380031793152915,1.51263835626632,1.89267014941924,164,52,70,47,1005,1019,2024,258.233333333333,258.733333333333,516.966666666667,1108,1142,-34,54.7430830039526,77.1577793539235
Jameer Nelson,2749,1.9679227272992,-0.0927515560362201,1.87517117126298,38,255,71,50,1949,1998,3947,499.7,510.783333333333,1010.48333333333,2261,2257,4,57.284013174563,80.5515512378565
Jonathon Simmons,203613,1.2918536448467,0.578490956084402,1.8703446009311,69,146,72,69,4003,4048,8051,991.516666666667,1016.15,2007.66666666667,4597,4536,61,57.0984970811079,82.4300182633239
Mirza Teletovic,203141,-0.415342302627112,2.24615725787106,1.83081495524395,306,27,73,10,290,302,592,77.3166666666667,80.9166666666667,158.233333333333,327,352,-25,55.2364864864865,74.396460922688
Evan Fournier,203095,0.579345849604504,1.19979149762643,1.77913734723093,141,77,74,57,3694,3700,7394,911.15,908.2,1819.35,4212,4211,1,56.9651068433865,83.3440514469453
D'Angelo Russell,1626156,0.263865459564381,1.48618249900025,1.75004795856463,187,53,75,48,2554,2522,5076,605.083333333333,611.233333333333,1216.31666666667,2855,2898,-43,56.2450748620961,84.501020841612
Luke Babbitt,202337,0.356757398845186,1.37318289695282,1.72994029579801,170,62,76,50,1386,1404,2790,352.333333333333,350.65,702.983333333333,1554,1621,-67,55.6989247311828,79.5808340643448
George Hill,201588,2.25020481982372,-0.528573400059074,1.72163141976465,26,333,77,67,3445,3528,6973,871.233333333333,910.966666666667,1782.2,4103,3882,221,58.8412448013767,82.8795870272697
JaVale McGee,201580,1.39995153747658,0.302506337168862,1.70245787464544,63,182,78,65,1227,1255,2482,290.083333333333,317.566666666667,607.65,1444,1418,26,58.1788879935536,85.5492470994816
Josh Magette,203705,1.52655457778758,0.16297816834602,1.6895327461336,55,201,79,18,419,413,832,105.933333333333,107.816666666667,213.75,464,470,-6,55.7692307692308,78.1473684210526
Wesley Matthews,202083,-0.180926859412305,1.84299294679236,1.66206608738006,264,40,80,63,4091,4093,8184,1086.85,1019.66666666667,2106.51666666667,4519,4746,-227,55.2174975562072,77.2289166158983
Quincy Acy,203112,0.582889010338043,1.07166981940489,1.65455882974293,139,91,81,70,2680,2723,5403,683,677.816666666667,1360.81666666667,3006,3088,-82,55.635757912271,79.5228355521807
PJ Tucker,200782,0.916241083533871,0.736014925687212,1.65225600922108,99,119,82,82,4407,4472,8879,1113.08333333333,1152.75,2265.83333333333,5154,5110,44,58.0470773735781,81.8877528503126
Darius Miller,203121,1.99730853874636,-0.385076777945966,1.6122317608004,35,313,83,82,3858,4026,7884,943.483333333333,1002.68333333333,1946.16666666667,4511,4475,36,57.2171486555048,83.444035283035
Rodney Hood,203918,1.6627577331793,-0.0638186325378905,1.59893910064141,50,250,84,60,3134,3105,6239,797.433333333333,806.083333333333,1603.51666666667,3644,3463,181,58.4067959608912,81.8101880242384
Manu Ginobili,1938,1.51843564760122,0.0771933137866561,1.59562896138787,57,220,85,65,2552,2578,5130,643.816666666667,669.2,1313.01666666667,2908,2836,72,56.6861598440546,79.7308995823866
Ivan Rabb,1628397,0.952157259266842,0.63434790378281,1.58650516304965,94,139,86,36,991,1015,2006,256.35,257.583333333333,513.933333333333,1170,1116,54,58.3250249252243,81.956155143339
Nene,2403,0.734543225651207,0.83700063585525,1.57154386150646,115,106,87,52,1490,1485,2975,373.15,384.65,757.8,1747,1697,50,58.7226890756303,82.9928741092637
Karl-Anthony Towns,1626157,-0.367174335232705,1.9275952729391,1.5604209377064,299,38,88,82,5716,5658,11374,1445.3,1426.8,2872.1,6393,6666,-273,56.2071390891507,80.1323073709133
Tyler Cavanaugh,1628463,-0.579943245881883,2.13678786555699,1.55684461967511,326,31,89,38,1070,1003,2073,272.883333333333,253.933333333333,526.816666666667,1172,1186,-14,56.5364206464062,80.0885823657819
Isaiah Canaan,203477,0.092936399895715,1.45790838688412,1.55084478677984,216,56,90,20,825,818,1643,210.266666666667,211.45,421.716666666667,941,931,10,57.273280584297,80.3288147650476
Ron Baker,1627758,-1.34987244003416,2.86134304036231,1.51147060032815,401,20,91,28,754,732,1486,189.2,190.483333333333,379.683333333333,808,856,-48,54.3741588156124,76.6112110969668
Ryan Anderson,201583,0.836956075656335,0.633913841457029,1.47086991711336,108,140,92,66,3373,3402,6775,826.883333333333,868.933333333333,1695.81666666667,3937,3883,54,58.1107011070111,83.57743073642
Taurean Prince,1627752,0.285736564901608,1.15007046432174,1.43580702922335,182,80,93,82,4793,4895,9688,1211.98333333333,1213.78333333333,2425.76666666667,5367,5638,-271,55.3984310487201,79.6498701441469
Jared Dudley,201162,0.936476607067979,0.496023992327381,1.43250059939536,96,154,94,48,1341,1386,2727,339.65,346.6,686.25,1534,1541,-7,56.2522918958563,80.472131147541
Eric Bledsoe,202339,1.27152409481146,0.132907114748399,1.40443120955986,72,208,95,74,4530,4497,9027,1150.78333333333,1136.5,2287.28333333333,5337,5055,282,59.1226321036889,84.0000874399761
Alec Burks,202692,1.78964464073541,-0.395942916312528,1.39370172442288,43,315,96,64,2001,2023,4024,519.05,535.9,1054.95,2313,2231,82,57.4801192842942,78.9307550120859
Zaza Pachulia,2585,-3.32839021101842,4.70219140852808,1.37380119750966,462,5,97,69,1902,1985,3887,454.233333333333,484.35,938.583333333333,2043,2508,-465,52.5598147671726,78.360649915653
Jakob Poeltl,1627751,0.672852462494081,0.696995809351807,1.36984827184589,127,128,98,82,2945,3041,5986,757.283333333333,763.4,1520.68333333333,3314,3463,-149,55.3625125292349,78.454203702283
Bogdan Bogdanovic,203992,0.453130687540804,0.904276238476594,1.3574069260174,148,99,99,78,4096,4216,8312,1044.2,1108.31666666667,2152.51666666667,4658,4689,-31,56.0394610202117,77.9032295530039
Torrey Craig,1628470,1.51930448892452,-0.190807375036501,1.32849711388802,56,278,100,39,1247,1280,2527,306.65,320.95,627.6,1479,1435,44,58.5278986941037,84.8374760994264
Josh Hart,1628404,0.870271784518112,0.444520547195058,1.31479233171317,105,158,101,63,2920,2961,5881,705.733333333333,741.666666666667,1447.4,3284,3309,-25,55.8408433939806,81.6802542489982
Jordan Bell,1628395,2.23133505316232,-0.923128125601603,1.30820692756072,27,375,102,57,1603,1675,3278,396.25,407.816666666667,804.066666666667,1911,1847,64,58.2977425259305,85.5600696459664
Joffrey Lauvergne,203530,1.98453031757628,-0.692393886652379,1.2921364309239,37,351,103,54,1043,1045,2088,258.616666666667,269.116666666667,527.733333333333,1211,1134,77,57.9980842911877,82.6099039919151
Rashad Vaughn,1626173,0.190648291578771,1.09947069578291,1.29011898736168,194,88,104,25,402,405,807,103.233333333333,107.6,210.833333333333,456,468,-12,56.5055762081784,77.8624505928854
Devin Harris,2734,0.645988666463898,0.626001350572144,1.27199001703604,132,141,105,71,2602,2636,5238,677.066666666667,659.783333333333,1336.85,2985,2997,-12,56.9873997709049,80.3829898642331
Sean Kilpatrick,203930,0.658924265131696,0.59539734535068,1.25432161048238,130,145,106,52,1245,1273,2518,305.866666666667,328.916666666667,634.783333333333,1392,1447,-55,55.2819698173153,78.9434715257174
Mario Hezonja,1626209,0.566499941382447,0.68326445675174,1.24976439813419,142,129,107,75,3227,3273,6500,814.783333333333,821.183333333333,1635.96666666667,3614,3651,-37,55.6,79.5272927321258
Devin Booker,1626164,1.1035671440443,0.145019952826364,1.24858709687067,83,205,108,54,3808,3906,7714,913.383333333333,929.35,1842.73333333333,4368,4280,88,56.6243194192378,85.3341051336783
Gary Payton II,1627780,-0.904016506191299,2.15128256939387,1.24726606320257,357,29,109,23,442,431,873,109.8,108.65,218.45,491,504,-13,56.2428407789233,80.9155413138018
Zach Randolph,2216,1.40768949187374,-0.167765439749233,1.2399240521245,62,270,110,59,2824,2925,5749,710.166666666667,769.25,1479.41666666667,3295,3203,92,57.3143155331362,80.1802512251451
Elfrid Payton,203901,1.30413049058217,-0.0683093981569781,1.23582109242519,67,252,111,63,3644,3708,7352,881.833333333333,889.516666666667,1771.35,4232,4110,122,57.5625680087051,86.0089762045897
Dennis Schroder,203471,-0.12681318612082,1.34333116815019,1.21651798202937,255,65,112,67,4045,4062,8107,1027.73333333333,1016.36666666667,2044.1,4510,4715,-205,55.6309362279512,79.4285993835918
Alec Peters,1628409,-3.48962341522167,4.69901330981434,1.20938989459266,463,6,113,20,479,443,922,114.183333333333,108.35,222.533333333333,481,545,-64,52.1691973969631,77.813061713601
Jake Layman,1627774,-0.739061867917078,1.93581699603965,1.19675512812257,346,37,114,33,307,308,615,77.95,79.8666666666667,157.816666666667,326,360,-34,53.0081300813008,74.3647692470166
Draymond Green,203110,0.529206952051221,0.649199632311168,1.17840658436239,144,136,115,70,4486,4690,9176,1083.36666666667,1168.86666666667,2252.23333333333,5166,5409,-243,56.2990409764603,82.574037621916
Malik Monk,1628370,3.046688278929,-1.88075228057404,1.16593599835496,17,436,116,63,1712,1734,3446,416.516666666667,430.05,846.566666666667,2054,1827,227,59.6053395240859,87.3457494979722
Malcolm Brogdon,1627763,1.03560129125443,0.126421674226893,1.16202296548132,87,209,117,48,2700,2762,5462,713.95,716.366666666667,1430.31666666667,3171,3116,55,58.0556572683999,79.8116967105187
Ramon Sessions,201196,0.446111677342064,0.698357293661387,1.14446897100345,150,127,118,28,768,761,1529,195.866666666667,195.65,391.516666666667,867,852,15,56.7037279267495,79.7207441147674
Kyle Korver,2594,1.96123320603038,-0.874944228862249,1.08628897716813,39,372,119,73,3076,3193,6269,764.216666666667,804.066666666667,1568.28333333333,3651,3518,133,58.2389535811134,83.8088355633017
Tobias Harris,202699,0.981954675641995,0.102435106598309,1.0843897822403,91,216,120,80,5202,5322,10524,1293.13333333333,1338.6,2631.73333333333,5988,5912,76,56.8985176738883,81.9110345526396
Skal Labissiere,1627746,-0.0328602714368626,1.09768645243581,1.06482618099895,239,89,121,60,2364,2428,4792,594.716666666667,625.766666666667,1220.48333333333,2662,2712,-50,55.550918196995,78.5197121359024
Ian Clark,203546,1.56401141135802,-0.506467739180751,1.05754367217727,53,329,122,74,2858,3003,5861,695.416666666667,757.35,1452.76666666667,3317,3318,-1,56.5944378092476,82.1962691875273
Julyan Stone,202933,-2.31963027643541,3.34732240739902,1.02769213096361,441,14,123,23,342,356,698,85.25,87.4666666666667,172.716666666667,372,409,-37,53.2951289398281,77.5373926469169
Pascal Siakam,1627783,0.679636890530107,0.345353107139513,1.02498999766962,124,176,124,81,3248,3293,6541,843.266666666667,832.7,1675.96666666667,3657,3725,-68,55.9088824338786,78.5528749577359
Jeff Teague,201952,-0.273827781287728,1.29602409893103,1.0221963176433,277,70,125,70,4617,4550,9167,1151.4,1129.58333333333,2280.98333333333,5162,5334,-172,56.3106796116505,81.4701261882668
Otto Porter Jr.,203490,-0.396019577013596,1.39900956909321,1.00298999207962,302,60,126,77,4675,4740,9415,1181.51666666667,1214.11666666667,2395.63333333333,5181,5461,-280,55.0292087095061,77.8566558599675
Mike Scott,203118,0.378438633491025,0.62150957394989,0.999948207440915,165,142,127,76,2758,2749,5507,703.683333333333,702.266666666667,1405.95,3135,3087,48,56.9275467586708,80.2731249333191
Gary Harris,203914,0.79835790705612,0.189842347467193,0.988200254523313,111,197,128,67,4469,4546,9015,1135.93333333333,1140.53333333333,2276.46666666667,5233,5128,105,58.0476982806434,82.7545611620347
Lance Stephenson,202362,0.633992557955925,0.350899004242169,0.984891562198094,135,173,129,82,3607,3654,7261,911.3,944.1,1855.4,4033,4116,-83,55.543313593169,78.2515899536488
Corey Brewer,201147,0.66832523776657,0.309866601227677,0.978191838994247,129,181,130,72,2476,2504,4980,604.683333333333,594.5,1199.18333333333,2806,2777,29,56.3453815261044,84.2373281816792
Nikola Jokic,203999,1.19383973380224,-0.21961529223075,0.974224441571489,78,282,131,75,4747,4744,9491,1195.15,1207.35,2402.5,5595,5320,275,58.9505847645138,83.837669094693
Montrezl Harrell,1626149,0.146679130624003,0.824584735394555,0.971263866018559,205,108,132,76,2640,2656,5296,637.35,655.566666666667,1292.91666666667,2996,3016,-20,56.570996978852,83.4206896551724
Patty Mills,201988,0.208349258683903,0.761699998024548,0.97004925670845,193,118,133,82,4048,4158,8206,1023.76666666667,1074.25,2098.01666666667,4487,4619,-132,54.6795028028272,76.9927153422677
JJ Redick,200755,0.436483448781579,0.531722147958741,0.96820559674032,152,150,134,70,4294,4312,8606,1054.21666666667,1027.1,2081.31666666667,4786,4848,-62,55.6123634673484,82.7822131823605
Julius Randle,203944,0.579479913881549,0.382313824414368,0.961793738295917,140,171,135,82,4374,4489,8863,1056.76666666667,1111.4,2168.16666666667,4891,5044,-153,55.1844747828049,81.2096241063879
Jeremy Lamb,203087,-0.168766961829182,1.12415252189234,0.955385560063154,262,84,136,80,3827,3981,7808,957.75,1000.23333333333,1957.98333333333,4359,4460,-101,55.8273565573771,80.1457281726947
Wayne Selden,1627782,0.301089405506724,0.647841343238324,0.948930748745048,177,137,137,35,1357,1365,2722,336.733333333333,353.383333333333,690.116666666667,1552,1519,33,57.0168993387215,80.9602241166952
Kemba Walker,202689,0.149462484562956,0.777582880548537,0.927045365111493,202,115,138,80,5440,5535,10975,1341.21666666667,1362.05,2703.26666666667,6157,6243,-86,56.1002277904328,81.9941305580902
Kyrie Irving,202681,1.16846629642094,-0.25483031908106,0.913635977339876,79,289,139,60,3791,3821,7612,941.383333333333,960.666666666667,1902.05,4343,4098,245,57.0546505517604,82.1997318682474
Eric Gordon,201569,1.72824644033386,-0.830210853447062,0.898035586886797,45,365,140,69,4283,4305,8588,1046.9,1095.88333333333,2142.78333333333,5069,4794,275,59.0242198416395,85.1621333623714
Tim Frazier,204025,1.43682473755672,-0.554964048503108,0.881860689053609,61,337,141,59,1594,1625,3219,409.366666666667,423,832.366666666667,1845,1778,67,57.3159366262815,79.7965640142565
Reggie Jackson,202704,0.37095318515544,0.50713411385446,0.8780872990099,168,152,142,45,2264,2334,4598,570.75,604.283333333333,1175.03333333333,2573,2586,-13,55.9591126576773,78.8301041105217
Trey Lyles,1626168,0.776285387874531,0.0577286762396805,0.834014064114211,114,222,143,73,2726,2741,5467,692.116666666667,695.3,1387.41666666667,3176,3067,109,58.0940186573989,82.4092738302601
Mason Plumlee,203486,-0.326381545331948,1.1404796114357,0.814098066103747,291,83,144,74,2783,2892,5675,707.283333333333,725.416666666667,1432.7,3176,3321,-145,55.9647577092511,79.8045648077058
Trevor Ariza,2772,-0.432306273862706,1.24569908831549,0.813392814452789,309,73,145,67,4455,4450,8905,1104.25,1131.71666666667,2235.96666666667,5105,5139,-34,57.3273441886581,82.1926385306877
Nicolas Batum,201587,0.684415390757367,0.113013802765862,0.79742919352323,122,211,146,64,3977,4008,7985,975.85,977.75,1953.6,4533,4471,62,56.7689417658109,83.531941031941
Kris Dunn,1627739,0.671185055671193,0.122787411475696,0.793972467146889,128,210,147,52,3010,3010,6020,736.6,762.8,1499.4,3333,3413,-80,55.3654485049834,80.0240096038415
DeMar DeRozan,201942,0.130062075811903,0.663248322617163,0.793310398429066,207,134,148,80,5447,5530,10977,1338.26666666667,1354.23333333333,2692.5,6067,6328,-261,55.2701102304819,81.1186629526462
Nikola Vucevic,202696,-0.321641260251723,1.11230493977429,0.790663679522564,290,86,149,57,3340,3363,6703,832.766666666667,822.833333333333,1655.6,3727,3826,-99,55.6019692674922,81.0413143271322
Trevor Booker,202344,-0.163843165681754,0.925033911973803,0.761190746292049,260,98,150,68,2294,2323,4617,570.85,588.7,1159.55,2536,2637,-101,54.927442061945,78.7339916346859
Nick Young,201156,1.85059774609688,-1.09118802405155,0.759409722045332,42,389,151,80,2763,2840,5603,683.65,707.366666666667,1391.01666666667,3256,3095,161,58.1117258611458,84.2664238386792
Thabo Sefolosha,200757,0.0115081435978282,0.732347659817883,0.743855803415712,231,121,152,38,1498,1542,3040,391.65,417.65,809.3,1687,1750,-63,55.4934210526316,75.0426294328432
Bryn Forbes,1627854,0.00641172828766043,0.67239137570557,0.67880310399323,233,132,153,80,2907,2977,5884,733.883333333333,776.466666666667,1510.35,3205,3282,-77,54.4697484704283,76.3928890654484
Norman Powell,1626181,0.64139515478123,0.0198146135723276,0.661209768353557,133,233,154,69,2071,2067,4138,528.05,520.666666666667,1048.71666666667,2323,2334,-11,56.1382310294829,79.7431781701445
Kelly Oubre Jr.,1626162,0.862657358172837,-0.219662190704511,0.642995167468327,106,283,155,81,4375,4419,8794,1096.41666666667,1129.48333333333,2225.9,5000,4917,83,56.8569479190357,80.8661664944517
Malachi Richardson,1627781,0.815238024391394,-0.202607782235918,0.612630242155476,109,281,156,26,609,629,1238,153.15,166.016666666667,319.166666666667,701,688,13,56.6235864297254,79.068407310705
Paul George,202331,0.71020326687734,-0.133024083921076,0.577179182956263,119,264,157,79,5678,5858,11536,1441.48333333333,1413.53333333333,2855.01666666667,6452,6443,9,55.9292649098474,81.3557422315106
Thaddeus Young,201152,-0.190049597752589,0.767065853478199,0.57701625572561,265,117,158,81,4982,5032,10014,1266.46666666667,1302.06666666667,2568.53333333333,5509,5763,-254,55.0129818254444,77.2129360465116
Chris McCullough,1626191,1.69932640897206,-1.12259920971659,0.576727199255471,48,391,159,19,190,190,380,45.05,43.05,88.1,226,200,26,59.4736842105263,92.3496027241771
Terrance Ferguson,1628390,1.16541801919287,-0.594533612021082,0.570884407171786,81,340,160,60,1475,1496,2971,377.066666666667,373.75,750.816666666667,1686,1621,65,56.7485695052171,80.8399742502608
TJ Leaf,1628388,0.102182026146044,0.46487242228647,0.567054448432514,212,156,161,53,922,940,1862,220.616666666667,235,455.616666666667,1019,1056,-37,54.7261009667025,80.5150528587629
Troy Daniels,203584,0.686922829660614,-0.125629579297642,0.561293250362972,121,262,162,79,3291,3313,6604,805.916666666667,809.45,1615.36666666667,3757,3626,131,56.8897637795276,83.7283588865273
Aaron Harrison,1626151,-2.30734817724288,2.86330415393649,0.555955976693611,440,19,163,9,472,457,929,116.866666666667,115.983333333333,232.85,471,541,-70,50.6996770721206,72.8194116383938
Jae Crowder,203109,-0.588001070664717,1.14187524264229,0.553874171977574,328,82,164,80,4074,4084,8158,1032.1,1036.08333333333,2068.18333333333,4592,4725,-133,56.2883059573425,79.9310183655543
Dewayne Dedmon,203473,0.715016769850627,-0.166544390675684,0.548472379174944,117,269,165,62,2950,3039,5989,754.45,766.233333333333,1520.68333333333,3326,3427,-101,55.5351477709133,78.7382865159303
Will Barton,203115,0.290317922394829,0.246360187477079,0.536678109871908,179,189,166,81,5274,5336,10610,1320.68333333333,1348.38333333333,2669.06666666667,6101,6015,86,57.502356267672,82.289439504446
Kyle O'Quinn,203124,-0.280664504442569,0.806673233335873,0.526008728893304,280,111,167,77,2758,2727,5485,699.3,685.95,1385.25,3039,3074,-35,55.4056517775752,78.977801840823
Ekpe Udoh,202327,-0.431705378895525,0.955600349228619,0.523894970333094,308,97,168,63,1512,1539,3051,393.983333333333,408.85,802.833333333333,1691,1739,-48,55.4244509996723,75.8264479966784
Kyle Lowry,200768,0.169139554977624,0.34781778172902,0.516957336706644,199,174,169,78,4981,5039,10020,1235.63333333333,1241.08333333333,2476.71666666667,5547,5736,-189,55.3592814371258,80.6277127648836
Patrick Beverley,201976,0.249830206199955,0.253043344657283,0.502873550857238,188,187,170,11,657,625,1282,165.65,160.7,326.35,720,701,19,56.1622464898596,79.4239313620346
Enes Kanter,202683,0.292281805395788,0.19685273477187,0.489134540167658,178,195,171,71,3617,3629,7246,890.25,901.633333333333,1791.88333333333,4036,4046,-10,55.699696384212,81.0856361556277
Jimmy Butler,202710,0.0404296563736118,0.423973966200964,0.464403622574576,226,164,172,59,4237,4124,8361,1074.43333333333,1061.1,2135.53333333333,4770,4753,17,57.0505920344457,80.4108263353417
E'Twaun Moore,202734,-0.687951024887489,1.14258519641786,0.454634171530373,344,81,173,82,5170,5308,10478,1231.38333333333,1311.5,2542.88333333333,5738,6064,-326,54.7623592288605,81.233770064166
Jonas Jerebko,201973,0.346257136021092,0.106416366528248,0.45267350254934,172,214,174,74,2127,2164,4291,557.6,561.516666666667,1119.11666666667,2385,2414,-29,55.5814495455605,76.7212235840767
Carmelo Anthony,2546,0.287896130015799,0.150363332917032,0.438259462932831,181,203,175,78,4931,5127,10058,1238.9,1228.58333333333,2467.48333333333,5573,5672,-99,55.4086299463114,81.308755884876
Joe Ingles,204060,-0.301902186678819,0.730729313056279,0.42882712637746,287,122,176,82,4891,4922,9813,1246.95,1287.45,2534.4,5415,5555,-140,55.1819015591562,76.9176136363636
Taj Gibson,201959,0.0848964941859041,0.343431708249046,0.42832820243495,217,177,177,82,5407,5355,10762,1358.93333333333,1339.7,2698.63333333333,6078,6179,-101,56.4764913584836,81.0810410207636
Russell Westbrook,201566,0.155047704304454,0.272305189050254,0.427352893354708,200,185,178,80,5731,5977,11708,1442.7,1429.78333333333,2872.48333333333,6464,6618,-154,55.2101127434233,81.0114360976855
Spencer Dinwiddie,203915,0.900415247868222,-0.478136058425999,0.422279189442223,102,327,179,80,4587,4602,9189,1134.36666666667,1146.33333333333,2280.7,5193,5068,125,56.513222331048,81.9695707458237
Jahlil Okafor,1626143,0.734537046086081,-0.312752733874722,0.421784312211359,116,295,180,28,669,674,1343,176.766666666667,172.533333333333,349.3,754,741,13,56.1429635145197,77.7097051245348
Cameron Payne,1626166,-1.63314064978118,2.03034817386435,0.397207524083175,415,32,181,25,1193,1150,2343,280.4,295.833333333333,576.233333333333,1246,1361,-115,53.1796841655997,77.8434661884653
Marco Belinelli,201158,-0.805064110404697,1.20026831236563,0.39520420196093,350,76,182,80,3891,3909,7800,993.433333333333,967.116666666667,1960.55,4262,4491,-229,54.6410256410256,78.2596720308077
Luc Mbah a Moute,201601,0.964703102170067,-0.60585844941666,0.358844652753406,93,342,183,61,3003,3034,6037,763.016666666667,796.15,1559.16666666667,3513,3382,131,58.1911545469604,81.1125601282737
Tyus Jones,1626145,1.0168322336351,-0.673830276359702,0.343001957275395,88,349,184,82,2838,2845,5683,718.25,739.383333333333,1457.63333333333,3276,3181,95,57.6456097131797,80.9092364334881
Lauri Markkanen,1628374,0.188973369043702,0.14578429908885,0.334757668132552,195,204,185,68,3973,3966,7939,989.1,998.5,1987.6,4338,4527,-189,54.6416425242474,78.5711410746629
Quinn Cook,1626188,-0.0860152357944364,0.420371316723219,0.334356080928782,249,167,186,33,1433,1472,2905,361.566666666667,370.266666666667,731.833333333333,1612,1661,-49,55.4905335628227,79.2967433386473
Jarrett Jack,101127,-0.0611363224395993,0.393487875342541,0.332351552902942,244,169,187,62,3079,3067,6146,747.966666666667,768.833333333333,1516.8,3407,3445,-38,55.4344288968435,80.8623417721519
Matthew Dellavedova,203521,-0.823986190417703,1.15262333468082,0.328637144263122,351,79,188,38,1362,1344,2706,362.116666666667,351.183333333333,713.3,1532,1550,-18,56.6149297856615,77.3195009112575
Gorgui Dieng,203476,0.426436284273996,-0.0985800317446137,0.327856252529382,155,258,189,79,2635,2606,5241,655.616666666667,677.966666666667,1333.58333333333,3020,2946,74,57.6225911085671,81.5247141161032
James Johnson,201949,0.556723190356899,-0.235788312876597,0.320934877480302,143,287,190,73,3734,3784,7518,951.383333333333,972.15,1923.53333333333,4199,4171,28,55.8526203777601,78.5866287734378
Zach Collins,1628380,-0.774038926895017,1.07022146391981,0.29618253702479,348,92,191,66,2039,2009,4048,516.85,519.816666666667,1036.66666666667,2200,2278,-78,54.3478260869565,76.3987138263666
John Wall,202322,-0.444961597768896,0.719297200859304,0.274335603090408,311,125,192,41,2797,2832,5629,691.583333333333,702.166666666667,1393.75,3119,3231,-112,55.4094865873157,80.5625112107624
Domantas Sabonis,1627734,0.613807791515141,-0.344464707881087,0.269343083634054,137,305,193,74,3491,3532,7023,888.083333333333,912.666666666667,1800.75,3908,3942,-34,55.6457354406949,78.1274468971262
Jonas Valanciunas,202685,0.496624039187481,-0.24084465055955,0.255779388627931,145,288,194,77,3484,3457,6941,853.95,839.45,1693.4,3887,3910,-23,56.0005762858378,82.6337545765915
Derrick Favors,202324,-0.11723428549883,0.371723474691661,0.25448918919283,253,172,195,77,4060,4082,8142,1042.8,1078.03333333333,2120.83333333333,4518,4574,-56,55.4900515843773,76.6906090373281
Michael Beasley,201563,0.382207854785603,-0.127923949462478,0.254283905323125,163,263,196,73,3299,3313,6612,816.766666666667,823.45,1640.21666666667,3688,3700,-12,55.7773744706594,80.9454035544085
John Henson,203089,0.689780258219862,-0.438977746017474,0.250802512202389,120,322,197,76,3809,3747,7556,972.516666666667,961.916666666667,1934.43333333333,4452,4181,271,58.920063525675,82.8521703168887
Malcolm Delaney,1627098,-0.243597243952004,0.49032541106665,0.246728167114646,270,155,198,54,1953,1999,3952,513.8,503.733333333333,1017.53333333333,2159,2273,-114,54.6305668016194,76.384721221254
Jodie Meeks,201975,1.50547678587088,-1.26203292930883,0.243443856562045,58,402,199,77,2182,2208,4390,549.6,563.916666666667,1113.51666666667,2538,2386,152,57.8132118451025,82.0535540554699
Maurice Harkless,203090,0.931695991964918,-0.702135121332283,0.229560870632636,97,353,200,59,2434,2504,4938,609.25,635.35,1244.6,2733,2713,20,55.3462940461725,79.0519042262574
Kevon Looney,1626172,-0.625983992973771,0.845176060227518,0.219192067253747,335,105,201,66,1837,1817,3654,457.733333333333,452.1,909.833333333333,2072,2062,10,56.7049808429119,81.9842461989375
Willie Cauley-Stein,1626161,0.388190895845539,-0.181294063330978,0.206896832514561,161,274,202,73,3815,3948,7763,973.95,1039.68333333333,2013.63333333333,4361,4322,39,56.1767357980162,77.9665281663328
Shaun Livingston,2733,1.73393058486496,-1.52971091661464,0.204219668250324,44,421,203,71,2151,2256,4407,538.866666666667,582.816666666667,1121.68333333333,2522,2418,104,57.2271386430679,80.9426308672977
Kyle Kuzma,1628398,0.231459520423995,-0.0325466983628378,0.198912822061157,189,243,204,77,4869,4932,9801,1169.78333333333,1213.31666666667,2383.1,5412,5455,-43,55.2188552188552,81.7556963618816
JaMychal Green,203210,0.275409897386398,-0.0955601485269326,0.179849748859466,183,257,205,55,2897,2884,5781,752.766666666667,757.266666666667,1510.03333333333,3288,3167,121,56.8759730150493,78.38767356129
Travis Wear,204037,-0.987107230015701,1.15739141195037,0.170284181934664,364,78,206,17,454,444,898,112.35,113.233333333333,225.583333333333,494,501,-7,55.011135857461,78.8356113779091
Luke Kornet,1628436,-3.0532011224758,3.21882999881585,0.165628876340049,459,15,207,20,663,650,1313,166.283333333333,161.216666666667,327.5,687,779,-92,52.3229246001523,75.5175572519084
Kentavious Caldwell-Pope,203484,0.39493793251798,-0.230850789196741,0.164087143321239,159,286,208,74,4985,5007,9992,1187.25,1234.9,2422.15,5529,5551,-22,55.3342674139311,82.1765786594555
Damian Lillard,203081,-0.0400123878394029,0.203249634675742,0.16323724683634,240,193,209,73,5310,5414,10724,1302.6,1345.16666666667,2647.76666666667,5852,5965,-113,54.5691906005222,79.5659234826835
Kent Bazemore,203145,0.452181923013223,-0.298465621784157,0.153716301229065,149,294,210,65,3417,3522,6939,873.416666666667,880.183333333333,1753.6,3848,3980,-132,55.4546764663496,78.9963503649635
Jawun Evans,1628393,-0.164301529381765,0.310738105762611,0.146436576380846,261,180,211,48,1563,1584,3147,386.5,388.733333333333,775.233333333333,1760,1775,-15,55.9262789958691,81.7302317581804
Emmanuel Mudiay,1626144,0.0433531296403773,0.0960829326874702,0.139436062327848,224,218,212,64,2484,2548,5032,612.783333333333,627.5,1240.28333333333,2793,2840,-47,55.5047694753577,81.0685730411062
Joe Harris,203925,-0.284802929058891,0.423610802213331,0.13880787315444,283,165,213,78,3915,3987,7902,973.416666666667,995.266666666667,1968.68333333333,4331,4472,-141,54.8089091369274,79.1981104122044
Tyler Dorsey,1628416,-0.96585484136064,1.10147115128367,0.135616309923032,361,87,214,56,1928,1966,3894,482.966666666667,490.516666666667,973.483333333333,2081,2245,-164,53.4411915767848,76.9566333955384
Wilson Chandler,201163,0.413455099485966,-0.279288945988524,0.134166153497442,157,293,215,74,4556,4630,9186,1150.88333333333,1170.05,2320.93333333333,5291,5190,101,57.5985194861746,82.0687079910381
Isaiah Taylor,1627819,1.01435030089241,-0.888937758800148,0.125412542092261,89,373,216,66,2304,2342,4646,574.083333333333,584,1158.08333333333,2580,2587,-7,55.5316401205338,80.2014823343168
Klay Thompson,202691,-0.202794524843152,0.325073024996059,0.122278500152907,267,179,217,73,4870,5117,9987,1176.11666666667,1282.63333333333,2458.75,5535,5869,-334,55.4220486632622,81.0411794611083
Tristan Thompson,202684,-2.03670858947252,2.14865928905527,0.111950699582751,428,30,218,53,2148,2140,4288,522.866666666667,538.7,1061.56666666667,2362,2548,-186,55.0839552238806,80.1004804220178
Markieff Morris,202693,-0.0679576843946066,0.167257565943153,0.0992998815485464,246,200,219,73,3782,3800,7582,957.533333333333,972.083333333333,1929.61666666667,4208,4308,-100,55.4998681086785,78.5067845945222
Giannis Antetokounmpo,203507,1.22417023878115,-1.12860571843363,0.0955645203475211,76,392,220,75,5301,5290,10591,1353.85,1363.25,2717.1,6247,5839,408,58.9840430554244,82.7691288506128
Justin Holiday,203200,-0.252815624816937,0.343182818799557,0.0903671939826198,274,178,221,72,4552,4478,9030,1117.51666666667,1120.45,2237.96666666667,4929,5123,-194,54.5847176079734,79.2880442067949
Rajon Rondo,200765,1.28242160318266,-1.19905692671689,0.0833646764657729,71,400,222,65,3456,3577,7033,806.15,869.033333333333,1675.18333333333,3951,3909,42,56.178017915541,84.9077215429157
DeAndre' Bembry,1627761,-0.341902602466447,0.421846548075971,0.0799439456095246,293,166,223,26,888,894,1782,231.483333333333,227.733333333333,459.216666666667,977,1016,-39,54.8260381593715,76.5912967734911
Jerryd Bayless,201573,-0.495788362194636,0.575215652242153,0.0794272900475172,317,147,224,39,1834,1893,3727,446.95,472.983333333333,919.933333333333,2019,2119,-100,54.1722565065737,79.0100731937097
Richard Jefferson,2210,-0.751122976980296,0.829906275904725,0.0787832989244292,347,107,225,19,327,318,645,85.4166666666667,77.3166666666667,162.733333333333,362,361,1,56.1240310077519,80.0819336337567
Brook Lopez,201572,-0.894044968250127,0.971749033345483,0.0777040650953554,355,96,226,74,3504,3546,7050,842.966666666667,854.216666666667,1697.18333333333,3815,4023,-208,54.113475177305,80.9223124588779
Delon Wright,1626153,-0.365177579486541,0.436619158752366,0.0714415792658249,297,161,227,69,2767,2816,5583,703.633333333333,721.766666666667,1425.4,3046,3203,-157,54.5584811033495,76.9299845657359
Wesley Johnson,202325,-0.496913731047434,0.561362006951354,0.0644482759039202,318,148,228,74,2958,3003,5961,736.883333333333,730.15,1467.03333333333,3300,3410,-110,55.3598389531958,80.9797550612347
Bradley Beal,203078,-0.476903679925788,0.535456678634569,0.058552998708781,313,149,229,82,5768,5839,11607,1449.16666666667,1491.66666666667,2940.83333333333,6398,6636,-238,55.1219091927285,78.3206574100312
Brice Johnson,1627744,3.58549545814289,-3.52701683301398,0.0584786251289011,13,471,230,18,193,213,406,46.5166666666667,51.8,98.3166666666667,235,213,22,57.8817733990148,86.0484827936939
Andre Drummond,203083,0.6774345341387,-0.619278309881539,0.0581562242571603,125,343,231,78,5067,5193,10260,1277.86666666667,1305.75,2583.61666666667,5766,5656,110,56.1988304093567,80.3431881664592
Guerschon Yabusele,1627824,-1.32737983393721,1.37862647873492,0.0512466447977034,398,61,232,32,479,442,921,118.433333333333,110.65,229.083333333333,506,494,12,54.9402823018458,79.5169152419062
Alex Abrines,203518,-0.399259837337382,0.444467266244914,0.0452074289075314,304,159,233,75,2217,2262,4479,560.866666666667,565.8,1126.66666666667,2457,2508,-51,54.8559946416611,78.5076923076923
Jerami Grant,203924,-0.246929967972259,0.280913688845238,0.0339837208729783,271,184,234,81,3190,3267,6457,819.833333333333,825.733333333333,1645.56666666667,3562,3604,-42,55.1649372773734,77.9257398667126
David Nwaba,1628021,0.0224662084878896,0.00856020325527614,0.0310264117431657,228,236,235,70,3307,3259,6566,794.7,835.383333333333,1630.08333333333,3599,3705,-106,54.8126713371916,79.4830530136496
Ben Simmons,1627732,-0.120870857586423,0.15155037592953,0.0306795183431078,254,202,236,81,5498,5518,11016,1361.3,1329.68333333333,2690.98333333333,6082,6161,-79,55.2106027596224,81.3650524281706
Andrew Wiggins,203952,0.0430749147961321,-0.0231513962497593,0.0199235185463729,225,242,237,82,5940,5889,11829,1481.98333333333,1475.93333333333,2957.91666666667,6682,6744,-62,56.4882914870234,81.324806310748
Dennis Smith Jr.,1628372,-1.07689671893412,1.09055212940737,0.0136554104732478,376,90,238,69,4013,3986,7999,1036.88333333333,982.733333333333,2019.61666666667,4337,4579,-242,54.2192774096762,77.3077399176411
Buddy Hield,1627741,-0.178678453143374,0.187462565314719,0.00878411217134506,263,198,239,80,3780,3966,7746,973.783333333333,1048.38333333333,2022.16666666667,4230,4340,-110,54.6088303640589,75.3053655320201
Clint Capela,203991,0.0211303915899045,-0.0195050717487757,0.00162531984112885,229,240,240,74,3967,3951,7918,985.566666666667,1006.93333333333,1992.5,4589,4477,112,57.9565546855267,82.9129234629862
,,1.40086191115982e-06,6.64917007160028e-07,2.06577891831985e-06,235,238,241,,,,,,,,,,,,
Rondae Hollis-Jefferson,1626178,0.148275172180496,-0.152447875419053,-0.00417270323855673,204,266,242,68,3875,3929,7804,937.4,958.45,1895.85,4336,4347,-11,55.5612506406971,82.3356278186566
James Webb III,1627821,2.98708293129595,-3.00389850626953,-0.016815574973581,18,467,243,10,234,245,479,59.1833333333333,59.5333333333333,118.716666666667,274,254,20,57.2025052192067,83.0885862698301
Wayne Ellington,201961,0.149078557309835,-0.170693171625311,-0.0216146143154759,203,271,244,77,3920,3887,7807,1023.38333333333,1023.85,2047.23333333333,4370,4299,71,55.9754066863072,76.8451731605256
Dario Saric,203967,-0.0458567439117504,0.00968334106331127,-0.0361734028484391,241,235,245,77,4610,4636,9246,1143.21666666667,1130.51666666667,2273.73333333333,5103,5161,-58,55.1914341336794,80.7957544127133
Marc Gasol,201188,0.330794127163638,-0.375935019624718,-0.0451408924610799,175,312,246,73,4529,4523,9052,1164.21666666667,1210.08333333333,2374.3,5128,4957,171,56.6504639858595,77.7526007665417
Ersan Ilyasova,101141,-0.00434521213307548,-0.0431330985973977,-0.0474783107304732,238,245,247,69,3417,3429,6846,864.416666666667,843.7,1708.11666666667,3800,3868,-68,55.5068653228163,80.0882063090929
Al Horford,201143,1.29749796161753,-1.35012602638621,-0.0526280647686797,68,413,248,72,4337,4446,8783,1112.51666666667,1127.43333333333,2239.95,4960,4683,277,56.4727314129569,79.7160650907386
Courtney Lee,201584,-0.0611184883753953,0.00732675958088871,-0.0537917287945066,243,237,249,76,4584,4590,9174,1130.7,1152.46666666667,2283.16666666667,5081,5107,-26,55.3847830826248,80.1150448937879
Dwight Powell,203939,0.0551219961663347,-0.120199007981116,-0.0650770118147812,222,261,250,79,3221,3162,6383,849.283333333333,806.366666666667,1655.65,3593,3546,47,56.2901456995143,78.125207622384
Nikola Mirotic,202703,0.153636474848671,-0.225459647282443,-0.0718231724337723,201,284,251,55,3104,3089,6193,729.683333333333,762.066666666667,1491.75,3483,3427,56,56.2409171645406,84.0542986425339
Dion Waiters,203079,-0.36264225124814,0.290038555756708,-0.0726036954914325,296,183,252,30,1741,1708,3449,454.033333333333,448.55,902.583333333333,1924,1898,26,55.784285300087,76.73972855692
Tomas Satoransky,203107,-0.352009009631947,0.269464852477954,-0.0825441571539933,294,186,253,73,3180,3213,6393,807.683333333334,820,1627.68333333333,3540,3613,-73,55.3730642890662,78.2953277152599
Cody Zeller,203469,0.462313566892632,-0.551266487371956,-0.0889529204793237,147,335,254,33,1195,1294,2489,304.566666666667,323.633333333333,628.2,1386,1401,-15,55.6850140618722,79.4269340974212
Mike Muscala,203488,0.0134237435006356,-0.103321515695459,-0.0898977721948231,230,259,255,53,2133,2193,4326,521.3,534.216666666667,1055.51666666667,2348,2462,-114,54.2764678687009,80.0821082882001
Anthony Tolliver,201229,0.361675204293053,-0.451983259782024,-0.0903080554889711,169,323,256,79,3372,3502,6874,855.333333333334,895.3,1750.63333333333,3778,3808,-30,54.9607215594996,77.6907404939165
Goran Dragic,201609,0.272500050544253,-0.371992890250146,-0.0994928397058928,185,310,257,75,4602,4575,9177,1164.81666666667,1166.61666666667,2331.43333333333,5126,5024,102,55.8570338890705,79.1513089229801
Treveon Graham,1626203,1.32369711164725,-1.42337062111954,-0.0996735094722911,66,417,258,63,1992,2127,4119,493.716666666667,550.566666666667,1044.28333333333,2338,2246,92,56.7613498421947,80.5988157747738
Luke Kennard,1628379,-0.353727502491776,0.244827207696613,-0.108900294795163,295,190,259,73,2810,2856,5666,718.85,737.583333333333,1456.43333333333,3106,3131,-25,54.8182139075185,76.773853935413
Tyler Johnson,204020,-0.146808401650306,0.0293579651306587,-0.117450436519647,257,229,260,72,4002,3881,7883,1028.36666666667,1003.3,2031.66666666667,4452,4303,149,56.4759609285805,78.8869565217391
De'Aaron Fox,1628368,0.682176437266286,-0.802523616543081,-0.120347179276795,123,361,261,73,3903,4013,7916,966.016666666667,1026.53333333333,1992.55,4463,4342,121,56.3794845881759,80.6343630021831
Shelvin Mack,202714,-0.112058539483303,-0.0185435870896576,-0.130602126572961,250,239,262,69,2615,2682,5297,676.116666666667,687.15,1363.26666666667,2879,2929,-50,54.351519728148,76.0262115506871
Cheick Diallo,1627767,-1.76495909008942,1.63189287639005,-0.133066213699376,422,45,263,52,1157,1203,2360,278.95,298.633333333333,577.583333333333,1273,1371,-98,53.9406779661017,79.3443947482326
Alex Len,203458,0.445074984893967,-0.598038807108421,-0.152963822214454,151,341,264,69,2863,2898,5761,692.35,695.716666666667,1388.06666666667,3243,3142,101,56.2923103627843,84.1083521444695
Davis Bertans,202722,0.0622159273313242,-0.228683713645165,-0.16646778631384,220,285,265,74,2082,2109,4191,526.6,549.15,1075.75,2312,2301,11,55.1658315437843,77.3711364164536
Serge Ibaka,201586,-1.0748113875923,0.901658262865612,-0.173153124726686,375,100,266,76,4200,4218,8418,1035.58333333333,1024.13333333333,2059.71666666667,4591,4850,-259,54.5378949869328,80.2421044965732
Brandon Paul,203464,0.0812841697781627,-0.266161380929077,-0.184877211150914,218,291,267,62,1088,1111,2199,278.55,292.05,570.6,1205,1203,2,54.7976352887676,76.0252365930599
Allen Crabbe,203459,-0.247203685398636,0.0475981109100596,-0.199605574488577,272,223,268,75,4470,4431,8901,1081.78333333333,1082.43333333333,2164.21666666667,4991,4918,73,56.0723514211886,83.0212625045244
Lance Thomas,202498,-0.316231554962121,0.112730675852907,-0.203500879109214,289,212,269,73,2636,2606,5242,667.05,669.166666666667,1336.21666666667,2909,2895,14,55.4940862266311,78.373517268906
Milos Teodosic,1628462,0.629179730634307,-0.843587858691498,-0.214408128057191,136,367,270,45,2299,2318,4617,550.25,565.5,1115.75,2634,2549,85,57.050032488629,84.9867801926955
Victor Oladipo,203506,-0.26001318025086,0.0374543567178637,-0.222558823532996,275,226,271,75,4930,4982,9912,1240.06666666667,1273.8,2513.86666666667,5449,5643,-194,54.9737691686844,78.0327781903045
Reggie Bullock,203493,0.0958341624223872,-0.324075751985432,-0.228241589563045,214,300,272,62,3388,3468,6856,839.55,872.15,1711.7,3820,3796,24,55.7176196032672,80.3411812817667
Harrison Barnes,203084,-0.57742753675063,0.347050580874708,-0.230376955875922,325,175,273,77,5117,5099,10216,1342.03333333333,1269.15,2611.18333333333,5580,5769,-189,54.6202036021926,76.9306380887337
Dwight Howard,2730,-0.159376935552922,-0.0714182267349753,-0.230795162287897,259,253,274,81,4927,4945,9872,1212.86666666667,1212.63333333333,2425.5,5541,5521,20,56.1284440842788,82.2411873840445
Okaro White,1627855,2.0537652933347,-2.28590854502524,-0.232143251690541,33,450,275,5,156,143,299,39.95,37.6833333333333,77.6333333333333,179,152,27,59.866220735786,83.0055817947617
Paul Millsap,200794,-0.332950519999042,0.0989875559013374,-0.233962964097705,292,217,276,38,2240,2249,4489,565,563.733333333333,1128.73333333333,2571,2544,27,57.2733348184451,81.9998818734865
OG Anunoby,1628384,-1.05713406228693,0.82178589256089,-0.235348169726035,371,109,277,74,2929,2953,5882,722.566666666667,725.783333333333,1448.35,3191,3393,-202,54.2502550153009,79.3150826802914
Blake Griffin,201933,-0.250047192293961,0.01140059482607,-0.238646597467891,273,234,278,58,3900,3910,7810,971.35,974.85,1946.2,4352,4348,4,55.7234314980794,80.5014900832391
Patrick McCaw,1627775,-0.207694966655413,-0.0404399611510639,-0.248134927806477,268,244,279,56,1901,1952,3853,468.166666666667,487,955.166666666667,2174,2170,4,56.4235660524267,81.9375327168033
James Ennis III,203516,0.318233382324561,-0.566951063853242,-0.248717681528681,176,338,280,72,3098,3084,6182,798.716666666667,798.95,1597.66666666667,3484,3356,128,56.3571659657069,78.5044857083246
Vince Carter,1713,-0.666246087329856,0.389754989619627,-0.276491097710229,340,170,281,58,1923,1996,3919,493.383333333333,534.583333333333,1027.96666666667,2127,2195,-68,54.2740495024241,74.488796653588
Willy Hernangomez,1626195,0.0104044911359479,-0.313225916937386,-0.302821425801438,232,296,282,48,960,986,1946,238.95,249.766666666667,488.716666666667,1071,1085,-14,55.0359712230216,78.8923370732872
Jabari Parker,203953,0.0939584821977269,-0.401653019232429,-0.307694537034702,215,317,283,31,1484,1503,2987,356.8,387.416666666667,744.216666666667,1709,1654,55,57.2145965852026,82.6694734956218
Jerian Grant,1626170,-1.7298870868369,1.40662229947048,-0.323264787366412,420,59,284,74,3302,3288,6590,831.066666666667,845.416666666667,1676.48333333333,3479,3830,-351,52.7921092564492,74.7063794251857
Malcolm Miller,1626259,3.39110776391772,-3.72079478762674,-0.329687023709024,15,473,285,15,242,247,489,62.2166666666667,60.1666666666667,122.383333333333,287,254,33,58.6912065439673,84.4232602478551
Donovan Mitchell,1628378,-0.857359243735026,0.50426381275383,-0.353095430981196,352,153,286,79,5010,5082,10092,1288.6,1315.8,2604.4,5500,5715,-215,54.4986127625842,76.0251881431424
Caris LeVert,1627747,-0.597992343357603,0.24309543636014,-0.354896906997463,330,191,287,71,3760,3823,7583,928.483333333333,936.5,1864.98333333333,4136,4281,-145,54.5430568376632,79.8377107927685
Tyler Ulis,1627755,-0.00348653514909108,-0.359167410847129,-0.362653945996221,237,308,288,71,3300,3371,6671,817.883333333333,817.133333333333,1635.01666666667,3691,3672,19,55.3290361265178,81.2688963415256
Al-Farouq Aminu,202329,-0.563706904131883,0.198983197648364,-0.364723706483518,324,194,289,69,4080,4203,8283,1006.15,1035.91666666667,2042.06666666667,4480,4629,-149,54.0866835687553,78.9788123143221
Ish Smith,202397,-0.289214284106303,-0.0810952864028564,-0.370309570509159,284,254,290,82,4005,4049,8054,1014.25,1013.05,2027.3,4469,4425,44,55.4879562950087,79.3587530212598
Richaun Holmes,1626158,0.333196226507382,-0.721500099283167,-0.388303872775785,174,357,291,48,1526,1548,3074,378.933333333333,370.483333333333,749.416666666667,1698,1688,10,55.2374756018217,81.567441343267
Tyreke Evans,201936,-1.21254825118689,0.817893890944637,-0.394654360242253,394,110,292,52,3069,3063,6132,778.716666666667,813.066666666667,1591.78333333333,3387,3418,-31,55.2348336594912,76.6008774225973
Terrence Ross,203082,-0.136612129223454,-0.258905436444025,-0.39551756566748,256,290,293,24,1194,1213,2407,288.016666666667,299.016666666667,587.033333333333,1330,1340,-10,55.2555047777316,81.5626597013231
Marcus Morris,202694,-1.05016669093014,0.647499726987894,-0.402666963942243,370,138,294,54,2838,2867,5705,718.533333333333,714.133333333333,1432.66666666667,3104,3147,-43,54.4084136722174,77.9972080037227
Robert Covington,203496,-0.114458167124578,-0.31328484307112,-0.427743010195698,252,297,295,80,5027,5059,10086,1243.11666666667,1238.18333333333,2481.3,5557,5614,-57,55.0961729129486,80.6238665215814
Dante Cunningham,201967,-2.84074732082599,2.40606842770134,-0.434678893124648,454,24,296,73,3100,3188,6288,761.333333333333,795.233333333333,1556.56666666667,3307,3769,-462,52.5922391857506,76.4837141572264
Anthony Davis,203076,-0.371751300665653,-0.0660670670879536,-0.437818367753607,301,251,297,75,5499,5656,11155,1298.91666666667,1394.86666666667,2693.78333333333,6144,6331,-187,55.0784401613626,82.1090535615955
Mario Chalmers,201596,-0.28406976033642,-0.157374164474369,-0.441443924810789,282,268,298,66,2703,2796,5499,689.3,734.116666666667,1423.41666666667,3051,3065,-14,55.4828150572832,77.1636321058486
Damien Wilkins,2863,-1.18712511374629,0.723740367401151,-0.46338474634514,387,123,299,19,300,312,612,72.4,77.5,149.9,322,358,-36,52.6143790849673,77.3315543695797
Aaron Gordon,203932,0.3728985487198,-0.840374376511603,-0.467475827791803,166,366,300,58,3788,3849,7637,944.816666666667,939.766666666667,1884.58333333333,4285,4238,47,56.1084195364672,81.8536369666151
T.J. Warren,203933,0.211704966763186,-0.690727863989273,-0.479022897226088,192,350,301,65,4327,4437,8764,1055.3,1052.18333333333,2107.48333333333,4911,4810,101,56.036056595162,83.8896313928936
Marvin Williams,101107,-0.481559838106497,-0.0208282188867617,-0.502388056993259,315,241,302,78,4047,4003,8050,990.5,976.916666666667,1967.41666666667,4515,4474,41,56.0869565217391,82.6159515439028
Nemanja Bjelica,202357,-0.307280981117941,-0.202024779017291,-0.509305760135232,288,280,303,67,2682,2728,5410,657.45,695.233333333333,1352.68333333333,3020,3100,-80,55.822550831793,80.3735784428482
Doug McDermott,203926,0.385396184969238,-0.89724685147157,-0.511850666502332,162,374,304,81,3482,3496,6978,873.4,890.783333333333,1764.18333333333,3847,3813,34,55.1304098595586,78.5020453278665
DeAndre Jordan,201599,-0.148594345013546,-0.365461011732554,-0.5140553567461,258,309,305,77,4808,4867,9675,1185.78333333333,1195.51666666667,2381.3,5407,5422,-15,55.8863049095607,81.7419056817705
Omri Casspi,201956,0.908242830877419,-1.43390914306444,-0.525666312187025,100,419,306,53,1455,1524,2979,358.666666666667,376.733333333333,735.4,1695,1638,57,56.8982880161128,82.9752515637748
Josh Richardson,1626196,-0.370486951872948,-0.156274745726115,-0.526761697599063,300,267,307,81,5189,5127,10316,1334.1,1317.83333333333,2651.93333333333,5729,5652,77,55.5350911205894,77.7711858015536
Pat Connaughton,1626192,-0.510512023277918,-0.0500068066988507,-0.560518829976769,320,247,308,82,2946,3000,5946,731.066666666667,759.633333333333,1490.7,3190,3328,-138,53.6495122771611,77.0376333266251
Antonio Blakeney,1628469,-0.396178902707455,-0.181677018627895,-0.577855921335349,303,275,309,19,652,634,1286,153.816666666667,160.2,314.016666666667,699,724,-25,54.3545878693624,80.1358738920439
Kyle Anderson,203937,-0.112200192050055,-0.466102898482451,-0.578303090532506,251,326,310,74,3759,3826,7585,946.35,997.933333333333,1944.28333333333,4109,4154,-45,54.1727092946605,76.0815038960371
CJ McCollum,203468,0.12848642721954,-0.715413826419635,-0.586927399200095,208,356,311,81,5741,5856,11597,1415.91666666667,1463.3,2879.21666666667,6329,6367,-38,54.5744589117875,79.1340237217299
Dragan Bender,1627733,0.401180012849766,-0.994904111923773,-0.593724099074008,158,380,312,82,4188,4218,8406,1031.96666666667,1016.08333333333,2048.05,4743,4552,191,56.423982869379,83.3710114499158
Deyonta Davis,1627738,0.489351990802609,-1.08826157744782,-0.598909586645215,146,388,313,62,1875,1841,3716,470.483333333333,466,936.483333333333,2168,1957,211,58.3423035522067,83.3415793126769
Jrue Holiday,201950,0.04819539137683,-0.652219124645263,-0.604023733268433,223,346,314,81,5861,6004,11865,1393.01666666667,1498.38333333333,2891.4,6581,6690,-109,55.4656552886641,81.938161444283
Steven Adams,203500,0.0958949594811744,-0.700127687721384,-0.60423272824021,213,352,315,76,4897,5073,9970,1234.78333333333,1212.33333333333,2447.11666666667,5530,5536,-6,55.4663991975928,81.3528846874213
Rudy Gay,200752,-0.295481487619636,-0.331671228023281,-0.627152715642916,286,303,316,57,2341,2440,4781,600.433333333333,631.183333333333,1231.61666666667,2582,2650,-68,54.0054381928467,75.4715347037092
LaMarcus Aldridge,200746,-0.673956681248836,0.0316701097559637,-0.642286571492872,342,227,317,75,4714,4863,9577,1202.56666666667,1266.93333333333,2469.5,5127,5332,-205,53.5345097629738,74.740635756226
Dillon Brooks,1628415,-0.68117415126997,0.0256305126260758,-0.655543638643894,343,230,318,82,4433,4431,8864,1142.35,1171.46666666667,2313.81666666667,4974,4869,105,56.1146209386282,77.389018144624
Myles Turner,1626167,-1.19464721498916,0.523394270188125,-0.671252944801034,388,151,319,65,3560,3556,7116,893.4,906.9,1800.3,3870,4064,-194,54.3844856661046,77.3871021496417
Marquis Teague,203104,4.12989747559252,-4.8109623962166,-0.681064920624079,10,480,320,3,143,145,288,37.8,36.8333333333333,74.6333333333334,178,143,35,61.8055555555556,85.8597588209022
Ricky Rubio,201937,0.0589506983005554,-0.746151059477249,-0.687200361176694,221,359,321,77,4220,4293,8513,1084.66666666667,1131.11666666667,2215.78333333333,4698,4737,-39,55.1861858334312,76.3287625896034
Joel Embiid,203954,-1.11970988868502,0.425238831308587,-0.694471057376432,383,163,322,63,3809,3834,7643,944.133333333333,934.233333333333,1878.36666666667,4143,4307,-164,54.2064634305901,79.403027452929
Malik Beasley,1627736,-0.230915259473365,-0.463636738644804,-0.694551998118169,269,325,323,62,1176,1198,2374,290.7,291.816666666667,582.516666666667,1333,1315,18,56.1499578770009,82.3804755228749
DeAndre Liggins,202732,-1.12828430016048,0.427419857827739,-0.700864442332746,384,162,324,56,1358,1391,2749,357.166666666667,361.883333333333,719.05,1528,1573,-45,55.5838486722445,76.5009387386135
Ian Mahinmi,101133,-0.91847658426404,0.196084305745272,-0.722392278518768,359,196,325,77,2207,2235,4442,570.15,572,1142.15,2463,2494,-31,55.4479963980189,77.6325351311124
Fred VanVleet,1627832,-0.904263458581152,0.170307119498034,-0.733956339083118,358,199,326,76,2975,3006,5981,768.1,750.933333333333,1519.03333333333,3273,3395,-122,54.7232904196623,77.5677514208598
Marcin Gortat,101162,-0.281548279524103,-0.4528278512399,-0.734376130764002,281,324,327,82,4010,4068,8078,1004.08333333333,1035.48333333333,2039.56666666667,4448,4568,-120,55.0631344392176,78.5107947766683
Nick Collison,2555,0.906974216929548,-1.64724503208501,-0.740270815155466,101,427,328,15,137,150,287,35.8833333333333,39.25,75.1333333333334,150,158,-8,52.2648083623693,71.8722271517303
Michael Kidd-Gilchrist,203077,0.123647667944417,-0.872132657249343,-0.748484989304926,209,371,329,74,3679,3748,7427,902.3,916.233333333333,1818.53333333333,4149,4132,17,55.8637404066245,82.1343206979984
Brandon Jennings,201943,1.47903342933221,-2.24905665689561,-0.770023227563404,59,447,330,14,406,416,822,94.6166666666667,110.333333333333,204.95,474,438,36,57.6642335766423,83.2593315442791
Jason Smith,201160,2.6445675767913,-3.41808250013378,-0.773514923342479,24,470,331,33,561,570,1131,140.7,142.883333333333,283.583333333333,669,582,87,59.1511936339523,84.9274169850132
Frank Mason,1628412,-0.431501463055586,-0.372484863538577,-0.803986326594164,307,311,332,52,1814,1884,3698,473.966666666667,507.766666666667,981.733333333333,2007,2043,-36,54.2725797728502,73.5963601792748
Avery Bradley,202340,0.926438796914663,-1.74336083660053,-0.816922039685872,98,433,333,46,2737,2816,5553,684.766666666667,721.1,1405.86666666667,3150,3008,142,56.7260940032415,80.6619878603945
Jayson Tatum,1628369,0.13970686268545,-0.978135428290505,-0.838428565605055,206,378,334,80,4681,4729,9410,1196.55,1199.65,2396.2,5238,5008,230,55.6641870350691,78.6945997829897
Khem Birch,203920,-0.986177974454089,0.13792974410069,-0.848248230353399,363,206,335,42,1113,1157,2270,281.4,294.783333333333,576.183333333333,1212,1277,-65,53.3920704845815,75.7258974284805
Tyrone Wallace,1627820,0.593083196018168,-1.49174544775306,-0.898662251734892,138,420,336,29,1720,1784,3504,406.55,434.55,841.1,1963,1948,15,56.0216894977169,84.0185471406492
Sam Dekker,1626155,-0.366332971118844,-0.567523163086747,-0.933856134205591,298,339,337,73,1791,1794,3585,435.7,442.266666666667,877.966666666667,2009,1986,23,56.0390516039052,82.3767037472949
Tony Parker,2225,-0.0790487618839622,-0.855624789107441,-0.934673550991403,248,370,338,55,2041,2099,4140,514.466666666667,547,1061.46666666667,2264,2260,4,54.6859903381643,76.78432357744
Tim Hardaway Jr.,203501,-0.618486006334117,-0.318336238662773,-0.93682224499689,333,299,339,57,3807,3814,7621,931.383333333333,930.783333333333,1862.16666666667,4204,4236,-32,55.1633643878756,81.2730690056386
Lucas Nogueira,203512,-0.621873649656575,-0.315016216358197,-0.936889866014772,334,298,340,49,802,809,1611,204.35,212.783333333333,417.133333333333,870,901,-31,54.0037243947859,75.0839060252517
Bojan Bogdanovic,202711,-1.07041162355359,0.106595576567533,-0.963816046986056,373,213,341,80,4764,4790,9554,1197.76666666667,1219.68333333333,2417.45,5195,5425,-230,54.3751308352523,77.3625100829386
Denzel Valentine,1627756,-2.09307635389843,1.11537352273465,-0.977702831163779,431,85,342,77,4156,4103,8259,1025.08333333333,1055.81666666667,2080.9,4356,4751,-395,52.7424627678896,75.3597001297516
Dante Exum,203957,-2.97173230214333,1.99201264366583,-0.979719658477499,457,35,343,14,466,461,927,118.483333333333,116.233333333333,234.716666666667,487,532,-45,52.5350593311758,74.6943122914152
Alex Caruso,1627936,-1.01105297853936,0.0302783035553671,-0.980774674983988,366,228,344,37,1097,1141,2238,265.766666666667,291.216666666667,556.983333333333,1187,1261,-74,53.0384271671135,76.7204284987582
Amir Johnson,101161,-0.280320075073556,-0.706989600639612,-0.987309675713168,279,354,345,74,2327,2311,4638,584.683333333333,575.433333333333,1160.11666666667,2567,2532,35,55.3471323846486,79.6575057106326
Andrew Harrison,1626150,0.289681668968921,-1.29079913437452,-1.0011174654056,180,408,346,56,2488,2480,4968,632.116666666667,668.7,1300.81666666667,2807,2660,147,56.5016103059581,77.6835065151379
Patrick Patterson,202335,-0.0674095004249585,-0.968039084104373,-1.03544858452933,245,377,347,82,2422,2456,4878,632.083333333333,633.233333333333,1265.31666666667,2703,2641,62,55.4120541205412,76.9040688101793
Justin Jackson,1628382,0.264395924635524,-1.30645612328807,-1.04206019865254,186,410,348,68,2865,2956,5821,718.433333333333,761.883333333333,1480.31666666667,3244,3163,81,55.7292561415564,78.8912282281944
T.J. McConnell,204456,-0.612473487550585,-0.433163369501864,-1.04563685705245,332,321,349,76,3459,3467,6926,860.116666666667,853.066666666667,1713.18333333333,3791,3815,-24,54.7357782269708,79.6622272377932
Jarell Martin,1626185,-0.0022245635143261,-1.04765758911386,-1.04988215262819,236,385,350,73,3154,3206,6360,801.016666666667,842.633333333333,1643.65,3560,3438,122,55.9748427672956,77.9728044291668
Marquese Chriss,1627737,0.0377555219947406,-1.09534135816741,-1.05758583617267,227,390,351,72,3081,3158,6239,751.65,749.166666666667,1500.81666666667,3458,3389,69,55.4255489661805,82.9468400537485
Josh Gray,1627982,-0.0462713049872987,-1.03645690519116,-1.08272821017846,242,382,352,5,186,173,359,46.4833333333333,40.4,86.8833333333333,206,182,24,57.3816155988858,85.355841166315
DeMarre Carroll,201960,0.17837500171325,-1.26279276242367,-1.08441776071042,196,404,353,73,4383,4405,8788,1062.51666666667,1083.1,2145.61666666667,4919,4791,128,55.9740555302686,82.5329159449109
Cory Joseph,202709,-0.90391844350523,-0.189448868168592,-1.09336731167382,356,277,354,82,4290,4374,8664,1085.8,1121.88333333333,2207.68333333333,4681,4895,-214,54.028162511542,76.3315994896611
Jeff Green,201145,0.177381992188312,-1.28263480497033,-1.10525281278202,197,407,355,78,3579,3704,7283,902.1,918.366666666667,1820.46666666667,4143,4075,68,56.8858986681313,81.9284432563079
Jordan Clarkson,203903,-1.20020650848569,0.0936774956811037,-1.10652901280458,390,219,356,81,3819,3818,7637,946.883333333333,948.433333333333,1895.31666666667,4185,4256,-71,54.7990048448344,79.4906743815897
CJ Miles,101139,-0.275144336993202,-0.854308373836877,-1.12945271083008,278,369,357,70,2631,2685,5316,664.5,667.783333333333,1332.28333333333,2917,2972,-55,54.8720842738902,78.8210715938802
Paul Zipser,1627835,-1.5572726694045,0.415796459008366,-1.14147621039614,410,168,358,53,1595,1575,3170,404.55,409.35,813.9,1672,1805,-133,52.7444794952681,73.9550313306303
Marcus Smart,203935,-0.197781785051804,-0.986200143435671,-1.18398192848747,266,379,359,54,3191,3155,6346,818.033333333333,798.5,1616.53333333333,3543,3347,196,55.8304443744091,78.9021774991752
Kyle Collinsworth,1627858,-2.57598960843727,1.37127204308508,-1.20471756535219,446,63,360,31,991,916,1907,251.266666666667,227.266666666667,478.533333333333,1032,1047,-15,54.116413214473,77.6372248537197
Shabazz Napier,203894,-1.44827289659525,0.226445532753912,-1.22182736384134,405,192,361,74,2959,3045,6004,752.2,777.383333333333,1529.58333333333,3160,3381,-221,52.6315789473684,74.3731953146282
Jaylen Brown,1627759,0.169653361486672,-1.43292125619026,-1.26326789470359,198,418,362,70,4216,4200,8416,1061.81666666667,1059.56666666667,2121.38333333333,4733,4416,317,56.2381178707224,80.3192885145699
Tyler Zeller,203092,0.335099022948999,-1.61492652257945,-1.27982749963045,173,426,363,66,2219,2228,4447,539.933333333333,548.1,1088.03333333333,2527,2370,157,56.824825725208,83.6114089641862
Michael Carter-Williams,203487,0.897027838136515,-2.17950494945263,-1.28247711131611,103,446,364,52,1565,1704,3269,391.916666666667,441.683333333333,833.6,1821,1770,51,55.7051085959009,78.6420345489443
Danuel House Jr.,1627863,-2.00356910416191,0.719496183023347,-1.28407292113856,427,124,365,23,827,798,1625,203.65,198.266666666667,401.916666666667,878,909,-31,54.0307692307692,78.6431681526021
Al Jefferson,2744,-0.628586333923779,-0.656975998578878,-1.28556233250266,336,347,366,36,952,963,1915,246.483333333333,240.366666666667,486.85,1041,1066,-25,54.3603133159269,76.9764814624628
Stanley Johnson,1626169,-0.671172807085023,-0.624067668257434,-1.29524047534246,341,344,367,69,3661,3708,7369,918.133333333333,948.166666666667,1866.3,4072,4021,51,55.2585154023613,78.5468574184215
Tyson Chandler,2199,-1.20454219604244,-0.111338433787132,-1.31588062982957,392,260,368,46,2311,2336,4647,574.3,555.966666666667,1130.26666666667,2547,2548,-1,54.8095545513234,81.1242184735166
Salah Mejri,1626257,-0.791693819906566,-0.527494412950077,-1.31918823285664,349,332,369,60,1434,1398,2832,384.4,345.866666666667,730.266666666667,1552,1549,3,54.8022598870057,76.509037794413
Mike James,1628455,-0.525669746229323,-0.813263498101473,-1.3389332443308,321,364,370,36,1453,1457,2910,345.583333333333,336.816666666667,682.4,1612,1565,47,55.3951890034364,85.0410316529894
Lonzo Ball,1628366,-0.494286924991961,-0.846817614453095,-1.34110453944506,316,368,371,52,3637,3643,7280,870.933333333333,886.083333333333,1757.01666666667,3990,3997,-7,54.8076923076923,81.7522125572704
Isaiah Hicks,1628439,-1.47747699444051,0.102966844441515,-1.37451014999899,409,215,372,18,493,477,970,124.466666666667,114.533333333333,239,523,546,-23,53.9175257731959,78.7782426778243
Andre Iguodala,2738,0.675764419793099,-2.07303697916895,-1.39727255937585,126,443,373,64,3169,3323,6492,785.683333333333,842.233333333333,1627.91666666667,3676,3582,94,56.6235366605052,81.2916304069619
Timofey Mozgov,202389,-1.06844859617883,-0.331624263418413,-1.40007285959724,372,302,374,31,705,721,1426,173.85,174.983333333333,348.833333333333,767,794,-27,53.7868162692847,79.1552795031056
Gerald Green,101123,-1.23130339538404,-0.192572663146433,-1.42387605853047,396,279,375,41,1843,1783,3626,461.266666666667,456.75,918.016666666667,2042,1990,52,56.315499172642,80.0769775421652
Marreese Speights,201578,-0.923919537058865,-0.518692956852719,-1.44261249391158,360,331,376,50,1322,1367,2689,328.516666666667,345.066666666667,673.583333333333,1438,1483,-45,53.4771290442544,76.8546331807497
Ben McLemore,203463,0.79770591513075,-2.29501029047452,-1.49730437534377,112,452,377,56,2101,2097,4198,547.25,537.533333333333,1084.78333333333,2450,2190,260,58.3611243449262,81.3065589134543
Quincy Pondexter,202347,-2.76593765421076,1.25275569207906,-1.51318196213171,452,72,378,23,377,380,757,96.8666666666667,98.0166666666667,194.883333333333,380,438,-58,50.1981505944518,70.1958436671513
Jarrett Allen,1628386,-1.56074518344914,0.0407664666178325,-1.51997871683131,411,224,379,72,2903,2884,5787,702.633333333333,720.666666666667,1423.3,3151,3219,-68,54.4496284776223,79.6992903815078
Daniel Theis,1628464,0.105684243082316,-1.64952595364339,-1.54384171056108,211,428,380,63,1846,1831,3677,474.983333333333,467.75,942.733333333333,2041,1925,116,55.5072069621975,77.9393253659572
Arron Afflalo,201167,-1.45819088169425,-0.0946496291803338,-1.55284051087458,407,256,381,53,1315,1358,2673,332.4,343.75,676.15,1411,1484,-73,52.7871305649084,75.125342009909
Justin Anderson,1626147,-1.04603602275456,-0.516275793329232,-1.56231181608379,369,330,382,38,1040,1069,2109,260.216666666667,264.233333333333,524.45,1129,1161,-32,53.5324798482693,77.4983315854705
Brandon Ingram,1627742,-1.59868715834677,0.0244407620797916,-1.57424639626698,413,231,383,59,4055,4004,8059,978.266666666667,971.2,1949.46666666667,4372,4449,-77,54.2499069363445,80.735927775118
C.J. Williams,203710,0.806354546188723,-2.39370028708569,-1.58734574089696,110,455,384,38,1396,1440,2836,336.55,360.166666666667,696.716666666667,1600,1525,75,56.4174894217207,82.6734923330861
Ed Davis,202334,-1.20232628308916,-0.432838111578188,-1.63516439466735,391,320,385,78,2846,2919,5765,714,757.016666666667,1471.01666666667,3053,3216,-163,52.9575021682567,74.715672833981
Semi Ojeleye,1628400,-2.11305708109545,0.462387237018016,-1.65066984407743,432,157,386,73,2219,2226,4445,583.716666666667,568.266666666667,1151.98333333333,2360,2434,-74,53.0933633295838,73.7510670003906
Josh Huestis,203962,-1.73186201922745,0.0398898698891337,-1.69197214933832,421,225,387,69,1880,1926,3806,482.033333333333,482.133333333333,964.166666666667,2038,2122,-84,53.5470310036784,76.0947277441659
Rudy Gobert,203497,-1.03850958466576,-0.657812559103524,-1.69632214376928,368,348,388,56,3447,3505,6952,883.233333333333,901.75,1784.98333333333,3745,3853,-108,53.8693901035673,75.5301169945564
John Collins,1628381,-1.27560642669508,-0.421190986841617,-1.69679741353669,397,319,389,74,3480,3522,7002,894.85,881.75,1776.6,3783,3955,-172,54.0274207369323,76.6565349544073
Dwyane Wade,2548,-0.889237269139769,-0.808478111824933,-1.6977153809647,354,363,390,67,3044,3099,6143,760.216666666667,780.8,1541.01666666667,3415,3415,0,55.5917304248738,79.7785012059138
Raymond Felton,101109,0.00309216287749236,-1.72368811629928,-1.72059595342179,234,432,391,82,2578,2618,5196,683.783333333333,675.366666666667,1359.15,2881,2777,104,55.4464973056197,76.3094581172056
D.J. Augustin,201571,-1.00996893598455,-0.710994327699803,-1.72096326368435,365,355,392,75,3444,3523,6967,862.416666666667,882.05,1744.46666666667,3761,3853,-92,53.9830630113392,77.6145526808576
Miles Plumlee,203101,-1.42256350521066,-0.326305052124446,-1.7488685573351,404,301,393,55,1755,1838,3593,435.283333333333,457.933333333333,893.216666666667,1874,2060,-186,52.1569718897857,75.5292668818689
Josh Jackson,1628367,-0.265460052974475,-1.57599265474797,-1.84145270772245,276,424,394,77,4000,4091,8091,969.883333333333,972.233333333333,1942.11666666667,4483,4351,132,55.4072426152515,83.0990242604718
Demetrius Jackson,1627743,-3.10480000463833,1.23326266035014,-1.87153734428818,461,74,395,15,152,150,302,38.2666666666667,40.2333333333333,78.5,161,165,-4,53.3112582781457,73.8343949044586
Garrett Temple,202066,-0.635387282884727,-1.26904706206041,-1.90443434494513,338,406,396,65,3031,3151,6182,767.383333333333,826.333333333333,1593.71666666667,3404,3369,35,55.0630863798124,76.8919611390565
Terry Rozier,1626179,-1.16913500157037,-0.741867850237509,-1.91100285180788,386,358,397,80,4030,4063,8093,1045.58333333333,1017.8,2063.38333333333,4367,4336,31,53.9602125293464,76.1913685451887
Dwayne Bacon,1628407,-1.56745794733193,-0.34857741480296,-1.91603536213489,412,306,398,53,1429,1450,2879,349.616666666667,357.7,707.316666666667,1596,1578,18,55.4359152483501,81.2309432361743
Dwight Buycks,202779,-0.559036267717605,-1.38586683981194,-1.94490310752955,323,414,399,29,799,836,1635,204.883333333333,223.916666666667,428.8,886,882,4,54.1896024464832,74.384328358209
Raul Neto,203526,-1.47283382608583,-0.550983948846815,-2.02381777493265,408,334,400,41,950,997,1947,243.333333333333,256.916666666667,500.25,1033,1091,-58,53.0559835644581,74.3388305847077
Tarik Black,204028,-2.16772538079946,0.133874466042255,-2.03385091475721,435,207,401,51,1052,1042,2094,263.716666666667,269.583333333333,533.3,1135,1163,-28,54.2024832855778,76.6172885805363
Kenneth Faried,202702,0.272710375151254,-2.31165779124282,-2.03894741609157,184,454,402,32,909,918,1827,226.95,229.666666666667,456.616666666667,1038,974,64,56.8144499178982,81.8366974486258
Danny Green,201980,-1.01143385864698,-1.04239332163864,-2.05382718028562,367,383,403,70,3400,3467,6867,862.516666666667,894.283333333333,1756.8,3664,3714,-50,53.3566331731469,75.0819672131148
Kristaps Porzingis,204001,-0.881753739122295,-1.19051233454795,-2.07226607367024,353,398,404,48,3066,3105,6171,745.5,783.516666666667,1529.01666666667,3349,3378,-29,54.2699724517906,78.8506774506491
Royce O'Neale,1626220,-0.479068325508303,-1.60447561900602,-2.08354394451432,314,425,405,69,2159,2265,4424,561.066666666667,585.516666666667,1146.58333333333,2377,2428,-51,53.7296564195298,74.6321680354677
Jusuf Nurkic,203994,-0.7073282149216,-1.39429374845985,-2.10162196338145,345,415,406,79,4099,4189,8288,1013.01666666667,1036.11666666667,2049.13333333333,4473,4488,-15,53.9695945945946,78.5834661808244
Joe Young,1626202,-1.08644098780223,-1.04632213605991,-2.13276312386215,378,384,407,53,1104,1111,2215,278.15,274.3,552.45,1188,1219,-31,53.6343115124154,77.4151506923704
Jamel Artis,1628503,-2.83920500571879,0.67917165939018,-2.16003334632861,453,130,408,15,547,554,1101,141.483333333333,136.75,278.233333333333,563,616,-53,51.1353315168029,72.8453336528094
Bam Adebayo,1628389,-1.60715960231303,-0.553251037845879,-2.16041064015891,414,336,409,69,2582,2616,5198,667.366666666667,693.1,1360.46666666667,2794,2873,-79,53.7514428626395,73.9334542068898
Robin Lopez,201577,-1.8201021399201,-0.342394327735886,-2.16249646765599,424,304,410,64,3328,3298,6626,828.283333333333,833.716666666667,1662,3519,3727,-208,53.1089646845759,76.2238267148015
James Young,203923,-1.91157826414866,-0.277035141467625,-2.18861340561629,425,292,411,6,122,114,236,31.8,28.7166666666667,60.5166666666667,130,127,3,55.0847457627119,77.3340677499312
Justise Winslow,1626159,-1.13081928673921,-1.08603423153887,-2.21685351827807,385,387,412,68,3257,3223,6480,832.8,836.183333333333,1668.98333333333,3543,3510,33,54.6759259259259,76.4225726240526
Iman Shumpert,202697,0.354764793436786,-2.63243254265717,-2.27766774922039,171,459,413,14,543,553,1096,136.15,136.05,272.2,628,597,31,57.2992700729927,83.0565760470242
Wes Iwundu,1628411,-1.10523420716632,-1.17717244757421,-2.28240665474053,381,396,414,62,1963,1999,3962,501.616666666667,510.533333333333,1012.15,2119,2152,-33,53.4830893488137,75.3682754532431
Larry Nance Jr.,1626204,-1.09853430655893,-1.21220600542245,-2.31074031198138,380,401,415,66,2919,2798,5717,718,691.416666666667,1409.41666666667,3205,3045,160,56.060871086234,81.8636551764915
Kay Felder,1627770,-0.63054403139356,-1.68508087825047,-2.31562490964403,337,430,416,15,270,284,554,66.7333333333333,73.2,139.933333333333,283,311,-28,51.0830324909747,72.8060981419724
Mike Conley,201144,-2.9688113427108,0.619412377165744,-2.34939896554506,456,143,417,12,716,697,1413,181.8,185.416666666667,367.216666666667,754,787,-33,53.3616418966738,73.9182135887079
Evan Turner,202323,-1.21711287902767,-1.14314062609544,-2.36025350512311,395,393,418,79,4002,4095,8097,982.433333333333,1030.2,2012.63333333333,4313,4426,-113,53.2666419661603,77.1466900743636
Cristiano Felicio,1626245,-3.09412577006099,0.666781434570617,-2.42734433549038,460,133,419,55,1913,1906,3819,467.416666666667,495.65,963.066666666667,1949,2197,-248,51.0343021733438,72.854769486363
Sindarius Thornwell,1628414,-1.68312475854609,-0.751921039701897,-2.43504579824798,418,360,420,72,2317,2348,4665,568.95,584.333333333333,1153.28333333333,2535,2607,-72,54.3408360128617,79.1305981473185
Solomon Hill,203524,-1.67138471013064,-0.802805677370032,-2.47419038750068,417,362,421,12,392,400,792,92.9666666666667,94.5833333333333,187.55,432,431,1,54.5454545454546,82.9218874966676
Ryan Arcidiacono,1627853,-2.0837087434828,-0.39840777388053,-2.48211651736333,430,316,422,24,601,584,1185,150.433333333333,151.383333333333,301.816666666667,623,658,-35,52.5738396624473,74.3100115964438
Joe Johnson,2207,-1.20458639318362,-1.30874589442274,-2.51333228760636,393,412,423,55,2381,2278,4659,612,591.55,1203.55,2625,2469,156,56.3425627817128,78.5177184163516
Frank Ntilikina,1628373,-1.34336580346799,-1.19056018380282,-2.53392598727082,399,399,424,78,3358,3348,6706,847.9,852.583333333334,1700.48333333333,3624,3664,-40,54.0411571726812,76.7217163747562
Yogi Ferrell,1627812,-0.595332207262741,-1.94775981326842,-2.54309202053116,329,439,425,82,4444,4377,8821,1172.33333333333,1102.71666666667,2275.05,4867,4739,128,55.1751502097268,77.0145711083273
Timothe Luwawu-Cabarrot,1627789,-1.08646982320633,-1.54805572905869,-2.63452555226502,379,422,426,52,1638,1663,3301,393.85,404.866666666667,798.716666666667,1775,1782,-7,53.7715843683732,80.0033386891472
Nik Stauskas,203917,-1.10889258297035,-1.57523689076065,-2.68412947373099,382,423,427,41,1040,1041,2081,262.816666666667,258.866666666667,521.683333333333,1125,1119,6,54.0605478135512,77.6333024504009
Tony Allen,2754,-0.500084699887702,-2.26179273840759,-2.7618774382953,319,449,428,22,538,573,1111,133.95,140.166666666667,274.116666666667,607,619,-12,54.6354635463546,79.7178816805496
Jon Leuer,202720,-1.07300780842763,-1.71016803875794,-2.78317584718557,374,431,429,8,269,264,533,68.3333333333334,67.25,135.583333333333,292,279,13,54.7842401500938,77.5316533497234
Maxi Kleber,1628467,-1.41286886855208,-1.41855846245122,-2.83142733100331,403,416,430,71,2350,2336,4686,611,579.033333333333,1190.03333333333,2512,2557,-45,53.6064874093043,75.9911487073191
Eric Moreland,203961,-0.583472258825439,-2.43159041403623,-3.01506267286167,327,456,431,67,1513,1548,3061,389.583333333333,412.633333333333,802.216666666667,1656,1613,43,54.0999673309376,74.3140880477012
Henry Ellenson,1627740,-0.399472725411611,-2.64338649955473,-3.04285922496634,305,460,432,37,639,633,1272,168.866666666667,158.35,327.216666666667,696,654,42,54.7169811320755,76.5731166912851
Shane Larkin,203499,-1.08456120649628,-2.00968138460888,-3.09424259110516,377,441,433,54,1465,1450,2915,396.016666666667,372.916666666667,768.933333333333,1586,1512,74,54.4082332761578,74.253511357725
Bismack Biyombo,202687,-0.432758215391777,-2.67170775812252,-3.1044659735143,310,463,434,82,2935,2968,5903,740.633333333333,744.983333333333,1485.61666666667,3262,3107,155,55.2600372691852,79.0459629558993
Rodney Purvis,1628681,0.969217102113399,-4.0809141169032,-3.11169701478981,92,477,435,16,568,586,1154,145.866666666667,143.133333333333,289,627,590,37,54.3327556325823,78.1038062283737
Glenn Robinson III,203922,-2.14021579535001,-1.14787424595133,-3.28809004130134,433,394,436,23,671,672,1343,168.566666666667,168.833333333333,337.4,716,734,-18,53.31347728965,76.3959691760522
Damion Lee,1627814,-2.23383698267715,-1.08429415586888,-3.31813113854604,437,386,437,15,829,812,1641,200.5,198.716666666667,399.216666666667,878,888,-10,53.5039609993906,79.1750511418194
Langston Galloway,204038,-2.68735547749037,-0.643475257582764,-3.33083073507313,450,345,438,58,1635,1684,3319,428.15,431.683333333333,859.833333333333,1730,1809,-79,52.1241337752335,72.4326419848808
Danilo Gallinari,201568,-2.98081498801328,-0.352969238154784,-3.33378422616806,458,307,439,21,1326,1319,2645,337.266666666667,318.616666666667,655.883333333333,1397,1468,-71,52.8166351606805,76.6782710339745
Nerlens Noel,203457,-2.32839508719046,-1.01924079023002,-3.34763587742048,442,381,440,29,917,905,1822,238.933333333333,229.666666666667,468.6,958,999,-41,52.5795828759605,73.5979513444302
Hassan Whiteside,202355,-2.06318546404711,-1.3086956767496,-3.37188114079671,429,411,441,54,2711,2657,5368,686.766666666667,653.25,1340.01666666667,2901,2861,40,54.0424739195231,77.9363440753225
Milton Doyle,1628495,0.426322945850027,-3.84308616298394,-3.41676321713391,156,475,442,10,236,254,490,61.5166666666667,62.65,124.166666666667,260,259,1,53.0612244897959,75.3825503355705
Tyler Ennis,203898,-2.28555107569437,-1.17922233781828,-3.46477341351265,439,397,443,54,1347,1390,2737,329.283333333333,347.783333333333,677.066666666667,1438,1500,-62,52.5392765801973,76.4592359196534
Kosta Koufos,201585,-1.19879149537347,-2.29630202085927,-3.49509351623275,389,453,444,71,2618,2742,5360,669.633333333333,713.683333333333,1383.31666666667,2867,2867,0,53.4888059701493,74.611983276907
Brandan Wright,201148,-1.65069513676634,-1.89877701596143,-3.54947215272777,416,437,445,28,728,726,1454,187.266666666667,191.8,379.066666666667,797,779,18,54.8143053645117,75.6911712979247
Sterling Brown,1628425,-2.38213829828829,-1.1686498354928,-3.55078813378109,444,395,446,54,1505,1516,3021,380.15,389.766666666667,769.916666666667,1647,1656,-9,54.5183714001986,77.0109319190389
Noah Vonleh,203943,-2.65793399597744,-0.951601139848669,-3.60953513582611,448,376,447,54,1744,1720,3464,422.733333333333,443.283333333333,866.016666666667,1805,1892,-87,52.107390300231,75.0331979754046
David West,2561,-1.44923900988776,-2.29294523160551,-3.74218424149326,406,451,448,73,1839,1930,3769,475.25,507.166666666667,982.416666666667,2054,2010,44,54.4972141151499,75.2674527101535
Jamil Wilson,203966,-0.602415237531627,-3.25132050242692,-3.85373573995854,331,468,449,15,522,555,1077,124.016666666667,143.916666666667,267.933333333333,586,577,9,54.4103992571959,78.7360039810898
Andre Roberson,203460,-0.976950124049977,-2.89850645846015,-3.87545658251013,362,465,450,39,1964,2028,3992,500.666666666667,518.633333333333,1019.3,2160,2114,46,54.1082164328657,76.2876483861474
Andrew White III,1628510,-5.44729882354122,1.51687400592594,-3.93042481761528,474,51,451,15,419,436,855,101.016666666667,109,210.016666666667,406,504,-98,47.4853801169591,69.594476628839
Kawhi Leonard,202695,-5.24008530245191,1.30370992521829,-3.93637537723363,473,69,452,9,398,403,801,102.566666666667,104.383333333333,206.95,391,451,-60,48.8139825218477,68.016429089152
Bruno Caboclo,203998,-1.37380379232998,-2.57762941736082,-3.95143320969079,402,458,453,11,194,210,404,52.3166666666667,52.7,105.016666666667,206,218,-12,50.990099009901,70.6173623234407
Isaiah Whitehead,1627785,-4.6810280774886,0.700634525756546,-3.98039355173205,472,126,454,16,342,362,704,88.05,88.8166666666667,176.866666666667,348,411,-63,49.4318181818182,70.8330192235205
Aron Baynes,203382,-1.76865915111869,-2.25619016138252,-4.02484931250121,423,448,455,81,2829,2797,5626,715.45,716.883333333333,1432.33333333333,3049,2886,163,54.1948098115891,76.6329997672795
Pau Gasol,2200,-2.3583222548436,-1.6719953809336,-4.0303176357772,443,429,456,77,3501,3508,7009,887.116666666667,893.316666666667,1780.43333333333,3675,3711,-36,52.4325866742759,74.3077527942636
Lorenzo Brown,203485,-6.37015326522769,2.32232811964765,-4.04782514558005,479,25,457,14,262,245,507,72.35,64.75,137.1,252,288,-36,49.7041420118343,66.1706783369803
Dejounte Murray,1627749,-2.24966892577205,-1.84310539240904,-4.09277431818109,438,435,458,80,3331,3369,6700,842.2,868.483333333333,1710.68333333333,3524,3558,-34,52.5970149253731,74.1598386609639
Kadeem Allen,1628443,-3.75751497247388,-0.390307182882178,-4.14782215535606,466,314,459,16,219,198,417,52.2166666666667,53,105.216666666667,227,215,12,54.4364508393285,77.6683035007128
Caleb Swanigan,1628403,-5.74642833967161,1.41876571973863,-4.32766261993298,477,58,460,26,353,373,726,92.1666666666667,94.3,186.466666666667,343,428,-85,47.2451790633609,66.2209510189489
Dorian Finney-Smith,1627827,-4.17059215814677,-0.184318012581761,-4.35491017072853,469,276,461,21,937,864,1801,240.55,212.3,452.85,933,965,-32,51.8045530260966,74.1702550513415
Jonathan Isaac,1628371,-1.69692569283532,-2.66228087704858,-4.35920656988389,419,462,462,27,1032,1052,2084,264.6,266.983333333333,531.583333333333,1102,1086,16,52.8790786948177,74.629879291425
Damian Jones,1627745,-2.48118725730139,-1.91911404263877,-4.40030129994017,445,438,463,15,167,185,352,43.7333333333333,44.3833333333333,88.1166666666667,180,197,-17,51.1363636363636,73.5388689237753
Johnathan Motley,1628405,-2.67702973518994,-2.0234060546753,-4.70043578986524,449,442,464,11,352,338,690,86.4833333333333,88.1333333333333,174.616666666667,346,368,-22,50.1449275362319,71.33339696478
Davon Reed,1628432,-2.14753568863584,-2.85187828505123,-4.99941397368707,434,464,465,21,500,480,980,124.616666666667,115.216666666667,239.833333333333,529,501,28,53.9795918367347,79.4051424600417
Jaylen Morris,1628537,-4.67097382481574,-0.414505273465506,-5.08547909828125,471,318,466,6,196,213,409,45.0666666666667,53.8166666666667,98.8833333333333,195,236,-41,47.6772616136919,70.9927524018203
Damyean Dotson,1628422,-5.88944800829489,0.771230312955723,-5.11821769533916,478,116,467,44,959,932,1891,239.55,231.216666666667,470.766666666667,931,1068,-137,49.2332099418297,71.1945054166962
Markelle Fultz,1628365,-5.54847571958461,0.020327873846594,-5.52814784573802,476,232,468,14,530,554,1084,122.15,132.033333333333,254.183333333333,520,608,-88,47.9704797047971,73.6476296636286
Marshall Plumlee,1627850,-2.1739445140971,-3.69257006331561,-5.86651457741271,436,472,469,8,99,101,200,25.9,26.1833333333333,52.0833333333333,106,105,1,53,73.2672
Ivica Zubac,1627826,0.371241733382127,-6.27698552931503,-5.9057437959329,167,483,470,43,812,836,1648,191.6,213.933333333333,405.533333333333,903,812,91,54.7936893203884,80.1611047180668
Emeka Okafor,2731,-2.96131473442521,-3.00027601264953,-5.96159074707473,455,466,471,26,746,755,1501,166.233333333333,177,343.233333333333,791,779,12,52.6982011992005,82.9639700883753
JaKarr Sampson,203960,-0.467145167503726,-5.7069147059024,-6.17405987340612,312,482,472,22,635,679,1314,162.983333333333,180.133333333333,343.116666666667,714,654,60,54.337899543379,74.9132947976879
Nigel Hayes,1628502,-3.64513245272085,-2.57542886651639,-6.22056131923725,465,457,473,9,229,228,457,59.5166666666667,62.05,121.566666666667,230,234,-4,50.328227571116,68.1107759802578
Dakari Johnson,1626177,-4.62065186880109,-1.98133189111637,-6.60198375991746,470,440,474,30,286,307,593,75.3666666666667,77.7166666666667,153.083333333333,285,323,-38,48.0607082630692,67.0223189983669
Derrick White,1628401,-4.05773722150319,-2.6476598252029,-6.7053970467061,468,461,475,16,275,283,558,66.9333333333333,70.9666666666667,137.9,280,292,-12,50.1792114695341,73.0964467005076
Zhou Qi,1627753,-2.71590290881146,-4.01005058172191,-6.72595349053337,451,476,476,18,244,246,490,60.7333333333333,61.2166666666667,121.95,253,249,4,51.6326530612245,74.6863468634686
Johnny O'Bryant III,203948,-1.34651590679549,-5.40621196772934,-6.75272787452483,400,481,477,36,736,790,1526,174.383333333333,202.633333333333,377.016666666667,835,759,76,54.7182175622543,79.7312231996817
Jack Cooley,204022,-6.98364738646521,-0.14142217757256,-7.12506956403777,481,265,478,7,169,176,345,41.2333333333333,47.4166666666667,88.65,160,188,-28,46.3768115942029,64.9746192893401
Derrick Jones Jr.,1627884,-3.53206817068799,-3.76246590382279,-7.29453407451077,464,474,479,20,485,484,969,121.3,119.35,240.65,498,492,6,51.3931888544892,74.4982339497195
Andrew Bogut,101106,-5.45940343447592,-2.09351000796403,-7.55291344243995,475,444,480,23,448,422,870,110.85,100.883333333333,211.733333333333,439,447,-8,50.4597701149425,74.6410579345088
Antonius Cleveland,1628499,-7.00958046152603,-1.81717306898307,-8.82675353050909,482,434,481,15,241,242,483,62.9833333333333,59.25,122.233333333333,229,258,-29,47.4120082815735,67.4447777474775
Alan Williams,1626210,-6.78311444380172,-2.1391264664145,-8.92224091021622,480,445,482,5,127,136,263,33.85,37.4333333333333,71.2833333333333,120,145,-25,45.6273764258555,60.6032265606734
Kyle Singler,202713,-8.02857682757197,-1.26285195842239,-9.29142878599437,483,405,483,11,101,113,214,28.0166666666667,27.3833333333333,55.4,92,118,-26,42.9906542056075,59.7833935018051
Udonis Haslem,2617,-12.1311764237496,1.6110906147428,-10.5200858090068,484,46,484,14,130,138,268,36.2833333333333,35.75,72.0333333333333,109,159,-50,40.6716417910448,54.4747801943545
