name,id,n_gm,n_poss_o,n_poss_d,n_poss_total,min_poss_o,min_poss_d,min_poss_total
LeBron James,2544,82,6187,6188,12375,1523.2333333333333,1517.0666666666666,3040.3
Khris Middleton,203114,82,5987,5981,11968,1481.0166666666667,1503.1833333333334,2984.2
Bradley Beal,203078,82,5956,5962,11918,1470,1493.1,2963.1
Andrew Wiggins,203952,82,5943,5939,11882,1476.7,1482.85,2959.55
CJ McCollum,203468,81,5891,5875,11766,1439.7833333333333,1487.6,2927.383333333333
Jrue Holiday,201950,81,6145,6131,12276,1400.9333333333334,1523.8166666666666,2924.75
Russell Westbrook,201566,80,5944,5943,11887,1487.8333333333333,1419.55,2907.383333333333
Karl-Anthony Towns,1626157,82,5749,5749,11498,1451.1,1447.9833333333333,2899.083333333333
Paul George,202331,79,5867,5884,11751,1476.25,1416.6333333333334,2892.883333333333
Giannis Antetokounmpo,203507,75,5505,5490,10995,1361.2333333333333,1391.2333333333333,2752.4666666666667
Kemba Walker,202689,80,5603,5609,11212,1373.8666666666668,1369.4166666666667,2743.2833333333338
Taj Gibson,201959,82,5433,5440,10873,1360.4,1365.9333333333334,2726.3333333333335
Anthony Davis,203076,75,5730,5730,11460,1304.0333333333333,1417,2721.0333333333333
Ben Simmons,1627732,81,5661,5664,11325,1372.6499999999999,1345.0666666666666,2717.7166666666662
DeMar DeRozan,201942,80,5538,5547,11085,1362.1666666666667,1351.7333333333333,2713.9
Will Barton,203115,81,5403,5397,10800,1342.6,1335.75,2678.35
Damian Lillard,203081,73,5404,5408,10812,1314.7166666666667,1355.2,2669.916666666667
Tobias Harris,202699,80,5378,5388,10766,1319.9833333333333,1338.4333333333334,2658.416666666667
Josh Richardson,1626196,81,5294,5304,10598,1336.75,1317.8,2654.55
Andre Drummond,203083,78,5257,5277,10534,1300.05,1324.5,2624.55
Thaddeus Young,201152,81,5194,5197,10391,1306.5333333333333,1313.8666666666666,2620.3999999999996
Donovan Mitchell,1628378,79,5237,5250,10487,1290.6,1324.6833333333334,2615.2833333333333
Harrison Barnes,203084,77,5209,5198,10407,1338.7333333333333,1273.4666666666667,2612.2
Lou Williams,101150,79,5431,5394,10825,1289.1666666666667,1317.1833333333334,2606.3500000000004
E'Twaun Moore,202734,82,5422,5433,10855,1242.15,1342.7166666666667,2584.866666666667
Joe Ingles,204060,82,5139,5136,10275,1260.2166666666667,1311.0666666666666,2571.2833333333333
Robert Covington,203496,80,5255,5268,10523,1275.0333333333333,1265.1833333333334,2540.2166666666667
Jamal Murray,1627750,81,5108,5083,10191,1262.3666666666666,1276.5833333333333,2538.95
Victor Oladipo,203506,75,5107,5107,10214,1266.4166666666667,1270.35,2536.7666666666664
James Harden,201935,72,5114,5122,10236,1244.2166666666667,1287.7333333333333,2531.95
Kyle Lowry,200768,78,5140,5128,10268,1269.4333333333334,1250.7666666666667,2520.2
Carmelo Anthony,2546,78,5091,5091,10182,1274.7166666666667,1236.3166666666666,2511.0333333333333
LaMarcus Aldridge,200746,75,4868,4882,9750,1215.45,1291.85,2507.3
Klay Thompson,202691,73,5199,5196,10395,1216.5,1287.05,2503.55
Steven Adams,203500,76,5026,5048,10074,1259.6666666666667,1228.3833333333334,2488.05
Dwight Howard,2730,81,5049,5059,10108,1240.4666666666667,1234.3,2474.7666666666664
Kentavious Caldwell-Pope,203484,74,5134,5124,10258,1208.6666666666665,1254.1666666666667,2462.833333333333
Bojan Bogdanovic,202711,80,4927,4932,9859,1230,1227.5,2457.5
Taurean Prince,1627752,82,5021,5038,10059,1238.9666666666667,1214.5,2453.4666666666667
DeAndre Jordan,201599,77,4939,4926,9865,1219.5833333333333,1216.45,2436.0333333333333
Otto Porter Jr.,203490,77,4850,4879,9729,1203.5,1221.7166666666667,2425.2166666666667
Nikola Jokic,203999,75,4852,4820,9672,1207.1833333333334,1216.8166666666666,2424
Jayson Tatum,1628369,80,4825,4812,9637,1209.8999999999999,1211.3500000000001,2421.25
Marc Gasol,201188,73,4704,4703,9407,1166.8,1246.4666666666667,2413.2666666666664
Goran Dragic,201609,75,4768,4773,9541,1196.45,1191.0166666666667,2387.4666666666667
Kyle Kuzma,1628398,77,4972,4953,9925,1172.05,1205.8833333333332,2377.9333333333334
Wilson Chandler,201163,74,4707,4740,9447,1172.4,1180.6833333333334,2353.0833333333335
Dillon Brooks,1628415,82,4582,4581,9163,1148.8333333333333,1180.5333333333333,2329.366666666667
Eric Bledsoe,202339,74,4688,4686,9374,1147.2333333333333,1176.7833333333333,2324.0166666666664
Kevin Durant,201142,68,4870,4873,9743,1127,1194.75,2321.75
Spencer Dinwiddie,203915,80,4684,4691,9375,1153.6,1166.45,2320.05
Courtney Lee,201584,76,4649,4663,9312,1138.6833333333334,1175.8333333333333,2314.5166666666664
Jeff Teague,201952,70,4648,4666,9314,1159.7,1153.2166666666667,2312.916666666667
Gary Harris,203914,67,4637,4640,9277,1148.7,1152.1333333333334,2300.8333333333335
Dario Saric,203967,77,4745,4748,9493,1155.9333333333334,1142.1666666666667,2298.1000000000004
Al Horford,201143,72,4551,4538,9089,1142.0333333333333,1149.5166666666667,2291.55
Draymond Green,203110,70,4775,4784,9559,1101.3500000000001,1179.85,2281.2
PJ Tucker,200782,82,4593,4589,9182,1120.3333333333333,1156.5,2276.833333333333
Trevor Ariza,2772,67,4625,4627,9252,1128.8333333333335,1147.5333333333333,2276.366666666667
Justin Holiday,203200,72,4689,4675,9364,1123.3833333333334,1146.7666666666667,2270.15
Ricky Rubio,201937,77,4495,4503,8998,1110.0666666666666,1158.6,2268.6666666666665
Yogi Ferrell,1627812,82,4484,4498,8982,1146.1166666666666,1118.1166666666668,2264.2333333333336
JR Smith,2747,80,4543,4551,9094,1131.75,1111.4333333333334,2243.1833333333334
Allen Crabbe,203459,75,4553,4543,9096,1100.75,1105.5,2206.25
Cory Joseph,202709,82,4375,4379,8754,1086.9333333333334,1112.4666666666667,2199.4
Kelly Oubre Jr.,1626162,81,4501,4493,8994,1092.2,1107.0166666666667,2199.2166666666667
DeMarre Carroll,201960,73,4470,4467,8937,1089.3,1106.5166666666667,2195.8166666666666
Julius Randle,203944,82,4544,4546,9090,1082.1666666666667,1109.2666666666667,2191.4333333333334
Bogdan Bogdanovic,203992,78,4311,4317,8628,1073.9166666666667,1106.9833333333333,2180.9
Derrick Favors,202324,77,4258,4259,8517,1053.6833333333334,1102.2166666666667,2155.9
Jimmy Butler,202710,59,4245,4248,8493,1075.3166666666666,1079.45,2154.7666666666664
Jaylen Brown,1627759,70,4293,4291,8584,1068.95,1079.3833333333334,2148.3333333333335
T.J. Warren,203933,65,4463,4459,8922,1066.2333333333333,1081.9166666666667,2148.15
Eric Gordon,201569,69,4368,4367,8735,1040.7166666666667,1095.05,2135.7666666666664
JJ Redick,200755,70,4460,4455,8915,1075.8999999999999,1051.75,2127.6499999999996
Wesley Matthews,202083,63,4213,4211,8424,1092.1166666666666,1028.7333333333333,2120.85
Patty Mills,201988,82,4169,4172,8341,1034.55,1073.6833333333334,2108.2333333333336
Serge Ibaka,201586,76,4284,4303,8587,1057.7666666666667,1046.3666666666666,2104.133333333333
Jusuf Nurkic,203994,79,4225,4222,8447,1036.45,1058.5166666666667,2094.9666666666667
Dennis Schroder,203471,67,4238,4245,8483,1052.7166666666667,1041,2093.7166666666667
Al-Farouq Aminu,202329,69,4204,4196,8400,1024.4333333333334,1062.75,2087.1833333333334
Denzel Valentine,1627756,77,4264,4245,8509,1034.0333333333333,1053.1,2087.133333333333
Jae Crowder,203109,80,4215,4221,8436,1038.1833333333334,1034.8666666666668,2073.05
Marcin Gortat,101162,82,4153,4176,8329,1021.7666666666667,1050.55,2072.3166666666666
Dragan Bender,1627733,82,4306,4309,8615,1026.65,1038.7833333333333,2065.4333333333334
Austin Rivers,203085,61,4138,4125,8263,1041.0333333333333,1021.1166666666667,2062.15
Terry Rozier,1626179,80,4104,4084,8188,1047.9833333333333,1008.3666666666667,2056.35
Tony Snell,203503,75,4130,4095,8225,1020.7666666666667,1029.7,2050.4666666666667
Wayne Ellington,201961,77,4016,3994,8010,1020.95,1022.4666666666667,2043.4166666666667
Tyler Johnson,204020,72,4076,4080,8156,1020.5500000000001,1021.6666666666666,2042.2166666666667
Evan Turner,202323,79,4097,4092,8189,1005.7666666666667,1034.9833333333333,2040.75
Willie Cauley-Stein,1626161,73,4033,4035,8068,996.9333333333333,1037.95,2034.8833333333332
Ish Smith,202397,82,4112,4110,8222,1025.3999999999999,1006.3666666666667,2031.7666666666664
Darren Collison,201954,69,4055,4067,8122,1012.1166666666667,1019.05,2031.1666666666665
Dennis Smith Jr.,1628372,69,4071,4079,8150,1036.25,987.3833333333333,2023.6333333333332
Jonathon Simmons,203613,69,4139,4137,8276,1009.8666666666667,1011.85,2021.7166666666667
Clint Capela,203991,74,4063,4042,8105,996.6333333333334,1023.5666666666666,2020.2
Marvin Williams,101107,78,4134,4131,8265,1013.4833333333333,1003.3666666666667,2016.85
De'Aaron Fox,1628368,73,4056,4060,8116,984.1333333333333,1031.7,2015.8333333333335
Buddy Hield,1627741,80,3946,3964,7910,982.25,1026.5666666666666,2008.8166666666666
Lauri Markkanen,1628374,68,4092,4097,8189,993.5166666666667,1005.45,1998.9666666666667
John Henson,203089,76,3947,3939,7886,986.8666666666667,996.8333333333333,1983.6999999999998
Nicolas Batum,201587,64,4069,4084,8153,995.5333333333333,987.7833333333333,1983.3166666666666
Blake Griffin,201933,58,3991,3985,7976,977.9666666666667,995.5166666666667,1973.4833333333333
Brandon Ingram,1627742,59,4102,4100,8202,982.6,982.0500000000001,1964.65
Markieff Morris,202693,73,3905,3927,7832,974.5833333333334,989.8,1964.3833333333332
Joe Harris,203925,78,4021,4009,8030,984.55,976.7166666666667,1961.2666666666667
Kyle Anderson,203937,74,3887,3872,7759,951,1010.0166666666667,1961.0166666666667
James Johnson,201949,73,3892,3900,7792,975.9166666666667,978.9999999999999,1954.9166666666665
Jeremy Lamb,203087,80,3952,3962,7914,966.65,986.9833333333333,1953.6333333333332
Marco Belinelli,201158,80,4009,3968,7977,986.8166666666667,963.7166666666667,1950.5333333333333
Dirk Nowitzki,1717,77,3867,3863,7730,991.5,951.0833333333334,1942.5833333333335
Kyrie Irving,202681,60,3906,3889,7795,963.9833333333333,976.8833333333333,1940.8666666666668
Josh Jackson,1628367,77,4080,4073,8153,960.6,972.1833333333333,1932.7833333333333
Darius Miller,203121,82,4002,4010,8012,933.4333333333333,986.6833333333334,1920.1166666666668
Aaron Gordon,203932,58,3944,3937,7881,961,945.5333333333333,1906.5333333333333
Rondae Hollis-Jefferson,1626178,68,3942,3946,7888,949.35,955.3,1904.65
Joel Embiid,203954,63,3893,3875,7768,960.0333333333333,937.5333333333334,1897.5666666666666
Tim Hardaway Jr.,203501,57,3834,3847,7681,930.9499999999999,956.8166666666667,1887.7666666666667
Stanley Johnson,1626169,69,3791,3770,7561,932.6333333333333,953.3333333333334,1885.9666666666667
Jordan Clarkson,203903,81,3878,3872,7750,943.1833333333334,934.4666666666666,1877.65
Chris Paul,101108,58,3732,3715,7447,922.9833333333335,941.6333333333333,1864.6166666666668
Michael Kidd-Gilchrist,203077,74,3813,3789,7602,932.5833333333334,928.8,1861.3833333333332
Devin Booker,1626164,54,3941,3942,7883,919.95,939.5833333333334,1859.5333333333333
Lance Stephenson,202362,82,3665,3657,7322,919.9,927.5833333333334,1847.4833333333333
Evan Fournier,203095,57,3817,3829,7646,926.8833333333333,910.7,1837.5833333333335
Enes Kanter,202683,71,3678,3710,7388,907.1333333333333,930.1666666666666,1837.3
Myles Turner,1626167,65,3681,3673,7354,921.4,915.6166666666667,1837.0166666666667
Caris LeVert,1627747,71,3815,3815,7630,918.8,916.4499999999999,1835.25
Jeff Green,201145,78,3725,3754,7479,903.6999999999999,924.9166666666666,1828.6166666666666
Pau Gasol,2200,77,3598,3599,7197,898.9666666666666,923.4166666666667,1822.3833333333332
George Hill,201588,67,3572,3596,7168,880.4833333333333,941.3333333333333,1821.8166666666666
Frank Kaminsky,1626163,79,3666,3677,7343,893.3333333333333,922.7833333333333,1816.1166666666666
Rudy Gobert,203497,56,3633,3629,7262,892.3000000000001,916.4,1808.7
Elfrid Payton,203901,63,3759,3768,7527,899.5666666666667,906.7166666666667,1806.2833333333333
Kent Bazemore,203145,65,3645,3639,7284,900.5,896.9333333333333,1797.4333333333334
Danny Green,201980,70,3502,3510,7012,867.65,923.6,1791.25
Domantas Sabonis,1627734,74,3556,3559,7115,885.4666666666667,895.85,1781.3166666666666
Kelly Olynyk,203482,76,3500,3495,6995,883.2666666666667,893.8833333333333,1777.15
Lonzo Ball,1628366,52,3752,3738,7490,877.4333333333333,894.3166666666667,1771.75
D.J. Augustin,201571,75,3590,3587,7177,878.75,886.3166666666666,1765.0666666666666
Anthony Tolliver,201229,79,3531,3502,7033,884.7166666666666,877.7166666666667,1762.4333333333334
Ersan Ilyasova,101141,69,3571,3570,7141,878.9,875.8166666666667,1754.7166666666667
Doug McDermott,203926,81,3529,3552,7081,863.95,890.7166666666667,1754.6666666666667
John Collins,1628381,74,3578,3557,7135,882.5166666666667,868.4833333333333,1751
Brook Lopez,201572,74,3640,3632,7272,871.9,872.7166666666667,1744.6166666666668
Jonas Valanciunas,202685,77,3511,3524,7035,871.3333333333334,868.0166666666667,1739.35
DeMarcus Cousins,202326,48,3560,3555,7115,848.7166666666667,886.0666666666667,1734.7833333333333
Reggie Bullock,203493,62,3492,3509,7001,852.6333333333333,880.3000000000001,1732.9333333333334
Dejounte Murray,1627749,81,3437,3415,6852,844.05,880.3,1724.35
Ryan Anderson,201583,66,3501,3496,6997,839.1,884.9499999999999,1724.05
Rajon Rondo,200765,65,3617,3625,7242,825.65,886.3833333333333,1712.0333333333333
T.J. McConnell,204456,76,3537,3534,7071,851.1166666666667,851.4166666666666,1702.5333333333333
Robin Lopez,201577,64,3466,3445,6911,847.3166666666667,851.0166666666667,1698.3333333333335
Jerian Grant,1626170,74,3388,3388,6776,835.0166666666667,855.8833333333333,1690.9
Dwight Powell,203939,79,3318,3329,6647,847.65,832.9666666666667,1680.6166666666668
Nikola Vucevic,202696,57,3495,3504,6999,848.1666666666666,829.25,1677.4166666666665
Frank Ntilikina,1628373,78,3372,3383,6755,818.1833333333333,855.1,1673.2833333333333
Jamal Crawford,2037,80,3326,3320,6646,818.8,850.4666666666667,1669.2666666666667
Justise Winslow,1626159,68,3327,3329,6656,828.4166666666666,838.7,1667.1166666666668
Pascal Siakam,1627783,81,3335,3320,6655,839.0166666666667,823.4833333333333,1662.5
Michael Beasley,201563,73,3356,3357,6713,814.5333333333333,842.15,1656.6833333333334
Kevin Love,201567,59,3353,3328,6681,828.5166666666667,822.2666666666667,1650.7833333333333
Tyler Ulis,1627755,71,3401,3404,6805,817.7166666666667,831.5333333333333,1649.25
Jarell Martin,1626185,73,3261,3261,6522,803.1333333333333,843.7833333333333,1646.9166666666665
Mario Hezonja,1626209,75,3321,3345,6666,825.0833333333334,820.7,1645.7833333333333
Bobby Portis,1626171,73,3340,3345,6685,792.3166666666666,844.7,1637.0166666666667
Tomas Satoransky,203107,73,3262,3285,6547,804.1166666666667,831,1635.1166666666668
Andre Iguodala,2738,64,3354,3349,6703,804.2833333333333,828.8666666666667,1633.15
Troy Daniels,203584,79,3346,3350,6696,807.9833333333333,820.4333333333333,1628.4166666666665
Stephen Curry,201939,51,3496,3498,6994,780.45,845.5666666666666,1626.0166666666667
Jerami Grant,203924,81,3260,3241,6501,824.9333333333333,800.6333333333333,1625.5666666666666
David Nwaba,1628021,70,3309,3323,6632,794.2666666666667,830,1624.2666666666667
Garrett Temple,202066,65,3193,3184,6377,786.3833333333333,834.3166666666666,1620.6999999999998
J.J. Barea,200826,69,3202,3201,6403,823.6333333333333,795.45,1619.0833333333335
Marcus Smart,203935,54,3241,3242,6483,807.85,803.25,1611.1
Tyreke Evans,201936,52,3131,3163,6294,781.5500000000001,827.65,1609.2
Rodney Hood,203918,60,3222,3228,6450,781.6833333333334,826.3833333333333,1608.0666666666666
James Ennis III,203516,72,3163,3164,6327,789.2,817.85,1607.0500000000002
Kyle Korver,2594,73,3258,3230,6488,772.1166666666667,805.3333333333333,1577.4499999999998
Dante Cunningham,201967,73,3245,3271,6516,775.7666666666667,795.1,1570.8666666666668
Jarrett Jack,101127,62,3131,3136,6267,770.3000000000001,790.6999999999999,1561
Dewayne Dedmon,203473,62,3155,3153,6308,781.75,773.35,1555.1
Kristaps Porzingis,204001,48,3097,3118,6215,756.2166666666667,796.4333333333333,1552.65
JaMychal Green,203210,55,3014,3012,6026,759.5166666666667,788.7666666666667,1548.2833333333333
Luc Mbah a Moute,201601,61,3128,3108,6236,760.9166666666667,787.1833333333333,1548.1
Dwyane Wade,2548,67,3160,3169,6329,764.2166666666667,782.75,1546.9666666666667
Shabazz Napier,203894,74,3026,3027,6053,755.9833333333333,773.4166666666666,1529.4
Zach Randolph,2216,59,2966,2995,5961,723.3666666666667,794.5666666666666,1517.9333333333334
Kris Dunn,1627739,52,3128,3125,6253,742.9,768.3333333333333,1511.2333333333331
Marquese Chriss,1627737,72,3164,3152,6316,756.5,754.3666666666667,1510.8666666666668
Jakob Poeltl,1627751,82,3029,3028,6057,758.5833333333333,746.1166666666667,1504.6999999999998
Fred VanVleet,1627832,76,2997,3e3,5997,762.75,738.7333333333333,1501.4833333333333
Nikola Mirotic,202703,55,3140,3128,6268,724.7666666666667,771.6166666666667,1496.3833333333332
Bryn Forbes,1627854,80,2982,2993,5975,724.6999999999999,771.5166666666667,1496.2166666666667
Bismack Biyombo,202687,82,2983,2982,5965,743.75,748.65,1492.4
Justin Jackson,1628382,68,2985,2976,5961,734.9,755.6,1490.5
Aron Baynes,203382,81,2923,2930,5853,746.5,743.1666666666667,1489.6666666666667
Wesley Johnson,202325,74,3097,3080,6177,746,741.85,1487.85
OG Anunoby,1628384,74,3002,2993,5995,737.15,734.95,1472.1
Pat Connaughton,1626192,82,2934,2943,5877,716.1,751.3166666666667,1467.4166666666667
Ed Davis,202334,78,2861,2857,5718,715.3333333333334,746.9333333333334,1462.2666666666669
Tyus Jones,1626145,82,2889,2873,5762,715.65,738.9333333333334,1454.5833333333335
Marcus Morris,202694,54,2905,2909,5814,733.6166666666667,720.0500000000001,1453.6666666666667
Luke Kennard,1628379,73,2885,2861,5746,727.7333333333333,721.1333333333333,1448.8666666666668
Josh Hart,1628404,63,2973,2980,5953,714.2166666666667,732.45,1446.6666666666667
Mason Plumlee,203486,74,2920,2934,5854,721.4166666666666,724.75,1446.1666666666665
Avery Bradley,202340,46,2881,2884,5765,702.6166666666667,735.0333333333334,1437.65
Ian Clark,203546,74,2984,2982,5966,695.6,737.6333333333333,1433.2333333333333
Mario Chalmers,201596,66,2870,2875,5745,693.5833333333334,734.9166666666666,1428.5
Malcolm Brogdon,1627763,48,2842,2827,5669,708.6,715.4,1424
Delon Wright,1626153,69,2839,2852,5691,709.4,709.2666666666668,1418.6666666666667
Jarrett Allen,1628386,72,2900,2891,5791,707.0666666666666,706.6666666666666,1413.7333333333331
Larry Nance Jr.,1626204,66,2904,2914,5818,700.05,710.8,1410.85
John Wall,202322,41,2899,2902,5801,705.9333333333334,702.0666666666666,1408
Nick Young,201156,80,2873,2867,5740,685.3833333333333,705.05,1390.4333333333334
Mike Scott,203118,76,2830,2809,5639,695.5166666666667,693.25,1388.7666666666667
Kosta Koufos,201585,71,2709,2698,5407,686.1333333333333,701.4833333333333,1387.6166666666668
Alex Len,203458,69,2917,2905,5822,683.3666666666667,703.1666666666666,1386.5333333333333
Trey Lyles,1626168,73,2770,2764,5534,692.5166666666667,682.5500000000001,1375.0666666666666
Kyle O'Quinn,203124,77,2765,2753,5518,680.2,694.6,1374.8000000000002
Hassan Whiteside,202355,54,2760,2753,5513,702.8000000000001,670.0166666666667,1372.8166666666666
Raymond Felton,101109,82,2658,2656,5314,689.2833333333333,682.1833333333334,1371.4666666666667
Nemanja Bjelica,202357,67,2773,2763,5536,665.6,698.9666666666667,1364.5666666666666
Quincy Acy,203112,70,2776,2775,5551,685.2,677.6166666666667,1362.8166666666666
Devin Harris,2734,71,2735,2736,5471,690.2833333333333,671.4833333333333,1361.7666666666667
NA,202714,69,2713,2719,5432,682.55,677.5833333333334,1360.1333333333332
Lance Thomas,202498,73,2701,2694,5395,667.2,680.85,1348.0500000000002
Bam Adebayo,1628389,69,2637,2654,5291,674.3333333333334,673.0166666666667,1347.35
CJ Miles,101139,70,2697,2726,5423,673.8833333333333,671.0166666666667,1344.9
Gorgui Dieng,203476,79,2701,2688,5389,657.75,680.5166666666667,1338.2666666666667
Andrew Harrison,1626150,56,2558,2551,5109,634.1333333333333,688.0833333333333,1322.2166666666667
Manu Ginobili,1938,65,2608,2610,5218,638.75,673.25,1312
Montrezl Harrell,1626149,76,2641,2655,5296,611.9,657.5666666666667,1269.4666666666667
Patrick Patterson,202335,82,2478,2479,4957,641.9333333333333,622.6166666666667,1264.55
Maurice Harkless,203090,59,2543,2529,5072,621.2,640.6333333333333,1261.8333333333335
Emmanuel Mudiay,1626144,64,2562,2563,5125,616.25,625.0666666666667,1241.3166666666666
Rudy Gay,200752,57,2430,2427,4857,600.5833333333333,627.8166666666667,1228.4
Skal Labissiere,1627746,60,2453,2454,4907,602.6666666666666,625.3166666666667,1227.9833333333333
D'Angelo Russell,1626156,48,2577,2579,5156,610.4666666666667,613.6666666666666,1224.1333333333332
Thon Maker,1627748,74,2420,2415,4835,600.1333333333333,620.6666666666666,1220.8
Corey Brewer,201147,72,2567,2561,5128,613.25,602.5,1215.75
Joe Johnson,2207,55,2401,2405,4806,592.55,615.4333333333333,1207.9833333333331
Reggie Jackson,202704,45,2378,2374,4752,585.9,612.7833333333334,1198.6833333333334
Amir Johnson,101161,74,2457,2474,4931,597.7333333333333,591.2666666666667,1189
Maxi Kleber,1628467,71,2366,2370,4736,606.2166666666667,580.75,1186.9666666666667
Trevor Booker,202344,68,2384,2374,4758,581.6833333333333,581.3333333333334,1163.0166666666667
Tyson Chandler,2199,46,2379,2385,4764,581.4333333333334,577.6999999999999,1159.1333333333332
Paul Millsap,200794,38,2306,2311,4617,571.5666666666667,579.6,1151.1666666666667
Shaun Livingston,2733,71,2315,2332,4647,555.8166666666666,589.7166666666667,1145.5333333333333
Isaiah Taylor,1627819,67,2364,2361,4725,571.6,570.5833333333334,1142.1833333333334
Ian Mahinmi,101133,77,2301,2276,4577,573.2333333333333,564.4666666666666,1137.6999999999998
Sindarius Thornwell,1628414,71,2335,2358,4693,557.05,578.2833333333333,1135.3333333333333
Royce O'Neale,1626220,69,2244,2247,4491,551.1833333333334,576.6666666666666,1127.85
Jonas Jerebko,201973,74,2228,2232,4460,555.6,572.2,1127.8000000000002
Semi Ojeleye,1628400,73,2244,2259,4503,574.75,551.7333333333333,1126.4833333333333
Alex Abrines,203518,74,2231,2253,4484,560.4,564.25,1124.65
Milos Teodosic,1628462,45,2331,2327,4658,547.3833333333333,572.7333333333333,1120.1166666666668
Jodie Meeks,201975,77,2278,2270,4548,548.65,562.0166666666667,1110.6666666666665
Tyler Zeller,203092,66,2277,2257,4534,554.0166666666667,555.75,1109.7666666666667
Ben McLemore,203463,56,2181,2176,4357,538.0166666666667,555.5666666666667,1093.5833333333335
Davis Bertans,202722,77,2161,2171,4332,526.5666666666666,554.4166666666666,1080.9833333333331
Tony Parker,2225,55,2124,2130,4254,517.7166666666667,562.8833333333333,1080.6
Tristan Thompson,202684,53,2173,2181,4354,536.75,529.6333333333333,1066.3833333333332
Mike Muscala,203488,53,2202,2189,4391,533.7333333333333,523.7333333333333,1057.4666666666667
Norman Powell,1626181,70,2140,2141,4281,534.1666666666666,521.2,1055.3666666666668
Alec Burks,202692,64,2092,2091,4183,512.4666666666667,542.4333333333333,1054.9
Greg Monroe,202328,51,2111,2102,4213,524.9,514.6166666666667,1039.5166666666667
Andre Roberson,203460,39,2056,2037,4093,518.2333333333333,519.3333333333333,1037.5666666666666
Vince Carter,1713,58,2011,2011,4022,506.1666666666667,528.4833333333333,1034.65
Treveon Graham,1626203,63,2089,2094,4183,499.75,533.1166666666667,1032.8666666666668
Zach Collins,1628380,66,2013,2019,4032,504.3666666666667,520.15,1024.5166666666667
Jameer Nelson,2749,50,2074,2063,4137,506.84999999999997,516.9333333333334,1023.7833333333333
David West,2561,73,1998,2005,4003,498.9333333333333,515.0166666666667,1013.9499999999999
Wes Iwundu,1628411,62,2019,2003,4022,502.6333333333333,503.73333333333335,1006.3666666666667
Malcolm Delaney,1627098,54,2039,2028,4067,507.79999999999995,496.98333333333335,1004.7833333333333
Zaza Pachulia,2585,69,2040,2043,4083,475.3500000000001,503.78333333333325,979.1333333333333
Frank Mason,1628412,52,1872,1882,3754,480.3,492.5,972.8
Josh Huestis,203962,69,1911,1904,3815,489.46666666666664,479.55,969.0166666666667
Cristiano Felicio,1626245,55,1956,1960,3916,477.6333333333333,489.91666666666663,967.55
Tyler Dorsey,1628416,56,1972,1975,3947,489.1,470.25,959.35
Patrick McCaw,1627775,57,1932,1941,3873,464.15000000000003,478.25,942.4000000000001
Deyonta Davis,1627738,62,1886,1884,3770,461.7833333333333,472.83333333333337,934.6166666666667
Miles Plumlee,203101,55,1888,1906,3794,472.71666666666664,456.78333333333336,929.5
Gerald Green,101123,41,1887,1876,3763,456.73333333333335,472.03333333333336,928.7666666666667
Jerryd Bayless,201573,39,1927,1927,3854,458.65,463.56666666666666,922.2166666666667
Dion Waiters,203079,30,1822,1820,3642,456.73333333333335,462.73333333333335,919.4666666666667
Daniel Theis,1628464,62,1814,1816,3630,458.0833333333333,451.75,909.8333333333333
Jose Calderon,101181,57,1817,1817,3634,456.0333333333333,453.40000000000003,909.4333333333334
Kevon Looney,1626172,66,1834,1827,3661,447.3,443.25,890.55
Noah Vonleh,203943,54,1753,1750,3503,433.03333333333336,441.16666666666663,874.2
Sam Dekker,1626155,73,1813,1809,3622,422.73333333333335,442.2833333333333,865.0166666666667
Isaiah Thomas,202738,32,1822,1810,3632,433.33333333333337,427.6166666666666,860.95
Langston Galloway,204038,58,1706,1718,3424,433.84999999999997,414.06666666666666,847.9166666666666
Tyrone Wallace,1627820,29,1789,1790,3579,409.9,435.43333333333334,845.3333333333333
Malik Monk,1628370,63,1740,1755,3495,411.3333333333333,430.3666666666667,841.7
Michael Carter-Williams,203487,52,1646,1641,3287,399.7,426.43333333333334,826.1333333333333
Jason Terry,1891,51,1649,1652,3301,405.8166666666667,417.71666666666664,823.5333333333333
Tim Frazier,204025,59,1658,1660,3318,410.6166666666667,409.46666666666664,820.0833333333333
Paul Zipser,1627835,53,1617,1612,3229,402.65,413.55,816.2
Thabo Sefolosha,200757,38,1613,1606,3219,397.90000000000003,412,809.9000000000001
Ekpe Udoh,202327,63,1599,1609,3208,393.73333333333335,408.65,802.3833333333333
Timothe Luwawu-Cabarrot,1627789,52,1665,1654,3319,393.56666666666666,397.91666666666663,791.4833333333333
Jordan Bell,1628395,57,1645,1643,3288,390.0833333333333,398.55,788.6333333333333
Eric Moreland,203961,67,1562,1548,3110,396.7333333333333,388.18333333333334,784.9166666666666
Trey Burke,203504,36,1597,1586,3183,391.3,393.26666666666665,784.5666666666666
Shane Larkin,203499,54,1524,1520,3044,396.25,376.4666666666667,772.7166666666667
Jawun Evans,1628393,48,1614,1615,3229,377.43333333333334,389.2,766.6333333333333
Nene,2403,52,1579,1578,3157,376.31666666666666,389.68333333333334,766
Sterling Brown,1628425,54,1526,1526,3052,378.8666666666667,383.21666666666664,762.0833333333333
Terrance Ferguson,1628390,61,1491,1491,2982,377.55,370.3333333333333,747.8833333333333
Jabari Parker,203953,31,1501,1503,3004,358.05,376.4166666666667,734.4666666666667
Richaun Holmes,1626158,48,1539,1537,3076,368.01666666666665,364.65,732.6666666666666
Quinn Cook,1626188,33,1488,1484,2972,361.43333333333334,369.51666666666665,730.95
NA,201956,53,1525,1517,3042,358.98333333333335,369.3,728.2833333333333
DeAndre Liggins,202732,56,1437,1442,2879,357.6,361.5333333333333,719.1333333333333
Luke Babbitt,202337,49,1463,1442,2905,361.5833333333333,353.68333333333334,715.2666666666667
Salah Mejri,1626257,60,1392,1385,2777,368.03333333333336,340.7833333333333,708.8166666666666
Matthew Dellavedova,203521,38,1392,1389,2781,352.6,354.68333333333334,707.2833333333333
C.J. Williams,203710,37,1427,1447,2874,342.48333333333335,361.75,704.2333333333333
Dwayne Bacon,1628407,53,1457,1460,2917,350.8833333333333,352.76666666666665,703.65
Channing Frye,101112,53,1419,1421,2840,339.6166666666667,357.55,697.1666666666667
Chandler Parsons,202718,36,1370,1374,2744,338.40000000000003,354.7,693.1
Jared Dudley,201162,48,1407,1413,2820,343.23333333333335,345.9166666666667,689.1500000000001
Arron Afflalo,201167,53,1369,1350,2719,346.15,340.5,686.65
Tyler Ennis,203898,54,1412,1411,2823,337.51666666666665,347.9,685.4166666666666
Wayne Selden,1627782,35,1385,1387,2772,335.7,346.43333333333334,682.1333333333333
Marreese Speights,201578,51,1359,1369,2728,338.3833333333334,340.8333333333333,679.2166666666667
NA,1628455,36,1464,1463,2927,339.05,339.76666666666665,678.8166666666666
Danilo Gallinari,201568,21,1346,1346,2692,343.1166666666667,333.01666666666665,676.1333333333333
Zach LaVine,203897,24,1358,1358,2716,326.0833333333333,336.95,663.0333333333333
Cedi Osman,1626224,60,1346,1354,2700,325.25,332.2166666666667,657.4666666666667
Sean Kilpatrick,203930,52,1298,1303,2601,309.85,325.6166666666667,635.4666666666667
Kobi Simmons,1628424,32,1277,1259,2536,309.26666666666665,323.68333333333334,632.95
Cody Zeller,203469,33,1259,1264,2523,307.3666666666667,312.9,620.2666666666667
Torrey Craig,1628470,39,1235,1255,2490,302.75,312.70000000000005,615.45
JaVale McGee,201580,65,1280,1273,2553,297.95,311.5333333333333,609.4833333333333
Terrence Ross,203082,24,1259,1261,2520,301.2,301.18333333333334,602.3833333333333
Cameron Payne,1626166,25,1200,1198,2398,289.05,297.06666666666666,586.1166666666667
Khem Birch,203920,42,1147,1147,2294,282.45,295.8,578.25
Malik Beasley,1627736,61,1197,1197,2394,283.18333333333334,292.03333333333336,575.2166666666667
Brandon Paul,203464,63,1182,1167,2349,282.51666666666665,291.03333333333336,573.55
Cheick Diallo,1627767,51,1188,1184,2372,279.73333333333335,284.3333333333333,564.0666666666666
Alex Caruso,1627936,37,1159,1171,2330,275.04999999999995,282.6166666666667,557.6666666666666
Joe Young,1626202,53,1088,1096,2184,271.66666666666663,277.0166666666667,548.6833333333334
Joffrey Lauvergne,203530,55,1079,1072,2151,254.86666666666667,272.46666666666664,527.3333333333333
Tarik Black,204028,51,1089,1085,2174,261.6,265.65,527.25
Jonathan Isaac,1628371,27,1071,1079,2150,261.95,264.08333333333337,526.0333333333333
Nik Stauskas,203917,41,1060,1050,2110,262.7333333333333,255.25,517.9833333333333
Abdel Nader,1627846,48,1067,1055,2122,269.25,247.93333333333334,517.1833333333334
Ivan Rabb,1628397,35,1020,1027,2047,247.2,262.73333333333335,509.93333333333334
Justin Anderson,1626147,38,1056,1037,2093,256.7166666666667,249.09999999999997,505.81666666666666
Tyler Cavanaugh,1628463,38,1032,1024,2056,256.25,243.46666666666667,499.7166666666667
Raul Neto,203526,41,1001,999,2e3,243.8166666666667,251.74999999999997,495.56666666666666
Al Jefferson,2744,36,965,967,1932,247.13333333333333,247.3666666666667,494.5
Willy Hernangomez,1626195,48,995,1001,1996,241.15,244.68333333333334,485.83333333333337
Kyle Collinsworth,1627858,32,945,944,1889,243.66666666666666,232.35,476.01666666666665
Nerlens Noel,203457,29,938,948,1886,239.3166666666667,229.2833333333333,468.6
Damyean Dotson,1628422,44,951,956,1907,234.95,232.4,467.35
Kenneth Faried,202702,32,930,922,1852,231.98333333333332,229.53333333333333,461.51666666666665
TJ Leaf,1628388,53,907,910,1817,223.11666666666667,227.21666666666667,450.33333333333337
DeAndre' Bembry,1627761,26,908,920,1828,223.31666666666666,224.78333333333336,448.1
Dorian Finney-Smith,1627827,21,888,885,1773,227.7,216.51666666666668,444.2166666666667
NA,203477,20,843,839,1682,209.46666666666667,214.95,424.41666666666663
Dwight Buycks,202779,29,839,835,1674,208.4333333333333,214.91666666666669,423.35
NA,203186,41,888,883,1771,211.9,210.86666666666665,422.76666666666665
Derrick Rose,201565,25,881,880,1761,202.54999999999998,216.71666666666667,419.26666666666665
Shabazz Muhammad,203498,43,844,845,1689,209.93333333333334,207.75,417.68333333333334
Lucas Nogueira,203512,49,835,844,1679,208.08333333333331,206.85000000000002,414.93333333333334
Damion Lee,1627814,15,844,840,1684,206.85,198.20000000000002,405.05
Ivica Zubac,1627826,43,841,844,1685,192.13333333333335,212.6,404.73333333333335
Danuel House Jr.,1627863,23,827,821,1648,200.14999999999998,201.15,401.29999999999995
Ramon Sessions,201196,28,791,784,1575,194.28333333333333,198.45,392.73333333333335
NA,201148,28,751,752,1503,187.66666666666666,195.96666666666667,383.6333333333333
Ron Baker,1627758,29,760,764,1524,186.56666666666666,192.76666666666668,379.33333333333337
Shaquille Harrison,1627885,23,808,801,1609,193.63333333333333,185.46666666666667,379.1
Mike Conley,201144,12,731,729,1460,186.88333333333335,189.58333333333331,376.4666666666667
Myke Henry,1627988,20,757,758,1515,181.75,194.3,376.05
NA,203948,36,771,761,1532,178.58333333333334,193.71666666666667,372.3
Timofey Mozgov,202389,31,770,773,1543,179.65,182.48333333333332,362.1333333333333
Emeka Okafor,2731,26,767,771,1538,171.2666666666667,188.46666666666664,359.73333333333335
Jahlil Okafor,1626143,28,698,702,1400,176.9,175.43333333333334,352.33333333333337
JaKarr Sampson,203960,22,675,665,1340,165.96666666666667,177.56666666666666,343.5333333333333
Boban Marjanovic,1626246,38,689,694,1383,162.66666666666663,171.93333333333337,334.6
Patrick Beverley,201976,11,650,656,1306,165.83333333333334,166.76666666666668,332.6
Glenn Robinson III,203922,23,664,671,1335,167.4,163.85,331.25
Luke Kornet,1628436,20,662,656,1318,162.28333333333333,160.06666666666666,322.35
Henry Ellenson,1627740,37,663,657,1320,162.5,158.63333333333335,321.1333333333333
Malachi Richardson,1627781,26,651,641,1292,158.48333333333332,162.25,320.73333333333335
Antonio Blakeney,1628469,19,628,632,1260,148.88333333333335,161.51666666666665,310.4
Troy Williams,1627786,21,638,636,1274,147.85,157.98333333333332,305.8333333333333
Ryan Arcidiacono,1627853,24,615,622,1237,147.11666666666667,153.1,300.2166666666667
Rodney McGruder,203585,18,594,590,1184,149.05000000000004,149.8833333333333,298.93333333333334
Rodney Purvis,1628681,16,577,579,1156,141.85000000000002,145.2,287.05
Jason Smith,201160,33,587,589,1176,139.86666666666667,142.9,282.76666666666665
Jordan Mickey,1626175,23,548,548,1096,141.16666666666666,138.81666666666666,279.98333333333335
NA,2754,22,574,584,1158,135.38333333333333,144.33333333333334,279.7166666666667
NA,203966,15,545,546,1091,132.36666666666667,143.21666666666664,275.5833333333333
Jamel Artis,1628503,15,544,549,1093,137.8,136.9,274.70000000000005
Iman Shumpert,202697,14,563,567,1130,135.65,136.6,272.25
Juancho Hernangomez,1627823,25,559,552,1111,135.53333333333333,136.68333333333334,272.2166666666667
Meyers Leonard,203086,32,520,516,1036,124.08333333333334,127.85,251.93333333333334
Markelle Fultz,1628365,14,544,542,1086,124.08333333333333,124.7,248.78333333333333
Derrick Jones Jr.,1627884,20,482,486,968,121.3,121.16666666666667,242.46666666666667
Davon Reed,1628432,21,496,503,999,120.36666666666666,118.00000000000001,238.36666666666667
Dante Exum,203957,14,483,473,956,121.39999999999996,113.65000000000002,235.04999999999998
Guerschon Yabusele,1627824,33,475,480,955,122.23333333333332,112.55000000000001,234.78333333333333
Isaiah Hicks,1628439,18,483,480,963,117.75,116.18333333333334,233.93333333333334
Aaron Harrison,1626151,9,468,473,941,120.58333333333333,112.45,233.03333333333333
Briante Weber,1627362,18,477,482,959,113,119.18333333333332,232.18333333333334
Travis Wear,204037,17,463,463,926,112.3,114.13333333333334,226.43333333333334
Alec Peters,1628409,20,466,467,933,111.86666666666666,110.45,222.31666666666666
NA,101106,23,453,452,905,111.43333333333335,107.4833333333333,218.91666666666666
Marcus Georges-Hunt,1627875,41,455,447,902,103.71666666666667,113.96666666666667,217.68333333333334
Gary Payton II,1627780,23,443,442,885,107.23333333333333,109.55,216.78333333333333
Josh Magette,203705,18,431,437,868,108.31666666666665,107.73333333333335,216.05
Kawhi Leonard,202695,9,420,422,842,103.26666666666667,107.35,210.61666666666667
NA,1626173,28,414,410,824,105.10000000000001,102.6,207.7
Ante Zizic,1627790,32,429,429,858,104.96666666666665,102.25,207.21666666666664
Brandon Jennings,201943,14,426,428,854,99.38333333333334,107.14999999999999,206.53333333333333
Andrew White III,1628510,15,426,432,858,103.51666666666667,102.31666666666666,205.83333333333331
NA,202347,23,403,399,802,98.83333333333334,97.64999999999999,196.48333333333335
MarShon Brooks,202705,7,384,388,772,92.11666666666666,101.45000000000002,193.56666666666666
Aaron Brooks,201166,32,385,388,773,89.33333333333333,100.51666666666667,189.85
Caleb Swanigan,1628403,27,370,371,741,93.86666666666667,91.58333333333333,185.45
Omer Asik,201600,18,373,373,746,89.48333333333333,93.68333333333332,183.16666666666666
Solomon Hill,203524,12,402,394,796,89.9,92.68333333333332,182.58333333333331
Jalen Jones,1627883,14,353,354,707,88.7,89.26666666666667,177.96666666666667
Isaiah Whitehead,1627785,16,367,374,741,92.85000000000001,84.18333333333332,177.03333333333333
Johnathan Motley,1628405,11,336,342,678,86.73333333333333,87,173.73333333333335
Julyan Stone,202933,23,362,365,727,89.56666666666666,82.60000000000001,172.16666666666669
NA,204066,23,354,356,710,86,85.16666666666667,171.16666666666669
Richard Jefferson,2210,20,334,335,669,84.91666666666666,81.5,166.41666666666666
NA,203141,10,320,319,639,81.05000000000001,78.64999999999999,159.7
Jake Layman,1627774,34,310,319,629,76.61666666666667,80.33333333333333,156.95
Dakari Johnson,1626177,30,312,307,619,80.11666666666667,74.21666666666665,154.33333333333331
NA,2863,19,298,301,599,74.26666666666667,77.76666666666668,152.03333333333336
Derrick Walton Jr.,1628476,16,286,286,572,73.93333333333332,71.00000000000001,144.93333333333334
Darrell Arthur,201589,18,289,292,581,68.43333333333334,70.28333333333333,138.71666666666667
Lorenzo Brown,203485,14,267,271,538,72.83333333333333,65.71666666666667,138.55
Kay Felder,1627770,15,282,285,567,66.36666666666666,69.61666666666667,135.98333333333335
Derrick White,1628401,16,286,284,570,65,69.76666666666667,134.76666666666665
Jon Leuer,202720,8,285,285,570,67.23333333333335,58.04999999999999,125.28333333333333
Malcolm Miller,1626259,14,252,253,505,58.55,66.11666666666666,124.66666666666666
Milton Doyle,1628495,10,252,256,508,60.933333333333344,61.39999999999999,122.33333333333334
Zhou Qi,1627753,18,254,255,509,59.35000000000001,61.58333333333333,120.93333333333334
Nigel Hayes,1628502,9,226,227,453,57.75,62.6,120.35
Georgios Papagiannis,1627834,17,246,244,490,58.833333333333336,60.86666666666666,119.69999999999999
Antonius Cleveland,1628499,16,247,249,496,61.53333333333334,57.36666666666666,118.9
James Webb III,1627821,10,244,241,485,60.28333333333333,57.85000000000001,118.13333333333334
NA,1628504,5,238,241,479,57.01666666666667,59.03333333333333,116.05000000000001
NA,201628,20,240,233,473,56.58333333333335,56.44999999999999,113.03333333333333
Jabari Bird,1628444,13,235,229,464,56.516666666666666,55.233333333333334,111.75
Bruno Caboclo,203998,12,205,208,413,53.43333333333333,52.75000000000001,106.18333333333334
Kadeem Allen,1628443,16,215,220,435,53.900000000000006,51.98333333333333,105.88333333333333
Alex Poythress,1627816,24,199,198,397,47.19999999999999,52.70000000000001,99.9
Jaylen Morris,1628537,6,210,208,418,49.14999999999999,47.683333333333344,96.83333333333334
NA,1627744,17,208,208,416,46.36666666666666,49.50000000000001,95.86666666666667
Darrun Hilliard,1626199,14,187,190,377,46.716666666666676,47.48333333333332,94.19999999999999
Jack Cooley,204022,7,164,164,328,43.083333333333336,45.05,88.13333333333333
Chris McCullough,1626191,19,192,194,386,41.050000000000004,46.99999999999999,88.05
Damian Jones,1627745,15,178,176,354,44.08333333333332,42.500000000000014,86.58333333333334
NA,1627982,5,184,183,367,43.166666666666664,42.583333333333336,85.75
Wade Baldwin IV,1627735,7,159,162,321,40.96666666666666,38.81666666666668,79.78333333333333
Okaro White,1627855,5,160,160,320,39.449999999999996,39.63333333333334,79.08333333333334
Demetrius Jackson,1627743,15,161,159,320,38.68333333333332,39.71666666666668,78.4
Furkan Korkmaz,1627788,14,169,168,337,36.7,40.68333333333333,77.38333333333333
NA,204179,4,152,148,300,36.93333333333333,37.966666666666676,74.9
Marquis Teague,203104,3,147,148,295,36.699999999999996,37.93333333333334,74.63333333333333
Nick Collison,2555,15,151,151,302,37.63333333333333,36.61666666666666,74.25
Udonis Haslem,2617,14,138,139,277,38.9,34.15,73.05
Thomas Bryant,1628418,15,149,150,299,33.16666666666667,38.33333333333333,71.5
Alan Williams,1626210,5,141,141,282,35.26666666666667,35.41666666666666,70.68333333333334
Larry Drew II,203580,9,135,139,274,32.81666666666666,35.71666666666667,68.53333333333333
D.J. Wilson,1628391,22,140,138,278,36.01666666666666,32.400000000000006,68.41666666666666
Andre Ingram,201281,2,139,140,279,34.099999999999994,29.400000000000006,63.5
NA,1628492,7,131,130,261,30.31666666666666,32.866666666666674,63.18333333333334
NA,1628506,12,124,128,252,30.983333333333334,31.98333333333333,62.96666666666667
NA,203923,6,119,119,238,31.383333333333336,29.483333333333327,60.86666666666666
Kyle Singler,202713,12,117,116,233,30.200000000000003,27.433333333333334,57.63333333333334
Jordan Crawford,202348,5,117,117,234,27.566666666666666,25.55,53.11666666666667
Alfonzo McKinnie,1628035,14,109,113,222,27.366666666666667,25.066666666666666,52.43333333333334
Marshall Plumlee,1627850,8,107,111,218,25.31666666666667,25.933333333333326,51.25
Cole Aldrich,202332,21,104,106,210,19.633333333333333,27.566666666666666,47.2
NA,203505,5,93,94,187,19.116666666666664,25.56666666666667,44.68333333333334
RJ Hunter,1626154,5,90,89,179,21.166666666666668,23.316666666666663,44.483333333333334
NA,203940,5,85,84,169,22.46666666666667,19.9,42.36666666666667
Joakim Noah,201149,7,88,87,175,19.333333333333336,22.266666666666662,41.599999999999994
Jonathan Gibson,1626780,4,84,86,170,19.900000000000002,19.849999999999994,39.75
NA,203481,9,82,81,163,18.68333333333333,19.76666666666667,38.45
Charles Cooke,1628429,12,81,77,158,18.016666666666666,18.616666666666667,36.63333333333333
NA,1627762,6,77,74,151,20.6,15.799999999999997,36.4
NA,1627215,5,73,72,145,17.6,16.283333333333328,33.883333333333326
NA,2937798,1,62,63,125,15.950000000000001,17.183333333333334,33.13333333333333
NA,1628451,5,72,71,143,17.233333333333338,15.766666666666664,33
Matt Costello,1627856,4,65,64,129,16.23333333333333,15.566666666666668,31.799999999999997
Georges Niang,1627777,9,68,71,139,13.433333333333335,17.299999999999997,30.733333333333334
Markel Brown,203900,4,60,62,122,13.549999999999997,16.8,30.349999999999998
Ike Anigbogu,1628387,11,62,63,125,14.266666666666667,14.566666666666666,28.833333333333336
Tony Bradley,1628396,9,58,61,119,13.21666666666667,14.799999999999997,28.016666666666666
Marcus Paige,1627779,5,56,57,113,13.083333333333332,14.350000000000003,27.433333333333337
Daniel Hamilton,1627772,6,56,54,110,13.649999999999997,13.400000000000002,27.049999999999997
NA,1627866,3,51,51,102,14.533333333333333,12.166666666666666,26.7
Jeremy Lin,202391,1,61,61,122,13.266666666666664,11.933333333333335,25.2
Monte Morris,1628420,3,51,52,103,11.516666666666666,12.700000000000001,24.21666666666667
Chinanu Onuaku,1627778,1,38,39,77,9.950000000000003,10.916666666666664,20.866666666666667
Xavier Munford,204098,6,41,43,84,10.500000000000002,9.899999999999999,20.4
Mangok Mathiang,1628493,4,42,41,83,9.766666666666666,9.783333333333335,19.55
NA,203489,5,34,36,70,8.983333333333333,9.75,18.733333333333334
NA,203949,3,38,38,76,8.233333333333333,9.433333333333334,17.666666666666664
Kendrick Perkins,2570,1,29,30,59,6.616666666666668,7.799999999999999,14.416666666666668
Luol Deng,2736,1,30,29,59,7.366666666666671,6.066666666666663,13.433333333333334
Devin Robinson,1628421,1,27,28,55,6.333333333333331,6.616666666666671,12.950000000000003
NA,1627817,3,32,30,62,7.65,5.1,12.75
NA,2746,3,26,26,52,6.616666666666666,5.433333333333334,12.05
NA,1628475,3,24,23,47,6.033333333333333,5.25,11.283333333333333
NA,1627852,3,20,20,40,4.416666666666667,4.783333333333333,9.2
Ben Moore,1628500,2,20,19,39,5.399999999999999,3.6333333333333355,9.033333333333335
Jarell Eddie,204067,3,19,18,37,5.6,3.3999999999999995,9
David Stockton,204065,3,21,21,42,3.466666666666666,5.5166666666666675,8.983333333333334
NA,202682,2,21,20,41,4.366666666666666,4.416666666666666,8.783333333333331
NA,203816,1,19,21,40,3.4166666666666643,4.916666666666669,8.333333333333332
NA,1626242,2,17,17,34,3.899999999999999,4.283333333333334,8.183333333333334
NA,1626205,4,16,15,31,3.8000000000000003,3.6333333333333333,7.433333333333334
Xavier Silas,202918,2,15,16,31,3.0666666666666695,4.18333333333333,7.25
Erik McCree,1628571,4,17,16,33,2.983333333333333,3.833333333333334,6.816666666666666
Reggie Hearn,203687,3,12,14,26,2.4166666666666665,3.866666666666667,6.283333333333333
NA,201177,2,13,12,25,3.0666666666666664,2.6833333333333345,5.750000000000001
NA,1626643,3,14,15,29,2.816666666666667,2.833333333333333,5.65
Jeremy Evans,202379,1,12,13,25,2.65,2.7833333333333337,5.433333333333334
Gordon Hayward,202330,1,11,10,21,2.599999999999996,2.650000000000004,5.25
Anthony Brown,1626148,1,10,10,20,1.2833333333333332,2.45,3.7333333333333334
Justin Patton,1628383,1,10,10,20,1.2833333333333332,2.45,3.7333333333333334
PJ Dozier,1628408,2,7,5,12,1.7333333333333334,1.2833333333333332,3.0166666666666666
Edmond Sumner,1628410,1,5,4,9,1.0833333333333333,0.95,2.033333333333333
Tyler Lydon,1628399,1,4,3,7,1.4833333333333334,0.44999999999999984,1.9333333333333331
NA,1627851,1,3,4,7,0.4999999999999998,0.9500000000000002,1.45
NA,1628449,1,3,2,5,0.95,0.36666666666666675,1.3166666666666667
NA,203590,1,3,3,6,0.45,0.6500000000000001,1.1
NA,1628513,1,1,2,3,0.25,0.26666666666666705,0.516666666666667
