name,id,gp_total,poss_o,poss_d,poss_total,mp_o,mp_d,mp_total,pts_o,pts_d,pm,pts_o_per100,pts_o_per36
LeBron James,2544,104,7731,7727,15458,1970.13333333333,1941.2,3911.33333333333,9018,9052,-34,58.3387242851598,83.001874893472
Klay Thompson,202691,94,6429,6657,13086,1556.55,1683.46666666667,3240.01666666667,7240,7592,-352,55.3263029191502,80.4440306377025
Jrue Holiday,201950,90,6558,6711,13269,1557.11666666667,1668.15,3225.26666666667,7371,7450,-79,55.5505313135881,82.2741272039521
Khris Middleton,203114,89,6255,6245,12500,1615.18333333333,1608.56666666667,3223.75,7325,7144,181,58.6,81.7991469561846
Bradley Beal,203078,88,6184,6266,12450,1553.73333333333,1599.33333333333,3153.06666666667,6898,7111,-213,55.4056224899598,78.7576116373478
James Harden,201935,89,6147,6161,12308,1555.01666666667,1574.5,3129.51666666667,7268,7001,267,59.0510237244069,83.6065207087357
Andrew Wiggins,203952,87,6286,6204,12490,1567.36666666667,1553.05,3120.41666666667,7069,7084,-15,56.5972778222578,81.5544932567766
Kevin Durant,201142,89,6260,6440,12700,1497.45,1609.7,3107.15,7206,7489,-283,56.740157480315,83.4900149654829
Russell Westbrook,201566,86,6212,6453,12665,1554.46666666667,1550.55,3105.01666666667,6945,7147,-202,54.8361626529807,80.5213069173005
Paul George,202331,85,6177,6354,12531,1562.71666666667,1541.23333333333,3103.95,6975,6992,-17,55.6619583433086,80.8969216643309
Jayson Tatum,1628369,99,5995,5993,11988,1551.7,1523.46666666667,3075.16666666667,6674,6371,303,55.6723390056724,78.1303994363449
Anthony Davis,203076,84,6254,6426,12680,1476.95,1580.71666666667,3057.66666666667,6991,7194,-203,55.1340694006309,82.3098223045895
Draymond Green,203110,91,6067,6262,12329,1470.56666666667,1574.23333333333,3044.8,6896,7145,-249,55.93316570687,81.5344193378875
DeMar DeRozan,201942,90,6145,6217,12362,1522.46666666667,1521.78333333333,3044.25,6907,7103,-196,55.8728361106617,81.6792313377679
CJ McCollum,203468,85,6049,6177,12226,1490.61666666667,1542.3,3032.91666666667,6717,6717,0,54.9402911827253,79.7291935705454
Karl-Anthony Towns,1626157,87,6036,5961,11997,1524.16666666667,1502.3,3026.46666666667,6777,7006,-229,56.4891222805701,80.6128158248342
Donovan Mitchell,1628378,90,5821,5856,11677,1492.28333333333,1509.7,3001.98333333333,6356,6556,-200,54.4317889868973,76.221609047352
Giannis Antetokounmpo,203507,82,5845,5797,11642,1502.9,1494.96666666667,2997.86666666667,6848,6431,417,58.8215083319017,82.2344778509162
Ben Simmons,1627732,91,6087,6164,12251,1514.43333333333,1481.86666666667,2996.3,6757,6859,-102,55.1546812505102,81.1841270900778
Joe Ingles,204060,93,5669,5683,11352,1446.25,1476.25,2922.5,6245,6390,-145,55.0123326286117,76.9272882805817
Al Horford,201143,91,5661,5730,11391,1468.3,1453.55,2921.85,6429,6095,334,56.4392941796155,79.2114584937625
JR Smith,2747,102,5754,5750,11504,1471.03333333333,1441.66666666667,2912.7,6629,6787,-158,57.6234353268428,81.9322278298486
PJ Tucker,200782,99,5545,5559,11104,1414.1,1431.2,2845.3,6461,6338,123,58.1862391930836,81.7474431518645
Kyle Lowry,200768,88,5702,5756,11458,1427.9,1415.26666666667,2843.16666666667,6439,6546,-107,56.1965438994589,81.5302186529105
E'Twaun Moore,202734,91,5745,5897,11642,1367.26666666667,1453.81666666667,2821.08333333333,6392,6700,-308,54.9046555574644,81.5686645201312
Taj Gibson,201959,87,5662,5572,11234,1424.2,1395.2,2819.4,6347,6412,-65,56.4981306747374,81.0427750585231
Damian Lillard,203081,77,5632,5743,11375,1381.23333333333,1427,2808.23333333333,6255,6324,-69,54.989010989011,80.1856445926858
Trevor Ariza,2772,84,5581,5543,11124,1396.98333333333,1410.98333333333,2807.96666666667,6407,6304,103,57.5961884214311,82.1420007360011
Thaddeus Young,201152,88,5410,5457,10867,1387.51666666667,1414.35,2801.86666666667,5984,6250,-266,55.0657955277446,76.8858856000761
Josh Richardson,1626196,86,5463,5425,10888,1402.73333333333,1387.2,2789.93333333333,6025,6003,22,55.3361498897869,77.7437931611269
Terry Rozier,1626179,99,5441,5427,10868,1421.5,1363.26666666667,2784.76666666667,5899,5842,57,54.2786161207214,76.2591719234406
Victor Oladipo,203506,82,5402,5460,10862,1373.01666666667,1398,2771.01666666667,5948,6194,-246,54.759712760081,77.274165318385
Robert Covington,203496,90,5579,5656,11235,1382.56666666667,1375.5,2758.06666666667,6177,6222,-45,54.9799732977303,80.626042396848
Kemba Walker,202689,80,5440,5535,10975,1341.21666666667,1362.05,2703.26666666667,6157,6243,-86,56.1002277904328,81.9941305580902
Eric Gordon,201569,86,5381,5399,10780,1327.08333333333,1368.86666666667,2695.95,6342,5955,387,58.8311688311688,84.6870305458187
Jaylen Brown,1627759,88,5338,5283,10621,1353.75,1340.45,2694.2,5953,5615,338,56.0493362206949,79.5442060723035
Will Barton,203115,81,5274,5336,10610,1320.68333333333,1348.38333333333,2669.06666666667,6101,6015,86,57.502356267672,82.289439504446
Carmelo Anthony,2546,84,5314,5525,10839,1330.31666666667,1328.93333333333,2659.25,5962,6128,-166,55.005074268844,80.7114788004136
LaMarcus Aldridge,200746,80,5067,5233,10300,1288.3,1368.36666666667,2656.66666666667,5532,5717,-185,53.7087378640777,74.9631116687579
Bojan Bogdanovic,202711,87,5189,5228,10417,1318.2,1335.1,2653.3,5676,5921,-245,54.4878563885956,77.0120227641051
Steven Adams,203500,82,5300,5477,10777,1328.5,1315.71666666667,2644.21666666667,5949,5975,-26,55.200890785933,80.9933628736929
Tobias Harris,202699,80,5202,5322,10524,1293.13333333333,1338.6,2631.73333333333,5988,5912,76,56.8985176738883,81.9110345526396
Harrison Barnes,203084,77,5117,5099,10216,1342.03333333333,1269.15,2611.18333333333,5580,5769,-189,54.6202036021926,76.9306380887337
Dario Saric,203967,87,5231,5285,10516,1302.86666666667,1285.33333333333,2588.2,5827,5843,-16,55.4108025865348,81.0493779460629
Andre Drummond,203083,78,5067,5193,10260,1277.86666666667,1305.75,2583.61666666667,5766,5656,110,56.1988304093567,80.3431881664592
Lou Williams,101150,79,5310,5282,10592,1284.9,1294.15,2579.05,6088,6112,-24,57.4773413897281,84.9801283418313
Otto Porter Jr.,203490,82,4977,5058,10035,1257.31666666667,1293.36666666667,2550.68333333333,5536,5817,-281,55.1669157947185,78.1343561529264
Jamal Murray,1627750,81,4963,5014,9977,1250.2,1274.46666666667,2524.66666666667,5909,5729,180,59.2262203067054,84.2582519144442
Eric Bledsoe,202339,81,4969,4908,9877,1272.48333333333,1242.55,2515.03333333333,5795,5546,249,58.6716614356586,82.9491988177758
Clint Capela,203991,91,5002,4931,9933,1250.7,1251.75,2502.45,5770,5546,224,58.0891976240813,83.00665347959
Goran Dragic,201609,80,4889,4887,9776,1237.23333333333,1239.83333333333,2477.06666666667,5443,5380,63,55.6771685761048,79.1048552050813
Jeff Teague,201952,75,4918,4851,9769,1225.88333333333,1205.6,2431.48333333333,5525,5657,-132,56.5564540894667,81.8019178964829
Taurean Prince,1627752,82,4793,4895,9688,1211.98333333333,1213.78333333333,2425.76666666667,5367,5638,-271,55.3984310487201,79.6498701441469
Dwight Howard,2730,81,4927,4945,9872,1212.86666666667,1212.63333333333,2425.5,5541,5521,20,56.1284440842788,82.2411873840445
Kentavious Caldwell-Pope,203484,74,4985,5007,9992,1187.25,1234.9,2422.15,5529,5551,-22,55.3342674139311,82.1765786594555
JJ Redick,200755,80,4965,5014,9979,1228.18333333333,1191.31666666667,2419.5,5532,5627,-95,55.4364164745967,82.3112213267204
Nikola Jokic,203999,75,4747,4744,9491,1195.15,1207.35,2402.5,5595,5320,275,58.9505847645138,83.837669094693
Derrick Favors,202324,88,4615,4642,9257,1179.9,1221.88333333333,2401.78333333333,5121,5216,-95,55.3202981527493,76.7579645679946
Ricky Rubio,201937,83,4578,4661,9239,1170.1,1223.28333333333,2393.38333333333,5054,5136,-82,54.7028899231519,76.0195817636122
Jae Crowder,203109,91,4732,4710,9442,1196.41666666667,1192.91666666667,2389.33333333333,5334,5384,-50,56.4922685871637,80.3671875
Kyle Kuzma,1628398,77,4869,4932,9801,1169.78333333333,1213.31666666667,2383.1,5412,5455,-43,55.2188552188552,81.7556963618816
DeAndre Jordan,201599,77,4808,4867,9675,1185.78333333333,1195.51666666667,2381.3,5407,5422,-15,55.8863049095607,81.7419056817705
Marc Gasol,201188,73,4529,4523,9052,1164.21666666667,1210.08333333333,2374.3,5128,4957,171,56.6504639858595,77.7526007665417
Kelly Oubre Jr.,1626162,87,4635,4674,9309,1161.38333333333,1194.13333333333,2355.51666666667,5281,5215,66,56.7300461918573,80.7109551336932
Cory Joseph,202709,89,4546,4633,9179,1157.15,1194.23333333333,2351.38333333333,4980,5199,-219,54.2542760649308,76.2444801995988
Jeff Green,201145,100,4603,4682,9285,1174.31666666667,1169.25,2343.56666666667,5223,5199,24,56.2520193861066,80.2315558905941
Wilson Chandler,201163,74,4556,4630,9186,1150.88333333333,1170.05,2320.93333333333,5291,5190,101,57.5985194861746,82.0687079910381
Chris Paul,101108,73,4586,4537,9123,1166.35,1151.76666666667,2318.11666666667,5414,5143,271,59.3445138660528,84.0785982874028
Serge Ibaka,201586,86,4691,4734,9425,1165.83333333333,1150.31666666667,2316.15,5196,5443,-247,55.1299734748011,80.7616087040995
Dillon Brooks,1628415,82,4433,4431,8864,1142.35,1171.46666666667,2313.81666666667,4974,4869,105,56.1146209386282,77.389018144624
George Hill,201588,86,4480,4502,8982,1149.1,1163.05,2312.15,5239,5046,193,58.3277666443999,81.5708323421923
Jimmy Butler,202710,64,4573,4444,9017,1159.63333333333,1142.21666666667,2301.85,5143,5130,13,57.0367084396141,80.4344331733171
Courtney Lee,201584,76,4584,4590,9174,1130.7,1152.46666666667,2283.16666666667,5081,5107,-26,55.3847830826248,80.1150448937879
Spencer Dinwiddie,203915,80,4587,4602,9189,1134.36666666667,1146.33333333333,2280.7,5193,5068,125,56.513222331048,81.9695707458237
Gary Harris,203914,67,4469,4546,9015,1135.93333333333,1140.53333333333,2276.46666666667,5233,5128,105,58.0476982806434,82.7545611620347
Yogi Ferrell,1627812,82,4444,4377,8821,1172.33333333333,1102.71666666667,2275.05,4867,4739,128,55.1751502097268,77.0145711083273
Kevin Love,201567,80,4405,4438,8843,1149.25,1125.25,2274.5,5191,5110,81,58.701798032342,82.1613541437679
Patty Mills,201988,87,4332,4462,8794,1091.98333333333,1159.3,2251.28333333333,4819,4927,-108,54.7987264043666,77.0600472323194
Justin Holiday,203200,72,4552,4478,9030,1117.51666666667,1120.45,2237.96666666667,4929,5123,-194,54.5847176079734,79.2880442067949
Marco Belinelli,201158,90,4433,4481,8914,1132.21666666667,1102.65,2234.86666666667,4864,5130,-266,54.5658514695984,78.3509829072577
Marcin Gortat,101162,88,4323,4393,8716,1085.75,1119.18333333333,2204.93333333333,4829,4943,-114,55.4038549793483,78.8432000967528
Darren Collison,201954,76,4283,4288,8571,1090.85,1105.36666666667,2196.21666666667,4795,4954,-159,55.9444638898612,78.5988024860935
Jordan Clarkson,203903,100,4353,4332,8685,1089.96666666667,1081.85,2171.81666666667,4761,4838,-77,54.8186528497409,78.9182635121135
Al-Farouq Aminu,202329,73,4337,4469,8806,1070.55,1100.06666666667,2170.61666666667,4803,4910,-107,54.542357483534,79.6584687915109
Julius Randle,203944,82,4374,4489,8863,1056.76666666667,1111.4,2168.16666666667,4891,5044,-153,55.1844747828049,81.2096241063879
Allen Crabbe,203459,75,4470,4431,8901,1081.78333333333,1082.43333333333,2164.21666666667,4991,4918,73,56.0723514211886,83.0212625045244
Rudy Gobert,203497,67,4218,4240,8458,1080.51666666667,1082.18333333333,2162.7,4573,4653,-80,54.0671553558761,76.1215147732002
Stephen Curry,201939,66,4457,4521,8978,1047.35,1114.15,2161.5,5140,5437,-297,57.2510581421252,85.6072172102707
Joel Embiid,203954,71,4359,4395,8754,1088.33333333333,1066.05,2154.38333333333,4717,4917,-200,53.8839387708476,78.8216272251147
Bogdan Bogdanovic,203992,78,4096,4216,8312,1044.2,1108.31666666667,2152.51666666667,4658,4689,-31,56.0394610202117,77.9032295530039
Tony Snell,203503,82,4187,4173,8360,1071.61666666667,1080.63333333333,2152.25,4882,4808,74,58.3971291866029,81.6596584969218
Wayne Ellington,201961,82,4125,4098,8223,1075.16666666667,1073.81666666667,2148.98333333333,4569,4553,16,55.563662896753,76.5403795593265
DeMarre Carroll,201960,73,4383,4405,8788,1062.51666666667,1083.1,2145.61666666667,4919,4791,128,55.9740555302686,82.5329159449109
Jusuf Nurkic,203994,83,4299,4395,8694,1059.73333333333,1084.53333333333,2144.26666666667,4732,4711,21,54.4283413848631,79.4453426190772
Tyler Johnson,204020,77,4160,4049,8209,1068.18333333333,1041.71666666667,2109.9,4628,4495,133,56.3771470337435,78.9648798521257
Darius Miller,203121,91,4182,4365,8547,1022.63333333333,1085.85,2108.48333333333,4889,4849,40,57.2013572013572,83.4742192255097
T.J. Warren,203933,65,4327,4437,8764,1055.3,1052.18333333333,2107.48333333333,4911,4810,101,56.036056595162,83.8896313928936
Wesley Matthews,202083,63,4091,4093,8184,1086.85,1019.66666666667,2106.51666666667,4519,4746,-227,55.2174975562072,77.2289166158983
Evan Turner,202323,82,4174,4283,8457,1022.21666666667,1075.38333333333,2097.6,4535,4622,-87,53.6242166252808,77.8318077803204
Markieff Morris,202693,79,4097,4141,8238,1035.01666666667,1058.5,2093.51666666667,4583,4687,-104,55.6324350570527,78.8090215028939
Denzel Valentine,1627756,77,4156,4103,8259,1025.08333333333,1055.81666666667,2080.9,4356,4751,-395,52.7424627678896,75.3597001297516
James Johnson,201949,78,4051,4118,8169,1030.23333333333,1050.41666666667,2080.65,4541,4558,-17,55.5881992899988,78.5696777449355
Kyle Korver,2594,95,4032,4092,8124,1026.41666666667,1035.95,2062.36666666667,4714,4529,185,58.0256031511571,82.286046774741
Marcus Smart,203935,69,4083,4006,8089,1053.05,1009.21666666667,2062.26666666667,4512,4271,241,55.7794535789344,78.7638197452641
Dragan Bender,1627733,82,4188,4218,8406,1031.96666666667,1016.08333333333,2048.05,4743,4552,191,56.423982869379,83.3710114499158
Dennis Schroder,203471,67,4045,4062,8107,1027.73333333333,1016.36666666667,2044.1,4510,4715,-205,55.6309362279512,79.4285993835918
Andre Iguodala,2738,79,3968,4128,8096,981.3,1049.53333333333,2030.83333333333,4540,4502,38,56.0770750988142,80.4792778005745
Ish Smith,202397,82,4005,4049,8054,1014.25,1013.05,2027.3,4469,4425,44,55.4879562950087,79.3587530212598
Buddy Hield,1627741,80,3780,3966,7746,973.783333333333,1048.38333333333,2022.16666666667,4230,4340,-110,54.6088303640589,75.3053655320201
Austin Rivers,203085,61,4027,4090,8117,1006.2,1014.68333333333,2020.88333333333,4598,4671,-73,56.6465442897622,81.90873627869
Dennis Smith Jr.,1628372,69,4013,3986,7999,1036.88333333333,982.733333333333,2019.61666666667,4337,4579,-242,54.2192774096762,77.3077399176411
Willie Cauley-Stein,1626161,73,3815,3948,7763,973.95,1039.68333333333,2013.63333333333,4361,4322,39,56.1767357980162,77.9665281663328
Kyle Anderson,203937,79,3905,3956,7861,978.3,1034.48333333333,2012.78333333333,4257,4295,-38,54.1534155959802,76.1393427012346
John Henson,203089,78,3965,3873,7838,1016.23333333333,992.116666666667,2008.35,4613,4336,277,58.8542995662159,82.6887743670177
Jonathon Simmons,203613,69,4003,4048,8051,991.516666666667,1016.15,2007.66666666667,4597,4536,61,57.0984970811079,82.4300182633239
Marcus Morris,202694,73,3957,3951,7908,1014.48333333333,991.683333333333,2006.16666666667,4313,4352,-39,54.5397066262013,77.3953642934286
Lance Stephenson,202362,89,3873,3927,7800,987.183333333333,1017.88333333333,2005.06666666667,4347,4428,-81,55.7307692307692,78.0482776965022
De'Aaron Fox,1628368,73,3903,4013,7916,966.016666666667,1026.53333333333,1992.55,4463,4342,121,56.3794845881759,80.6343630021831
Myles Turner,1626167,72,3911,3905,7816,991.3,1000.48333333333,1991.78333333333,4217,4471,-254,53.953428863869,76.2191336072364
Lauri Markkanen,1628374,68,3973,3966,7939,989.1,998.5,1987.6,4338,4527,-189,54.6416425242474,78.5711410746629
Rajon Rondo,200765,74,4067,4200,8267,952.133333333333,1019.73333333333,1971.86666666667,4655,4608,47,56.3082133784928,84.9854621678274
Domantas Sabonis,1627734,81,3785,3848,7633,972.416666666667,996.3,1968.71666666667,4252,4289,-37,55.7054893226779,77.7521735817749
Joe Harris,203925,78,3915,3987,7902,973.416666666667,995.266666666667,1968.68333333333,4331,4472,-141,54.8089091369274,79.1981104122044
Marvin Williams,101107,78,4047,4003,8050,990.5,976.916666666667,1967.41666666667,4515,4474,41,56.0869565217391,82.6159515439028
Jeremy Lamb,203087,80,3827,3981,7808,957.75,1000.23333333333,1957.98333333333,4359,4460,-101,55.8273565573771,80.1457281726947
Nicolas Batum,201587,64,3977,4008,7985,975.85,977.75,1953.6,4533,4471,62,56.7689417658109,83.531941031941
Brandon Ingram,1627742,59,4055,4004,8059,978.266666666667,971.2,1949.46666666667,4372,4449,-77,54.2499069363445,80.735927775118
Blake Griffin,201933,58,3900,3910,7810,971.35,974.85,1946.2,4352,4348,4,55.7234314980794,80.5014900832391
Josh Jackson,1628367,77,4000,4091,8091,969.883333333333,972.233333333333,1942.11666666667,4483,4351,132,55.4072426152515,83.0990242604718
Ersan Ilyasova,101141,79,3875,3918,7793,982.366666666667,957.483333333333,1939.85,4267,4389,-122,54.7542666495573,79.1875660489213
Jonas Valanciunas,202685,87,3955,3920,7875,976.033333333333,950.55,1926.58333333333,4454,4441,13,56.5587301587302,83.22712920109
Kelly Olynyk,203482,81,3716,3603,7319,970.216666666667,948,1918.21666666667,4245,4115,130,57.9997267386255,79.6677469524645
Kyrie Irving,202681,60,3791,3821,7612,941.383333333333,960.666666666667,1902.05,4343,4098,245,57.0546505517604,82.1997318682474
Rondae Hollis-Jefferson,1626178,68,3875,3929,7804,937.4,958.45,1895.85,4336,4347,-11,55.5612506406971,82.3356278186566
Aaron Gordon,203932,58,3788,3849,7637,944.816666666667,939.766666666667,1884.58333333333,4285,4238,47,56.1084195364672,81.8536369666151
Pau Gasol,2200,82,3686,3685,7371,927.6,941.95,1869.55,3891,3895,-4,52.7879527879528,74.9249819475275
Stanley Johnson,1626169,69,3661,3708,7369,918.133333333333,948.166666666667,1866.3,4072,4021,51,55.2585154023613,78.5468574184215
Caris LeVert,1627747,71,3760,3823,7583,928.483333333333,936.5,1864.98333333333,4136,4281,-145,54.5430568376632,79.8377107927685
Danny Green,201980,75,3601,3678,7279,910.15,953.783333333333,1863.93333333333,3903,3920,-17,53.6200027476302,75.3825244107443
Tim Hardaway Jr.,203501,57,3807,3814,7621,931.383333333333,930.783333333333,1862.16666666667,4204,4236,-32,55.1633643878756,81.2730690056386
Pascal Siakam,1627783,91,3624,3639,7263,942.8,918.65,1861.45,4071,4116,-45,56.0512185047501,78.7321711568938
T.J. McConnell,204456,86,3750,3759,7509,936,923.266666666667,1859.26666666667,4079,4137,-58,54.3214808895992,78.9795259779842
Dirk Nowitzki,1717,77,3632,3645,7277,959.8,899.35,1859.15,4112,4172,-60,56.506802253676,79.6234838501466
Rodney Hood,203918,76,3622,3574,7196,925.016666666667,931.616666666667,1856.63333333333,4153,4005,148,57.7126181211784,80.5264008330491
Devin Booker,1626164,54,3808,3906,7714,913.383333333333,929.35,1842.73333333333,4368,4280,88,56.6243194192378,85.3341051336783
Frank Kaminsky,1626163,79,3530,3736,7266,882.45,952.633333333333,1835.08333333333,4179,4077,102,57.514450867052,81.9821079878298
Evan Fournier,203095,57,3694,3700,7394,911.15,908.2,1819.35,4212,4211,1,56.9651068433865,83.3440514469453
Michael Kidd-Gilchrist,203077,74,3679,3748,7427,902.3,916.233333333333,1818.53333333333,4149,4132,17,55.8637404066245,82.1343206979984
Aron Baynes,203382,100,3575,3539,7114,905.566666666667,908.133333333333,1813.7,3837,3686,151,53.9359010402024,76.1603352263329
Nikola Mirotic,202703,64,3754,3755,7509,883.566666666667,923.416666666667,1806.98333333333,4223,4147,76,56.2391796510854,84.1335928204466
Dejounte Murray,1627749,85,3509,3550,7059,884.35,919.25,1803.6,3717,3747,-30,52.6561835954101,74.1916167664671
Justise Winslow,1626159,73,3510,3496,7006,894.333333333333,902.833333333333,1797.16666666667,3831,3805,26,54.681701398801,76.7407956969304
Enes Kanter,202683,71,3617,3629,7246,890.25,901.633333333333,1791.88333333333,4036,4046,-10,55.699696384212,81.0856361556277
Ryan Anderson,201583,77,3567,3597,7164,876.133333333333,915.266666666667,1791.4,4175,4092,83,58.2774986041318,83.9008596628336
Jerami Grant,203924,87,3463,3527,6990,884.316666666667,893.183333333333,1777.5,3856,3868,-12,55.1645207439199,78.0962025316456
John Collins,1628381,74,3480,3522,7002,894.85,881.75,1776.6,3783,3955,-172,54.0274207369323,76.6565349544073
Jamal Crawford,2037,85,3471,3487,6958,871.183333333333,904.916666666667,1776.1,3988,4044,-56,57.3153204943949,80.8332864140533
Elfrid Payton,203901,63,3644,3708,7352,881.833333333333,889.516666666667,1771.35,4232,4110,122,57.5625680087051,86.0089762045897
Doug McDermott,203926,81,3482,3496,6978,873.4,890.783333333333,1764.18333333333,3847,3813,34,55.1304098595586,78.5020453278665
Lonzo Ball,1628366,52,3637,3643,7280,870.933333333333,886.083333333333,1757.01666666667,3990,3997,-7,54.8076923076923,81.7522125572704
Kent Bazemore,203145,65,3417,3522,6939,873.416666666667,880.183333333333,1753.6,3848,3980,-132,55.4546764663496,78.9963503649635
Anthony Tolliver,201229,79,3372,3502,6874,855.333333333334,895.3,1750.63333333333,3778,3808,-30,54.9607215594996,77.6907404939165
D.J. Augustin,201571,75,3444,3523,6967,862.416666666667,882.05,1744.46666666667,3761,3853,-92,53.9830630113392,77.6145526808576
Larry Nance Jr.,1626204,86,3508,3389,6897,872.783333333333,847.283333333333,1720.06666666667,3820,3696,124,55.3863998840075,79.9503895197861
Reggie Bullock,203493,62,3388,3468,6856,839.55,872.15,1711.7,3820,3796,24,55.7176196032672,80.3411812817667
Luc Mbah a Moute,201601,70,3293,3326,6619,842.133333333333,864.983333333333,1707.11666666667,3854,3691,163,58.2263181749509,81.273882862917
DeMarcus Cousins,202326,48,3318,3416,6734,826.816666666667,875.1,1701.91666666667,3689,4035,-346,54.7817047817048,78.0320227194829
Frank Ntilikina,1628373,78,3358,3348,6706,847.9,852.583333333334,1700.48333333333,3624,3664,-40,54.0411571726812,76.7217163747562
Brook Lopez,201572,74,3504,3546,7050,842.966666666667,854.216666666667,1697.18333333333,3815,4023,-208,54.113475177305,80.9223124588779
Tomas Satoransky,203107,79,3299,3334,6633,835.583333333333,849.95,1685.53333333333,3671,3737,-66,55.3444896728479,78.4060435865997
OG Anunoby,1628384,84,3379,3417,6796,843.816666666667,837.266666666667,1681.08333333333,3765,3941,-176,55.4002354326074,80.6265800822882
Jerian Grant,1626170,74,3302,3288,6590,831.066666666667,845.416666666667,1676.48333333333,3479,3830,-351,52.7921092564492,74.7063794251857
Dwyane Wade,2548,72,3322,3364,6686,827.183333333333,845.283333333333,1672.46666666667,3703,3706,-3,55.3843852826802,79.7074181847172
Robin Lopez,201577,64,3328,3298,6626,828.283333333333,833.716666666667,1662,3519,3727,-208,53.1089646845759,76.2238267148015
Jakob Poeltl,1627751,91,3225,3302,6527,828.616666666667,830.3,1658.91666666667,3614,3764,-150,55.3700015320974,78.4270859496659
Dwight Powell,203939,79,3221,3162,6383,849.283333333333,806.366666666667,1655.65,3593,3546,47,56.2901456995143,78.125207622384
Nikola Vucevic,202696,57,3340,3363,6703,832.766666666667,822.833333333333,1655.6,3727,3826,-99,55.6019692674922,81.0413143271322
Ian Clark,203546,83,3264,3424,6688,792.683333333334,859.416666666667,1652.1,3756,3805,-49,56.1602870813397,81.8449246413655
Jarell Martin,1626185,73,3154,3206,6360,801.016666666667,842.633333333333,1643.65,3560,3438,122,55.9748427672956,77.9728044291668
Bobby Portis,1626171,73,3369,3237,6606,811.616666666667,830.983333333333,1642.6,3697,3785,-88,55.9642749016046,81.0252039449653
Delon Wright,1626153,79,3204,3217,6421,816.766666666667,823.666666666667,1640.43333333333,3511,3652,-141,54.6799563930852,77.0503728689574
Michael Beasley,201563,73,3299,3313,6612,816.766666666667,823.45,1640.21666666667,3688,3700,-12,55.7773744706594,80.9454035544085
John Wall,202322,47,3274,3311,6585,813.966666666667,822.983333333333,1636.95,3666,3782,-116,55.6719817767654,80.6231100522313
Mario Hezonja,1626209,75,3227,3273,6500,814.783333333333,821.183333333333,1635.96666666667,3614,3651,-37,55.6,79.5272927321258
Tyler Ulis,1627755,71,3300,3371,6671,817.883333333333,817.133333333333,1635.01666666667,3691,3672,19,55.3290361265178,81.2688963415256
Fred VanVleet,1627832,82,3196,3216,6412,830.7,802.9,1633.6,3545,3654,-109,55.2869619463506,78.1219392752204
David Nwaba,1628021,70,3307,3259,6566,794.7,835.383333333333,1630.08333333333,3599,3705,-106,54.8126713371916,79.4830530136496
Troy Daniels,203584,79,3291,3313,6604,805.916666666667,809.45,1615.36666666667,3757,3626,131,56.8897637795276,83.7283588865273
Malcolm Brogdon,1627763,55,3057,3071,6128,811.116666666667,797.016666666667,1608.13333333333,3572,3482,90,58.289817232376,79.9635187795374
Nick Young,201156,100,3195,3274,6469,788.683333333333,811.166666666667,1599.85,3705,3544,161,57.273148863812,83.3703159671219
James Ennis III,203516,72,3098,3084,6182,798.716666666667,798.95,1597.66666666667,3484,3356,128,56.3571659657069,78.5044857083246
J.J. Barea,200826,69,3080,3074,6154,821.9,774.066666666667,1595.96666666667,3519,3494,25,57.182320441989,79.3775976941874
Garrett Temple,202066,65,3031,3151,6182,767.383333333333,826.333333333333,1593.71666666667,3404,3369,35,55.0630863798124,76.8919611390565
Tyreke Evans,201936,52,3069,3063,6132,778.716666666667,813.066666666667,1591.78333333333,3387,3418,-31,55.2348336594912,76.6008774225973
Shabazz Napier,203894,76,3026,3110,6136,770.5,794.216666666667,1564.71666666667,3231,3451,-220,52.6564537157758,74.3367808868485
Bryn Forbes,1627854,84,3009,3074,6083,760.466666666667,800.533333333333,1561,3330,3381,-51,54.7427256288016,76.7969250480461
CJ Miles,101139,80,3080,3112,6192,782.5,776.55,1559.05,3427,3461,-34,55.3456072351421,79.1328052339566
Dante Cunningham,201967,73,3100,3188,6288,761.333333333333,795.233333333333,1556.56666666667,3307,3769,-462,52.5922391857506,76.4837141572264
Pat Connaughton,1626192,86,3061,3110,6171,761.35,789.366666666667,1550.71666666667,3322,3443,-121,53.8324420677362,77.1204711799921
Ed Davis,202334,82,2978,3050,6028,748.4,793.433333333333,1541.83333333333,3213,3364,-151,53.3012607830126,75.0197816452275
Mike Scott,203118,82,3012,3014,6026,766.316666666667,766.183333333333,1532.5,3420,3416,4,56.754065715234,80.3393148450245
Kristaps Porzingis,204001,48,3066,3105,6171,745.5,783.516666666667,1529.01666666667,3349,3378,-29,54.2699724517906,78.8506774506491
Dewayne Dedmon,203473,62,2950,3039,5989,754.45,766.233333333333,1520.68333333333,3326,3427,-101,55.5351477709133,78.7382865159303
Jarrett Jack,101127,62,3079,3067,6146,747.966666666667,768.833333333333,1516.8,3407,3445,-38,55.4344288968435,80.8623417721519
Tyus Jones,1626145,86,2953,2945,5898,748.333333333333,764.083333333333,1512.41666666667,3390,3291,99,57.4771108850458,80.6920491487134
JaMychal Green,203210,55,2897,2884,5781,752.766666666667,757.266666666667,1510.03333333333,3288,3167,121,56.8759730150493,78.38767356129
Marquese Chriss,1627737,72,3081,3158,6239,751.65,749.166666666667,1500.81666666667,3458,3389,69,55.4255489661805,82.9468400537485
Kris Dunn,1627739,52,3010,3010,6020,736.6,762.8,1499.4,3333,3413,-80,55.3654485049834,80.0240096038415
Bismack Biyombo,202687,82,2935,2968,5903,740.633333333333,744.983333333333,1485.61666666667,3262,3107,155,55.2600372691852,79.0459629558993
Shaun Livingston,2733,92,2883,2972,5855,716.333333333333,767.5,1483.83333333333,3329,3221,108,56.8573868488472,80.7664832079074
Bam Adebayo,1628389,74,2821,2866,5687,724.5,756.65,1481.15,3078,3153,-75,54.123439423246,74.8121392161496
Justin Jackson,1628382,68,2865,2956,5821,718.433333333333,761.883333333333,1480.31666666667,3244,3163,81,55.7292561415564,78.8912282281944
Zach Randolph,2216,59,2824,2925,5749,710.166666666667,769.25,1479.41666666667,3295,3203,92,57.3143155331362,80.1802512251451
Wesley Johnson,202325,74,2958,3003,5961,736.883333333333,730.15,1467.03333333333,3300,3410,-110,55.3598389531958,80.9797550612347
Tristan Thompson,202684,72,2969,2891,5860,735.183333333333,729.816666666667,1465,3233,3451,-218,55.1706484641638,79.4457337883959
Luke Kennard,1628379,73,2810,2856,5666,718.85,737.583333333333,1456.43333333333,3106,3131,-25,54.8182139075185,76.773853935413
Josh Hart,1628404,63,2920,2961,5881,705.733333333333,741.666666666667,1447.4,3284,3309,-25,55.8408433939806,81.6802542489982
Raymond Felton,101109,88,2733,2778,5511,720.633333333333,718.35,1438.98333333333,3042,2947,95,55.1986935220468,76.1037306431624
Mason Plumlee,203486,74,2783,2892,5675,707.283333333333,725.416666666667,1432.7,3176,3321,-145,55.9647577092511,79.8045648077058
Manu Ginobili,1938,70,2773,2811,5584,695.516666666667,730.35,1425.86666666667,3160,3085,75,56.5902578796562,79.783055919207
Mario Chalmers,201596,66,2703,2796,5499,689.3,734.116666666667,1423.41666666667,3051,3065,-14,55.4828150572832,77.1636321058486
Jarrett Allen,1628386,72,2903,2884,5787,702.633333333333,720.666666666667,1423.3,3151,3219,-68,54.4496284776223,79.6992903815078
Hassan Whiteside,202355,59,2868,2816,5684,725.85,689.1,1414.95,3050,3034,16,53.6593947923997,77.5999151913495
Avery Bradley,202340,46,2737,2816,5553,684.766666666667,721.1,1405.86666666667,3150,3008,142,56.7260940032415,80.6619878603945
Gorgui Dieng,203476,84,2778,2745,5523,693.333333333333,711.266666666667,1404.6,3154,3085,69,57.1066449393446,80.8372490388723
Royce O'Neale,1626220,80,2672,2752,5424,695.833333333333,707.233333333333,1403.06666666667,2975,2927,48,54.8488200589971,76.3327948303716
Semi Ojeleye,1628400,90,2691,2698,5389,714.383333333333,687.666666666667,1402.05,2894,2960,-66,53.7019855260716,74.308334224885
Nemanja Bjelica,202357,72,2784,2830,5614,681.916666666667,718.1,1400.01666666667,3121,3197,-76,55.5931599572497,80.2533303174962
Rudy Gay,200752,62,2628,2748,5376,671.75,717.033333333333,1388.78333333333,2902,2965,-63,53.9806547619048,75.2255571423428
Alex Len,203458,69,2863,2898,5761,692.35,695.716666666667,1388.06666666667,3243,3142,101,56.2923103627843,84.1083521444695
Trey Lyles,1626168,73,2726,2741,5467,692.116666666667,695.3,1387.41666666667,3176,3067,109,58.0940186573989,82.4092738302601
Kyle O'Quinn,203124,77,2758,2727,5485,699.3,685.95,1385.25,3039,3074,-35,55.4056517775752,78.977801840823
Kosta Koufos,201585,71,2618,2742,5360,669.633333333333,713.683333333333,1383.31666666667,2867,2867,0,53.4888059701493,74.611983276907
Shelvin Mack,202714,69,2615,2682,5297,676.116666666667,687.15,1363.26666666667,2879,2929,-50,54.351519728148,76.0262115506871
Quincy Acy,203112,70,2680,2723,5403,683,677.816666666667,1360.81666666667,3006,3088,-82,55.635757912271,79.5228355521807
Thon Maker,1627748,80,2526,2597,5123,663.15,687.966666666667,1351.11666666667,2940,3010,-70,57.3882490728089,78.3352042137985
Corey Brewer,201147,78,2775,2806,5581,677.416666666667,668.066666666667,1345.48333333333,3121,3130,-9,55.9218777996775,83.5060511092668
Devin Harris,2734,71,2602,2636,5238,677.066666666667,659.783333333333,1336.85,2985,2997,-12,56.9873997709049,80.3829898642331
Lance Thomas,202498,73,2636,2606,5242,667.05,669.166666666667,1336.21666666667,2909,2895,14,55.4940862266311,78.373517268906
Patrick Patterson,202335,88,2532,2565,5097,660.45,662.2,1322.65,2816,2771,45,55.2481852069845,76.6461270933353
Andrew Harrison,1626150,56,2488,2480,4968,632.116666666667,668.7,1300.81666666667,2807,2660,147,56.5016103059581,77.6835065151379
Maurice Harkless,203090,61,2530,2602,5132,636.216666666667,660.033333333333,1296.25,2854,2831,23,55.6118472330476,79.2624879459981
Montrezl Harrell,1626149,76,2640,2656,5296,637.35,655.566666666667,1292.91666666667,2996,3016,-20,56.570996978852,83.4206896551724
Kevon Looney,1626172,87,2601,2578,5179,642.35,642.916666666667,1285.26666666667,2898,2851,47,55.9567484070284,81.1722599719902
Joe Johnson,2207,63,2489,2394,4883,640.8,616.916666666667,1257.71666666667,2748,2565,183,56.2768789678476,78.6568251991042
Amir Johnson,101161,82,2509,2518,5027,631.933333333333,622.833333333333,1254.76666666667,2785,2771,14,55.4008354883628,79.9033020747549
Emmanuel Mudiay,1626144,64,2484,2548,5032,612.783333333333,627.5,1240.28333333333,2793,2840,-47,55.5047694753577,81.0685730411062
Alex Abrines,203518,81,2431,2479,4910,612.866666666667,622.966666666667,1235.83333333333,2701,2727,-26,55.010183299389,78.6805124747134
Trevor Booker,202344,75,2408,2440,4848,602.183333333333,620.6,1222.78333333333,2669,2767,-98,55.0536303630363,78.5781073234561
Skal Labissiere,1627746,60,2364,2428,4792,594.716666666667,625.766666666667,1220.48333333333,2662,2712,-50,55.550918196995,78.5197121359024
D'Angelo Russell,1626156,48,2554,2522,5076,605.083333333333,611.233333333333,1216.31666666667,2855,2898,-43,56.2450748620961,84.501020841612
Jonas Jerebko,201973,84,2274,2312,4586,598.816666666667,599.483333333333,1198.3,2555,2565,-10,55.7130396860009,76.7587415505299
Ian Mahinmi,101133,83,2313,2344,4657,595.033333333333,598.833333333333,1193.86666666667,2581,2609,-28,55.4219454584497,77.8277864641501
Gerald Green,101123,58,2401,2323,4724,600.65,591.65,1192.3,2652,2584,68,56.1388653683319,80.0738069277866
Maxi Kleber,1628467,71,2350,2336,4686,611,579.033333333333,1190.03333333333,2512,2557,-45,53.6064874093043,75.9911487073191
Reggie Jackson,202704,45,2264,2334,4598,570.75,604.283333333333,1175.03333333333,2573,2586,-13,55.9591126576773,78.8301041105217
Alec Burks,202692,73,2245,2263,4508,581.833333333333,592.966666666667,1174.8,2595,2497,98,57.564330079858,79.5199182839632
Isaiah Taylor,1627819,66,2304,2342,4646,574.083333333333,584,1158.08333333333,2580,2587,-7,55.5316401205338,80.2014823343168
David West,2561,91,2191,2270,4461,558.233333333333,597.8,1156.03333333333,2451,2405,46,54.9428379287155,76.3265188431706
Sindarius Thornwell,1628414,72,2317,2348,4665,568.95,584.333333333333,1153.28333333333,2535,2607,-72,54.3408360128617,79.1305981473185
Tyler Zeller,203092,73,2352,2343,4695,571.85,580.083333333333,1151.93333333333,2675,2484,191,56.975505857295,83.5985878812431
Davis Bertans,202722,79,2229,2267,4496,563.433333333333,587.733333333333,1151.16666666667,2484,2474,10,55.2491103202847,77.6811929926162
Greg Monroe,202328,62,2221,2247,4468,572.033333333333,570.2,1142.23333333333,2519,2529,-10,56.3786929274843,79.3918347097791
Tyson Chandler,2199,46,2311,2336,4647,574.3,555.966666666667,1130.26666666667,2547,2548,-1,54.8095545513234,81.1242184735166
Paul Millsap,200794,38,2240,2249,4489,565,563.733333333333,1128.73333333333,2571,2544,27,57.2733348184451,81.9998818734865
Tony Parker,2225,60,2177,2229,4406,545.116666666667,583.1,1128.21666666667,2422,2376,46,54.9704947798457,77.2830277872158
Milos Teodosic,1628462,45,2299,2318,4617,550.25,565.5,1115.75,2634,2549,85,57.050032488629,84.9867801926955
Jodie Meeks,201975,77,2182,2208,4390,549.6,563.916666666667,1113.51666666667,2538,2386,152,57.8132118451025,82.0535540554699
Zach Collins,1628380,70,2157,2133,4290,547.9,554.366666666667,1102.26666666667,2340,2405,-65,54.5454545454546,76.4243377283174
Norman Powell,1626181,75,2147,2147,4294,547.533333333333,540.15,1087.68333333333,2414,2426,-12,56.2179785747555,79.898254700357
Ben McLemore,203463,56,2101,2097,4198,547.25,537.533333333333,1084.78333333333,2450,2190,260,58.3611243449262,81.3065589134543
Mike Muscala,203488,53,2133,2193,4326,521.3,534.216666666667,1055.51666666667,2348,2462,-114,54.2764678687009,80.0821082882001
Treveon Graham,1626203,63,1992,2127,4119,493.716666666667,550.566666666667,1044.28333333333,2338,2246,92,56.7613498421947,80.5988157747738
Vince Carter,1713,58,1923,1996,3919,493.383333333333,534.583333333333,1027.96666666667,2127,2195,-68,54.2740495024241,74.488796653588
Andre Roberson,203460,39,1964,2028,3992,500.666666666667,518.633333333333,1019.3,2160,2114,46,54.1082164328657,76.2876483861474
Malcolm Delaney,1627098,54,1953,1999,3952,513.8,503.733333333333,1017.53333333333,2159,2273,-114,54.6305668016194,76.384721221254
Wes Iwundu,1628411,62,1963,1999,3962,501.616666666667,510.533333333333,1012.15,2119,2152,-33,53.4830893488137,75.3682754532431
Jameer Nelson,2749,50,1949,1998,3947,499.7,510.783333333333,1010.48333333333,2261,2257,4,57.284013174563,80.5515512378565
Jose Calderon,101181,69,1918,1935,3853,504.466666666667,485.3,989.766666666667,2250,2185,65,58.3960550220607,81.8374701108005
Josh Huestis,203962,73,1927,1965,3892,492.216666666667,492.333333333333,984.55,2086,2166,-80,53.5971223021583,76.2744400995379
Frank Mason,1628412,52,1814,1884,3698,473.966666666667,507.766666666667,981.733333333333,2007,2043,-36,54.2725797728502,73.5963601792748
Tyler Dorsey,1628416,56,1928,1966,3894,482.966666666667,490.516666666667,973.483333333333,2081,2245,-164,53.4411915767848,76.9566333955384
Jordan Bell,1628395,74,1931,2019,3950,478.866666666667,492.433333333333,971.3,2295,2200,95,58.1012658227848,85.0612581076907
Patrick McCaw,1627775,62,1935,1986,3921,475.716666666667,495.15,970.866666666667,2213,2203,10,56.4396837541444,82.0586417633729
Cristiano Felicio,1626245,55,1913,1906,3819,467.416666666667,495.65,963.066666666667,1949,2197,-248,51.0343021733438,72.854769486363
Zaza Pachulia,2585,75,1948,2041,3989,465.766666666667,496.233333333333,962,2097,2556,-459,52.5695663073452,78.4740124740125
Daniel Theis,1628464,63,1846,1831,3677,474.983333333333,467.75,942.733333333333,2041,1925,116,55.5072069621975,77.9393253659572
Deyonta Davis,1627738,62,1875,1841,3716,470.483333333333,466,936.483333333333,2168,1957,211,58.3423035522067,83.3415793126769
Shane Larkin,203499,65,1760,1730,3490,478.283333333333,444.283333333333,922.566666666667,1903,1835,68,54.5272206303725,74.2580481988655
Jerryd Bayless,201573,40,1837,1898,3735,447.55,473.75,921.3,2021,2124,-103,54.1097724230254,78.9710192119831
Quinn Cook,1626188,49,1783,1833,3616,444.35,459.266666666667,903.616666666667,2002,2019,-17,55.3650442477876,79.7594850323699
Dion Waiters,203079,30,1741,1708,3449,454.033333333333,448.55,902.583333333333,1924,1898,26,55.784285300087,76.73972855692
Jabari Parker,203953,38,1790,1780,3570,440.466666666667,458.6,899.066666666667,2036,1965,71,57.03081232493,81.524543971526
Miles Plumlee,203101,55,1755,1838,3593,435.283333333333,457.933333333333,893.216666666667,1874,2060,-186,52.1569718897857,75.5292668818689
Sam Dekker,1626155,73,1791,1794,3585,435.7,442.266666666667,877.966666666667,2009,1986,23,56.0390516039052,82.3767037472949
Noah Vonleh,203943,54,1744,1720,3464,422.733333333333,443.283333333333,866.016666666667,1805,1892,-87,52.107390300231,75.0331979754046
Nene,2403,63,1703,1698,3401,428.45,436.666666666667,865.116666666667,1994,1912,82,58.6298147603646,82.9760918565897
Langston Galloway,204038,58,1635,1684,3319,428.15,431.683333333333,859.833333333333,1730,1809,-79,52.1241337752335,72.4326419848808
Isaiah Thomas,202738,32,1755,1816,3571,417.283333333333,439.266666666667,856.55,1956,2175,-219,54.7745729487539,82.2088611289475
Jason Terry,1891,52,1627,1637,3264,424.6,425.4,850,1903,1856,47,58.3026960784314,80.5976470588235
Malik Monk,1628370,63,1712,1734,3446,416.516666666667,430.05,846.566666666667,2054,1827,227,59.6053395240859,87.3457494979722
Tyrone Wallace,1627820,29,1720,1784,3504,406.55,434.55,841.1,1963,1948,15,56.0216894977169,84.0185471406492
Tim Frazier,204025,61,1605,1637,3242,411.85,426.4,838.25,1858,1790,68,57.3103022825417,79.7948106173576
Michael Carter-Williams,203487,52,1565,1704,3269,391.916666666667,441.683333333333,833.6,1821,1770,51,55.7051085959009,78.6420345489443
Ekpe Udoh,202327,69,1559,1590,3149,404.75,419.5,824.25,1752,1792,-40,55.6367100666878,76.5204731574158
Paul Zipser,1627835,53,1595,1575,3170,404.55,409.35,813.9,1672,1805,-133,52.7444794952681,73.9550313306303
Thabo Sefolosha,200757,38,1498,1542,3040,391.65,417.65,809.3,1687,1750,-63,55.4934210526316,75.0426294328432
Eric Moreland,203961,67,1513,1548,3061,389.583333333333,412.633333333333,802.216666666667,1656,1613,43,54.0999673309376,74.3140880477012
Timothe Luwawu-Cabarrot,1627789,52,1638,1663,3301,393.85,404.866666666667,798.716666666667,1775,1782,-7,53.7715843683732,80.0033386891472
Matthew Dellavedova,203521,44,1521,1498,3019,402.633333333333,393.45,796.083333333333,1704,1720,-16,56.4425306392845,77.0572594996336
Sterling Brown,1628425,56,1528,1543,3071,385.733333333333,396.45,782.183333333333,1678,1691,-13,54.6401823510257,77.2299759220984
Trey Burke,203504,36,1580,1580,3160,394.266666666667,383.483333333333,777.75,1807,1840,-33,57.1835443037975,83.6412729026037
Jawun Evans,1628393,48,1563,1584,3147,386.5,388.733333333333,775.233333333333,1760,1775,-15,55.9262789958691,81.7302317581804
JaVale McGee,201580,78,1525,1563,3088,364.166666666667,396.216666666667,760.383333333333,1788,1740,48,57.9015544041451,84.6520395414594
Richaun Holmes,1626158,51,1548,1575,3123,383.116666666667,377.216666666667,760.333333333333,1726,1712,14,55.2673711175152,81.7220517316966
Terrance Ferguson,1628390,63,1488,1506,2994,380.2,376.733333333333,756.933333333333,1710,1634,76,57.1142284569138,81.3281662850097
Omri Casspi,201956,53,1455,1524,2979,358.666666666667,376.733333333333,735.4,1695,1638,57,56.8982880161128,82.9752515637748
DeAndre Liggins,202732,59,1382,1426,2808,363.616666666667,368.666666666667,732.283333333333,1546,1614,-68,55.0569800569801,76.003368459385
Salah Mejri,1626257,60,1434,1398,2832,384.4,345.866666666667,730.266666666667,1552,1549,3,54.8022598870057,76.509037794413
Cedi Osman,1626224,71,1463,1446,2909,356.55,364.066666666667,720.616666666667,1693,1647,46,58.1986937091784,84.5775608853528
Dwayne Bacon,1628407,53,1429,1450,2879,349.616666666667,357.7,707.316666666667,1596,1578,18,55.4359152483501,81.2309432361743
Luke Babbitt,202337,52,1391,1411,2802,353.4,352.666666666667,706.066666666667,1556,1630,-74,55.5317630264097,79.335284675668
C.J. Williams,203710,38,1396,1440,2836,336.55,360.166666666667,696.716666666667,1600,1525,75,56.4174894217207,82.6734923330861
Channing Frye,101112,53,1344,1394,2738,339.1,352.916666666667,692.016666666667,1609,1531,78,58.7655222790358,83.7031863394427
Wayne Selden,1627782,35,1357,1365,2722,336.733333333333,353.383333333333,690.116666666667,1552,1519,33,57.0168993387215,80.9602241166952
Chandler Parsons,202718,36,1324,1313,2637,337.383333333333,350.2,687.583333333333,1587,1472,115,60.1820250284414,83.0910192703915
Jared Dudley,201162,48,1341,1386,2727,339.65,346.6,686.25,1534,1541,-7,56.2522918958563,80.472131147541
Mike James,1628455,36,1453,1457,2910,345.583333333333,336.816666666667,682.4,1612,1565,47,55.3951890034364,85.0410316529894
Tyler Ennis,203898,54,1347,1390,2737,329.283333333333,347.783333333333,677.066666666667,1438,1500,-62,52.5392765801973,76.4592359196534
Arron Afflalo,201167,53,1315,1358,2673,332.4,343.75,676.15,1411,1484,-73,52.7871305649084,75.125342009909
Marreese Speights,201578,50,1322,1367,2689,328.516666666667,345.066666666667,673.583333333333,1438,1483,-45,53.4771290442544,76.8546331807497
Danilo Gallinari,201568,21,1326,1319,2645,337.266666666667,318.616666666667,655.883333333333,1397,1468,-71,52.8166351606805,76.6782710339745
Zach LaVine,203897,24,1312,1289,2601,315.966666666667,326.233333333333,642.2,1443,1522,-79,55.4786620530565,80.8906882591093
Kobi Simmons,1628424,32,1241,1264,2505,313.316666666667,323.15,636.466666666667,1530,1340,190,61.0778443113773,86.5402744317587
Sean Kilpatrick,203930,52,1245,1273,2518,305.866666666667,328.916666666667,634.783333333333,1392,1447,-55,55.2819698173153,78.9434715257174
Cody Zeller,203469,33,1195,1294,2489,304.566666666667,323.633333333333,628.2,1386,1401,-15,55.6850140618722,79.4269340974212
Torrey Craig,1628470,39,1247,1280,2527,306.65,320.95,627.6,1479,1435,44,58.5278986941037,84.8374760994264
Cheick Diallo,1627767,59,1247,1311,2558,301.716666666667,324.216666666667,625.933333333333,1365,1493,-128,53.3620015637217,78.5067632335712
Terrence Ross,203082,24,1194,1213,2407,288.016666666667,299.016666666667,587.033333333333,1330,1340,-10,55.2555047777316,81.5626597013231
Malik Beasley,1627736,62,1176,1198,2374,290.7,291.816666666667,582.516666666667,1333,1315,18,56.1499578770009,82.3804755228749
Cameron Payne,1626166,25,1193,1150,2343,280.4,295.833333333333,576.233333333333,1246,1361,-115,53.1796841655997,77.8434661884653
Khem Birch,203920,42,1113,1157,2270,281.4,294.783333333333,576.183333333333,1212,1277,-65,53.3920704845815,75.7258974284805
Brandon Paul,203464,63,1093,1117,2210,280.233333333333,292.916666666667,573.15,1210,1217,-7,54.7511312217195,76.0010468463753
Raul Neto,203526,49,1095,1149,2244,281.666666666667,290.65,572.316666666667,1204,1254,-50,53.6541889483066,75.7342962811963
Alex Caruso,1627936,37,1097,1141,2238,265.766666666667,291.216666666667,556.983333333333,1187,1261,-74,53.0384271671135,76.7204284987582
Justin Anderson,1626147,45,1107,1133,2240,276.616666666667,280.033333333333,556.65,1189,1238,-49,53.0803571428572,76.895715440582
Joe Young,1626202,54,1111,1116,2227,279.283333333333,275.783333333333,555.066666666667,1192,1228,-36,53.5249214189493,77.3096324765794
Tarik Black,204028,58,1089,1083,2172,274.75,277.35,552.1,1186,1204,-18,54.6040515653775,77.33381633762
Abdel Nader,1627846,57,1068,1083,2151,273.483333333333,275,548.483333333333,1172,1215,-43,54.4862854486286,76.9248533835729
Joffrey Lauvergne,203530,55,1056,1058,2114,261.55,271.8,533.35,1221,1147,74,57.7578051087985,82.4149245336083
Jonathan Isaac,1628371,27,1032,1052,2084,264.6,266.983333333333,531.583333333333,1102,1086,16,52.8790786948177,74.629879291425
Derrick Rose,201565,30,1072,1098,2170,260.45,270.8,531.25,1269,1282,-13,58.4792626728111,85.9934117647059
Tyler Cavanaugh,1628463,38,1070,1003,2073,272.883333333333,253.933333333333,526.816666666667,1172,1186,-14,56.5364206464062,80.0885823657819
Nik Stauskas,203917,41,1040,1041,2081,262.816666666667,258.866666666667,521.683333333333,1125,1119,6,54.0605478135512,77.6333024504009
Ivan Rabb,1628397,36,991,1015,2006,256.35,257.583333333333,513.933333333333,1170,1116,54,58.3250249252243,81.956155143339
Willy Hernangomez,1626195,48,960,986,1946,238.95,249.766666666667,488.716666666667,1071,1085,-14,55.0359712230216,78.8923370732872
Al Jefferson,2744,36,952,963,1915,246.483333333333,240.366666666667,486.85,1041,1066,-25,54.3603133159269,76.9764814624628
Kyle Collinsworth,1627858,31,991,916,1907,251.266666666667,227.266666666667,478.533333333333,1032,1047,-15,54.116413214473,77.6372248537197
Damyean Dotson,1628422,44,959,932,1891,239.55,231.216666666667,470.766666666667,931,1068,-137,49.2332099418297,71.1945054166962
Nerlens Noel,203457,29,917,905,1822,238.933333333333,229.666666666667,468.6,958,999,-41,52.5795828759605,73.5979513444302
TJ Leaf,1628388,54,930,946,1876,222.083333333333,237.183333333333,459.266666666667,1025,1067,-42,54.637526652452,80.3454782987371
DeAndre' Bembry,1627761,26,888,894,1782,231.483333333333,227.733333333333,459.216666666667,977,1016,-39,54.8260381593715,76.5912967734911
Kenneth Faried,202702,32,909,918,1827,226.95,229.666666666667,456.616666666667,1038,974,64,56.8144499178982,81.8366974486258
Dorian Finney-Smith,1627827,21,937,864,1801,240.55,212.3,452.85,933,965,-32,51.8045530260966,74.1702550513415
Shabazz Muhammad,203498,47,869,872,1741,218.366666666667,222.233333333333,440.6,998,1014,-16,57.323377369328,81.5433499773037
Lucas Nogueira,203512,54,843,854,1697,216.366666666667,224.133333333333,440.5,923,960,-37,54.3901001767826,75.4324631101022
Dwight Buycks,202779,29,799,836,1635,204.883333333333,223.916666666667,428.8,886,882,4,54.1896024464832,74.384328358209
Willie Reed,203186,41,868,833,1701,215.533333333333,208.383333333333,423.916666666667,973,968,5,57.201646090535,82.6294476115589
Isaiah Canaan,203477,20,825,818,1643,210.266666666667,211.45,421.716666666667,941,931,10,57.273280584297,80.3288147650476
Ivica Zubac,1627826,43,812,836,1648,191.6,213.933333333333,405.533333333333,903,812,91,54.7936893203884,80.1611047180668
Danuel House Jr.,1627863,23,827,798,1625,203.65,198.266666666667,401.916666666667,878,909,-31,54.0307692307692,78.6431681526021
Damion Lee,1627814,15,829,812,1641,200.5,198.716666666667,399.216666666667,878,888,-10,53.5039609993906,79.1750511418194
Ramon Sessions,201196,28,768,761,1529,195.866666666667,195.65,391.516666666667,867,852,15,56.7037279267495,79.7207441147674
Shaquille Harrison,1627885,23,777,765,1542,190.366666666667,191.766666666667,382.133333333333,846,913,-67,54.863813229572,79.6999302163294
Ron Baker,1627758,28,754,732,1486,189.2,190.483333333333,379.683333333333,808,856,-48,54.3741588156124,76.6112110969668
Brandan Wright,201148,28,728,726,1454,187.266666666667,191.8,379.066666666667,797,779,18,54.8143053645117,75.6911712979247
Johnny O'Bryant III,203948,36,736,790,1526,174.383333333333,202.633333333333,377.016666666667,835,759,76,54.7182175622543,79.7312231996817
Myke Henry,1627988,20,718,741,1459,182.45,193.083333333333,375.533333333333,852,818,34,58.3961617546265,81.67583880703
Mike Conley,201144,12,716,697,1413,181.8,185.416666666667,367.216666666667,754,787,-33,53.3616418966738,73.9182135887079
Jahlil Okafor,1626143,28,669,674,1343,176.766666666667,172.533333333333,349.3,754,741,13,56.1429635145197,77.7097051245348
Timofey Mozgov,202389,31,705,721,1426,173.85,174.983333333333,348.833333333333,767,794,-27,53.7868162692847,79.1552795031056
Emeka Okafor,2731,27,754,762,1516,168.516666666667,178.4,346.916666666667,796,791,5,52.5065963060686,82.6019697333654
Dante Exum,203957,24,694,680,1374,176.333333333333,170.4,346.733333333333,771,775,-4,56.1135371179039,80.0499903864641
JaKarr Sampson,203960,22,635,679,1314,162.983333333333,180.133333333333,343.116666666667,714,654,60,54.337899543379,74.9132947976879
Glenn Robinson III,203922,25,682,682,1364,170.7,171.966666666667,342.666666666667,728,747,-19,53.3724340175953,76.4824902723735
Boban Marjanovic,1626246,37,668,669,1337,166.05,169.35,335.4,778,759,19,58.1899775617053,83.5062611806798
Luke Kornet,1628436,20,663,650,1313,166.283333333333,161.216666666667,327.5,687,779,-92,52.3229246001523,75.5175572519084
Henry Ellenson,1627740,37,639,633,1272,168.866666666667,158.35,327.216666666667,696,654,42,54.7169811320755,76.5731166912851
Patrick Beverley,201976,11,657,625,1282,165.65,160.7,326.35,720,701,19,56.1622464898596,79.4239313620346
Malachi Richardson,1627781,26,609,629,1238,153.15,166.016666666667,319.166666666667,701,688,13,56.6235864297254,79.068407310705
Rodney McGruder,203585,22,623,612,1235,157.183333333333,157.416666666667,314.6,675,718,-43,54.6558704453441,77.2409408773045
Antonio Blakeney,1628469,19,652,634,1286,153.816666666667,160.2,314.016666666667,699,724,-25,54.3545878693624,80.1358738920439
Troy Williams,1627786,21,613,631,1244,150.033333333333,154.6,304.633333333333,764,662,102,61.4147909967846,90.2855892329577
Ryan Arcidiacono,1627853,24,601,584,1185,150.433333333333,151.383333333333,301.816666666667,623,658,-35,52.5738396624473,74.3100115964438
Solomon Hill,203524,21,625,643,1268,148.933333333333,152.05,300.983333333333,706,707,-1,55.6782334384858,84.4432139099618
Rodney Purvis,1628681,16,568,586,1154,145.866666666667,143.133333333333,289,627,590,37,54.3327556325823,78.1038062283737
Jason Smith,201160,34,566,574,1140,141.65,143.7,285.35,674,586,88,59.1228070175439,85.0324163308218
Jordan Mickey,1626175,23,525,544,1069,137.95,144.366666666667,282.316666666667,604,605,-1,56.5014031805426,77.0198949170553
Jamel Artis,1628503,15,547,554,1101,141.483333333333,136.75,278.233333333333,563,616,-53,51.1353315168029,72.8453336528094
Guerschon Yabusele,1627824,44,572,538,1110,142.55,133.433333333333,275.983333333333,601,602,-1,54.1441441441442,78.3960384081164
Tony Allen,2754,22,538,573,1111,133.95,140.166666666667,274.116666666667,607,619,-12,54.6354635463546,79.7178816805496
Iman Shumpert,202697,14,543,553,1096,136.15,136.05,272.2,628,597,31,57.2992700729927,83.0565760470242
Markelle Fultz,1628365,17,565,596,1161,129.65,142.2,271.85,559,658,-99,48.1481481481482,74.0261173441236
Juancho Hernangomez,1627823,25,535,542,1077,135.35,135.8,271.15,632,604,28,58.6815227483751,83.9092753088696
Jamil Wilson,203966,15,522,555,1077,124.016666666667,143.916666666667,267.933333333333,586,577,9,54.4103992571959,78.7360039810898
Meyers Leonard,203086,34,498,494,992,125.333333333333,127.85,253.183333333333,590,574,16,59.4758064516129,83.891778026463
Derrick Jones Jr.,1627884,20,485,484,969,121.3,119.35,240.65,498,492,6,51.3931888544892,74.4982339497195
Davon Reed,1628432,21,500,480,980,124.616666666667,115.216666666667,239.833333333333,529,501,28,53.9795918367347,79.4051424600417
Isaiah Hicks,1628439,18,493,477,970,124.466666666667,114.533333333333,239,523,546,-23,53.9175257731959,78.7782426778243
Briante Weber,1627362,18,465,481,946,114.866666666667,120.583333333333,235.45,551,555,-4,58.2452431289641,84.2471862391166
Aaron Harrison,1626151,9,472,457,929,116.866666666667,115.983333333333,232.85,471,541,-70,50.6996770721206,72.8194116383938
Ante Zizic,1627790,39,472,470,942,112.65,118.6,231.25,538,548,-10,57.1125265392781,83.7535135135135
Marcus Georges-Hunt,1627875,42,455,466,921,109.166666666667,116.883333333333,226.05,549,520,29,59.6091205211727,87.4319840743199
Travis Wear,204037,17,454,444,898,112.35,113.233333333333,225.583333333333,494,501,-7,55.011135857461,78.8356113779091
Alec Peters,1628409,20,479,443,922,114.183333333333,108.35,222.533333333333,481,545,-64,52.1691973969631,77.813061713601
Gary Payton II,1627780,23,442,431,873,109.8,108.65,218.45,491,504,-13,56.2428407789233,80.9155413138018
Josh Magette,203705,18,419,413,832,105.933333333333,107.816666666667,213.75,464,470,-6,55.7692307692308,78.1473684210526
Andrew Bogut,101106,23,448,422,870,110.85,100.883333333333,211.733333333333,439,447,-8,50.4597701149425,74.6410579345088
Rashad Vaughn,1626173,25,402,405,807,103.233333333333,107.6,210.833333333333,456,468,-12,56.5055762081784,77.8624505928854
Andrew White III,1628510,15,419,436,855,101.016666666667,109,210.016666666667,406,504,-98,47.4853801169591,69.594476628839
Brandon Jennings,201943,15,416,423,839,96.7833333333333,112.8,209.583333333333,483,452,31,57.5685339690107,82.9646123260438
Kawhi Leonard,202695,9,398,403,801,102.566666666667,104.383333333333,206.95,391,451,-60,48.8139825218477,68.016429089152
Caleb Swanigan,1628403,27,381,405,786,99.9,101.933333333333,201.833333333333,367,474,-107,46.6921119592875,65.4599504541701
Quincy Pondexter,202347,23,377,380,757,96.8666666666667,98.0166666666667,194.883333333333,380,438,-58,50.1981505944518,70.1958436671513
MarShon Brooks,202705,7,368,397,765,94.05,98.0333333333333,192.083333333333,486,433,53,63.5294117647059,91.0854663774404
Aaron Brooks,201166,33,374,368,742,91.4,97.7833333333333,189.183333333333,431,434,-3,58.0862533692722,82.0156814377588
Omer Asik,201600,18,340,363,703,85.6,95.4833333333333,181.083333333333,412,414,-2,58.6059743954481,81.907040957202
Jalen Jones,1627883,14,362,356,718,88.0166666666667,92.1333333333333,180.15,391,438,-47,54.4568245125348,78.1348875936719
Isaiah Whitehead,1627785,16,342,362,704,88.05,88.8166666666667,176.866666666667,348,411,-63,49.4318181818182,70.8330192235205
Johnathan Motley,1628405,11,352,338,690,86.4833333333333,88.1333333333333,174.616666666667,346,368,-22,50.1449275362319,71.33339696478
Julyan Stone,202933,23,342,356,698,85.25,87.4666666666667,172.716666666667,372,409,-37,53.2951289398281,77.5373926469169
John Holland,204066,24,333,362,695,81.1166666666667,91.3833333333333,172.5,386,426,-40,55.5395683453238,80.5565217391304
Jake Layman,1627774,34,321,324,645,81.8166666666667,83.6833333333334,165.5,338,383,-45,52.4031007751938,73.5226586102719
Lorenzo Brown,203485,18,318,298,616,86.5166666666667,78.2,164.716666666667,308,351,-43,50,67.3155924314479
Richard Jefferson,2210,19,327,318,645,85.4166666666667,77.3166666666667,162.733333333333,362,361,1,56.1240310077519,80.0819336337567
Mirza Teletovic,203141,10,290,302,592,77.3166666666667,80.9166666666667,158.233333333333,327,352,-25,55.2364864864865,74.396460922688
Dakari Johnson,1626177,32,294,311,605,77.5666666666667,78.7,156.266666666667,299,327,-28,49.4214876033058,68.882252559727
Derrick White,1628401,19,312,320,632,76.5666666666667,79.0666666666667,155.633333333333,325,340,-15,51.4240506329114,75.1766973656029
Damien Wilkins,2863,19,300,312,612,72.4,77.5,149.9,322,358,-36,52.6143790849673,77.3315543695797
Derrick Walton Jr.,1628476,16,274,284,558,72.8166666666667,73.75,146.566666666667,309,321,-12,55.3763440860215,75.8972026381624
Kay Felder,1627770,15,270,284,554,66.7333333333333,73.2,139.933333333333,283,311,-28,51.0830324909747,72.8060981419724
Darrell Arthur,201589,18,273,280,553,68.85,70.2,139.05,313,326,-13,56.6003616636528,81.0355987055016
Jon Leuer,202720,8,269,264,533,68.3333333333334,67.25,135.583333333333,292,279,13,54.7842401500938,77.5316533497234
Zhou Qi,1627753,21,255,255,510,63.5166666666667,63.4833333333333,127,264,260,4,51.7647058823529,74.8346456692913
Milton Doyle,1628495,10,236,254,490,61.5166666666667,62.65,124.166666666667,260,259,1,53.0612244897959,75.3825503355705
Malcolm Miller,1626259,15,242,247,489,62.2166666666667,60.1666666666667,122.383333333333,287,254,33,58.6912065439673,84.4232602478551
Antonius Cleveland,1628499,15,241,242,483,62.9833333333333,59.25,122.233333333333,229,258,-29,47.4120082815735,67.4447777474775
Nigel Hayes,1628502,9,229,228,457,59.5166666666667,62.05,121.566666666667,230,234,-4,50.328227571116,68.1107759802578
Georgios Papagiannis,1627834,17,240,246,486,58.55,62.4333333333333,120.983333333333,291,285,6,59.8765432098766,86.5904394544703
James Webb III,1627821,10,234,245,479,59.1833333333333,59.5333333333333,118.716666666667,274,254,20,57.2025052192067,83.0885862698301
Xavier Rathan-Mayes,1628504,5,224,229,453,57.8,60.7333333333333,118.533333333333,290,224,66,64.0176600441501,88.0764904386952
Jabari Bird,1628444,13,227,224,451,57.8833333333333,55.5333333333333,113.416666666667,287,226,61,63.6363636363636,91.0977222630419
Bobby Brown,201628,20,219,228,447,55.5666666666667,57.25,112.816666666667,261,256,5,58.3892617449665,83.2855665534052
Kadeem Allen,1628443,16,219,198,417,52.2166666666667,53,105.216666666667,227,215,12,54.4364508393285,77.6683035007128
Bruno Caboclo,203998,11,194,210,404,52.3166666666667,52.7,105.016666666667,206,218,-12,50.990099009901,70.6173623234407
Alex Poythress,1627816,25,213,210,423,50.45,52.2833333333333,102.733333333333,235,242,-7,55.5555555555556,82.3491239454899
Ty Lawson,201951,5,210,194,404,53.05,46.2333333333333,99.2833333333333,215,217,-2,53.2178217821782,77.9587040456606
Wade Baldwin IV,1627735,11,184,188,372,48.5833333333333,50.65,99.2333333333334,203,227,-24,54.5698924731183,73.6446086664427
Jaylen Morris,1628537,6,196,213,409,45.0666666666667,53.8166666666667,98.8833333333333,195,236,-41,47.6772616136919,70.9927524018203
Brice Johnson,1627744,18,193,213,406,46.5166666666667,51.8,98.3166666666667,235,213,22,57.8817733990148,86.0484827936939
Damian Jones,1627745,19,186,212,398,48.5666666666667,49.6833333333333,98.25,201,227,-26,50.5025125628141,73.6488549618321
Darrun Hilliard,1626199,14,180,185,365,46.15,46.35,92.5,218,221,-3,59.7260273972603,84.8432432432433
Jack Cooley,204022,7,169,176,345,41.2333333333333,47.4166666666667,88.65,160,188,-28,46.3768115942029,64.9746192893401
Chris McCullough,1626191,19,190,190,380,45.05,43.05,88.1,226,200,26,59.4736842105263,92.3496027241771
Josh Gray,1627982,5,186,173,359,46.4833333333333,40.4,86.8833333333333,206,182,24,57.3816155988858,85.355841166315
Demetrius Jackson,1627743,15,152,150,302,38.2666666666667,40.2333333333333,78.5,161,165,-4,53.3112582781457,73.8343949044586
Furkan Korkmaz,1627788,14,166,166,332,38.6166666666667,39.8666666666667,78.4833333333334,217,157,60,65.3614457831325,99.5370566999363
Okaro White,1627855,5,156,143,299,39.95,37.6833333333333,77.6333333333333,179,152,27,59.866220735786,83.0055817947617
Nick Collison,2555,15,137,150,287,35.8833333333333,39.25,75.1333333333334,150,158,-8,52.2648083623693,71.8722271517303
Marquis Teague,203104,3,143,145,288,37.8,36.8333333333333,74.6333333333334,178,143,35,61.8055555555556,85.8597588209022
Omari Johnson,204179,4,144,150,294,35.7666666666667,38.3166666666667,74.0833333333333,193,176,17,65.6462585034014,93.7862767154106
Udonis Haslem,2617,14,130,138,268,36.2833333333333,35.75,72.0333333333333,109,159,-50,40.6716417910448,54.4747801943545
Thomas Bryant,1628418,15,139,140,279,33.1833333333333,38.3,71.4833333333334,163,161,2,58.4229390681004,82.0890650501282
Alan Williams,1626210,5,127,136,263,33.85,37.4333333333333,71.2833333333333,120,145,-25,45.6273764258555,60.6032265606734
D.J. Wilson,1628391,21,130,122,252,35.3666666666667,33.5166666666667,68.8833333333333,139,161,-22,55.1587301587302,72.6445681103315
Jordan Crawford,202348,7,135,154,289,32.5,36.25,68.75,168,196,-28,58.1314878892734,87.9709090909091
Larry Drew II,203580,10,129,138,267,31.5333333333333,37,68.5333333333333,155,150,5,58.0524344569288,81.420233463035
Gian Clavell,1628492,7,129,120,249,34.45,31.8833333333333,66.3333333333333,150,133,17,60.2409638554217,81.4070351758794
Andre Ingram,201281,2,125,126,251,32.85,31.3666666666667,64.2166666666667,130,163,-33,51.792828685259,72.8782766675318
London Perrantes,1628506,14,130,119,249,31.9333333333333,31,62.9333333333333,147,154,-7,59.0361445783133,84.0889830508475
James Young,203923,6,122,114,236,31.8,28.7166666666667,60.5166666666667,130,127,3,55.0847457627119,77.3340677499312
Kyle Singler,202713,11,101,113,214,28.0166666666667,27.3833333333333,55.4,92,118,-26,42.9906542056075,59.7833935018051
Aaron Jackson,1628935,8,93,100,193,25.65,26.8333333333333,52.4833333333333,100,100,0,51.8134715025907,68.5932041918069
Marshall Plumlee,1627850,8,99,101,200,25.9,26.1833333333333,52.0833333333333,106,105,1,53,73.2672
Alfonzo McKinnie,1628035,13,120,99,219,28.35,23.3,51.65,121,132,-11,55.2511415525114,84.3368828654405
Vander Blue,203505,5,79,80,159,19.85,24.9,44.75,99,80,19,62.2641509433962,79.6424581005586
Cole Aldrich,202332,20,102,92,194,21.45,23.25,44.7,134,97,37,69.0721649484536,107.919463087248
RJ Hunter,1626154,5,90,88,178,21.4,21.7166666666667,43.1166666666667,94,83,11,52.8089887640449,78.484731349053
Adreian Payne,203940,5,72,85,157,18.9833333333333,22.2333333333333,41.2166666666667,83,108,-25,52.8662420382166,72.4949454104327
Joakim Noah,201149,7,76,77,153,19.1666666666667,21.2166666666667,40.3833333333333,79,70,9,51.6339869281046,70.4250928600908
Jonathan Gibson,1626780,4,77,84,161,18.05,21.1666666666667,39.2166666666667,110,90,20,68.3229813664596,100.977475563111
Joel Bolomboy,1627762,6,76,67,143,19.9833333333333,16.7166666666667,36.7,69,70,-1,48.2517482517483,67.6839237057221
Charles Cooke,1628429,12,74,87,161,16.2333333333333,19.8333333333333,36.0666666666667,74,85,-11,45.9627329192547,73.8632162661738
Jeff Withey,203481,8,75,67,142,18.1833333333333,17.15,35.3333333333333,78,66,12,54.9295774647887,79.4716981132076
Walter Lemon Jr.,1627215,5,68,74,142,17.35,16.85,34.2,82,108,-26,57.7464788732394,86.3157894736842
Jacob Wiley,1628451,5,65,67,132,15.6,16.8333333333333,32.4333333333333,57,69,-12,43.1818181818182,63.2682425488181
Matt Costello,1627856,4,55,59,114,14.7166666666667,16.9333333333333,31.65,63,82,-19,55.2631578947369,71.6587677725119
Georges Niang,1627777,9,62,60,122,15.5666666666667,14.5666666666667,30.1333333333333,73,67,6,59.8360655737705,87.212389380531
Markel Brown,203900,4,64,61,125,15.7166666666667,14.3666666666667,30.0833333333333,73,59,14,58.4,87.3573407202216
Tony Bradley,1628396,10,56,74,130,13.3666666666667,16.6166666666667,29.9833333333333,65,71,-6,50,78.0433574207893
Ike Anigbogu,1628387,11,60,71,131,13.3666666666667,14.95,28.3166666666667,60,92,-32,45.8015267175573,76.2801648028252
Daniel Hamilton,1627772,6,56,53,109,13.8833333333333,13.5833333333333,27.4666666666667,55,50,5,50.4587155963303,72.0873786407767
Marcus Paige,1627779,5,52,59,111,12.3333333333333,14.75,27.0833333333333,63,67,-4,56.7567567567568,83.7415384615385
Jameel Warney,1627866,3,57,51,108,14.4666666666667,12.4666666666667,26.9333333333333,57,62,-5,52.7777777777778,76.1881188118812
Monte Morris,1628420,2,50,51,101,12.85,12.2,25.05,55,62,-7,54.4554455445545,79.0419161676647
Chinanu Onuaku,1627778,2,42,45,87,12.0833333333333,12.3666666666667,24.45,37,46,-9,42.5287356321839,54.478527607362
Jeremy Lin,202391,1,55,60,115,12.0333333333333,12.3833333333333,24.4166666666667,64,74,-10,55.6521739130435,94.3617747440273
Mangok Mathiang,1628493,4,39,40,79,9.86666666666667,9.7,19.5666666666667,42,41,1,53.1645569620253,77.2742759795571
Xavier Munford,204098,6,39,37,76,9.58333333333333,9.18333333333333,18.7666666666667,41,49,-8,53.9473684210526,78.6500888099467
James Michael McAdoo,203949,3,31,38,69,8.78333333333333,9.26666666666667,18.05,46,33,13,66.6666666666667,91.7451523545706
Nate Wolters,203489,5,33,41,74,8.1,9.65,17.75,37,41,-4,50,75.0422535211267
Kendrick Perkins,2570,1,30,27,57,7.91666666666667,6.55,14.4666666666667,37,38,-1,64.9122807017544,92.073732718894
David Stockton,204065,5,31,30,61,8.13333333333333,6.31666666666667,14.45,43,34,9,70.4918032786885,107.128027681661
Devin Robinson,1628421,1,23,34,57,5.83333333333333,7.35,13.1833333333333,26,31,-5,45.6140350877193,70.9987357774968
Luol Deng,2736,1,32,30,62,6.48333333333333,6.26666666666667,12.75,32,27,5,51.6129032258065,90.3529411764706
Tim Quarterman,1627817,3,23,29,52,4.98333333333333,7.55,12.5333333333333,17,27,-10,32.6923076923077,48.8297872340426
Josh Smith,2746,3,27,27,54,6.53333333333333,5.25,11.7833333333333,21,25,-4,38.8888888888889,64.1584158415842
Matt Williams Jr.,1628475,3,22,18,40,5.88333333333334,4.68333333333333,10.5666666666667,22,22,0,55,74.9526813880126
Nicolas Brussino,1627852,3,20,18,38,5.15,4.61666666666667,9.76666666666667,25,8,17,65.7894736842105,92.1501706484642
Ben Moore,1628500,2,20,20,40,4.46666666666667,4.46666666666667,8.93333333333333,20,35,-15,50,80.5970149253731
Derrick Williams,202682,2,13,19,32,3.58333333333333,4.88333333333334,8.46666666666667,12,9,3,37.5,51.0236220472441
Scotty Hopson,203816,1,17,21,38,4.06666666666667,4.31666666666667,8.38333333333333,30,17,13,78.9473684210526,128.82703777336
Jarell Eddie,204067,3,13,19,32,3.81666666666667,4.53333333333333,8.35,8,28,-20,25,34.4910179640719
,1962937798,1,18,14,32,4.33333333333333,3.85,8.18333333333333,14,20,-6,43.75,61.5885947046843
Erik McCree,1628571,4,14,16,30,3.61666666666667,4.4,8.01666666666667,17,25,-8,56.6666666666667,76.3409563409564
Luis Montero,1626242,2,16,14,30,4.56666666666667,3.26666666666667,7.83333333333333,17,11,6,56.6666666666667,78.1276595744681
Xavier Silas,202918,1,18,16,34,3.13333333333333,4.31666666666667,7.45,18,17,1,52.9411764705882,86.9798657718121
Vincent Hunter,1626205,3,12,21,33,3.18333333333333,4.23333333333333,7.41666666666667,14,21,-7,42.4242424242424,67.9550561797753
Reggie Hearn,203687,3,16,14,30,3.75,2.96666666666667,6.71666666666667,12,13,-1,40,64.317617866005
Jacob Pullen,1626643,3,11,15,26,3.05,2.83333333333333,5.88333333333333,10,10,0,38.4615384615385,61.1898016997167
Josh McRoberts,201177,2,11,11,22,3.1,2.58333333333333,5.68333333333333,12,13,-1,54.5454545454546,76.0117302052786
Jeremy Evans,202379,1,12,13,25,2.25,3.06666666666667,5.31666666666667,10,19,-9,40,67.7115987460815
Gordon Hayward,202330,1,12,10,22,2.46666666666667,2.51666666666667,4.98333333333333,12,9,3,54.5454545454546,86.6889632107023
Anthony Brown,1626148,1,8,8,16,1.48333333333333,1.91666666666667,3.4,12,9,3,75,127.058823529412
Justin Patton,1628383,1,8,8,16,1.48333333333333,1.91666666666667,3.4,12,9,3,75,127.058823529412
PJ Dozier,1628408,2,5,9,14,1.26666666666667,1.86666666666667,3.13333333333334,5,7,-2,35.7142857142857,57.4468085106383
Tyler Lydon,1628399,1,5,5,10,1.23333333333333,0.916666666666667,2.15,2,10,-8,20,33.4883720930233
Edmond Sumner,1628410,1,4,5,9,1,0.916666666666666,1.91666666666667,2,8,-6,22.2222222222222,37.5652173913044
Mindaugas Kuzminskas,1627851,1,3,3,6,0.6,1.15,1.75,0,0,0,0,0
Trey McKinney-Jones,203590,1,3,3,6,0.416666666666667,0.783333333333333,1.2,4,4,0,66.6666666666667,120
Chris Boucher,1628449,1,1,2,3,0.316666666666667,0.633333333333334,0.950000000000001,0,2,-2,0,0
Naz Mitrou-Long,1628513,1,1,1,2,0.183333333333333,0.233333333333333,0.416666666666666,3,3,0,150,259.2
