season,id_player,name_player,name_player_summary_nbastatr,gp_calc_total,gp_summary_nbastatr,poss_calc_o,poss_calc_d,poss_calc_total,mp_calc_o,mp_calc_d,mp_calc_total,mp_game_logs_nbastatr,mp_summary1_nbastatr,mp_summary2_nbastatr,pts_calc_o,pts_calc_d,pts_o_per100_calc,pm_calc,pm_game_logs_nbastatr
2015,203110,Draymond Green,Draymond Green,81,81,6725,6866,13591,1307.9,1496.45,2804.35,2807,2808,2808,6992,5913,103.970260223048,1079,1080
2015,201939,Stephen Curry,Stephen Curry,79,79,6517,6645,13162,1256.28333333333,1438.91666666667,2695.2,2705,2700,2700,6775,5754,103.958876783796,1021,1030
2015,202691,Klay Thompson,Klay Thompson,80,80,6258,6477,12735,1242.7,1407.73333333333,2650.43333333333,2661,2666,2666,6495,5651,103.787152444871,844,846
2015,202695,Kawhi Leonard,Kawhi Leonard,72,72,5323,5293,10616,1231.1,1144.61666666667,2375.71666666667,2381,2380,2380,5172,4490,97.1632538042457,682,652
2015,201566,Russell Westbrook,Russell Westbrook,80,80,6698,6548,13246,1322.56666666667,1423.7,2746.26666666667,2749,2750,2750,6497,5842,96.999104210212,655,631
2015,201142,Kevin Durant,Kevin Durant,72,72,6243,6148,12391,1250.91666666667,1326.61666666667,2577.53333333333,2577,2578,2578,6113,5475,97.9176677879225,638,647
2015,2544,LeBron James,LeBron James,76,76,6211,6058,12269,1384.83333333333,1319.8,2704.63333333333,2708,2709,2709,6069,5477,97.7137336982773,592,618
2015,201980,Danny Green,Danny Green,79,79,4595,4528,9123,1062.48333333333,984.916666666667,2047.4,2063,2062,2062,4379,3856,95.2992383025027,523,506
2015,200746,LaMarcus Aldridge,LaMarcus Aldridge,74,74,5013,5007,10020,1171.03333333333,1086.86666666667,2257.9,2259,2261,2261,4851,4339,96.7684021543986,512,509
2015,101108,Chris Paul,Chris Paul,74,74,5556,5673,11229,1193.38333333333,1220.78333333333,2414.16666666667,2425,2420,2420,5503,4992,99.0460763138949,511,555
2015,201586,Serge Ibaka,Serge Ibaka,78,78,6001,5935,11936,1203.31666666667,1287.83333333333,2491.15,2504,2500,2500,5802,5309,96.6838860189968,493,532
2015,201599,DeAndre Jordan,DeAndre Jordan,77,77,5936,6066,12002,1277.85,1312.48333333333,2590.33333333333,2600,2598,2598,5812,5335,97.911051212938,477,436
2015,200755,JJ Redick,J.J. Redick,75,75,4803,4904,9707,1031.28333333333,1058.2,2089.48333333333,2097,2097,2097,4736,4278,98.6050385175932,458,510
2015,203500,Steven Adams,Steven Adams,80,80,4821,4712,9533,969.366666666667,1040.05,2009.41666666667,2019,2014,2014,4559,4101,94.5654428541796,458,473
2015,2738,Andre Iguodala,Andre Iguodala,65,65,4152,4251,8403,823.366666666667,906.25,1729.61666666667,1735,1732,1732,4129,3679,99.4460500963391,450,455
2015,101106,Andrew Bogut,Andrew Bogut,70,70,3361,3441,6802,680.016666666667,762.2,1442.21666666667,1452,1451,1451,3378,2941,100.505801844689,437,406
2015,2225,Tony Parker,Tony Parker,72,72,4376,4378,8754,1034.38333333333,938.25,1972.63333333333,1979,1980,1980,4192,3782,95.7952468007313,410,415
2015,203084,Harrison Barnes,Harrison Barnes,66,66,4810,4882,9692,982.116666666667,1059.33333333333,2041.45,2043,2042,2042,4787,4380,99.5218295218295,407,460
2015,1495,Tim Duncan,Tim Duncan,61,61,3437,3384,6821,798.683333333333,734.35,1533.03333333333,1534,1536,1536,3248,2851,94.5010183299389,397,426
2015,201988,Patty Mills,Patty Mills,81,81,3788,3808,7596,846.15,819.783333333333,1665.93333333333,1659,1662,1662,3685,3293,97.2808870116156,392,377
2015,201567,Kevin Love,Kevin Love,77,77,5474,5329,10803,1231.03333333333,1179.71666666667,2410.75,2424,2424,2424,5270,4883,96.2732919254658,387,426
2015,200768,Kyle Lowry,Kyle Lowry,77,77,6446,6338,12784,1473.55,1363.25,2836.8,2853,2851,2851,6142,5758,95.2838969903816,384,375
2015,202335,Patrick Patterson,Patrick Patterson,79,79,4548,4530,9078,1038.48333333333,977.883333333333,2016.36666666667,2017,2020,2020,4384,4019,96.3940193491645,365,406
2015,203521,Matthew Dellavedova,Matthew Dellavedova,76,76,4258,4179,8437,947.766666666667,926,1873.76666666667,1869,1867,1867,4096,3735,96.195396899953,361,381
2015,202684,Tristan Thompson,Tristan Thompson,81,82,5197,5058,10255,1164.7,1104.48333333333,2269.18333333333,2268,2269,2269,4957,4597,95.3819511256494,360,357
2015,2561,David West,David West,78,78,3139,3140,6279,716.85,679.75,1396.6,1407,1404,1404,3012,2665,95.9541255176808,347,329
2015,1938,Manu Ginobili,Manu Ginobili,58,58,2613,2646,5259,584.2,558.016666666667,1142.21666666667,1137,1134,1134,2543,2215,97.3210868733257,328,329
2015,2747,JR Smith,J.R. Smith,77,77,5411,5274,10685,1216.85,1141.95,2358.8,2367,2362,2362,5204,4895,96.1744594344853,309,308
2015,2594,Kyle Korver,Kyle Korver,80,80,5490,5643,11133,1159.38333333333,1218.71666666667,2378.1,2402,2401,2401,5142,4862,93.6612021857924,280,424
2015,2564,Boris Diaw,Boris Diaw,76,76,3147,3175,6322,712.883333333333,675.1,1387.98333333333,1383,1386,1386,3029,2752,96.250397203686,277,289
2015,203460,Andre Roberson,Andre Roberson,70,70,3676,3648,7324,738.466666666667,804.583333333333,1543.05,1552,1553,1553,3499,3225,95.1849836779108,274,258
2015,202709,Cory Joseph,Cory Joseph,80,80,4652,4631,9283,1062.75,978.9,2041.65,2053,2046,2046,4366,4100,93.8521066208083,266,275
2015,202340,Avery Bradley,Avery Bradley,76,76,6057,6078,12135,1199.11666666667,1322.86666666667,2521.98333333333,2536,2536,2536,5684,5430,93.841835892356,254,216
2015,203471,Dennis Schroder,Dennis Schroder,80,80,3671,3762,7433,779.35,840.166666666667,1619.51666666667,1614,1621,1621,3440,3192,93.7074366657587,248,223
2015,101107,Marvin Williams,Marvin Williams,81,81,5269,5283,10552,1184.81666666667,1140.01666666667,2324.83333333333,2339,2338,2338,5072,4826,96.2611501233631,246,246
2015,202738,Isaiah Thomas,Isaiah Thomas,82,82,6412,6372,12784,1259.08333333333,1383.76666666667,2642.85,2646,2644,2644,5985,5740,93.3406113537118,245,295
2015,201601,Luc Mbah a Moute,Luc Mbah a Moute,73,75,2836,2961,5797,620.283333333333,651.883333333333,1272.16666666667,1273,1274,1274,2776,2537,97.8843441466855,239,156
2015,202689,Kemba Walker,Kemba Walker,81,81,6538,6560,13098,1465.63333333333,1413.71666666667,2879.35,2885,2885,2885,6226,5997,95.2278984398899,229,237
2015,201609,Goran Dragic,Goran Dragic,72,72,5402,5386,10788,1205.91666666667,1148.91666666667,2354.83333333333,2361,2363,2363,5017,4798,92.8730099962977,219,203
2015,203079,Dion Waiters,Dion Waiters,78,78,5244,5109,10353,1069.31666666667,1082.4,2151.71666666667,2157,2152,2152,4926,4708,93.9359267734554,218,219
2015,201587,Nicolas Batum,Nicolas Batum,70,70,5524,5582,11106,1233.33333333333,1204.71666666667,2438.05,2452,2448,2448,5305,5090,96.0354815351195,215,210
2015,203082,Terrence Ross,Terrence Ross,73,73,3918,3892,7810,900.766666666667,843.45,1744.21666666667,1751,1747,1747,3679,3464,93.8999489535477,215,241
2015,203105,Festus Ezeli,Festus Ezeli,46,46,1849,1833,3682,361.166666666667,406.616666666667,767.783333333333,768,770,770,1800,1590,97.3499188750676,210,223
2015,202681,Kyrie Irving,Kyrie Irving,53,53,3788,3686,7474,853.583333333333,801.65,1655.23333333333,1665,1667,1667,3642,3433,96.1457233368532,209,204
2015,202697,Iman Shumpert,Iman Shumpert,54,54,2983,2960,5943,676.95,637.65,1314.6,1319,1316,1316,2848,2639,95.4743546765002,209,185
2015,200794,Paul Millsap,Paul Millsap,81,81,6108,6290,12398,1290.45,1345.06666666667,2635.51666666667,2647,2647,2647,5696,5488,93.2547478716437,208,215
2015,2733,Shaun Livingston,Shaun Livingston,78,78,3534,3608,7142,730.466666666667,784.966666666667,1515.43333333333,1512,1520,1520,3405,3203,96.3497453310696,202,208
2015,101161,Amir Johnson,Amir Johnson,79,79,4257,4260,8517,838.933333333334,943.75,1782.68333333333,1798,1800,1800,3956,3754,92.9292929292929,202,139
2015,203937,Kyle Anderson,Kyle Anderson,78,78,2737,2785,5522,643.25,593.983333333333,1237.23333333333,1247,1245,1245,2632,2431,96.1636828644501,201,205
2015,203109,Jae Crowder,Jae Crowder,73,73,5551,5570,11121,1086.55,1205.51666666667,2292.06666666667,2310,2308,2308,5132,4935,92.4518104845974,197,216
2015,201143,Al Horford,Al Horford,82,82,5977,6229,12206,1258.46666666667,1354.73333333333,2613.2,2635,2631,2631,5567,5373,93.1403714237912,194,231
2015,202331,Paul George,Paul George,81,81,6614,6652,13266,1391.66666666667,1423.98333333333,2815.65,2827,2819,2819,6055,5874,91.5482310250983,181,181
2015,202730,Lavoy Allen,Lavoy Allen,79,79,3677,3649,7326,789.633333333333,804.733333333333,1594.36666666667,1601,1599,1599,3351,3170,91.1340766929562,181,189
2015,203469,Cody Zeller,Cody Zeller,73,73,4032,4007,8039,880.333333333334,882.416666666667,1762.75,1773,1774,1774,3889,3715,96.453373015873,174,165
2015,201942,DeMar DeRozan,DeMar DeRozan,78,78,6370,6282,12652,1464.41666666667,1337.86666666667,2802.28333333333,2804,2804,2804,6005,5833,94.2700156985871,172,172
2015,203083,Andre Drummond,Andre Drummond,81,81,6306,5998,12304,1331.21666666667,1329.65,2660.86666666667,2664,2666,2666,5656,5485,89.6923564858865,171,125
2015,203484,Kentavious Caldwell-Pope,Kentavious Caldwell-Pope,76,76,6640,6341,12981,1392.15,1393.98333333333,2786.13333333333,2789,2789,2789,5979,5811,90.0451807228916,168,173
2015,201976,Patrick Beverley,Patrick Beverley,71,71,4813,4779,9592,973.483333333333,1057.48333333333,2030.96666666667,2037,2041,2041,4536,4372,94.2447537918138,164,137
2015,201933,Blake Griffin,Blake Griffin,35,35,2716,2726,5442,579.333333333333,585.983333333333,1165.31666666667,1171,1170,1170,2573,2410,94.7349042709867,163,180
2015,203497,Rudy Gobert,Rudy Gobert,61,61,4236,4179,8415,1000.48333333333,924.133333333333,1924.61666666667,1930,1932,1932,3868,3705,91.3125590179415,163,150
2015,203096,Jared Sullinger,Jared Sullinger,81,81,4590,4542,9132,907.966666666667,1000.55,1908.51666666667,1917,1915,1915,4207,4048,91.6557734204793,159,214
2015,1717,Dirk Nowitzki,Dirk Nowitzki,75,75,5267,5346,10613,1217.38333333333,1142.43333333333,2359.81666666667,2362,2364,2364,5045,4888,95.7850768938675,157,255
2015,202687,Bismack Biyombo,Bismack Biyombo,82,82,4080,4067,8147,929.75,879.183333333333,1808.93333333333,1810,1808,1808,3747,3594,91.8382352941177,153,86
2015,202704,Reggie Jackson,Reggie Jackson,79,79,5732,5466,11198,1207.9,1202.76666666667,2410.66666666667,2424,2424,2424,5232,5079,91.2770411723657,153,129
2015,203087,Jeremy Lamb,Jeremy Lamb,66,66,2801,2818,5619,621.05,604.666666666667,1225.71666666667,1226,1227,1227,2549,2399,91.0032131381649,150,153
2015,203468,CJ McCollum,CJ McCollum,80,80,6519,6419,12938,1408.4,1360.55,2768.95,2776,2780,2780,6079,5933,93.2504985427213,146,157
2015,202683,Enes Kanter,Enes Kanter,82,82,4154,4030,8184,864.6,853.216666666667,1717.81666666667,1720,1721,1721,3881,3737,93.4280211844006,144,129
2015,201584,Courtney Lee,Courtney Lee,79,79,5184,5252,10436,1195.01666666667,1126.86666666667,2321.88333333333,2338,2334,2334,4933,4792,95.1581790123457,141,148
2015,202694,Marcus Morris,Marcus Morris,80,80,6670,6425,13095,1431.41666666667,1411.58333333333,2843,2852,2856,2856,6061,5921,90.8695652173913,140,156
2015,203118,Mike Scott,Mike Scott,75,75,2630,2684,5314,554.883333333333,593.033333333333,1147.91666666667,1147,1146,1146,2401,2268,91.2927756653992,133,113
2015,203482,Kelly Olynyk,Kelly Olynyk,69,69,3352,3366,6718,676.133333333333,713.4,1389.53333333333,1396,1395,1395,3031,2900,90.4236276849642,131,216
2015,101133,Ian Mahinmi,Ian Mahinmi,71,71,4178,4208,8386,886.95,918.55,1805.5,1816,1816,1816,3824,3694,91.5270464337003,130,108
2015,1626159,Justise Winslow,Justise Winslow,78,78,5041,5061,10102,1127.9,1101.9,2229.8,2237,2232,2232,4612,4483,91.4897837730609,129,111
2015,203503,Tony Snell,Tony Snell,64,64,3051,3081,6132,640.816666666667,655.966666666667,1296.78333333333,1300,1301,1301,2731,2604,89.5116355293346,127,97
2015,201168,Tiago Splitter,Tiago Splitter,36,36,1340,1355,2695,285.35,295.066666666667,580.416666666667,578,579,579,1246,1122,92.9850746268657,124,102
2015,203935,Marcus Smart,Marcus Smart,61,61,4117,4061,8178,805.216666666667,875.033333333333,1680.25,1666,1667,1667,3717,3596,90.284187515181,121,82
2015,101145,Monta Ellis,Monta Ellis,81,81,6413,6474,12887,1347.91666666667,1382.61666666667,2730.53333333333,2733,2734,2734,5829,5713,90.8934975830345,116,108
2015,201935,James Harden,James Harden,82,82,7462,7411,14873,1502.43333333333,1620.7,3123.13333333333,3121,3125,3125,6988,6872,93.6478155990351,116,120
2015,202685,Jonas Valanciunas,Jonas Valanciunas,60,60,3509,3422,6931,817.933333333333,728.9,1546.83333333333,1558,1557,1557,3349,3238,95.4402963807352,111,147
2015,202391,Jeremy Lin,Jeremy Lin,78,78,4682,4730,9412,1043.65,1005.96666666667,2049.61666666667,2047,2048,2048,4328,4218,92.439128577531,110,86
2015,201588,George Hill,George Hill,74,74,5768,5825,11593,1247.65,1260.66666666667,2508.31666666667,2526,2524,2524,5268,5159,91.3314840499307,109,97
2015,203501,Tim Hardaway Jr.,Tim Hardaway Jr.,51,51,1968,2013,3981,413.35,450.55,863.9,863,864,864,1856,1747,94.3089430894309,109,101
2015,203918,Rodney Hood,Rodney Hood,79,79,5511,5419,10930,1323.03333333333,1197.43333333333,2520.46666666667,2545,2541,2541,5064,4955,91.8889493739793,109,130
2015,202714,Shelvin Mack,Shelvin Mack,52,52,2381,2312,4693,548.65,511.766666666667,1060.41666666667,1057,1058,1058,2191,2084,92.0201595968081,107,97
2015,203991,Clint Capela,Clint Capela,77,77,3558,3505,7063,700.683333333333,766.916666666667,1467.6,1468,1471,1471,3242,3135,91.1186059584036,107,102
2015,201627,Anthony Morrow,Anthony Morrow,67,68,2176,2164,4340,459.35,461.2,920.55,928,926,926,2099,1996,96.4613970588236,103,111
2015,202083,Wesley Matthews,Wesley Matthews,78,78,5852,5956,11808,1350.46666666667,1287.18333333333,2637.65,2641,2644,2644,5650,5548,96.5481886534518,102,97
2015,202344,Trevor Booker,Trevor Booker,79,79,3709,3618,7327,856.8,788.016666666667,1644.81666666667,1631,1632,1632,3308,3207,89.1884605014829,101,65
2015,203526,Raul Neto,Raul Neto,81,81,3235,3230,6465,777.883333333333,712.583333333333,1490.46666666667,1501,1499,1499,2967,2866,91.7156105100464,101,76
2015,203999,Nikola Jokic,Nikola Jokic,80,80,4066,3868,7934,850.583333333333,873.166666666667,1723.75,1733,1733,1733,3678,3577,90.4574520413182,101,93
2015,202325,Wesley Johnson,Wesley Johnson,80,80,3861,3952,7813,830.666666666667,832.2,1662.86666666667,1664,1666,1666,3550,3451,91.9450919450919,99,121
2015,201596,Mario Chalmers,Mario Chalmers,61,61,3161,3177,6338,694.533333333333,677.216666666667,1371.75,1378,1373,1373,2889,2791,91.3951281240114,98,73
2015,203613,Jonathon Simmons,Jonathon Simmons,55,55,1828,1860,3688,418.366666666667,390.766666666667,809.133333333333,811,813,813,1769,1672,96.7724288840263,97,92
2015,201973,Jonas Jerebko,Jonas Jerebko,78,78,2819,2803,5622,576.583333333333,596.583333333333,1173.16666666667,1178,1176,1176,2516,2422,89.251507626818,94,32
2015,202323,Evan Turner,Evan Turner,81,81,5457,5430,10887,1095.78333333333,1170.85,2266.63333333333,2269,2271,2271,4882,4789,89.463074949606,93,101
2015,101112,Channing Frye,Channing Frye,70,70,2664,2658,5322,598.616666666667,594.816666666667,1193.43333333333,1196,1200,1200,2499,2408,93.8063063063063,91,102
2015,202355,Hassan Whiteside,Hassan Whiteside,73,73,4796,4802,9598,1086.08333333333,1034.95,2121.03333333333,2122,2125,2125,4384,4296,91.4095079232694,88,86
2015,203909,KJ McDaniels,K.J. McDaniels,35,37,578,587,1165,103.333333333333,129.5,232.833333333333,234,235,235,561,474,97.0588235294118,87,76
2015,200757,Thabo Sefolosha,Thabo Sefolosha,75,75,3995,4152,8147,844.266666666667,910.483333333333,1754.75,1755,1758,1758,3660,3574,91.6145181476846,86,-19
2015,203086,Meyers Leonard,Meyers Leonard,61,61,3097,3016,6113,681.05,647.783333333333,1328.83333333333,1331,1333,1333,2924,2842,94.4139489828867,82,100
2015,203081,Damian Lillard,Damian Lillard,75,75,6347,6294,12641,1353.58333333333,1320.21666666667,2673.8,2673,2676,2676,6000,5921,94.5328501654325,79,94
2015,202330,Gordon Hayward,Gordon Hayward,80,80,6461,6337,12798,1498.5,1388.13333333333,2886.63333333333,2889,2893,2893,5874,5796,90.9147190837332,78,94
2015,203145,Kent Bazemore,Kent Bazemore,75,75,4763,4982,9745,1000.25,1065.5,2065.75,2082,2083,2083,4385,4309,92.0638253201764,76,76
2015,1626181,Norman Powell,Norman Powell,49,49,1639,1618,3257,377.166666666667,342.95,720.116666666667,728,725,725,1555,1480,94.8749237339841,75,66
2015,203187,Chris Johnson,Chris Johnson,70,70,1890,1902,3792,436.516666666667,409.816666666667,846.333333333333,857,857,857,1708,1636,90.3703703703704,72,2
2015,203486,Mason Plumlee,Mason Plumlee,82,82,4845,4837,9682,1040.6,1034.85,2075.45,2087,2084,2084,4598,4527,94.9019607843137,71,37
2015,2446,Rasual Butler,Rasual Butler,46,46,933,962,1895,221.116666666667,199.333333333333,420.45,432,432,432,916,847,98.1779206859593,69,80
2015,202329,Al-Farouq Aminu,Al-Farouq Aminu,82,82,5501,5500,11001,1174.88333333333,1159.55,2334.43333333333,2342,2341,2341,5180,5111,94.1646973277586,69,62
2015,203524,Solomon Hill,Solomon Hill,58,59,2044,2039,4083,426.45,437.5,863.95,867,866,866,1862,1795,91.0958904109589,67,45
2015,202322,John Wall,John Wall,77,77,6503,6505,13008,1321.68333333333,1453.81666666667,2775.5,2783,2784,2784,6053,5987,93.0801168691373,66,100
2015,202324,Derrick Favors,Derrick Favors,62,62,4394,4274,8668,1037.75,937.883333333333,1975.63333333333,1987,1983,1983,4012,3946,91.3063268092854,66,96
2015,201960,DeMarre Carroll,DeMarre Carroll,26,26,1837,1756,3593,421.966666666667,364.116666666667,786.083333333333,787,786,786,1664,1599,90.5824714207948,65,47
2015,200751,Randy Foye,Randy Foye,81,81,3857,3814,7671,820.566666666667,815.15,1635.71666666667,1640,1642,1642,3478,3415,90.1737101374125,63,28
2015,2744,Al Jefferson,Al Jefferson,47,47,2455,2511,4966,565.216666666667,530.55,1095.76666666667,1096,1096,1096,2305,2243,93.8900203665988,62,48
2015,202326,DeMarcus Cousins,DeMarcus Cousins,65,65,5469,5453,10922,1082.78333333333,1157.36666666667,2240.15,2244,2246,2246,5066,5006,92.6311940025599,60,37
2015,2588,Matt Bonner,Matt Bonner,29,30,439,449,888,108.95,95.0833333333333,204.033333333333,206,206,206,455,397,103.644646924829,58,63
2015,203895,Jordan McRae,Jordan McRae,22,22,426,441,867,93.7166666666667,99.8833333333333,193.6,195,195,195,420,363,98.5915492957746,57,44
2015,1626245,Cristiano Felicio,Cristiano Felicio,31,31,749,721,1470,158.733333333333,160,318.733333333333,318,321,321,705,648,94.1255006675567,57,53
2015,2403,Nene,Nene Hilario,57,57,2520,2558,5078,515.383333333333,573.55,1088.93333333333,1096,1094,1094,2374,2318,94.2063492063492,56,30
2015,203077,Michael Kidd-Gilchrist,Michael Kidd-Gilchrist,7,7,474,457,931,101.35,102.666666666667,204.016666666667,205,205,205,455,399,95.9915611814346,56,58
2015,201937,Ricky Rubio,Ricky Rubio,76,76,5379,5407,10786,1143.41666666667,1171.96666666667,2315.38333333333,2321,2323,2323,5055,5002,93.9765755716676,53,16
2015,708,Kevin Garnett,Kevin Garnett,38,38,1231,1258,2489,263.316666666667,287.133333333333,550.45,558,556,556,1128,1076,91.6328188464663,52,56
2015,2736,Luol Deng,Luol Deng,74,74,5441,5434,10875,1230.56666666667,1155.96666666667,2386.53333333333,2395,2394,2394,5019,4968,92.2440727807388,51,25
2015,201162,Jared Dudley,Jared Dudley,81,81,4857,4895,9752,995.733333333333,1099.46666666667,2095.2,2098,2098,2098,4542,4492,93.514515132798,50,60
2015,2037,Jamal Crawford,Jamal Crawford,79,79,4867,4983,9850,1068.25,1051.83333333333,2120.08333333333,2126,2126,2126,4541,4492,93.3018286418738,49,168
2015,202389,Timofey Mozgov,Timofey Mozgov,76,76,2944,2939,5883,669.366666666667,647.766666666667,1317.13333333333,1328,1326,1326,2736,2687,92.9347826086957,49,2
2015,1626196,Josh Richardson,Josh Richardson,52,52,2482,2499,4981,563.983333333333,537.566666666667,1101.55,1105,1107,1107,2289,2242,92.2240128928284,47,39
2015,203481,Jeff Withey,Jeff Withey,51,51,1431,1427,2858,337.1,316.633333333333,653.733333333333,657,658,658,1286,1243,89.8672257162823,43,57
2015,1626257,Salah Mejri,Salah Mejri,33,34,883,912,1795,201.9,192.033333333333,393.933333333333,397,397,397,852,809,96.4892412231031,43,43
2015,201150,Spencer Hawes,Spencer Hawes,57,57,2350,2378,4728,527.466666666667,509.15,1036.61666666667,1032,1035,1035,2132,2090,90.7234042553192,42,44
2015,201952,Jeff Teague,Jeff Teague,79,79,5203,5406,10609,1094.65,1147.58333333333,2242.23333333333,2257,2255,2255,4777,4735,91.8124159138958,42,70
2015,2571,Leandro Barbosa,Leandro Barbosa,68,68,2585,2588,5173,522.5,555.033333333333,1077.53333333333,1079,1079,1079,2427,2387,93.8878143133462,40,42
2015,203934,Lamar Patterson,Lamar Patterson,35,35,939,925,1864,199.083333333333,201.1,400.183333333333,394,395,395,893,854,95.1011714589989,39,31
2015,1626246,Boban Marjanovic,Boban Marjanovic,54,54,1145,1124,2269,265.016666666667,238.066666666667,503.083333333333,508,508,508,1076,1037,93.9737991266376,39,54
2015,202700,Donatas Motiejunas,Donatas Motiejunas,37,37,1278,1310,2588,258.65,283.683333333333,542.333333333333,547,547,547,1201,1163,93.9749608763693,38,46
2015,203094,Andrew Nicholson,Andrew Nicholson,56,56,1860,1879,3739,415.116666666667,406.016666666667,821.133333333333,821,823,823,1674,1636,90,38,34
2015,203490,Otto Porter Jr.,Otto Porter,75,75,5332,5307,10639,1066.03333333333,1197.26666666667,2263.3,2272,2276,2276,4939,4901,92.629407351838,38,45
2015,101187,Alan Anderson,Alan Anderson,13,13,453,440,893,91.4333333333333,101.416666666667,192.85,193,192,192,427,390,94.2604856512141,37,30
2015,201144,Mike Conley,Mike Conley,56,56,3901,3910,7811,907.433333333333,844.866666666667,1752.3,1754,1761,1761,3625,3590,92.924891053576,35,68
2015,203463,Ben McLemore,Ben McLemore,68,68,3540,3504,7044,688.1,744.666666666667,1432.76666666667,1444,1443,1443,3269,3234,92.3446327683616,35,22
2015,202334,Ed Davis,Ed Davis,81,81,3959,3907,7866,865.433333333333,821.416666666667,1686.85,1684,1684,1684,3589,3555,90.6542056074766,34,20
2015,203459,Allen Crabbe,Allen Crabbe,81,81,4991,4952,9943,1069.56666666667,1032.23333333333,2101.8,2111,2105,2105,4639,4605,92.9473051492687,34,42
2015,1626149,Montrezl Harrell,Montrezl Harrell,39,39,915,924,1839,172.816666666667,201.866666666667,374.683333333333,378,379,379,860,827,93.9890710382514,33,37
2015,201945,Gerald Henderson,Gerald Henderson,72,72,3355,3331,6686,734.083333333333,698.066666666667,1432.15,1434,1431,1431,3090,3058,92.1013412816692,32,20
2015,201950,Jrue Holiday,Jrue Holiday,65,65,4302,4191,8493,869.983333333333,954.866666666667,1824.85,1829,1831,1831,4023,3991,93.5146443514645,32,28
2015,201956,Omri Casspi,Omri Casspi,69,69,4579,4593,9172,907.966666666667,973.033333333333,1881,1883,1880,1880,4238,4206,92.552959161389,32,8
2015,2555,Nick Collison,Nick Collison,59,59,1656,1598,3254,349.316666666667,347.016666666667,696.333333333333,700,699,699,1457,1426,87.9830917874396,31,25
2015,2772,Trevor Ariza,Trevor Ariza,81,81,6780,6733,13513,1369.28333333333,1482.73333333333,2852.01666666667,2860,2859,2859,6341,6310,93.5250737463127,31,41
2015,1889,Andre Miller,Andre Miller,39,39,993,1009,2002,233.283333333333,227.016666666667,460.3,461,461,461,971,941,97.7844914400806,30,32
2015,101114,Deron Williams,Deron Williams,65,65,4691,4796,9487,1070.91666666667,1031.1,2102.01666666667,2107,2106,2106,4395,4366,93.6900447665743,29,-2
2015,203512,Lucas Nogueira,Lucas Nogueira,29,29,514,522,1036,114.45,109.516666666667,223.966666666667,227,225,225,507,479,98.6381322957198,28,24
2015,2760,Anderson Varejao,Anderson Varejao,53,53,1182,1145,2327,253.716666666667,242.5,496.216666666667,494,496,496,1061,1035,89.7631133671743,26,24
2015,203492,Ray McCallum,Ray McCallum,40,41,1089,1060,2149,245,225.45,470.45,473,475,475,993,967,91.1845730027548,26,21
2015,1718,Paul Pierce,Paul Pierce,68,68,2708,2835,5543,609.466666666667,610.816666666667,1220.28333333333,1235,1231,1231,2585,2560,95.4579025110783,25,55
2015,2730,Dwight Howard,Dwight Howard,71,71,5391,5321,10712,1091.55,1179.45,2271,2281,2280,2280,4945,4922,91.726952327954,23,18
2015,101123,Gerald Green,Gerald Green,69,69,3475,3504,6979,783.783333333333,769.333333333333,1553.11666666667,1557,1557,1557,3197,3175,92,22,43
2015,201977,Marcus Thornton,Marcus Thornton,61,61,2681,2662,5343,537.066666666667,568.7,1105.76666666667,1110,1109,1109,2460,2438,91.7568071615069,22,43
2015,1626153,Delon Wright,Delon Wright,27,27,517,516,1033,122.433333333333,107.733333333333,230.166666666667,230,229,229,485,463,93.8104448742747,22,13
2015,202407,Elijah Millsap,Elijah Millsap,20,20,401,395,796,88.5166666666667,84.75,173.266666666667,173,173,173,360,339,89.7755610972569,21,21
2015,201941,Jordan Hill,Jordan Hill,73,73,3493,3500,6993,768.7,746.483333333333,1515.18333333333,1509,1513,1513,3134,3114,89.7223017463499,20,52
2015,1626147,Justin Anderson,Justin Anderson,55,55,1488,1495,2983,327.55,316.383333333333,643.933333333333,644,647,647,1345,1325,90.3897849462366,20,7
2015,1626273,Marcelo Huertas,Marcelo Huertas,53,53,1984,1959,3943,429.433333333333,437.2,866.633333333333,866,869,869,1784,1764,89.9193548387097,20,17
2015,203912,CJ Wilcox,C.J. Wilcox,23,23,361,398,759,82.65,81.5,164.15,167,167,167,358,339,99.1689750692521,19,22
2015,2547,Chris Bosh,Chris Bosh,53,53,3882,3964,7846,898.283333333333,874.616666666667,1772.9,1778,1778,1778,3550,3533,91.4477073673364,17,29
2015,2550,Kirk Hinrich,Kirk Hinrich,46,46,1452,1459,2911,315.566666666667,315.516666666667,631.083333333333,630,631,631,1277,1260,87.9476584022039,17,14
2015,202699,Tobias Harris,Tobias Harris,76,76,5773,5650,11423,1254.6,1248.08333333333,2502.68333333333,2515,2513,2513,5233,5217,90.6461112073445,16,18
2015,203090,Maurice Harkless,Maurice Harkless,78,78,3455,3452,6907,737.7,715.366666666667,1453.06666666667,1454,1457,1457,3182,3166,92.0984081041968,16,30
2015,202703,Nikola Mirotic,Nikola Mirotic,66,66,3792,3837,7629,813.533333333333,824.75,1638.28333333333,1650,1646,1646,3522,3507,92.879746835443,15,41
2015,203951,Keith Appling,Keith Appling,5,5,60,55,115,12.7166666666667,13.4666666666667,26.1833333333333,27,27,27,56,42,93.3333333333333,14,14
2015,204028,Tarik Black,Tarik Black,39,39,1142,1115,2257,240.633333333333,254.216666666667,494.85,495,496,496,1030,1016,90.1926444833625,14,20
2015,204001,Kristaps Porzingis,Kristaps Porzingis,72,72,4591,4600,9191,1037.83333333333,992.133333333333,2029.96666666667,2047,2047,2047,4207,4194,91.6358091918972,13,13
2015,202718,Chandler Parsons,Chandler Parsons,61,61,3946,4094,8040,909.066666666667,882.216666666667,1791.28333333333,1801,1799,1799,3749,3738,95.0076026355803,11,3
2015,101162,Marcin Gortat,Marcin Gortat,75,75,5279,5272,10551,1066.05,1189.65,2255.7,2255,2256,2256,4867,4857,92.1954915703732,10,64
2015,201975,Jodie Meeks,Jodie Meeks,3,3,93,92,185,20.2166666666667,22.2,42.4166666666667,44,43,43,86,76,92.4731182795699,10,9
2015,202726,Andrew Goudelock,Andrew Goudelock,7,8,122,143,265,20.1333333333333,28.65,48.7833333333333,51,50,50,114,105,93.4426229508197,9,10
2015,2405,Amar'e Stoudemire,Amar'e Stoudemire,52,52,1680,1704,3384,391.6,365.3,756.9,765,762,762,1561,1553,92.9166666666667,8,9
2015,201578,Marreese Speights,Marreese Speights,72,72,1932,1986,3918,403.85,423.783333333333,827.633333333333,836,832,832,1814,1806,93.8923395445135,8,11
2015,1626210,Alan Williams,Alan Williams,10,10,191,167,358,32.5833333333333,34.65,67.2333333333334,67,68,68,175,167,91.6230366492147,8,1
2015,202066,Garrett Temple,Garrett Temple,79,80,4498,4549,9047,918.433333333333,1024.13333333333,1942.56666666667,1950,1951,1951,4112,4105,91.418408181414,7,-37
2015,203921,Cleanthony Early,Cleanthony Early,16,17,344,351,695,74.7666666666667,77.35,152.116666666667,152,154,154,295,288,85.7558139534884,7,0
2015,203950,Jarnell Stokes,Jarnell Stokes,7,7,41,38,79,8.81666666666667,8.51666666666667,17.3333333333333,18,18,18,38,31,92.6829268292683,7,9
2015,1626175,Jordan Mickey,Jordan Mickey,16,16,135,129,264,27.5333333333333,27.1833333333333,54.7166666666667,58,57,57,111,105,82.2222222222222,6,6
2015,1626199,Darrun Hilliard,Darrun Hilliard,38,38,873,865,1738,186.566666666667,193.633333333333,380.2,385,383,383,793,787,90.836197021764,6,-3
2015,201149,Joakim Noah,Joakim Noah,29,29,1514,1480,2994,312.616666666667,323.65,636.266666666667,636,635,635,1299,1294,85.7992073976222,5,-34
2015,203268,Jorge Gutierrez,Jorge Gutierrez,12,12,145,154,299,30.15,31.4333333333333,61.5833333333333,64,63,63,148,143,102.068965517241,5,8
2015,204020,Tyler Johnson,Tyler Johnson,36,36,1908,1931,3839,438.066666666667,423.8,861.866666666667,862,863,863,1696,1691,88.8888888888889,5,9
2015,201188,Marc Gasol,Marc Gasol,52,52,3993,3975,7968,930.566666666667,857.583333333333,1788.15,1792,1791,1791,3616,3612,90.5584773353369,4,11
2015,203919,Jordan Adams,Jordan Adams,2,2,38,34,72,7.41666666666667,7.21666666666667,14.6333333333333,15,15,15,34,30,89.4736842105263,4,4
2015,1626262,Coty Clarke,Coty Clarke,3,3,14,12,26,3.23333333333333,2.53333333333333,5.76666666666667,6,6,6,18,14,128.571428571429,4,4
2015,200779,Steve Novak,Steve Novak,10,10,106,116,222,21.6,22.5333333333333,44.1333333333333,43,44,44,107,104,100.943396226415,3,7
2015,201943,Brandon Jennings,Brandon Jennings,48,48,2049,2022,4071,427.216666666667,441.116666666667,868.333333333333,869,868,868,1875,1872,91.5080527086384,3,12
2015,2563,Dahntay Jones,Dahntay Jones,1,1,92,88,180,21.9666666666667,20.1166666666667,42.0833333333333,42,42,42,88,86,95.6521739130435,2,-1
2015,201177,Josh McRoberts,Josh McRoberts,42,42,1306,1333,2639,297.45,292.616666666667,590.066666666667,596,595,595,1211,1209,92.7258805513017,2,5
2015,202332,Cole Aldrich,Cole Aldrich,60,60,1761,1860,3621,401.95,394.566666666667,796.516666666667,800,800,800,1600,1598,90.8574673480977,2,-26
2015,203527,Ryan Kelly,Ryan Kelly,36,36,1115,1113,2228,226.466666666667,242.2,468.666666666667,469,470,470,976,974,87.5336322869955,2,-2
2015,1626155,Sam Dekker,Sam Dekker,3,3,17,17,34,2.58333333333334,3.41666666666667,6,6,6,6,21,19,123.529411764706,2,-2
2015,203508,Sergey Karasev,Sergey Karasev,40,40,930,938,1868,198.483333333333,199.633333333333,398.116666666667,405,399,399,886,885,95.2688172043011,1,-6
2015,202710,Jimmy Butler,Jimmy Butler,67,67,5736,5773,11509,1244.68333333333,1229.08333333333,2473.76666666667,2473,2474,2474,5184,5184,90.3765690376569,0,-12
2015,203123,Kostas Papanikolaou,Kostas Papanikolaou,26,26,648,654,1302,143.616666666667,147.7,291.316666666667,294,294,294,576,576,88.8888888888889,0,-10
2015,101236,Chuck Hayes,Chuck Hayes,2,2,54,62,116,11.6333333333333,12.5333333333333,24.1666666666667,24,24,24,45,46,83.3333333333333,-1,-3
2015,203475,Erick Green,Erick Green,9,9,91,87,178,22.2666666666667,18.6333333333333,40.9,42,42,42,91,92,100,-1,-1
2015,203961,Eric Moreland,Eric Moreland,8,8,112,123,235,22.1166666666667,25.7,47.8166666666667,46,48,48,110,111,98.2142857142857,-1,7
2015,203962,Josh Huestis,Josh Huestis,5,5,132,129,261,26.8,28.5166666666667,55.3166666666667,55,55,55,122,123,92.4242424242424,-1,2
2015,202343,Elliot Williams,Elliot Williams,5,5,99,99,198,21.8,23.3666666666667,45.1666666666667,45,45,45,90,92,90.9090909090909,-2,-3
2015,201583,Ryan Anderson,Ryan Anderson,66,66,4767,4652,9419,980.566666666667,1031.3,2011.86666666667,2011,2008,2008,4439,4443,93.1193622823579,-4,31
2015,1627293,Alex Stepheson,Alex Stepheson,8,8,194,170,364,40.1,32.25,72.35,72,73,73,141,145,72.680412371134,-4,-2
2015,201155,Rodney Stuckey,Rodney Stuckey,58,58,2907,2962,5869,630.066666666667,649.533333333333,1279.6,1274,1275,1275,2623,2628,90.2304781561748,-5,10
2015,201619,Sasha Kaun,Sasha Kaun,23,25,217,224,441,48.9,44.5166666666667,93.4166666666667,94,95,95,183,188,84.331797235023,-5,-4
2015,203648,Thanasis Antetokounmpo,Thanasis Antetokounmpo,2,2,15,18,33,2.8,3.21666666666667,6.01666666666667,6,6,6,15,20,100,-5,-6
2015,203998,Bruno Caboclo,Bruno Caboclo,6,6,103,99,202,23.5666666666667,19.0666666666667,42.6333333333333,43,43,43,82,87,79.6116504854369,-5,-8
2015,1626151,Aaron Harrison,Aaron Harrison,21,21,212,230,442,44.3833333333333,46.3833333333333,90.7666666666667,96,93,93,201,206,94.811320754717,-5,-7
2015,201936,Tyreke Evans,Tyreke Evans,25,25,1731,1707,3438,376.55,386.65,763.2,764,765,765,1586,1592,91.6233391103408,-6,-14
2015,201949,James Johnson,James Johnson,57,57,2083,2066,4149,476.716666666667,451.133333333333,927.85,924,926,926,1914,1920,91.8867018722996,-6,8
2015,203994,Jusuf Nurkic,Jusuf Nurkic,32,32,1299,1257,2556,271.066666666667,273.566666666667,544.633333333333,547,547,547,1168,1174,89.9153194765204,-6,-7
2015,204002,Edy Tavares,Edy Tavares,11,11,199,197,396,40.8833333333333,42.5666666666667,83.45,72,73,73,194,200,97.4874371859297,-6,-10
2015,1626266,JJ O'Brien,J.J. O'Brien,2,2,12,16,28,2.98333333333333,3.11666666666667,6.1,6,6,6,12,18,100,-6,-8
2015,201166,Aaron Brooks,Aaron Brooks,69,69,2569,2551,5120,553.316666666667,554.733333333333,1108.05,1110,1108,1108,2317,2324,90.1907356948229,-7,-13
2015,1737,Nazr Mohammed,Nazr Mohammed,5,5,42,45,87,9.2,9.18333333333334,18.3833333333333,20,19,19,31,39,73.8095238095238,-8,-3
2015,203963,Shayne Whittington,Shayne Whittington,7,7,93,91,184,20.4833333333333,20.2333333333333,40.7166666666667,41,41,41,70,78,75.2688172043011,-8,-6
2015,2585,Zaza Pachulia,Zaza Pachulia,76,76,4417,4463,8880,1023.4,973.933333333333,1997.33333333333,2005,2004,2004,4080,4089,92.3703871405932,-9,-7
2015,203946,Cameron Bairstow,Cameron Bairstow,18,18,246,244,490,48.3666666666667,54.1,102.466666666667,103,103,103,205,214,83.3333333333333,-9,-8
2015,1626251,Duje Dukan,Duje Dukan,1,1,63,60,123,13.9,10.45,24.35,24,24,24,45,54,71.4285714285714,-9,-8
2015,201575,Brandon Rush,Brandon Rush,72,72,2448,2558,5006,499.75,546.516666666667,1046.26666666667,1050,1055,1055,2413,2423,98.5702614379085,-10,-31
2015,203078,Bradley Beal,Bradley Beal,55,55,4048,4000,8048,816.266666666667,887.65,1703.91666666667,1709,1708,1708,3740,3750,92.3913043478261,-10,-24
2015,1626176,Rakeem Christmas,Rakeem Christmas,1,1,13,13,26,3.05,2.8,5.85,6,6,6,14,24,107.692307692308,-10,-10
2015,202353,Tibor Pleiss,Tibor Pleiss,12,12,178,190,368,42.1833333333333,41.8666666666667,84.05,81,82,82,164,176,92.1348314606742,-12,-15
2015,202692,Alec Burks,Alec Burks,31,31,1823,1780,3603,412.216666666667,385.2,797.416666666667,798,797,797,1612,1624,88.4256719692814,-12,-13
2015,203461,Anthony Bennett,Anthony Bennett,19,19,211,188,399,44.2333333333333,39.9,84.1333333333333,85,84,84,185,197,87.6777251184834,-12,-30
2015,1626146,Cliff Alexander,Cliff Alexander,8,8,76,84,160,17.3,17.4333333333333,34.7333333333333,36,36,36,67,80,88.1578947368421,-13,-13
2015,1626253,Axel Toupane,Axel Toupane,21,21,685,694,1379,149.466666666667,153.45,302.916666666667,307,305,305,661,674,96.4963503649635,-13,-17
2015,203928,Cory Jefferson,Cory Jefferson,6,8,118,126,244,25.2333333333333,24.9166666666667,50.15,50,50,50,104,118,88.135593220339,-14,-6
2015,204014,Damjan Rudez,Damjan Rudez,33,33,650,646,1296,134.05,142.083333333333,276.133333333333,278,277,277,598,612,92,-14,-11
2015,1626183,Branden Dawson,Branden Dawson,6,6,58,68,126,14.6666666666667,13.1833333333333,27.85,28,29,29,56,70,96.551724137931,-14,-15
2015,201574,Jason Thompson,Jason Thompson,47,47,1073,1101,2174,246.216666666667,222.7,468.916666666667,471,471,471,1002,1017,93.3830382106244,-15,-7
2015,2548,Dwyane Wade,Dwyane Wade,74,74,5070,5127,10197,1157.98333333333,1089.38333333333,2247.36666666667,2258,2258,2258,4695,4711,92.603550295858,-16,-8
2015,2617,Udonis Haslem,Udonis Haslem,37,37,542,580,1122,132.566666666667,126.266666666667,258.833333333333,259,260,260,508,525,93.7269372693727,-17,-17
2015,101139,CJ Miles,C.J. Miles,64,64,3448,3513,6961,723.683333333333,738.933333333333,1462.61666666667,1467,1464,1464,3150,3167,91.3573085846868,-17,3
2015,201202,Joel Anthony,Joel Anthony,18,19,214,205,419,47.5833333333333,46.2,93.7833333333333,95,96,96,174,191,81.3084112149533,-17,-17
2015,1626192,Pat Connaughton,Pat Connaughton,33,34,328,337,665,72.4,64.1,136.5,145,143,143,266,283,81.0975609756098,-17,-13
2015,202498,Lance Thomas,Lance Thomas,59,59,2988,3081,6069,675.583333333333,652.45,1328.03333333333,1314,1313,1313,2766,2784,92.570281124498,-18,-42
2015,202713,Kyle Singler,Kyle Singler,67,68,2395,2326,4721,494.733333333333,479.066666666667,973.8,982,977,977,2106,2124,87.9331941544885,-18,-22
2015,203906,Devyn Marble,Devyn Marble,28,28,590,591,1181,121.1,126.2,247.3,249,249,249,508,526,86.1016949152542,-18,-13
2015,101126,Nate Robinson,Nate Robinson,2,2,55,58,113,11.9333333333333,11.05,22.9833333333333,23,23,23,38,58,69.0909090909091,-20,-20
2015,203506,Victor Oladipo,Victor Oladipo,72,72,5527,5590,11117,1176,1199.38333333333,2375.38333333333,2382,2379,2379,5090,5110,92.0933598697304,-20,-22
2015,1626154,RJ Hunter,R.J. Hunter,36,36,743,734,1477,153.283333333333,159,312.283333333333,319,315,315,604,624,81.2920592193809,-20,-28
2015,1626172,Kevon Looney,Kevon Looney,5,5,56,52,108,11.5,8.85,20.35,21,21,21,49,69,87.5,-20,-22
2015,1891,Jason Terry,Jason Terry,72,72,2992,2979,5971,592.166666666667,659.566666666667,1251.73333333333,1258,1258,1258,2766,2787,92.4465240641711,-21,32
2015,203552,Seth Curry,Seth Curry,44,44,1657,1648,3305,333.316666666667,355.233333333333,688.55,694,692,692,1535,1556,92.6372963186482,-21,-36
2015,202734,E'Twaun Moore,E'Twaun Moore,59,59,2907,2973,5880,626.583333333333,632.8,1259.38333333333,1265,1263,1263,2676,2698,92.0536635706914,-22,-37
2015,203114,Khris Middleton,Khris Middleton,79,79,6558,6643,13201,1403.36666666667,1442.48333333333,2845.85,2855,2852,2852,6045,6067,92.1774931381519,-22,-31
2015,203923,James Young,James Young,29,29,460,466,926,94,103.85,197.85,199,199,199,420,442,91.304347826087,-22,-27
2015,201571,D.J. Augustin,D.J. Augustin,62,62,2750,2734,5484,600.233333333333,573.166666666667,1173.4,1182,1178,1178,2518,2541,91.5636363636364,-23,-31
2015,202379,Jeremy Evans,Jeremy Evans,29,30,583,600,1183,127.616666666667,121.3,248.916666666667,248,251,251,519,542,89.0222984562607,-23,-40
2015,202690,Jimmer Fredette,Jimmer Fredette,6,6,40,39,79,9.55,7.76666666666667,17.3166666666667,17,18,18,19,42,47.5,-23,-25
2015,201229,Anthony Tolliver,Anthony Tolliver,72,72,3109,2996,6105,672.916666666667,664.516666666667,1337.43333333333,1338,1341,1341,2741,2765,88.1633965905436,-24,14
2015,203925,Joe Harris,Joe Harris,5,5,35,41,76,8.1,6.7,14.8,15,15,15,30,54,85.7142857142857,-24,-21
2015,204060,Joe Ingles,Joe Ingles,81,81,2794,2739,5533,648.15,592.783333333333,1240.93333333333,1239,1241,1241,2456,2480,87.9026485325698,-24,2
2015,203955,Bryce Cotton,Bryce Cotton,8,8,86,93,179,18.7666666666667,19.25,38.0166666666667,39,39,39,80,105,93.0232558139535,-25,-24
2015,1626185,Jarell Martin,Jarell Martin,27,27,934,862,1796,196.65,185.883333333333,382.533333333333,382,380,380,794,819,85.0107066381156,-25,-39
2015,204098,Xavier Munford,Xavier Munford,14,14,594,546,1140,125.716666666667,122.283333333333,248,246,244,244,518,545,87.2053872053872,-27,-25
2015,203485,Lorenzo Brown,Lorenzo Brown,8,8,141,133,274,30.7166666666667,29.0666666666667,59.7833333333334,60,61,61,116,144,82.2695035460993,-28,-30
2015,204025,Tim Frazier,Tim Frazier,49,51,1714,1701,3415,365.1,372.783333333333,737.883333333333,742,741,741,1562,1590,91.1318553092182,-28,-31
2015,2754,Tony Allen,Tony Allen,64,64,3685,3610,7295,826.216666666667,784.55,1610.76666666667,1622,1620,1620,3267,3296,88.6567164179104,-29,-89
2015,203893,Russ Smith,Russ Smith,15,15,155,162,317,32.4166666666667,33.15,65.5666666666667,64,66,66,137,166,88.3870967741936,-29,-41
2015,2756,Sasha Vujacic,Sasha Vujacic,61,61,2109,2079,4188,465.333333333333,441.866666666667,907.2,908,908,908,1874,1904,88.8572783309625,-30,-42
2015,201978,Chase Budinger,Chase Budinger,66,66,2209,2154,4363,457.983333333333,464.816666666667,922.8,930,929,929,1952,1982,88.3657763693979,-30,1
2015,2549,Chris Kaman,Chris Kaman,16,16,250,249,499,57.4666666666667,53.2333333333333,110.7,113,112,112,211,242,84.4,-31,-31
2015,203473,Dewayne Dedmon,Dewayne Dedmon,58,58,1636,1650,3286,334.95,366.25,701.2,709,705,705,1458,1490,89.119804400978,-32,-36
2015,203922,Glenn Robinson III,Glenn Robinson III,45,45,1181,1159,2340,262.433333333333,243.3,505.733333333333,511,508,508,1017,1049,86.1134631668078,-32,-37
2015,2592,James Jones,James Jones,47,48,1038,1053,2091,235.3,227.733333333333,463.033333333333,465,463,463,900,933,86.7052023121387,-33,-21
2015,202712,Justin Harper,Justin Harper,4,5,74,69,143,16.5833333333333,17.0666666666667,33.65,35,35,35,55,88,74.3243243243243,-33,-32
2015,203111,Orlando Johnson,Orlando Johnson,7,7,254,236,490,52.75,49.4166666666667,102.166666666667,102,101,101,206,239,81.1023622047244,-33,-37
2015,2546,Carmelo Anthony,Carmelo Anthony,72,72,5736,5758,11494,1298.33333333333,1229.45,2527.78333333333,2529,2530,2530,5293,5327,92.2768479776848,-34,-43
2015,203996,Damien Inglis,Damien Inglis,20,20,344,372,716,74.9166666666667,81.2333333333333,156.15,159,156,156,280,314,81.3953488372093,-34,-44
2015,1626214,Bryce Dejean-Jones,Bryce Dejean-Jones,14,14,652,616,1268,133.183333333333,143.316666666667,276.5,280,279,279,563,597,86.3496932515337,-34,-39
2015,1882,Elton Brand,Elton Brand,17,17,515,546,1061,113.666666666667,111.583333333333,225.25,225,225,225,433,468,84.0776699029126,-35,-39
2015,202339,Eric Bledsoe,Eric Bledsoe,31,31,2532,2541,5073,517.733333333333,539.233333333333,1056.96666666667,1058,1059,1059,2293,2328,90.5608214849921,-35,-49
2015,1626166,Cameron Payne,Cameron Payne,57,57,1655,1619,3274,350.8,341.833333333333,692.633333333333,702,698,698,1493,1528,90.2114803625378,-35,-28
2015,203099,Jared Cunningham,Jared Cunningham,41,44,918,940,1858,203.116666666667,205.9,409.016666666667,410,410,410,828,864,90.1960784313726,-36,-43
2015,203210,JaMychal Green,JaMychal Green,78,78,3401,3272,6673,720.866666666667,715.15,1436.01666666667,1443,1446,1446,3032,3068,89.1502499264922,-36,-44
2015,1626148,Anthony Brown,Anthony Brown,29,29,1396,1349,2745,305.483333333333,292.133333333333,597.616666666667,596,599,599,1208,1244,86.5329512893983,-36,-33
2015,1626202,Joe Young,Joe Young,40,41,916,891,1807,195.166666666667,188.016666666667,383.183333333333,384,384,384,786,822,85.8078602620087,-36,-33
2015,2406,Caron Butler,Caron Butler,17,17,423,422,845,89.8333333333333,86.95,176.783333333333,176,176,176,357,394,84.3971631205674,-37,-41
2015,201160,Jason Smith,Jason Smith,76,76,2691,2706,5397,587.6,590.283333333333,1177.88333333333,1180,1181,1181,2473,2511,91.8989223337049,-38,-35
2015,203516,James Ennis III,James Ennis,21,22,757,740,1497,163.483333333333,160,323.483333333333,328,329,329,695,733,91.8097754293263,-38,-45
2015,1626163,Frank Kaminsky,Frank Kaminsky,81,81,3890,3904,7794,861.316666666667,842.1,1703.41666666667,1713,1708,1708,3503,3541,90.0514138817481,-38,-19
2015,201971,DeJuan Blair,DeJuan Blair,29,29,532,524,1056,105.916666666667,110.8,216.716666666667,216,218,218,468,507,87.9699248120301,-39,-39
2015,203092,Tyler Zeller,Tyler Zeller,60,60,1729,1743,3472,342.666666666667,371.25,713.916666666667,714,710,710,1499,1539,86.6975130133025,-40,-65
2015,203476,Gorgui Dieng,Gorgui Dieng,82,82,5054,5139,10193,1107.83333333333,1108,2215.83333333333,2222,2220,2220,4748,4788,93.9453897902651,-40,-7
2015,1626242,Luis Montero,Luis Montero,11,12,90,90,180,21.75,17.6333333333333,39.3833333333333,42,42,42,54,94,60,-40,-39
2015,200811,Lou Amundson,Lou Amundson,29,29,474,470,944,100.95,103.6,204.55,202,204,204,373,414,78.6919831223629,-41,-47
2015,1626162,Kelly Oubre Jr.,Kelly Oubre,62,63,1603,1617,3220,326.3,341.533333333333,667.833333333333,671,671,671,1449,1490,90.3930131004367,-41,-46
2015,201946,Tyler Hansbrough,Tyler Hansbrough,44,44,790,795,1585,172.916666666667,166.933333333333,339.85,346,343,343,721,763,91.2658227848101,-42,-33
2015,203894,Shabazz Napier,Shabazz Napier,55,55,1358,1351,2709,294.75,302.15,596.9,598,600,600,1209,1251,89.0279823269514,-42,-51
2015,2210,Richard Jefferson,Richard Jefferson,74,74,2944,2948,5892,671.35,647.116666666667,1318.46666666667,1326,1326,1326,2649,2692,89.9796195652174,-43,-45
2015,203135,Robert Sacre,Robert Sacre,25,25,773,743,1516,162.633333333333,158.316666666667,320.95,320,320,320,654,697,84.6054333764554,-43,-35
2015,203939,Dwight Powell,Dwight Powell,68,69,2266,2309,4575,505.083333333333,483.4,988.483333333333,996,992,992,2016,2059,88.9673433362754,-43,-80
2015,203943,Noah Vonleh,Noah Vonleh,78,78,2696,2660,5356,587.5,573.4,1160.9,1173,1174,1174,2415,2458,89.5771513353116,-43,-60
2015,1626174,Christian Wood,Christian Wood,17,17,346,362,708,72.1166666666667,70.7333333333333,142.85,145,145,145,304,347,87.8612716763006,-43,-49
2015,1626178,Rondae Hollis-Jefferson,Rondae Hollis-Jefferson,29,29,1457,1426,2883,308.116666666667,306.433333333333,614.55,614,615,615,1248,1291,85.6554564172958,-43,-61
2015,1626179,Terry Rozier,Terry Rozier,38,39,753,747,1500,154.9,153.6,308.5,309,311,311,618,661,82.0717131474104,-43,-46
2015,101109,Raymond Felton,Raymond Felton,80,80,4928,5054,9982,1131.98333333333,1059.46666666667,2191.45,2190,2192,2192,4618,4662,93.7094155844156,-44,-67
2015,201145,Jeff Green,Jeff Green,80,80,5013,5129,10142,1141.83333333333,1106.68333333333,2248.51666666667,2257,2253,2253,4630,4676,92.359864352683,-46,-41
2015,201582,Alexis Ajinca,Alexis Ajinca,59,59,1982,1963,3945,416.25,438.85,855.1,862,861,861,1752,1798,88.3955600403633,-46,-66
2015,203200,Justin Holiday,Justin Holiday,53,53,1819,1844,3663,381.533333333333,403.416666666667,784.95,769,773,773,1661,1707,91.3139087410665,-46,-89
2015,203515,Phil Pressey,Phil Pressey,23,23,704,702,1406,139.9,142.016666666667,281.916666666667,287,283,283,605,651,85.9375,-46,-39
2015,201564,O.J. Mayo,O.J. Mayo,41,41,2481,2534,5015,528.3,555.65,1083.95,1088,1090,1090,2218,2266,89.3994357114067,-48,-56
2015,201965,Jeff Ayres,Jeff Ayres,17,17,225,264,489,52.85,52.2333333333333,105.083333333333,105,107,107,211,259,93.7777777777778,-48,-46
2015,204067,Jarell Eddie,Jarell Eddie,25,26,352,355,707,72.05,72.25,144.3,146,147,147,292,340,82.9545454545455,-48,-33
2015,203143,Pablo Prigioni,Pablo Prigioni,59,59,1823,1902,3725,415.883333333333,401.516666666667,817.4,815,823,823,1613,1662,88.4805266044981,-49,-67
2015,2590,Mo Williams,Mo Williams,41,41,1698,1671,3369,385.666666666667,358.883333333333,744.55,748,748,748,1471,1521,86.6313309776207,-50,-50
2015,2757,Beno Udrih,Beno Udrih,44,44,1541,1568,3109,356.9,347.85,704.75,708,707,707,1390,1440,90.2011680726801,-50,-20
2015,201228,C.J. Watson,C.J. Watson,33,33,1534,1585,3119,318.733333333333,339,657.733333333333,655,656,656,1446,1497,94.2633637548892,-51,-47
2015,201580,JaVale McGee,JaVale McGee,34,34,836,848,1684,187.85,179.75,367.6,368,370,370,718,769,85.8851674641148,-51,-54
2015,203124,Kyle O'Quinn,Kyle O'Quinn,65,65,1764,1812,3576,395.966666666667,381.716666666667,777.683333333333,760,764,764,1580,1631,89.5691609977324,-51,-59
2015,202337,Luke Babbitt,Luke Babbitt,47,47,1985,1967,3952,410.266666666667,430.7,840.966666666667,846,845,845,1864,1916,93.904282115869,-52,-26
2015,203504,Trey Burke,Trey Burke,64,64,3100,3035,6135,710.35,659.45,1369.8,1361,1366,1366,2715,2767,87.5806451612903,-52,0
2015,203915,Spencer Dinwiddie,Spencer Dinwiddie,12,12,362,351,713,80.7,77.5333333333333,158.233333333333,159,159,159,261,313,72.0994475138122,-52,-56
2015,203956,Mitch McGary,Mitch McGary,20,20,172,185,357,36.6,34,70.6,72,72,72,144,196,83.7209302325582,-52,-51
2015,2449,Luis Scola,Luis Scola,76,76,3684,3614,7298,858.066666666667,772.6,1630.66666666667,1635,1636,1636,3380,3433,91.7480998914224,-53,-28
2015,201147,Corey Brewer,Corey Brewer,82,82,4056,4085,8141,797.45,874.783333333333,1672.23333333333,1670,1669,1669,3643,3697,89.8175542406312,-54,-87
2015,202362,Lance Stephenson,Lance Stephenson,69,69,3200,3175,6375,691,677.566666666667,1368.56666666667,1371,1372,1372,2892,2946,90.375,-54,-64
2015,1626209,Mario Hezonja,Mario Hezonja,79,79,3250,3236,6486,699.75,707.65,1407.4,1412,1413,1413,2959,3013,91.0461538461538,-54,0
2015,202341,James Anderson,James Anderson,51,51,1755,1811,3566,352.1,366.733333333333,718.833333333333,719,721,721,1578,1634,89.9145299145299,-56,-82
2015,101179,Ronnie Price,Ronnie Price,62,62,2910,2829,5739,601.35,610.15,1211.5,1210,1211,1211,2490,2547,85.5670103092784,-57,-75
2015,201148,Brandan Wright,Brandan Wright,12,12,479,495,974,108.016666666667,104.8,212.816666666667,213,212,212,427,484,89.1440501043841,-57,-56
2015,201593,Nikola Pekovic,Nikola Pekovic,12,12,338,341,679,79.15,76.6166666666667,155.766666666667,156,156,156,287,344,84.9112426035503,-57,-63
2015,203098,John Jenkins,John Jenkins,43,43,1176,1166,2342,239.266666666667,238.683333333333,477.95,477,480,480,1030,1087,87.5850340136054,-57,-63
2015,203186,Willie Reed,Willie Reed,38,39,983,971,1954,217.45,205.75,423.2,426,426,426,847,904,86.1648016276704,-57,-80
2015,203488,Mike Muscala,Mike Muscala,59,60,1280,1309,2589,274.183333333333,290.75,564.933333333333,567,565,565,1139,1196,88.984375,-57,-32
2015,203584,Troy Daniels,Troy Daniels,43,43,1085,1121,2206,240.316666666667,232.733333333333,473.05,478,476,476,990,1047,91.2442396313364,-57,-42
2015,1626168,Trey Lyles,Trey Lyles,80,80,3007,3014,6021,725.716666666667,653.716666666667,1379.43333333333,1383,1382,1382,2701,2759,89.8237445959428,-58,-45
2015,201589,Darrell Arthur,Darrell Arthur,70,70,3530,3529,7059,755.866666666667,757.883333333333,1513.75,1517,1516,1516,3147,3206,89.1501416430595,-59,-52
2015,202696,Nikola Vucevic,Nikola Vucevic,65,65,4711,4631,9342,1025.23333333333,1006.95,2032.18333333333,2038,2037,2037,4295,4354,91.1696030566759,-59,-46
2015,101138,Brandon Bass,Brandon Bass,66,66,3124,3118,6242,674.733333333333,667.283333333333,1342.01666666667,1342,1342,1342,2874,2934,91.9974391805378,-60,-20
2015,1626161,Willie Cauley-Stein,Willie Cauley-Stein,66,66,3387,3401,6788,682.266666666667,721.933333333333,1404.2,1411,1412,1412,3128,3188,92.3531148509005,-60,-78
2015,1897,Metta World Peace,Metta World Peace,35,35,1360,1334,2694,295.316666666667,295.25,590.566666666667,588,590,590,1145,1207,84.1911764705882,-62,-64
2015,1626167,Myles Turner,Myles Turner,60,60,3170,3270,6440,677.816666666667,689.833333333333,1367.65,1367,1367,1367,2827,2889,89.1798107255521,-62,-68
2015,2734,Devin Harris,Devin Harris,64,64,2949,3041,5990,658.5,621.016666666667,1279.51666666667,1277,1280,1280,2672,2736,90.606985418786,-64,-87
2015,203493,Reggie Bullock,Reggie Bullock,37,37,991,943,1934,217.85,210.883333333333,428.733333333333,427,429,429,877,942,88.4964682139253,-65,-58
2015,1627362,Briante Weber,Briante Weber,7,7,432,372,804,91.0833333333333,76.3166666666667,167.4,170,169,169,328,393,75.9259259259259,-65,-67
2015,2207,Joe Johnson,Joe Johnson,81,81,6122,6108,12230,1372.11666666667,1322.13333333333,2694.25,2703,2703,2703,5704,5770,93.172165958837,-66,-57
2015,200770,Jordan Farmar,Jordan Farmar,12,12,685,648,1333,146.666666666667,142.25,288.916666666667,291,291,291,579,645,84.5255474452555,-66,-64
2015,201563,Michael Beasley,Michael Beasley,20,20,887,895,1782,169.616666666667,193.816666666667,363.433333333333,360,363,363,773,839,87.1476888387824,-66,-68
2015,202706,Jordan Hamilton,Jordan Hamilton,11,11,700,703,1403,149.783333333333,152.316666666667,302.1,305,304,304,648,714,92.5714285714286,-66,-64
2015,203952,Andrew Wiggins,Andrew Wiggins,81,81,6593,6591,13184,1409.75,1430.26666666667,2840.01666666667,2843,2845,2845,6123,6189,92.871227059002,-66,-68
2015,2200,Pau Gasol,Pau Gasol,72,72,5308,5420,10728,1148.15,1139.61666666667,2287.76666666667,2295,2291,2291,4800,4867,90.4295403165034,-67,-3
2015,2581,Steve Blake,Steve Blake,58,58,2293,2217,4510,500.55,486.416666666667,986.966666666667,987,986,986,1997,2064,87.0911469690362,-67,-52
2015,201581,JJ Hickson,J.J. Hickson,35,35,1055,1047,2102,219.866666666667,216.816666666667,436.683333333333,437,436,436,891,958,84.4549763033175,-67,-59
2015,201196,Ramon Sessions,Ramon Sessions,82,82,3914,3950,7864,794.583333333333,872.35,1666.93333333333,1667,1667,1667,3583,3652,91.543178334185,-69,-54
2015,1626158,Richaun Holmes,Richaun Holmes,51,51,1675,1693,3368,350.933333333333,348.783333333333,699.716666666667,702,702,702,1521,1590,90.8059701492537,-69,-53
2015,203100,Tony Wroten,Tony Wroten,8,8,355,354,709,70.6166666666667,73.7666666666667,144.383333333333,145,144,144,264,334,74.3661971830986,-70,-68
2015,203898,Tyler Ennis,Tyler Ennis,46,46,1492,1501,2993,328.866666666667,328.483333333333,657.35,657,654,654,1305,1375,87.4664879356569,-70,-70
2015,203901,Elfrid Payton,Elfrid Payton,73,73,5030,4935,9965,1058.68333333333,1078.6,2137.28333333333,2144,2145,2145,4505,4575,89.5626242544732,-70,-72
2015,203932,Aaron Gordon,Aaron Gordon,78,78,4355,4351,8706,915.733333333333,946.066666666667,1861.8,1861,1863,1863,3939,4010,90.4477611940299,-71,-73
2015,2365,Chris Andersen,Chris Andersen,27,27,906,886,1792,198.966666666667,198.2,397.166666666667,404,402,402,790,862,87.19646799117,-72,-72
2015,201569,Eric Gordon,Eric Gordon,45,45,3405,3438,6843,722.7,755.9,1478.6,1481,1481,1481,3140,3213,92.2173274596182,-73,-73
2015,1713,Vince Carter,Vince Carter,60,60,2361,2333,4694,508.466666666667,497.683333333333,1006.15,1009,1005,1005,2108,2182,89.2842016094875,-74,-35
2015,200826,J.J. Barea,J.J. Barea,74,74,3783,3857,7640,851.216666666667,808.716666666667,1659.93333333333,1666,1667,1667,3553,3627,93.9201691779011,-74,-70
2015,202720,Jon Leuer,Jon Leuer,67,67,3015,3013,6028,615.766666666667,637.966666666667,1253.73333333333,1258,1255,1255,2699,2777,89.5190713101161,-78,-67
2015,203142,Chris Copeland,Chris Copeland,24,24,347,361,708,76.6833333333333,78.3333333333333,155.016666666667,158,156,156,284,366,81.8443804034582,-82,-79
2015,2399,Mike Dunleavy,Mike Dunleavy,31,31,1611,1623,3234,353.85,343.516666666667,697.366666666667,702,703,703,1492,1575,92.6132836747362,-83,-69
2015,2216,Zach Randolph,Zach Randolph,68,68,4565,4493,9058,1044.31666666667,967.083333333333,2011.4,2019,2016,2016,4111,4195,90.0547645125958,-84,-11
2015,2400,Drew Gooden,Drew Gooden,30,30,714,719,1433,151.416666666667,150.333333333333,301.75,304,305,305,617,701,86.4145658263305,-84,-83
2015,101135,David Lee,David Lee,55,55,2105,2145,4250,450.083333333333,455.083333333333,905.166666666667,904,903,903,1854,1938,88.0760095011877,-84,-84
2015,202962,Greg Smith,Greg Smith,18,18,442,440,882,95,95.95,190.95,194,192,192,370,455,83.710407239819,-85,-77
2015,203949,James Michael McAdoo,James Michael McAdoo,40,41,619,618,1237,129.616666666667,129.7,259.316666666667,263,262,262,545,631,88.0452342487884,-86,-88
2015,203148,Brian Roberts,Brian Roberts,51,51,1083,1088,2171,236.75,228.466666666667,465.216666666667,473,470,470,940,1027,86.7959372114497,-87,-63
2015,203546,Ian Clark,Ian Clark,66,66,1324,1392,2716,289.516666666667,283.266666666667,572.783333333333,579,578,578,1237,1324,93.429003021148,-87,-79
2015,2570,Kendrick Perkins,Kendrick Perkins,37,37,1241,1251,2492,267.883333333333,274.383333333333,542.266666666667,542,542,542,1165,1253,93.8759065269944,-88,-77
2015,202693,Markieff Morris,Markieff Morris,64,64,3852,3764,7616,796.433333333333,820.966666666667,1617.4,1630,1629,1629,3438,3527,89.2523364485981,-89,-90
2015,2746,Josh Smith,Josh Smith,55,55,2064,2095,4159,429.95,450.583333333333,880.533333333333,878,880,880,1805,1895,87.4515503875969,-90,-75
2015,201603,Sonny Weems,Sonny Weems,43,43,1227,1186,2413,245.25,252.033333333333,497.283333333333,501,499,499,1040,1130,84.759576202119,-90,-97
2015,202338,Kevin Seraphin,Kevin Seraphin,48,48,1183,1201,2384,266.05,260.25,526.3,530,526,526,995,1085,84.1081994928149,-90,-86
2015,2034,Mike Miller,Mike Miller,44,47,885,861,1746,187.833333333333,184.25,372.083333333333,372,373,373,744,835,84.0677966101695,-91,-90
2015,2743,Kris Humphries,Kris Humphries,53,53,1986,1992,3978,397.083333333333,435.85,832.933333333333,836,835,835,1786,1877,89.9295065458207,-91,-105
2015,200752,Rudy Gay,Rudy Gay,70,70,5713,5723,11436,1148.16666666667,1221.23333333333,2369.4,2382,2379,2379,5251,5343,91.9131804656048,-92,-82
2015,203156,Henry Sims,Henry Sims,14,14,619,618,1237,131.2,131.966666666667,263.166666666667,263,263,263,524,616,84.6526655896608,-92,-94
2015,203085,Austin Rivers,Austin Rivers,67,67,3339,3535,6874,734.433333333333,733.883333333333,1468.31666666667,1465,1464,1464,3055,3149,91.4944594189877,-94,-163
2015,202349,Greivis Vasquez,Greivis Vasquez,23,23,1038,1073,2111,227.2,232.166666666667,459.366666666667,461,460,460,894,989,86.1271676300578,-95,-92
2015,2419,Tayshaun Prince,Tayshaun Prince,77,77,3254,3334,6588,724.766666666667,731.933333333333,1456.7,1462,1462,1462,2927,3023,89.9508297480025,-96,-133
2015,1626191,Chris McCullough,Chris McCullough,24,24,857,844,1701,179.7,179.983333333333,359.683333333333,363,362,362,757,857,88.3313885647608,-100,-119
2015,101111,Charlie Villanueva,Charlie Villanueva,61,62,1545,1539,3084,332.516666666667,325.9,658.416666666667,664,665,665,1357,1460,87.831715210356,-103,-88
2015,101181,Jose Calderon,Jose Calderon,72,72,4509,4564,9073,1036.15,980.366666666667,2016.51666666667,2026,2024,2024,4148,4251,91.993790197383,-103,-76
2015,201959,Taj Gibson,Taj Gibson,73,73,4438,4523,8961,960.783333333333,969.866666666667,1930.65,1935,1936,1936,3970,4073,89.4547093285264,-103,-153
2015,203101,Miles Plumlee,Miles Plumlee,61,61,2002,2045,4047,431.7,437.316666666667,869.016666666667,869,870,870,1728,1832,86.3136863136863,-104,-99
2015,203088,Kendall Marshall,Kendall Marshall,30,30,949,968,1917,199.7,200.316666666667,400.016666666667,399,400,400,842,947,88.7249736564805,-105,-114
2015,203382,Aron Baynes,Aron Baynes,81,81,2857,2786,5643,620.616666666667,607.45,1228.06666666667,1241,1233,1233,2535,2640,88.7294364718236,-105,-52
2015,1626169,Stanley Johnson,Stanley Johnson,73,73,3994,3849,7843,847.433333333333,839.733333333333,1687.16666666667,1685,1687,1687,3481,3586,87.1557336004006,-105,-132
2015,204038,Langston Galloway,Langston Galloway,82,82,4631,4655,9286,1025.11666666667,998.566666666667,2023.68333333333,2032,2033,2033,4122,4228,89.0088533793997,-106,-103
2015,101141,Ersan Ilyasova,Ersan Ilyasova,74,74,4503,4274,8777,943.233333333333,933.95,1877.18333333333,1882,1881,1881,3959,4068,87.9191650011104,-109,-141
2015,1626204,Larry Nance Jr.,Larry Nance Jr.,63,63,2915,2903,5818,649.383333333333,617.333333333333,1266.71666666667,1268,1266,1266,2574,2683,88.3018867924528,-109,-96
2015,201954,Darren Collison,Darren Collison,74,74,5331,5387,10718,1080.25,1139.31666666667,2219.56666666667,2216,2219,2219,4918,5031,92.2528606265241,-113,-69
2015,203487,Michael Carter-Williams,Michael Carter-Williams,54,54,3816,3847,7663,809.883333333333,833.15,1643.03333333333,1649,1649,1649,3409,3525,89.3343815513627,-116,-130
2015,1626157,Karl-Anthony Towns,Karl-Anthony Towns,82,82,6063,6076,12139,1291.48333333333,1326.15,2617.63333333333,2620,2627,2627,5647,5763,93.1387102094673,-116,-131
2015,203948,Johnny O'Bryant III,Johnny O'Bryant,65,66,1915,1959,3874,424.466666666667,432.666666666667,857.133333333333,860,857,857,1692,1809,88.355091383812,-117,-131
2015,201568,Danilo Gallinari,Danilo Gallinari,53,53,4356,4222,8578,928.8,908,1836.8,1837,1839,1839,3892,4011,89.3480257116621,-119,-99
2015,202357,Nemanja Bjelica,Nemanja Bjelica,60,60,2505,2490,4995,539.15,534.266666666667,1073.41666666667,1078,1075,1075,2263,2382,90.3393213572854,-119,-127
2015,203933,T.J. Warren,T.J. Warren,47,47,2576,2506,5082,537.066666666667,530.316666666667,1067.38333333333,1065,1070,1070,2292,2411,88.9751552795031,-119,-111
2015,202702,Kenneth Faried,Kenneth Faried,67,67,4029,3871,7900,853.35,835.45,1688.8,1697,1694,1694,3628,3749,90.0471581037478,-121,-109
2015,202708,Norris Cole,Norris Cole,45,45,2783,2753,5536,576,615.133333333333,1191.13333333333,1199,1198,1198,2529,2650,90.8731584620913,-121,-101
2015,203112,Quincy Acy,Quincy Acy,59,59,2117,2111,4228,430.75,439.116666666667,869.866666666667,877,876,876,1831,1955,86.4903164855928,-124,-126
2015,202328,Greg Monroe,Greg Monroe,79,79,5273,5301,10574,1143.91666666667,1163.41666666667,2307.33333333333,2316,2314,2314,4858,4983,92.1297174284089,-125,-112
2015,202388,Donald Sloan,Donald Sloan,61,61,2967,3007,5974,662.783333333333,652.583333333333,1315.36666666667,1316,1318,1318,2753,2878,92.7873272665993,-125,-125
2015,201577,Robin Lopez,Robin Lopez,82,82,4963,4975,9938,1129.28333333333,1070.13333333333,2199.41666666667,2219,2219,2219,4480,4606,90.2679830747532,-126,-100
2015,1626144,Emmanuel Mudiay,Emmanuel Mudiay,68,68,4913,4790,9703,1032.81666666667,1027.65,2060.46666666667,2067,2068,2068,4421,4547,89.9857520863016,-126,-117
2015,203940,Adreian Payne,Adreian Payne,52,52,1103,1137,2240,241.416666666667,241.583333333333,483,486,486,486,986,1117,89.3925657298277,-131,-120
2015,201962,Toney Douglas,Toney Douglas,61,61,2971,2914,5885,623.35,637.166666666667,1260.51666666667,1264,1262,1262,2744,2876,92.3594749242679,-132,-140
2015,201171,Carl Landry,Carl Landry,36,36,1329,1348,2677,288.316666666667,280.016666666667,568.333333333333,570,569,569,1210,1343,91.04589917231,-133,-111
2015,2755,Kevin Martin,Kevin Martin,55,55,2530,2524,5054,557.833333333333,534.95,1092.78333333333,1093,1095,1095,2262,2396,89.4071146245059,-134,-121
2015,200797,Ryan Hollins,Ryan Hollins,37,37,1068,1016,2084,234.5,223,457.5,461,460,460,867,1004,81.1797752808989,-137,-148
2015,2749,Jameer Nelson,Jameer Nelson,39,39,2399,2344,4743,517.816666666667,516.233333333333,1034.05,1038,1036,1036,2109,2247,87.9116298457691,-138,-133
2015,203089,John Henson,John Henson,57,57,2176,2235,4411,467.3,489.066666666667,956.366666666667,959,960,960,1855,1993,85.2481617647059,-138,-147
2015,101127,Jarrett Jack,Jarrett Jack,32,32,2411,2373,4784,520.766666666667,504.283333333333,1025.05,1027,1027,1027,2120,2261,87.9303193695562,-141,-133
2015,203930,Sean Kilpatrick,Sean Kilpatrick,31,31,1470,1454,2924,304.083333333333,309.083333333333,613.166666666667,613,616,616,1342,1483,91.2925170068027,-141,-146
2015,1626145,Tyus Jones,Tyus Jones,37,37,1331,1344,2675,281.133333333333,291.166666666667,572.3,576,573,573,1172,1313,88.0540946656649,-141,-133
2015,202087,Alonzo Gee,Alonzo Gee,73,73,3817,3808,7625,794.166666666667,835.25,1629.41666666667,1632,1632,1632,3395,3545,88.9441970133613,-150,-196
2015,1626173,Rashad Vaughn,Rashad Vaughn,70,70,2312,2307,4619,496.6,503.583333333333,1000.18333333333,1000,1001,1001,2005,2158,86.7214532871972,-153,-143
2015,1626170,Jerian Grant,Jerian Grant,76,76,2880,2923,5803,640.916666666667,627.65,1268.56666666667,1261,1265,1265,2495,2651,86.6319444444445,-156,-166
2015,201167,Arron Afflalo,Arron Afflalo,71,71,5258,5331,10589,1209.46666666667,1146.71666666667,2356.18333333333,2367,2371,2371,4811,4968,91.4986686953214,-157,-152
2015,203926,Doug McDermott,Doug McDermott,81,81,4342,4354,8696,922.25,938.766666666667,1861.01666666667,1858,1861,1861,3869,4026,89.1064025794565,-157,-65
2015,203115,Will Barton,Will Barton,82,82,5535,5457,10992,1174.73333333333,1177.21666666667,2351.95,2355,2353,2353,4969,5127,89.7741644083108,-158,-131
2015,201951,Ty Lawson,Ty Lawson,66,66,3380,3400,6780,688.683333333333,723.75,1412.43333333333,1414,1411,1411,2983,3142,88.2544378698225,-159,-160
2015,203960,JaKarr Sampson,JaKarr Sampson,73,73,2693,2717,5410,572.033333333333,575.433333333333,1147.46666666667,1166,1160,1160,2344,2503,87.0404753063498,-159,-233
2015,200765,Rajon Rondo,Rajon Rondo,72,72,6167,6221,12388,1225.9,1306.01666666667,2531.91666666667,2537,2537,2537,5645,5807,91.5355926706665,-162,-154
2015,203095,Evan Fournier,Evan Fournier,79,79,5885,5893,11778,1269.56666666667,1292.33333333333,2561.9,2568,2566,2566,5381,5544,91.4358538657604,-163,-191
2015,203798,PJ Hairston,P.J. Hairston,66,66,2959,2978,5937,658.9,645.333333333333,1304.23333333333,1313,1313,1313,2677,2845,90.4697532950321,-168,-189
2015,1626171,Bobby Portis,Bobby Portis,62,62,2556,2545,5101,551.133333333333,551.533333333333,1102.66666666667,1103,1102,1102,2263,2431,88.5367762128326,-168,-178
2015,202390,Gary Neal,Gary Neal,40,40,1852,1913,3765,386.15,424.466666666667,810.616666666667,807,807,807,1699,1872,91.7386609071274,-173,-163
2015,201565,Derrick Rose,Derrick Rose,66,66,4883,4964,9847,1034.93333333333,1051.76666666667,2086.7,2095,2097,2097,4371,4547,89.5146426377227,-176,-166
2015,203507,Giannis Antetokounmpo,Giannis Antetokounmpo,80,80,6445,6481,12926,1386.33333333333,1428.26666666667,2814.6,2825,2823,2823,5873,6049,91.1249030256012,-176,-164
2015,2440,Matt Barnes,Matt Barnes,76,76,5068,4973,10041,1116.56666666667,1072.55,2189.11666666667,2190,2190,2190,4503,4682,88.8516179952644,-179,-212
2015,201573,Jerryd Bayless,Jerryd Bayless,52,52,3379,3455,6834,748.016666666667,750.633333333333,1498.65,1506,1505,1505,3052,3233,90.3225806451613,-181,-184
2015,201572,Brook Lopez,Brook Lopez,73,73,5573,5527,11100,1237.6,1205.48333333333,2443.08333333333,2459,2457,2457,5043,5225,90.4898618338417,-182,-122
2015,203141,Mirza Teletovic,Mirza Teletovic,79,79,4072,4048,8120,837.416666666667,846.5,1683.91666666667,1683,1686,1686,3707,3890,91.0363457760314,-183,-162
2015,200745,Andrea Bargnani,Andrea Bargnani,46,46,1451,1436,2887,326.283333333333,310.65,636.933333333333,634,634,634,1224,1413,84.355616815989,-189,-191
2015,203076,Anthony Davis,Anthony Davis,61,61,5029,4961,9990,1053.93333333333,1102.65,2156.58333333333,2159,2164,2164,4582,4771,91.1115529926427,-189,-200
2015,203914,Gary Harris,Gary Harris,76,76,5800,5622,11422,1217.76666666667,1211.21666666667,2428.98333333333,2440,2439,2439,5205,5396,89.7413793103448,-191,-212
2015,203953,Jabari Parker,Jabari Parker,76,76,5484,5541,11025,1179.31666666667,1214,2393.31666666667,2407,2408,2408,4962,5154,90.4814004376368,-192,-194
2015,201156,Nick Young,Nick Young,54,54,2367,2365,4732,522.766666666667,511,1033.76666666667,1036,1033,1033,2061,2258,87.0722433460076,-197,-200
2015,201152,Thaddeus Young,Thaddeus Young,73,73,5476,5447,10923,1214.75,1183.36666666667,2398.11666666667,2413,2407,2407,4978,5195,90.9057706355004,-217,-235
2015,201600,Omer Asik,Omer Asik,68,68,2722,2636,5358,584.1,587.783333333333,1171.88333333333,1181,1178,1178,2344,2561,86.1131520940485,-217,-204
2015,202688,Brandon Knight,Brandon Knight,52,52,4479,4426,8905,927.166666666667,943.366666666667,1870.53333333333,1872,1870,1870,3977,4195,88.7921411029248,-218,-210
2015,203530,Joffrey Lauvergne,Joffrey Lauvergne,59,59,2387,2416,4803,530.116666666667,507.983333333333,1038.1,1043,1041,1041,2107,2326,88.2697947214076,-219,-221
2015,201158,Marco Belinelli,Marco Belinelli,68,68,3990,4025,8015,826.466666666667,845.866666666667,1672.33333333333,1670,1672,1672,3537,3757,88.6466165413534,-220,-187
2015,203462,Archie Goodwin,Archie Goodwin,57,57,2695,2633,5328,557.316666666667,551.466666666667,1108.78333333333,1113,1114,1114,2373,2593,88.0519480519481,-220,-209
2015,203900,Markel Brown,Markel Brown,61,62,2296,2290,4586,484.466666666667,496.866666666667,981.333333333333,987,982,982,2064,2289,89.8954703832753,-225,-237
2015,203093,Terrence Jones,Terrence Jones,50,50,2474,2495,4969,507.65,536.466666666667,1044.11666666667,1047,1044,1044,2205,2436,89.1269199676637,-231,-241
2015,202682,Derrick Williams,Derrick Williams,80,80,3242,3304,6546,729.75,700.383333333333,1430.13333333333,1439,1435,1435,2832,3071,87.3534855027761,-239,-205
2015,201585,Kosta Koufos,Kosta Koufos,78,78,3537,3563,7100,730.583333333333,751.383333333333,1481.96666666667,1488,1482,1482,3127,3374,88.4082555838281,-247,-226
2015,201967,Dante Cunningham,Dante Cunningham,80,80,4541,4466,9007,957.466666666667,1012.05,1969.51666666667,1973,1971,1971,4142,4400,91.2133891213389,-258,-279
2015,203458,Alex Len,Alex Len,78,78,4343,4265,8608,907.7,903.466666666667,1811.16666666667,1819,1821,1821,3708,3967,85.3787704351831,-259,-288
2015,203080,Thomas Robinson,Thomas Robinson,70,71,2170,2142,4312,470.266666666667,445.683333333333,915.95,915,917,917,1831,2095,84.3778801843318,-264,-278
2015,203496,Robert Covington,Robert Covington,67,67,4456,4499,8955,956.266666666667,938.716666666667,1894.98333333333,1902,1903,1903,3885,4149,87.1858168761221,-264,-280
2015,203498,Shabazz Muhammad,Shabazz Muhammad,82,82,3882,3925,7807,832.133333333333,848.483333333333,1680.61666666667,1678,1682,1682,3487,3758,89.8248325605358,-271,-266
2015,204456,T.J. McConnell,T.J. McConnell,81,81,3716,3781,7497,824.616666666667,781.533333333333,1606.15,1609,1606,1606,3288,3570,88.4822389666308,-282,-274
2015,203897,Zach LaVine,Zach LaVine,82,82,5284,5382,10666,1125.95,1161.18333333333,2287.13333333333,2295,2294,2294,4881,5183,92.3732021196064,-302,-292
2015,201961,Wayne Ellington,Wayne Ellington,76,76,3679,3680,7359,821.316666666667,787.9,1609.21666666667,1614,1615,1615,3158,3462,85.8385430823593,-304,-322
2015,200782,PJ Tucker,P.J. Tucker,82,82,6054,5964,12018,1262.35,1261.88333333333,2524.23333333333,2540,2540,2540,5269,5596,87.0333663693426,-327,-357
2015,203499,Shane Larkin,Shane Larkin,78,78,4049,4024,8073,881.266666666667,862.85,1744.11666666667,1752,1751,1751,3547,3886,87.6018770066683,-339,-344
2015,202397,Ish Smith,Ish Smith,77,77,5236,5350,10586,1115.93333333333,1117.91666666667,2233.85,2240,2239,2239,4691,5038,89.5912910618793,-347,-348
2015,2199,Tyson Chandler,Tyson Chandler,66,66,3838,3759,7597,816.85,798.216666666667,1615.06666666667,1617,1618,1618,3204,3577,83.4809796769151,-373,-395
2015,101150,Lou Williams,Lou Williams,67,67,4445,4486,8931,966.75,939.6,1906.35,1911,1907,1907,3950,4333,88.8638920134983,-383,-403
2015,1626164,Devin Booker,Devin Booker,76,76,5029,5000,10029,1051.3,1047.98333333333,2099.28333333333,2110,2108,2108,4372,4765,86.9357725193876,-393,-375
2015,203138,Hollis Thompson,Hollis Thompson,77,77,5058,5197,10255,1090.16666666667,1062.61666666667,2152.78333333333,2157,2154,2154,4457,4858,88.1178331356267,-401,-371
2015,202711,Bojan Bogdanovic,Bojan Bogdanovic,79,79,4846,4887,9733,1072.51666666667,1041.81666666667,2114.33333333333,2114,2115,2115,4297,4704,88.6710689228229,-407,-391
2015,203924,Jerami Grant,Jerami Grant,77,77,4773,4941,9714,1038.78333333333,1017.95,2056.73333333333,2068,2066,2066,4131,4543,86.5493400377121,-412,-497
2015,203457,Nerlens Noel,Nerlens Noel,67,67,4561,4674,9235,999.116666666667,963.65,1962.76666666667,1963,1965,1965,3869,4306,84.8278886209165,-437,-459
2015,203917,Nik Stauskas,Nik Stauskas,73,73,4260,4331,8591,923.116666666667,895.283333333333,1818.4,1810,1809,1809,3649,4099,85.6572769953052,-450,-406
2015,1626143,Jahlil Okafor,Jahlil Okafor,53,53,3615,3655,7270,828.716666666667,752.866666666667,1581.58333333333,1594,1591,1591,2973,3480,82.240663900415,-507,-496
2015,203477,Isaiah Canaan,Isaiah Canaan,77,77,4579,4641,9220,1003.98333333333,952.55,1956.53333333333,1968,1966,1966,3885,4396,84.843852369513,-511,-484
2015,1626156,D'Angelo Russell,D'Angelo Russell,80,80,5225,5224,10449,1161.48333333333,1095.45,2256.93333333333,2257,2259,2259,4499,5062,86.1052631578948,-563,-549
2015,977,Kobe Bryant,Kobe Bryant,66,66,4340,4400,8740,957.816666666667,894.5,1852.31666666667,1861,1863,1863,3792,4358,87.3732718894009,-566,-569
2015,201579,Roy Hibbert,Roy Hibbert,81,81,4296,4358,8654,974.866666666667,890.716666666667,1865.58333333333,1881,1878,1878,3617,4250,84.1945996275605,-633,-686
2015,203903,Jordan Clarkson,Jordan Clarkson,79,79,5915,5920,11835,1310.46666666667,1224.33333333333,2534.8,2556,2552,2552,5123,5756,86.6103127641589,-633,-627
2015,203944,Julius Randle,Julius Randle,81,81,5313,5268,10581,1179.01666666667,1095.96666666667,2274.98333333333,2287,2286,2286,4573,5239,86.0718991153774,-666,-683
2016,201939,Stephen Curry,Stephen Curry,79,79,6475,6539,13014,1231.01666666667,1402.08333333333,2633.1,2636,2638,2638,6801,5819,105.034749034749,982,1017
2016,203110,Draymond Green,Draymond Green,76,76,5923,6045,11968,1144.7,1311.91666666667,2456.61666666667,2475,2471,2471,6079,5293,102.633800438967,786,822
2016,202691,Klay Thompson,Klay Thompson,78,78,6252,6461,12713,1239.06666666667,1398,2637.06666666667,2647,2649,2649,6465,5690,103.406909788868,775,793
2016,201142,Kevin Durant,Kevin Durant,62,62,4956,5079,10035,967.55,1096.28333333333,2063.83333333333,2072,2070,2070,5207,4536,105.064568200161,671,711
2016,101108,Chris Paul,Chris Paul,61,61,4426,4415,8841,959.666666666667,954.216666666667,1913.88333333333,1921,1921,1921,4527,3983,102.281970176231,544,581
2016,2738,Andre Iguodala,Andre Iguodala,76,76,4744,4923,9667,950.116666666667,1050.61666666667,2000.73333333333,2001,1998,1998,4834,4325,101.897133220911,509,526
2016,201599,DeAndre Jordan,DeAndre Jordan,81,81,5937,5943,11880,1284.83333333333,1276.31666666667,2561.15,2569,2570,2570,5935,5463,99.9663129526697,472,455
2016,2544,LeBron James,LeBron James,74,74,6476,6424,12900,1407.65,1374.21666666667,2781.86666666667,2796,2794,2794,6567,6107,101.405188387894,460,482
2016,2585,Zaza Pachulia,Zaza Pachulia,70,70,3039,3038,6077,581.85,676.25,1258.1,1265,1268,1268,3128,2687,102.928594932544,441,419
2016,203497,Rudy Gobert,Rudy Gobert,81,81,5994,5959,11953,1418.16666666667,1315.93333333333,2734.1,2737,2744,2744,5775,5334,96.3463463463464,441,434
2016,201933,Blake Griffin,Blake Griffin,61,61,4812,4799,9611,1034.45,1036.68333333333,2071.13333333333,2078,2076,2076,4891,4457,101.641729010806,434,442
2016,200755,JJ Redick,J.J. Redick,78,78,5092,5116,10208,1092.3,1096.15,2188.45,2199,2198,2198,5156,4743,101.256873527101,413,473
2016,202695,Kawhi Leonard,Kawhi Leonard,74,74,5536,5533,11069,1259.46666666667,1201,2460.46666666667,2478,2474,2474,5509,5101,99.5122832369942,408,434
2016,201935,James Harden,James Harden,81,81,7106,7105,14211,1411.71666666667,1534.38333333333,2946.1,2955,2947,2947,7192,6792,101.210244863496,400,424
2016,201988,Patty Mills,Patty Mills,80,80,4101,4093,8194,878.3,884.2,1762.5,1754,1754,1754,4047,3653,98.6832479882955,394,408
2016,200768,Kyle Lowry,Kyle Lowry,60,60,5100,5079,10179,1116.3,1108.65,2224.95,2245,2244,2244,5057,4684,99.156862745098,373,354
2016,203109,Jae Crowder,Jae Crowder,72,72,5369,5524,10893,1137.96666666667,1182.76666666667,2320.73333333333,2337,2335,2335,5412,5058,100.800894021233,354,353
2016,201583,Ryan Anderson,Ryan Anderson,72,72,5047,5010,10057,1013.73333333333,1095.13333333333,2108.86666666667,2113,2116,2116,5067,4733,100.39627501486,334,408
2016,2772,Trevor Ariza,Trevor Ariza,80,80,6671,6673,13344,1327.48333333333,1441.66666666667,2769.15,2773,2773,2773,6691,6362,100.299805126668,329,366
2016,201976,Patrick Beverley,Patrick Beverley,67,67,4922,4915,9837,971.65,1066.63333333333,2038.28333333333,2055,2058,2058,4901,4573,99.573344169037,328,353
2016,202335,Patrick Patterson,Patrick Patterson,65,65,3671,3668,7339,798.933333333334,799.483333333333,1598.41666666667,1601,1599,1599,3670,3343,99.9727594660855,327,347
2016,202330,Gordon Hayward,Gordon Hayward,73,73,5510,5499,11009,1299.21666666667,1210.96666666667,2510.18333333333,2519,2516,2516,5340,5017,96.9147005444646,323,348
2016,201601,Luc Mbah a Moute,Luc Mbah a Moute,80,80,4083,4170,8253,883.133333333333,896.583333333333,1779.71666666667,1784,1787,1787,4082,3761,99.9755082047514,321,263
2016,202681,Kyrie Irving,Kyrie Irving,72,72,5933,5881,11814,1273.68333333333,1251.16666666667,2524.85,2524,2525,2525,5987,5667,100.910163492331,320,330
2016,203078,Bradley Beal,Bradley Beal,77,77,6301,6325,12626,1299.58333333333,1370.71666666667,2670.3,2689,2684,2684,6243,5926,99.0795111887002,317,332
2016,201567,Kevin Love,Kevin Love,60,60,4494,4392,8886,956.05,931.733333333333,1887.78333333333,1887,1885,1885,4456,4142,99.1544281263907,314,336
2016,201569,Eric Gordon,Eric Gordon,75,75,5628,5696,11324,1101.05,1224.38333333333,2325.43333333333,2322,2323,2323,5535,5232,98.3475479744136,303,295
2016,201580,JaVale McGee,JaVale McGee,77,77,1871,1853,3724,352.916666666667,388.95,741.866666666667,739,739,739,1973,1671,105.451630144308,302,312
2016,101161,Amir Johnson,Amir Johnson,80,80,3646,3721,7367,785.216666666667,815.2,1600.41666666667,1609,1608,1608,3647,3364,100.027427317608,283,207
2016,203999,Nikola Jokic,Nikola Jokic,73,73,4890,4726,9616,1006.33333333333,1023,2029.33333333333,2033,2038,2038,4925,4643,100.715746421268,282,297
2016,101135,David Lee,David Lee,79,79,3381,3415,6796,739.716666666667,736.716666666667,1476.43333333333,1480,1477,1477,3299,3021,97.5746820467317,278,315
2016,200746,LaMarcus Aldridge,LaMarcus Aldridge,72,72,5186,5169,10355,1207.5,1128.11666666667,2335.61666666667,2335,2335,2335,5001,4737,96.4327034323178,264,272
2016,201980,Danny Green,Danny Green,68,68,3987,4015,8002,928.7,871.45,1800.15,1806,1807,1807,3837,3573,96.2377727614748,264,268
2016,1938,Manu Ginobili,Manu Ginobili,69,69,3062,3053,6115,644.483333333333,645.883333333333,1290.36666666667,1295,1291,1291,3019,2756,98.5956890920967,263,258
2016,201588,George Hill,George Hill,49,49,3381,3298,6679,803.266666666667,732.283333333333,1535.55,1545,1544,1544,3269,3013,96.6873706004141,256,258
2016,202322,John Wall,John Wall,78,78,6728,6733,13461,1372.16666666667,1449.81666666667,2821.98333333333,2836,2836,2836,6624,6370,98.4542211652794,254,247
2016,201566,Russell Westbrook,Russell Westbrook,81,81,6936,6632,13568,1319.31666666667,1475.03333333333,2794.35,2802,2802,2802,6443,6200,92.8921568627451,243,247
2016,203613,Jonathon Simmons,Jonathon Simmons,78,78,3194,3212,6406,711.65,688.216666666667,1399.86666666667,1396,1392,1392,3013,2773,94.3331246086412,240,211
2016,202738,Isaiah Thomas,Isaiah Thomas,76,76,5935,6102,12037,1258.71666666667,1297,2555.71666666667,2572,2569,2569,6024,5786,101.499578770008,238,274
2016,203469,Cody Zeller,Cody Zeller,62,62,3930,3841,7771,861.633333333333,853.5,1715.13333333333,1723,1725,1725,3797,3569,96.6157760814249,228,210
2016,2200,Pau Gasol,Pau Gasol,64,64,3603,3626,7229,827.716666666667,787.4,1615.11666666667,1627,1627,1627,3559,3341,98.7787954482376,218,227
2016,203473,Dewayne Dedmon,Dewayne Dedmon,76,76,3038,3019,6057,676.516666666667,656.983333333333,1333.5,1329,1330,1330,2820,2603,92.8242264647795,217,191
2016,2403,Nene,Nene Hilario,67,67,2976,2929,5905,572.716666666667,631.833333333333,1204.55,1198,1198,1198,2902,2686,97.5134408602151,216,195
2016,202689,Kemba Walker,Kemba Walker,79,79,6246,6214,12460,1378.63333333333,1352.53333333333,2731.16666666667,2743,2739,2739,6101,5889,97.6785142491194,212,186
2016,202693,Markieff Morris,Markieff Morris,76,76,5545,5544,11089,1157.16666666667,1193.68333333333,2350.85,2372,2374,2374,5373,5162,96.8981064021641,211,177
2016,202710,Jimmy Butler,Jimmy Butler,76,76,6597,6438,13035,1430.08333333333,1374.71666666667,2804.8,2808,2809,2809,6107,5902,92.5723813854782,205,205
2016,203506,Victor Oladipo,Victor Oladipo,67,67,5384,5177,10561,1062.96666666667,1148.66666666667,2211.63333333333,2225,2222,2222,4926,4721,91.4933135215453,205,173
2016,203937,Kyle Anderson,Kyle Anderson,72,72,2285,2303,4588,507.25,502,1009.25,1019,1020,1020,2197,1995,96.1487964989059,202,179
2016,203991,Clint Capela,Clint Capela,65,65,3658,3668,7326,731.3,811.983333333333,1543.28333333333,1554,1551,1551,3663,3464,100.136686714051,199,215
2016,2225,Tony Parker,Tony Parker,63,63,3498,3483,6981,828.233333333333,757.266666666667,1585.5,1588,1587,1587,3350,3154,95.7690108633505,196,178
2016,202703,Nikola Mirotic,Nikola Mirotic,70,70,3944,3872,7816,836.483333333333,839.783333333333,1676.26666666667,1681,1679,1679,3699,3512,93.7880324543611,187,198
2016,101162,Marcin Gortat,Marcin Gortat,82,82,5995,5979,11974,1241.06666666667,1308.61666666667,2549.68333333333,2561,2556,2556,5851,5677,97.5979983319433,174,202
2016,201144,Mike Conley,Mike Conley,69,69,5169,5055,10224,1198.18333333333,1086.93333333333,2285.11666666667,2295,2292,2292,4906,4732,94.9119752369898,174,187
2016,203500,Steven Adams,Steven Adams,80,80,5849,5579,11428,1132.91666666667,1248.18333333333,2381.1,2390,2389,2389,5358,5184,91.6054026329287,174,193
2016,203512,Lucas Nogueira,Lucas Nogueira,55,57,2494,2563,5057,540.716666666667,546.683333333333,1087.4,1091,1088,1088,2489,2316,99.7995188452285,173,178
2016,203460,Andre Roberson,Andre Roberson,79,79,5782,5574,11356,1121.8,1249.8,2371.6,2380,2376,2376,5310,5144,91.8367346938775,166,147
2016,1626167,Myles Turner,Myles Turner,81,81,5740,5909,11649,1246.61666666667,1288.8,2535.41666666667,2543,2541,2541,5616,5451,97.8397212543554,165,144
2016,201143,Al Horford,Al Horford,68,68,5002,5140,10142,1076.75,1105.2,2181.95,2199,2193,2193,4962,4798,99.2003198720512,164,215
2016,204060,Joe Ingles,Joe Ingles,82,82,4350,4346,8696,1011.61666666667,954.333333333333,1965.95,1975,1972,1972,4223,4065,97.0804597701149,158,159
2016,2733,Shaun Livingston,Shaun Livingston,76,76,3067,3171,6238,648.633333333333,691.816666666667,1340.45,1345,1345,1345,2935,2778,95.6961199869579,157,151
2016,203490,Otto Porter Jr.,Otto Porter,80,80,6136,6119,12255,1259.2,1326.21666666667,2585.41666666667,2602,2605,2605,5969,5812,97.2783572359844,157,190
2016,2207,Joe Johnson,Joe Johnson,78,78,4016,4020,8036,958.883333333333,884.416666666667,1843.3,1842,1843,1843,3899,3744,97.0866533864542,155,115
2016,1713,Vince Carter,Vince Carter,73,73,4058,3959,8017,941.716666666667,858.683333333334,1800.4,1801,1799,1799,3831,3677,94.4061113849187,154,157
2016,2561,David West,David West,68,68,1879,1974,3853,411.35,440.566666666667,851.916666666667,855,854,854,1851,1697,98.5098456625865,154,119
2016,202331,Paul George,Paul George,75,75,6106,6241,12347,1336.15,1357.46666666667,2693.61666666667,2687,2689,2689,5980,5827,97.9364559449722,153,169
2016,202684,Tristan Thompson,Tristan Thompson,78,78,5457,5396,10853,1183.08333333333,1151.78333333333,2334.86666666667,2337,2336,2336,5307,5156,97.2512369433755,151,131
2016,2210,Richard Jefferson,Richard Jefferson,79,79,3678,3702,7380,809.716666666667,792.016666666667,1601.73333333333,1617,1614,1614,3630,3480,98.694942903752,150,132
2016,201949,James Johnson,James Johnson,76,76,4853,4826,9679,1072.91666666667,1011.38333333333,2084.3,2086,2085,2085,4521,4376,93.158870801566,145,143
2016,201942,DeMar DeRozan,DeMar DeRozan,74,74,6031,6082,12113,1339.95,1284.46666666667,2624.41666666667,2621,2620,2620,5880,5736,97.4962692754104,144,149
2016,201568,Danilo Gallinari,Danilo Gallinari,63,63,5103,4998,10101,1056.95,1070.65,2127.6,2134,2134,2134,5003,4861,98.0403684107388,142,159
2016,2749,Jameer Nelson,Jameer Nelson,75,75,4943,4708,9651,1020.06666666667,1015.93333333333,2036,2049,2045,2045,4768,4627,96.4596398948007,141,133
2016,203082,Terrence Ross,Terrence Ross,78,78,4599,4589,9188,954.75,996.116666666667,1950.86666666667,1954,1955,1955,4512,4371,98.1082844096543,141,125
2016,203918,Rodney Hood,Rodney Hood,59,59,3447,3467,6914,829.366666666667,756.816666666667,1586.18333333333,1591,1593,1593,3293,3167,95.5323469683783,126,109
2016,203501,Tim Hardaway Jr.,Tim Hardaway Jr.,79,79,5098,5084,10182,1042.75,1106.91666666667,2149.66666666667,2150,2154,2154,4782,4657,93.8014907806983,125,158
2016,203935,Marcus Smart,Marcus Smart,79,79,5639,5691,11330,1198.31666666667,1208.41666666667,2406.73333333333,2403,2399,2399,5407,5283,95.8857953537861,124,130
2016,1891,Jason Terry,Jason Terry,74,74,3051,3101,6152,675.583333333333,688.483333333333,1364.06666666667,1366,1365,1365,2913,2794,95.4768928220256,119,107
2016,1626155,Sam Dekker,Sam Dekker,77,77,3406,3441,6847,670.983333333333,746.366666666667,1417.35,1420,1419,1419,3321,3202,97.5044039929536,119,76
2016,201960,DeMarre Carroll,DeMarre Carroll,72,72,4278,4295,8573,952.533333333333,922.516666666667,1875.05,1885,1882,1882,4128,4011,96.4936886395512,117,116
2016,203079,Dion Waiters,Dion Waiters,46,46,3174,3201,6375,706.983333333333,674.533333333333,1381.51666666667,1384,1384,1384,3015,2903,94.9905482041588,112,83
2016,203090,Maurice Harkless,Maurice Harkless,77,77,5194,5260,10454,1113.13333333333,1105.41666666667,2218.55,2219,2223,2223,5105,4993,98.2864844050828,112,45
2016,203382,Aron Baynes,Aron Baynes,75,75,2624,2615,5239,575.45,583.983333333333,1159.43333333333,1163,1163,1163,2432,2322,92.6829268292683,110,136
2016,201147,Corey Brewer,Corey Brewer,82,82,3064,3050,6114,606.316666666667,668.283333333333,1274.6,1282,1281,1281,2915,2809,95.1370757180157,106,72
2016,202328,Greg Monroe,Greg Monroe,81,81,4132,4163,8295,911.2,920.783333333333,1831.98333333333,1820,1823,1823,4052,3948,98.0638915779284,104,137
2016,203081,Damian Lillard,Damian Lillard,75,75,6362,6308,12670,1362.56666666667,1325.61666666667,2688.18333333333,2692,2694,2694,6164,6060,96.8877711411506,104,79
2016,1626149,Montrezl Harrell,Montrezl Harrell,58,58,2552,2606,5158,508.516666666667,547.066666666667,1055.58333333333,1068,1064,1064,2557,2453,100.19592476489,104,106
2016,202722,Davis Bertans,Davis Bertans,67,67,1859,1860,3719,400.816666666667,403.116666666667,803.933333333333,803,808,808,1766,1664,94.9973103819258,102,116
2016,202355,Hassan Whiteside,Hassan Whiteside,77,77,5791,5724,11515,1289.8,1214.23333333333,2504.03333333333,2516,2513,2513,5429,5330,93.7489207390779,99,96
2016,202685,Jonas Valanciunas,Jonas Valanciunas,80,80,4705,4665,9370,1058.2,1000.78333333333,2058.98333333333,2066,2066,2066,4526,4427,96.1955366631243,99,107
2016,201152,Thaddeus Young,Thaddeus Young,74,74,5077,5259,10336,1105.68333333333,1125.41666666667,2231.1,2241,2237,2237,4924,4827,96.9864092968288,97,63
2016,201961,Wayne Ellington,Wayne Ellington,62,62,3449,3453,6902,775.216666666667,719.733333333333,1494.95,1496,1500,1500,3266,3171,94.6941142360104,95,86
2016,200794,Paul Millsap,Paul Millsap,69,69,5498,5529,11027,1148.33333333333,1188.88333333333,2337.21666666667,2343,2343,2343,5108,5020,92.9065114587123,88,136
2016,203526,Raul Neto,Raul Neto,40,40,775,789,1564,173.083333333333,172.8,345.883333333333,346,346,346,762,676,98.3225806451613,86,84
2016,1626153,Delon Wright,Delon Wright,27,27,1018,981,1999,224.3,223.416666666667,447.716666666667,449,446,446,942,857,92.5343811394892,85,90
2016,1627763,Malcolm Brogdon,Malcolm Brogdon,75,75,4456,4522,8978,973.8,1000.93333333333,1974.73333333333,1979,1982,1982,4323,4242,97.0152603231598,81,89
2016,203141,Mirza Teletovic,Mirza Teletovic,70,70,2549,2579,5128,559.166666666667,568.583333333333,1127.75,1137,1133,1133,2419,2341,94.899960768929,78,72
2016,2754,Tony Allen,Tony Allen,71,71,4299,4214,8513,992.566666666667,912.866666666667,1905.43333333333,1917,1914,1914,3948,3871,91.8353105373343,77,-9
2016,203914,Gary Harris,Gary Harris,57,57,4262,4148,8410,887.766666666667,889.4,1777.16666666667,1782,1782,1782,4293,4216,100.727358047865,77,81
2016,201609,Goran Dragic,Goran Dragic,73,73,5725,5685,11410,1269.25,1183.76666666667,2453.01666666667,2459,2459,2459,5378,5302,93.938864628821,76,67
2016,203114,Khris Middleton,Khris Middleton,29,29,1943,1990,3933,440.416666666667,448.633333333333,889.05,892,889,889,1913,1838,98.4559958826557,75,90
2016,203954,Joel Embiid,Joel Embiid,31,31,1847,1847,3694,387.233333333333,395.15,782.383333333333,786,786,786,1690,1615,91.4997292907417,75,71
2016,201587,Nicolas Batum,Nicolas Batum,77,77,5985,5995,11980,1311.83333333333,1297.98333333333,2609.81666666667,2618,2617,2617,5786,5714,96.6750208855472,72,69
2016,1626181,Norman Powell,Norman Powell,76,76,3123,3160,6283,688.65,675.816666666667,1364.46666666667,1367,1368,1368,3025,2953,96.8619916746718,72,83
2016,203210,JaMychal Green,JaMychal Green,77,77,4673,4621,9294,1084.85,1006.1,2090.95,2102,2101,2101,4326,4255,92.574363364006,71,-28
2016,1627832,Fred VanVleet,Fred VanVleet,34,37,681,690,1371,147.183333333333,144.383333333333,291.566666666667,294,294,294,629,559,92.3641703377386,70,63
2016,1626163,Frank Kaminsky,Frank Kaminsky,75,75,4439,4460,8899,994.85,958.8,1953.65,1956,1954,1954,4348,4279,97.9499887362019,69,43
2016,203516,James Ennis III,James Ennis,64,64,3411,3360,6771,792.35,707.516666666667,1499.86666666667,1503,1501,1501,3120,3052,91.4687774846086,68,45
2016,201188,Marc Gasol,Marc Gasol,74,74,5664,5567,11231,1324.93333333333,1200.11666666667,2525.05,2526,2531,2531,5290,5223,93.3968926553672,67,64
2016,202340,Avery Bradley,Avery Bradley,55,55,4223,4340,8563,899.8,927.766666666667,1827.56666666667,1837,1835,1835,4126,4059,97.7030547004499,67,73
2016,1627855,Okaro White,Okaro White,35,35,1070,1086,2156,246,222.85,468.85,470,471,471,1046,980,97.7570093457944,66,68
2016,1627736,Malik Beasley,Malik Beasley,22,22,397,399,796,78.9666666666667,85.4166666666667,164.383333333333,165,165,165,407,342,102.518891687657,65,58
2016,2747,JR Smith,J.R. Smith,41,41,2757,2806,5563,605.666666666667,585.5,1191.16666666667,1188,1187,1187,2735,2671,99.2020311933261,64,71
2016,101112,Channing Frye,Channing Frye,74,74,3156,3229,6385,699.5,696.083333333333,1395.58333333333,1400,1398,1398,3146,3084,99.6831432192649,62,60
2016,2757,Beno Udrih,Beno Udrih,37,39,1248,1219,2467,282.516666666667,274.233333333333,556.75,561,560,560,1145,1084,91.7467948717949,61,86
2016,202709,Cory Joseph,Cory Joseph,80,80,4595,4621,9216,1011.63333333333,990.283333333333,2001.91666666667,2004,2003,2003,4418,4357,96.1479869423286,61,46
2016,202732,DeAndre Liggins,DeAndre Liggins,61,62,1773,1772,3545,387.016666666667,379.433333333333,766.45,776,777,777,1704,1643,96.1082910321489,61,53
2016,202697,Iman Shumpert,Iman Shumpert,76,76,4371,4463,8834,973.25,952.466666666667,1925.71666666667,1937,1937,1937,4318,4258,98.7874628231526,60,43
2016,1626170,Jerian Grant,Jerian Grant,63,63,2377,2333,4710,517.25,507.05,1024.3,1029,1028,1028,2202,2142,92.637778712663,60,52
2016,203546,Ian Clark,Ian Clark,77,77,2686,2786,5472,558.833333333333,579.7,1138.53333333333,1137,1137,1137,2543,2484,94.6760982874162,59,36
2016,2734,Devin Harris,Devin Harris,65,65,2404,2420,4824,567.083333333333,517.7,1084.78333333333,1089,1087,1087,2275,2217,94.6339434276206,58,39
2016,203493,Reggie Bullock,Reggie Bullock,31,31,1102,1038,2140,234.316666666667,229.183333333333,463.5,466,467,467,1010,952,91.6515426497278,58,55
2016,202324,Derrick Favors,Derrick Favors,50,50,2570,2548,5118,613.45,567.516666666667,1180.96666666667,1188,1186,1186,2400,2344,93.3852140077821,56,57
2016,1627098,Malcolm Delaney,Malcolm Delaney,73,73,2883,2876,5759,613.066666666667,636.3,1249.36666666667,1247,1248,1248,2646,2590,91.7793964620187,56,30
2016,203510,Pierre Jackson,Pierre Jackson,8,8,203,195,398,42.15,41.6166666666667,83.7666666666667,83,84,84,205,152,100.985221674877,53,55
2016,201952,Jeff Teague,Jeff Teague,82,82,6069,6246,12315,1323.11666666667,1337.41666666667,2660.53333333333,2659,2657,2657,5905,5853,97.2977426264624,52,50
2016,1627750,Jamal Murray,Jamal Murray,82,82,4237,4178,8415,865.75,894.183333333333,1759.93333333333,1765,1764,1764,4066,4014,95.9641255605381,52,76
2016,203507,Giannis Antetokounmpo,Giannis Antetokounmpo,80,80,6400,6485,12885,1389.08333333333,1445.6,2834.68333333333,2847,2845,2845,6095,6044,95.234375,51,46
2016,1627884,Derrick Jones Jr.,Derrick Jones,32,32,1338,1336,2674,260.266666666667,283.783333333333,544.05,544,545,545,1261,1211,94.2451420029895,50,33
2016,200752,Rudy Gay,Rudy Gay,30,30,2374,2324,4698,520.85,488.366666666667,1009.21666666667,1013,1013,1013,2202,2155,92.7548441449031,47,68
2016,1626191,Chris McCullough,Chris McCullough,16,16,197,190,387,35.15,42.6166666666667,77.7666666666667,82,80,80,210,163,106.598984771574,47,52
2016,203076,Anthony Davis,Anthony Davis,75,75,6271,6404,12675,1299.03333333333,1405.25,2704.28333333333,2704,2708,2708,5841,5797,93.1430393876575,44,50
2016,203957,Dante Exum,Dante Exum,66,66,2699,2721,5420,629.75,595.9,1225.65,1230,1228,1228,2486,2444,92.1081882178585,42,-2
2016,204020,Tyler Johnson,Tyler Johnson,73,73,5076,5010,10086,1112.2,1056.2,2168.4,2178,2178,2178,4653,4612,91.6666666666667,41,33
2016,101139,CJ Miles,C.J. Miles,76,76,4044,4055,8099,889.916666666667,877.916666666667,1767.83333333333,1779,1776,1776,3866,3826,95.5984174085064,40,76
2016,203077,Michael Kidd-Gilchrist,Michael Kidd-Gilchrist,81,81,5329,5316,10645,1184.98333333333,1154.55,2339.53333333333,2356,2349,2349,5006,4966,93.9388252955526,40,-5
2016,201577,Robin Lopez,Robin Lopez,81,81,5319,5168,10487,1159.86666666667,1101.86666666667,2261.73333333333,2273,2271,2271,4840,4801,90.9945478473397,39,74
2016,202329,Al-Farouq Aminu,Al-Farouq Aminu,61,61,4021,4123,8144,891.333333333333,882.266666666667,1773.6,1775,1773,1773,3898,3859,96.9410594379508,39,21
2016,203584,Troy Daniels,Troy Daniels,67,67,2743,2634,5377,620.05,561.266666666667,1181.31666666667,1188,1183,1183,2499,2460,91.1046299671892,39,89
2016,203085,Austin Rivers,Austin Rivers,74,74,4720,4755,9475,1046.51666666667,1002.35,2048.86666666667,2055,2054,2054,4547,4510,96.3347457627119,37,-10
2016,1626246,Boban Marjanovic,Boban Marjanovic,34,35,695,640,1335,148.433333333333,141.883333333333,290.316666666667,292,293,293,637,601,91.6546762589928,36,32
2016,1627835,Paul Zipser,Paul Zipser,44,44,1970,1956,3926,421.9,419.483333333333,841.383333333333,839,843,843,1788,1752,90.761421319797,36,15
2016,101133,Ian Mahinmi,Ian Mahinmi,31,31,1309,1294,2603,269.2,285.216666666667,554.416666666667,556,555,555,1211,1177,92.5133689839572,34,31
2016,203524,Solomon Hill,Solomon Hill,80,80,5518,5626,11144,1144.6,1222.56666666667,2367.16666666667,2375,2374,2374,5167,5135,93.6389996375498,32,5
2016,201973,Jonas Jerebko,Jonas Jerebko,78,78,2807,2912,5719,619.316666666667,610.866666666667,1230.18333333333,1235,1232,1232,2736,2706,97.4706091913075,30,39
2016,101150,Lou Williams,Lou Williams,81,81,4870,4847,9717,971.383333333333,1013.3,1984.68333333333,1992,1994,1994,4667,4639,95.8316221765914,28,49
2016,201959,Taj Gibson,Taj Gibson,78,78,4771,4560,9331,1001.25,984.9,1986.15,1988,1989,1989,4291,4264,89.9392160972542,27,2
2016,1718,Paul Pierce,Paul Pierce,25,25,625,636,1261,144.333333333333,131.083333333333,275.416666666667,278,277,277,611,585,97.76,26,28
2016,201950,Jrue Holiday,Jrue Holiday,67,67,5084,5168,10252,1047.66666666667,1139.35,2187.01666666667,2185,2190,2190,4721,4695,92.8599527930763,26,38
2016,1626174,Christian Wood,Christian Wood,13,13,248,237,485,57.1666666666667,51.3333333333333,108.5,106,107,107,231,205,93.1451612903226,26,19
2016,203186,Willie Reed,Willie Reed,71,71,2376,2420,4796,527.666666666667,506.566666666667,1034.23333333333,1028,1031,1031,2199,2174,92.5505050505051,25,35
2016,203107,Tomas Satoransky,Tomas Satoransky,57,57,1616,1659,3275,357.883333333333,360.633333333333,718.516666666667,721,719,719,1506,1483,93.1930693069307,23,15
2016,202397,Ish Smith,Ish Smith,81,81,4532,4414,8946,974,983.45,1957.45,1957,1955,1955,4180,4159,92.2330097087379,21,50
2016,201148,Brandan Wright,Brandan Wright,28,28,989,1008,1997,236.916666666667,209.55,446.466666666667,446,447,447,918,898,92.8210313447927,20,35
2016,202713,Kyle Singler,Kyle Singler,32,32,932,889,1821,181.333333333333,203.216666666667,384.55,384,385,385,825,805,88.519313304721,20,8
2016,203486,Mason Plumlee,Mason Plumlee,81,81,4984,5021,10005,1062.76666666667,1068.6,2131.36666666667,2148,2148,2148,4903,4885,98.3747993579454,18,-1
2016,1626199,Darrun Hilliard,Darrun Hilliard,38,39,853,820,1673,187.783333333333,182.95,370.733333333333,380,381,381,760,742,89.0973036342321,18,13
2016,203898,Tyler Ennis,Tyler Ennis,53,53,1403,1350,2753,283.35,298.016666666667,581.366666666667,587,588,588,1279,1262,91.1617961511048,17,-2
2016,1628021,David Nwaba,David Nwaba,20,20,970,974,1944,197.95,211.383333333333,409.333333333333,398,397,397,901,884,92.8865979381443,17,11
2016,1627848,Shawn Long,Shawn Long,17,18,580,570,1150,115.183333333333,118.733333333333,233.916666666667,233,234,234,555,539,95.6896551724138,16,20
2016,203468,CJ McCollum,CJ McCollum,80,80,6479,6563,13042,1404.33333333333,1380.63333333333,2784.96666666667,2788,2796,2796,6258,6243,96.5889797808304,15,62
2016,201962,Toney Douglas,Toney Douglas,24,24,944,874,1818,212.783333333333,183.316666666667,396.1,395,394,394,865,851,91.6313559322034,14,11
2016,202348,Jordan Crawford,Jordan Crawford,19,19,1014,1025,2039,218,224.25,442.25,442,442,442,1031,1017,101.676528599606,14,16
2016,1626169,Stanley Johnson,Stanley Johnson,77,77,3180,3056,6236,685.466666666667,682.8,1368.26666666667,1374,1371,1371,2898,2884,91.1320754716981,14,3
2016,203934,Lamar Patterson,Lamar Patterson,5,5,91,90,181,17.85,22.6666666666667,40.5166666666667,41,40,40,79,66,86.8131868131868,13,13
2016,1627734,Domantas Sabonis,Domantas Sabonis,81,81,3824,3755,7579,764.616666666667,847.866666666667,1612.48333333333,1631,1632,1632,3426,3414,89.592050209205,12,18
2016,1627762,Joel Bolomboy,Joel Bolomboy,12,12,119,120,239,26.4333333333333,25.2666666666667,51.7,54,53,53,113,101,94.9579831932773,12,14
2016,101249,John Lucas III,John Lucas III,5,5,24,25,49,5.98333333333333,4.05,10.0333333333333,10,11,11,26,16,108.333333333333,10,12
2016,204002,Edy Tavares,Edy Tavares,2,2,65,58,123,13.7833333333333,13.5333333333333,27.3166666666667,28,28,28,57,47,87.6923076923077,10,10
2016,1626168,Trey Lyles,Trey Lyles,71,71,2571,2567,5138,591.133333333333,563.133333333333,1154.26666666667,1160,1158,1158,2359,2349,91.754181252431,10,26
2016,1626210,Alan Williams,Alan Williams,47,47,1768,1734,3502,337.85,368.583333333333,706.433333333333,705,708,708,1620,1610,91.6289592760181,10,2
2016,1627751,Jakob Poeltl,Jakob Poeltl,54,54,1446,1402,2848,318.033333333333,306.95,624.983333333333,624,626,626,1291,1281,89.2807745504841,10,-8
2016,2365,Chris Andersen,Chris Andersen,12,12,256,282,538,53.55,59.2166666666667,112.766666666667,115,114,114,262,253,102.34375,9,8
2016,201941,Jordan Hill,Jordan Hill,7,7,104,108,212,21.9,23.5833333333333,45.4833333333333,48,47,47,94,85,90.3846153846154,9,12
2016,1626179,Terry Rozier,Terry Rozier,74,74,2916,2944,5860,634.6,628.15,1262.75,1269,1263,1263,2670,2661,91.5637860082304,9,-13
2016,202357,Nemanja Bjelica,Nemanja Bjelica,64,65,2740,2714,5454,594.05,581.933333333333,1175.98333333333,1189,1190,1190,2508,2500,91.5328467153285,8,-13
2016,202362,Lance Stephenson,Lance Stephenson,18,18,843,826,1669,182.766666666667,178.616666666667,361.383333333333,362,361,361,752,744,89.2052194543298,8,10
2016,203527,Ryan Kelly,Ryan Kelly,16,16,243,253,496,51.4333333333333,57.3833333333333,108.816666666667,111,110,110,220,212,90.5349794238683,8,4
2016,203894,Shabazz Napier,Shabazz Napier,51,53,1123,1166,2289,260.116666666667,248.883333333333,509,514,512,512,1115,1107,99.2876224398931,8,17
2016,1626254,Maurice Ndour,Maurice Ndour,32,32,781,751,1532,160.95,167.95,328.9,334,331,331,703,695,90.0128040973111,8,-2
2016,1627850,Marshall Plumlee,Marshall Plumlee,21,21,416,403,819,85.5833333333333,83.9166666666667,169.5,171,170,170,382,374,91.8269230769231,8,-3
2016,101123,Gerald Green,Gerald Green,47,47,1231,1257,2488,264.383333333333,270.65,535.033333333333,539,538,538,1177,1170,95.6133225020309,7,9
2016,202683,Enes Kanter,Enes Kanter,72,72,3682,3568,7250,747.466666666667,783.25,1530.71666666667,1534,1533,1533,3413,3406,92.6941879413362,7,52
2016,203098,John Jenkins,John Jenkins,4,4,35,29,64,5.38333333333334,6.85,12.2333333333333,13,13,13,37,30,105.714285714286,7,9
2016,1627744,Brice Johnson,Brice Johnson,3,3,20,20,40,3.66666666666667,4.93333333333333,8.6,10,9,9,22,15,110,7,7
2016,203940,Adreian Payne,Adreian Payne,18,18,326,318,644,67.6666666666667,65.9166666666667,133.583333333333,134,135,135,284,278,87.1165644171779,6,9
2016,203585,Rodney McGruder,Rodney McGruder,78,78,4489,4475,8964,1003.23333333333,952.983333333333,1956.21666666667,1965,1966,1966,4173,4168,92.9605702829138,5,7
2016,1627749,Dejounte Murray,Dejounte Murray,37,38,711,742,1453,159.383333333333,157.5,316.883333333333,318,322,322,662,657,93.1082981715893,5,1
2016,1627756,Denzel Valentine,Denzel Valentine,57,57,2259,2260,4519,484.533333333333,489.016666666667,973.55,975,976,976,2082,2077,92.1646746347942,5,-18
2016,202087,Alonzo Gee,Alonzo Gee,12,13,214,227,441,44.1,44.4833333333333,88.5833333333333,87,89,89,212,208,99.0654205607477,4,-18
2016,202337,Luke Babbitt,Luke Babbitt,68,68,2385,2444,4829,530.633333333333,526.6,1057.23333333333,1067,1065,1065,2197,2194,92.1174004192872,3,-10
2016,203476,Gorgui Dieng,Gorgui Dieng,81,82,6071,5912,11983,1347.83333333333,1267.55,2615.38333333333,2656,2653,2653,5709,5706,94.0372261571405,3,32
2016,203962,Josh Huestis,Josh Huestis,2,2,79,72,151,15.4,15.4,30.8,31,31,31,77,74,97.4683544303798,3,3
2016,203998,Bruno Caboclo,Bruno Caboclo,8,9,97,95,192,20.9,18.5166666666667,39.4166666666667,40,40,40,78,75,80.4123711340206,3,1
2016,1627740,Henry Ellenson,Henry Ellenson,19,19,341,332,673,73.8,70.9833333333333,144.783333333333,145,146,146,304,301,89.1495601173021,3,-3
2016,2563,Dahntay Jones,Dahntay Jones,1,1,29,23,52,6.63333333333333,5.3,11.9333333333333,12,12,12,25,23,86.2068965517242,2,2
2016,203950,Jarnell Stokes,Jarnell Stokes,2,2,18,16,34,2.9,3.81666666666666,6.71666666666666,7,7,7,17,16,94.4444444444444,1,0
2016,1626148,Anthony Brown,Anthony Brown,11,11,358,360,718,74.1333333333333,82.3,156.433333333333,159,159,159,319,318,89.1061452513967,1,4
2016,2564,Boris Diaw,Boris Diaw,73,73,2774,2798,5572,663.45,614.1,1277.55,1287,1283,1283,2608,2608,94.0158615717376,0,18
2016,202692,Alec Burks,Alec Burks,42,42,1493,1458,2951,336.916666666667,316.166666666667,653.083333333333,656,653,653,1368,1368,91.6275954454119,0,0
2016,1627863,Danuel House Jr.,"",1,,1,1,2,0.316666666666667,0.366666666666667,0.683333333333334,1,,,0,0,0,0,0
2016,1627777,Georges Niang,Georges Niang,22,23,227,214,441,45.4166666666667,43.65,89.0666666666667,94,93,93,199,200,87.6651982378855,-1,3
2016,203092,Tyler Zeller,Tyler Zeller,51,51,1229,1262,2491,258.566666666667,269.383333333333,527.95,525,525,525,1148,1150,93.4092758340114,-2,-4
2016,1627771,Michael Gbinije,Michael Gbinije,9,9,75,71,146,16.6166666666667,14.8166666666667,31.4333333333333,31,32,32,69,71,92,-2,-3
2016,201627,Anthony Morrow,Anthony Morrow,49,49,1753,1679,3432,349.8,364.55,714.35,711,714,714,1571,1574,89.6177980604678,-3,21
2016,202336,Larry Sanders,Larry Sanders,5,5,30,31,61,6.13333333333334,6.08333333333334,12.2166666666667,12,13,13,25,28,83.3333333333333,-3,-1
2016,1627752,Taurean Prince,Taurean Waller-Prince,59,59,2331,2309,4640,477.166666666667,500.516666666667,977.683333333333,982,981,981,2011,2014,86.2719862719863,-3,-29
2016,2037,Jamal Crawford,Jamal Crawford,82,82,4976,4990,9966,1106.71666666667,1043.1,2149.81666666667,2158,2157,2157,4755,4759,95.5586816720257,-4,21
2016,203487,Michael Carter-Williams,Michael Carter-Williams,45,45,2015,1935,3950,428.533333333333,417.25,845.783333333333,845,846,846,1801,1805,89.3796526054591,-4,-28
2016,204067,Jarell Eddie,Jarell Eddie,5,5,155,162,317,29.6,31.2333333333333,60.8333333333334,62,62,62,127,131,81.9354838709677,-4,-5
2016,1627743,Demetrius Jackson,Demetrius Jackson,3,5,39,38,77,6.51666666666667,9.15,15.6666666666667,17,17,17,37,41,94.8717948717949,-4,1
2016,1626151,Aaron Harrison,Aaron Harrison,5,5,33,35,68,7.78333333333334,8.38333333333333,16.1666666666667,16,17,17,27,32,81.8181818181818,-5,-5
2016,1627817,Tim Quarterman,Tim Quarterman,15,16,183,195,378,39.55,38.2333333333333,77.7833333333333,79,80,80,162,167,88.5245901639344,-5,1
2016,101127,Jarrett Jack,Jarrett Jack,2,2,77,73,150,15.4833333333333,17.2833333333333,32.7666666666667,33,33,33,61,67,79.2207792207792,-6,-6
2016,200779,Steve Novak,Steve Novak,8,8,41,49,90,10.1333333333333,11,21.1333333333333,24,22,22,39,45,95.1219512195122,-6,0
2016,202407,Elijah Millsap,Elijah Millsap,2,2,51,55,106,11.1,11.8,22.9,23,23,23,39,45,76.4705882352941,-6,-6
2016,1626196,Josh Richardson,Josh Richardson,53,53,3708,3696,7404,824.616666666667,788.183333333333,1612.8,1615,1614,1614,3403,3409,91.7745415318231,-6,8
2016,101141,Ersan Ilyasova,Ersan Ilyasova,82,82,5105,5136,10241,1052.21666666667,1083.36666666667,2135.58333333333,2143,2142,2142,4651,4658,91.1067580803134,-7,-29
2016,200770,Jordan Farmar,Jordan Farmar,2,2,79,88,167,17.2333333333333,17.9333333333333,35.1666666666667,36,35,35,81,88,102.53164556962,-7,-1
2016,202390,Gary Neal,Gary Neal,2,2,45,40,85,8.3,9.95,18.25,19,18,18,31,38,68.8888888888889,-7,-5
2016,202712,Justin Harper,Justin Harper,3,3,67,68,135,13.8333333333333,13.7,27.5333333333333,32,31,31,57,64,85.0746268656716,-7,-11
2016,202714,Shelvin Mack,Shelvin Mack,55,55,2646,2659,5305,623.616666666667,578.8,1202.41666666667,1204,1205,1205,2459,2466,92.9327286470144,-7,16
2016,1626150,Andrew Harrison,Andrew Harrison,72,72,3322,3308,6630,776.616666666667,696.533333333333,1473.15,1474,1474,1474,2983,2990,89.7953040337146,-7,-26
2016,1627773,AJ Hammons,A.J. Hammons,21,22,372,370,742,81.6166666666667,78,159.616666666667,160,163,163,333,341,89.5161290322581,-8,-5
2016,2034,Mike Miller,Mike Miller,20,20,362,352,714,71.2166666666667,77.3166666666667,148.533333333333,152,151,151,338,347,93.3701657458564,-9,-5
2016,200826,J.J. Barea,J.J. Barea,35,35,1668,1701,3369,398.616666666667,371,769.616666666667,770,771,771,1579,1588,94.6642685851319,-9,10
2016,1626245,Cristiano Felicio,Cristiano Felicio,66,66,2415,2375,4790,510.15,527.8,1037.95,1039,1040,1040,2165,2174,89.648033126294,-9,-34
2016,1626253,Axel Toupane,Axel Toupane,4,4,105,117,222,22.85,24.5,47.35,49,47,47,92,101,87.6190476190476,-9,-11
2016,202708,Norris Cole,Norris Cole,13,13,299,284,583,59.2833333333334,63.4666666666667,122.75,124,125,125,256,266,85.61872909699,-10,-16
2016,1626154,RJ Hunter,R.J. Hunter,3,3,24,23,47,4.4,4.68333333333333,9.08333333333333,10,9,9,5,15,20.8333333333333,-10,-10
2016,201163,Wilson Chandler,Wilson Chandler,71,71,5299,5132,10431,1099.7,1094.23333333333,2193.93333333333,2194,2197,2197,5097,5108,96.1879599924514,-11,-34
2016,203482,Kelly Olynyk,Kelly Olynyk,75,75,3554,3623,7177,767.783333333333,770.4,1538.18333333333,1534,1538,1538,3305,3316,92.9938097917839,-11,16
2016,1626162,Kelly Oubre Jr.,Kelly Oubre,79,79,3720,3803,7523,787.5,808.25,1595.75,1608,1605,1605,3514,3525,94.4623655913979,-11,-42
2016,1627774,Jake Layman,Jake Layman,35,35,575,595,1170,124.65,119.866666666667,244.516666666667,252,249,249,511,522,88.8695652173913,-11,-1
2016,1626184,Chasson Randle,Chasson Randle,26,26,709,705,1414,143.283333333333,153.416666666667,296.7,300,299,299,655,667,92.3836389280677,-12,-11
2016,1626145,Tyus Jones,Tyus Jones,57,60,1765,1750,3515,381.466666666667,366.4,747.866666666667,772,774,774,1675,1688,94.9008498583569,-13,34
2016,1627791,Ben Bentil,Ben Bentil,3,3,22,27,49,5.21666666666667,4.76666666666667,9.98333333333333,10,10,10,19,32,86.3636363636364,-13,-12
2016,202349,Greivis Vasquez,Greivis Vasquez,3,3,93,93,186,19.7,18.7833333333333,38.4833333333333,39,39,39,80,94,86.0215053763441,-14,-13
2016,202620,Arinze Onuaku,Arinze Onuaku,8,8,61,62,123,13.7666666666667,14.1,27.8666666666667,29,28,28,48,62,78.6885245901639,-14,-15
2016,1627868,Patricio Garino,Patricio Garino,5,5,96,99,195,23.7166666666667,18.8166666666667,42.5333333333333,43,43,43,82,96,85.4166666666667,-14,-14
2016,201168,Tiago Splitter,Tiago Splitter,8,8,199,184,383,39.6333333333333,37.2,76.8333333333333,77,76,76,167,182,83.9195979899498,-15,-4
2016,201202,Joel Anthony,Joel Anthony,18,19,276,273,549,62.75,57.6666666666667,120.416666666667,123,122,122,232,247,84.0579710144928,-15,-13
2016,1626159,Justise Winslow,Justise Winslow,18,18,1429,1439,2868,313.116666666667,310.516666666667,623.633333333333,627,625,625,1282,1297,89.7130860741778,-15,-6
2016,202699,Tobias Harris,Tobias Harris,82,82,5865,5691,11556,1270.08333333333,1281.81666666667,2551.9,2566,2567,2567,5428,5444,92.5490196078431,-16,0
2016,203912,CJ Wilcox,C.J. Wilcox,22,22,258,248,506,51.7333333333333,53.3666666666667,105.1,111,108,108,218,236,84.4961240310078,-18,-17
2016,1627861,Mike Tobey,Mike Tobey,2,2,48,53,101,13.4,11.7166666666667,25.1166666666667,25,25,25,32,50,66.6666666666667,-18,-17
2016,1627733,Dragan Bender,Dragan Bender,42,43,1352,1334,2686,269.966666666667,291.316666666667,561.283333333333,574,574,574,1245,1264,92.085798816568,-19,-25
2016,201158,Marco Belinelli,Marco Belinelli,74,74,4021,4034,8055,905.15,870.3,1775.45,1777,1778,1778,3893,3913,96.8167122606317,-20,43
2016,1627775,Patrick McCaw,Patrick McCaw,70,71,2590,2619,5209,525.133333333333,548.016666666667,1073.15,1077,1074,1074,2398,2418,92.5868725868726,-20,-37
2016,1627781,Malachi Richardson,Malachi Richardson,22,22,442,447,889,99.6666666666667,96.1833333333333,195.85,198,198,198,396,416,89.5927601809955,-20,-17
2016,201937,Ricky Rubio,Ricky Rubio,74,75,5690,5543,11233,1256.48333333333,1181.33333333333,2437.81666666667,2468,2469,2469,5387,5408,94.6748681898067,-21,-7
2016,202412,Manny Harris,Manny Harris,4,4,66,58,124,12.7,11.8166666666667,24.5166666666667,25,25,25,43,64,65.1515151515152,-21,-21
2016,1626257,Salah Mejri,Salah Mejri,73,73,1949,1956,3905,478.55,428.983333333333,907.533333333333,905,905,905,1775,1796,91.0723447922011,-21,-18
2016,1627819,Isaiah Taylor,Isaiah Taylor,4,4,124,132,256,25.7166666666667,25.9166666666667,51.6333333333333,52,52,52,118,139,95.1612903225806,-21,-19
2016,203552,Seth Curry,Seth Curry,70,70,4347,4413,8760,1066.5,959.6,2026.1,2029,2029,2029,4144,4166,95.3301127214171,-22,-37
2016,1627748,Thon Maker,Thon Maker,56,57,1208,1244,2452,268.35,285.633333333333,553.983333333333,565,562,562,1158,1180,95.8609271523179,-22,-27
2016,201573,Jerryd Bayless,Jerryd Bayless,3,3,164,171,335,36.2666666666667,35.2333333333333,71.5,71,71,71,134,157,81.7073170731707,-23,-21
2016,1627761,DeAndre' Bembry,DeAndre' Bembry,37,38,846,845,1691,182.983333333333,185.2,368.183333333333,370,371,371,761,784,89.9527186761229,-23,-47
2016,101145,Monta Ellis,Monta Ellis,74,74,4513,4653,9166,997.633333333333,991.466666666667,1989.1,1997,1998,1998,4339,4363,96.1444715267007,-24,-70
2016,1627875,Marcus Georges-Hunt,Marcus Georges-Hunt,5,5,109,112,221,25.6333333333333,21.5833333333333,47.2166666666667,47,48,48,90,114,82.5688073394495,-24,-27
2016,2216,Zach Randolph,Zach Randolph,73,73,4094,3925,8019,949.666666666667,840.183333333333,1789.85,1786,1786,1786,3661,3686,89.4235466536395,-25,75
2016,2756,Sasha Vujacic,Sasha Vujacic,42,42,975,958,1933,205.15,204.883333333333,410.033333333333,408,408,408,848,873,86.974358974359,-25,-9
2016,201160,Jason Smith,Jason Smith,74,74,2494,2526,5020,532.85,540.783333333333,1073.63333333333,1067,1068,1068,2344,2369,93.9855653568565,-25,-10
2016,202332,Cole Aldrich,Cole Aldrich,61,62,1207,1182,2389,257.733333333333,255.583333333333,513.316666666667,535,531,531,1120,1145,92.7920463960232,-25,-31
2016,202130,Reggie Williams,Reggie Williams,6,6,203,179,382,40.5666666666667,39.5666666666667,80.1333333333333,79,79,79,155,181,76.3546798029557,-26,-24
2016,1626188,Quinn Cook,Quinn Cook,13,14,402,412,814,90.6333333333333,87.8,178.433333333333,188,188,188,393,419,97.7611940298507,-26,-41
2016,1627745,Damian Jones,Damian Jones,10,10,200,193,393,43.3166666666667,41.1333333333333,84.45,86,85,85,158,184,79,-26,-28
2016,1627816,Alex Poythress,Alex Poythress,6,6,380,376,756,76.1833333333333,80.4666666666667,156.65,157,157,157,347,373,91.3157894736842,-26,-35
2016,203948,Johnny O'Bryant III,Johnny O'Bryant,11,11,190,185,375,41.6,41.6666666666667,83.2666666666667,81,80,80,178,205,93.6842105263158,-27,-26
2016,1626172,Kevon Looney,Kevon Looney,53,53,1087,1093,2180,226.483333333333,217.766666666667,444.25,445,447,447,966,993,88.8684452621895,-27,-19
2016,1627823,Juancho Hernangomez,"",62,,2060,1969,4029,412.566666666667,426.633333333333,839.2,841,,,1942,1969,94.2718446601942,-27,-34
2016,1627851,Mindaugas Kuzminskas,Mindaugas Kuzminskas,68,68,2446,2414,4860,506.966666666667,511,1017.96666666667,1019,1016,1016,2204,2231,90.1062959934587,-27,-3
2016,203087,Jeremy Lamb,Jeremy Lamb,62,62,2574,2572,5146,591.783333333333,546.933333333333,1138.71666666667,1142,1143,1143,2455,2483,95.3768453768454,-28,-40
2016,1626192,Pat Connaughton,Pat Connaughton,39,39,712,724,1436,159.633333333333,151.6,311.233333333333,318,316,316,666,694,93.5393258426966,-28,-17
2016,1627738,Deyonta Davis,Deyonta Davis,34,36,549,546,1095,119.183333333333,116.716666666667,235.9,237,238,238,469,497,85.4280510018215,-28,-42
2016,201628,Bobby Brown,Bobby Brown,24,25,291,308,599,61.1666666666667,59.5166666666667,120.683333333333,124,123,123,279,309,95.8762886597938,-30,-34
2016,204028,Tarik Black,Tarik Black,67,67,2644,2559,5203,537.533333333333,548.483333333333,1086.01666666667,1090,1091,1091,2357,2387,89.1452344931921,-30,-49
2016,1627754,Diamond Stone,Diamond Stone,7,7,51,58,109,12.7166666666667,11.0833333333333,23.8,25,24,24,29,59,56.8627450980392,-30,-27
2016,2760,Anderson Varejao,Anderson Varejao,14,14,224,224,448,45.2166666666667,46.5833333333333,91.8,91,92,92,193,224,86.1607142857143,-31,-30
2016,201589,Darrell Arthur,Darrell Arthur,41,41,1480,1492,2972,310.616666666667,326.883333333333,637.5,641,639,639,1422,1454,96.0810810810811,-32,-22
2016,203200,Justin Holiday,Justin Holiday,82,82,3887,3863,7750,816.8,829.15,1645.95,1635,1639,1639,3524,3556,90.6611782865964,-32,-41
2016,203089,John Henson,John Henson,58,58,2557,2597,5154,550.566666666667,565.45,1116.01666666667,1124,1123,1123,2375,2408,92.8822839264763,-33,-52
2016,203481,Jeff Withey,Jeff Withey,51,51,980,991,1971,224.566666666667,207.233333333333,431.8,431,432,432,921,954,93.9795918367347,-33,-21
2016,203909,KJ McDaniels,K.J. McDaniels,49,49,1207,1215,2422,245.9,258.05,503.95,506,505,505,1115,1148,92.3777961888981,-33,-44
2016,203949,James Michael McAdoo,James Michael McAdoo,52,52,1072,1111,2183,223.783333333333,229.633333333333,453.416666666667,458,457,457,946,980,88.2462686567164,-34,-40
2016,101106,Andrew Bogut,Andrew Bogut,27,27,1236,1268,2504,310.283333333333,271.6,581.883333333333,584,583,583,1062,1097,85.9223300970874,-35,-34
2016,203118,Mike Scott,Mike Scott,18,18,440,451,891,90.95,100.933333333333,191.883333333333,198,195,195,375,410,85.2272727272727,-35,-42
2016,1627757,Stephen Zimmerman,Stephen Zimmerman,19,19,247,248,495,53.0166666666667,53.4,106.416666666667,110,108,108,208,243,84.2105263157895,-35,-40
2016,1627783,Pascal Siakam,Pascal Siakam,55,55,1942,1964,3906,430.983333333333,421.116666666667,852.1,860,859,859,1816,1851,93.5118434603502,-35,-53
2016,1627849,Daniel Ochefu,Daniel Ochefu,19,19,172,176,348,38.0166666666667,36.6166666666667,74.6333333333334,76,75,75,154,189,89.5348837209303,-35,-28
2016,101107,Marvin Williams,Marvin Williams,76,76,5185,5153,10338,1154.03333333333,1122.5,2276.53333333333,2298,2295,2295,4910,4946,94.6962391513983,-36,-31
2016,1626203,Treveon Graham,Treveon Graham,27,27,419,422,841,98.2666666666667,91.4333333333333,189.7,187,189,189,366,402,87.3508353221957,-36,-39
2016,1627787,Kyle Wiltjer,Kyle Wiltjer,14,14,107,116,223,22.2,21.05,43.25,45,44,44,82,118,76.6355140186916,-36,-38
2016,201578,Marreese Speights,Marreese Speights,82,82,2889,2981,5870,655.033333333333,628.05,1283.08333333333,1285,1286,1286,2776,2813,96.0886119764625,-37,-32
2016,203952,Andrew Wiggins,Andrew Wiggins,81,82,7080,6870,13950,1549.25,1460.83333333333,3010.08333333333,3050,3048,3048,6741,6778,95.2118644067797,-37,-17
2016,1627782,Wayne Selden,Wayne Selden,14,14,498,535,1033,119.766666666667,114.783333333333,234.55,236,236,236,457,494,91.7670682730924,-37,-42
2016,200782,PJ Tucker,P.J. Tucker,80,81,5309,5201,10510,1100.1,1108.06666666667,2208.16666666667,2234,2236,2236,4871,4909,91.7498587304577,-38,-77
2016,203462,Archie Goodwin,Archie Goodwin,15,15,490,517,1007,102.883333333333,109.283333333333,212.166666666667,213,214,214,453,492,92.4489795918367,-39,-36
2016,1626273,Marcelo Huertas,Marcelo Huertas,23,23,562,555,1117,116.15,119.2,235.35,238,237,237,514,553,91.4590747330961,-39,-43
2016,2555,Nick Collison,Nick Collison,20,20,311,302,613,62.4833333333333,65.5833333333333,128.066666666667,128,128,128,231,271,74.2765273311897,-40,-39
2016,1627879,Nicolas Laprovittola,Nicolas Laprovittola,18,18,382,402,784,89.6333333333333,84.4333333333333,174.066666666667,173,174,174,328,368,85.8638743455497,-40,-44
2016,1627834,Georgios Papagiannis,Georgios Papagiannis,22,22,808,820,1628,179.766666666667,176.35,356.116666666667,355,355,355,762,803,94.3069306930693,-41,-30
2016,203498,Shabazz Muhammad,Shabazz Muhammad,77,78,3550,3460,7010,766.233333333333,739.9,1506.13333333333,1515,1516,1516,3258,3300,91.7746478873239,-42,-76
2016,201166,Aaron Brooks,Aaron Brooks,65,65,2035,2031,4066,457.933333333333,430.666666666667,888.6,893,894,894,1832,1876,90.02457002457,-44,-33
2016,203096,Jared Sullinger,Jared Sullinger,11,11,270,263,533,62.25,55.9833333333333,118.233333333333,119,118,118,210,254,77.7777777777778,-44,-29
2016,1627778,Chinanu Onuaku,Chinanu Onuaku,5,5,121,125,246,25.8833333333333,25.0166666666667,50.9,50,52,52,108,152,89.2561983471074,-44,-45
2016,101179,Ronnie Price,Ronnie Price,14,14,335,327,662,64.2166666666667,69.8333333333333,134.05,135,134,134,275,320,82.089552238806,-45,-43
2016,201155,Rodney Stuckey,Rodney Stuckey,39,39,1583,1612,3195,354.933333333333,342.566666666667,697.5,692,696,696,1467,1513,92.6721415034744,-46,-33
2016,202718,Chandler Parsons,Chandler Parsons,34,34,1482,1478,2960,351.466666666667,318.066666666667,669.533333333333,675,675,675,1368,1414,92.3076923076923,-46,-47
2016,203926,Doug McDermott,Doug McDermott,66,66,3568,3430,6998,747.733333333333,755.666666666667,1503.4,1507,1508,1508,3253,3299,91.1715246636771,-46,-29
2016,1627770,Kay Felder,Kay Felder,42,42,855,901,1756,186.45,192.366666666667,378.816666666667,386,386,386,794,840,92.8654970760234,-46,-52
2016,203112,Quincy Acy,Quincy Acy,38,38,1323,1324,2647,275.35,281.716666666667,557.066666666667,559,558,558,1215,1262,91.8367346938775,-47,-39
2016,1626176,Rakeem Christmas,Rakeem Christmas,28,29,524,515,1039,111.05,107.216666666667,218.266666666667,217,219,219,441,489,84.1603053435115,-48,-34
2016,201967,Dante Cunningham,Dante Cunningham,66,66,3823,3888,7711,798.6,851.566666666667,1650.16666666667,1648,1649,1649,3626,3675,94.846978812451,-49,-51
2016,203923,James Young,James Young,29,29,510,520,1030,109.616666666667,108.433333333333,218.05,221,220,220,455,504,89.2156862745098,-49,-38
2016,1897,Metta World Peace,Metta World Peace,25,25,373,359,732,79.2833333333334,79.6333333333333,158.916666666667,162,160,160,308,358,82.573726541555,-50,-59
2016,200757,Thabo Sefolosha,Thabo Sefolosha,62,62,3741,3756,7497,786.266666666667,810.4,1596.66666666667,1595,1596,1596,3397,3447,90.8045977011494,-50,-65
2016,201579,Roy Hibbert,Roy Hibbert,48,48,1570,1601,3171,345.45,334.316666666667,679.766666666667,684,682,682,1450,1500,92.3566878980892,-50,-22
2016,203148,Brian Roberts,Brian Roberts,41,41,903,901,1804,215.85,197.683333333333,413.533333333333,412,416,416,813,863,90.0332225913621,-50,-55
2016,1627758,Ron Baker,Ron Baker,52,52,1983,1971,3954,425.116666666667,430.466666666667,855.583333333333,858,857,857,1793,1843,90.4185577407968,-50,-55
2016,1627767,Cheick Diallo,Cheick Diallo,15,17,459,471,930,93.1,99.15,192.25,198,199,199,418,468,91.0675381263617,-50,-53
2016,1627789,Timothe Luwawu-Cabarrot,Timothe Luwawu-Cabarrot,69,69,2821,2860,5681,580.7,604.183333333333,1184.88333333333,1189,1190,1190,2564,2614,90.8897554058844,-50,-58
2016,2440,Matt Barnes,Matt Barnes,74,74,4083,4109,8192,897.216666666667,879.133333333333,1776.35,1780,1777,1777,3807,3859,93.2402645113887,-52,-66
2016,202326,DeMarcus Cousins,DeMarcus Cousins,72,72,5636,5575,11211,1262.61666666667,1197.48333333333,2460.1,2466,2465,2465,5330,5382,94.5706174591909,-52,-28
2016,202325,Wesley Johnson,Wesley Johnson,68,68,1824,1884,3708,404.383333333333,399.866666666667,804.25,818,810,810,1683,1736,92.2697368421053,-53,-56
2016,201582,Alexis Ajinca,Alexis Ajinca,39,39,1364,1408,2772,281.466666666667,303.7,585.166666666667,584,584,584,1227,1282,89.9560117302053,-55,-59
2016,1627362,Briante Weber,Briante Weber,20,20,449,440,889,108.166666666667,95.9833333333333,204.15,206,205,205,399,454,88.8641425389755,-55,-50
2016,2399,Mike Dunleavy,Mike Dunleavy,53,53,1936,1945,3881,416.366666666667,421.866666666667,838.233333333333,845,841,841,1703,1759,87.9648760330579,-56,-36
2016,201600,Omer Asik,Omer Asik,31,31,1132,1136,2268,239.983333333333,239.9,479.883333333333,483,482,482,988,1045,87.2791519434629,-57,-60
2016,203518,Alex Abrines,Alex Abrines,68,68,2583,2493,5076,515.266666666667,536.633333333333,1051.9,1056,1055,1055,2363,2420,91.4827719705769,-57,-1
2016,1627780,Gary Payton II,Gary Payton II,6,6,220,223,443,49.6166666666667,48.6166666666667,98.2333333333333,100,99,99,176,233,80,-57,-58
2016,2743,Kris Humphries,Kris Humphries,56,56,1562,1573,3135,342.566666666667,338.916666666667,681.483333333333,689,689,689,1375,1433,88.0281690140845,-58,-67
2016,201563,Michael Beasley,Michael Beasley,56,56,2151,2176,4327,454.633333333333,475.583333333333,930.216666666667,934,935,935,2026,2084,94.1887494188749,-58,-41
2016,201943,Brandon Jennings,Brandon Jennings,81,81,4290,4302,8592,893,910.7,1803.7,1802,1802,1802,3981,4039,92.7972027972028,-58,-63
2016,1626175,Jordan Mickey,Jordan Mickey,23,25,327,322,649,65.4833333333333,73.7,139.183333333333,142,141,141,287,346,87.7675840978593,-59,-58
2016,1627746,Skal Labissiere,Skal Labissiere,33,33,1381,1408,2789,302.666666666667,300.633333333333,603.3,612,612,612,1270,1329,91.9623461259957,-59,-41
2016,201575,Brandon Rush,Brandon Rush,46,47,2368,2364,4732,531.1,489.866666666667,1020.96666666667,1031,1030,1030,2227,2287,94.0456081081081,-60,-40
2016,203895,Jordan McRae,Jordan McRae,37,37,856,894,1750,192.316666666667,185.966666666667,378.283333333333,385,384,384,813,873,94.9766355140187,-60,-60
2016,1627815,Sheldon Mac,Sheldon Mac,30,30,656,668,1324,137.483333333333,146.316666666667,283.8,287,287,287,562,622,85.6707317073171,-60,-55
2016,202702,Kenneth Faried,Kenneth Faried,61,61,3176,3045,6221,649.4,648.466666666667,1297.86666666667,1300,1296,1296,2996,3058,94.3324937027708,-62,-59
2016,1627784,Jarrod Uthoff,Jarrod Uthoff,9,9,259,261,520,57.05,56.7,113.75,116,115,115,214,276,82.6254826254826,-62,-62
2016,1627854,Bryn Forbes,Bryn Forbes,36,36,635,650,1285,143.566666666667,139.866666666667,283.433333333333,285,285,285,537,599,84.5669291338583,-62,-51
2016,101187,Alan Anderson,Alan Anderson,30,30,680,700,1380,160.95,146.266666666667,307.216666666667,309,308,308,638,701,93.8235294117647,-63,-77
2016,2571,Leandro Barbosa,Leandro Barbosa,66,67,2265,2284,4549,460.216666666667,490.166666666667,950.383333333333,960,963,963,2102,2166,92.80353200883,-64,-66
2016,1626157,Karl-Anthony Towns,Karl-Anthony Towns,81,82,7000,6803,13803,1537.7,1448.35,2986.05,3033,3030,3030,6644,6708,94.9142857142857,-64,-26
2016,203086,Meyers Leonard,Meyers Leonard,74,74,2792,2851,5643,627.783333333333,589.566666666667,1217.35,1224,1222,1222,2657,2722,95.1647564469914,-65,-28
2016,1626202,Joe Young,Joe Young,32,33,327,310,637,68.85,61.75,130.6,137,135,135,251,316,76.7584097859327,-65,-57
2016,202720,Jon Leuer,Jon Leuer,75,75,4492,4323,8815,965.816666666667,973.983333333333,1939.8,1943,1944,1944,4012,4078,89.3143365983972,-66,-75
2016,1626195,Willy Hernangomez,Willy Hernangomez,72,72,3121,3124,6245,659.7,658.816666666667,1318.51666666667,1324,1324,1324,2861,2928,91.6693367510413,-67,-59
2016,203922,Glenn Robinson III,Glenn Robinson III,69,69,3255,3351,6606,714.466666666667,706.316666666667,1420.78333333333,1426,1427,1427,3046,3115,93.57910906298,-69,-74
2016,1626185,Jarell Martin,Jarell Martin,42,42,1277,1294,2571,283.516666666667,270.816666666667,554.333333333333,555,558,558,1073,1142,84.0250587314017,-69,-69
2016,1627827,Dorian Finney-Smith,Dorian Finney-Smith,80,81,3540,3607,7147,847.433333333333,785.933333333333,1633.36666666667,1642,1642,1642,3318,3387,93.728813559322,-69,-120
2016,203488,Mike Muscala,Mike Muscala,70,70,2920,2876,5796,604.516666666667,635.05,1239.56666666667,1237,1237,1237,2634,2704,90.2054794520548,-70,-79
2016,204038,Langston Galloway,Langston Galloway,74,74,3452,3502,6954,724.533333333333,771.116666666667,1495.65,1494,1495,1495,3202,3272,92.7578215527231,-70,-59
2016,1626171,Bobby Portis,Bobby Portis,64,64,2321,2295,4616,499.533333333333,500.1,999.633333333333,1002,1000,1000,2084,2154,89.7888841016803,-70,-80
2016,2617,Udonis Haslem,Udonis Haslem,16,16,293,317,610,69.1666666666667,63.2333333333333,132.4,131,130,130,225,296,76.7918088737202,-71,-68
2016,203994,Jusuf Nurkic,Jusuf Nurkic,65,65,3351,3281,6632,696.833333333333,686.933333333333,1383.76666666667,1393,1391,1391,3030,3101,90.420769919427,-71,-52
2016,1627759,Jaylen Brown,Jaylen Brown,78,78,3063,3134,6197,659.633333333333,673.916666666667,1333.55,1342,1341,1341,2857,2928,93.2745674175645,-71,-124
2016,203477,Isaiah Canaan,Isaiah Canaan,39,39,1382,1368,2750,291.333333333333,300.1,591.433333333333,594,592,592,1200,1272,86.8306801736614,-72,-84
2016,203138,Hollis Thompson,Hollis Thompson,40,40,1728,1771,3499,379.966666666667,367.9,747.866666666667,753,752,752,1530,1603,88.5416666666667,-73,-73
2016,1627786,Troy Williams,Troy Williams,29,30,1279,1319,2598,277.6,274.683333333333,552.283333333333,557,557,557,1142,1215,89.2885066458171,-73,-76
2016,203521,Matthew Dellavedova,Matthew Dellavedova,76,76,4541,4586,9127,971.416666666667,1010.96666666667,1982.38333333333,1987,1986,1986,4268,4342,93.9881083461793,-74,-74
2016,201162,Jared Dudley,Jared Dudley,63,64,3259,3271,6530,652.483333333333,684.566666666667,1337.05,1364,1362,1362,2940,3015,90.2117213869285,-75,-44
2016,203101,Miles Plumlee,Miles Plumlee,45,45,1090,1119,2209,239.133333333333,244.216666666667,483.35,486,484,484,975,1050,89.4495412844037,-75,-65
2016,1626166,Cameron Payne,Cameron Payne,31,31,1077,1068,2145,225.833333333333,233.6,459.433333333333,464,462,462,921,996,85.5153203342618,-75,-70
2016,1717,Dirk Nowitzki,Dirk Nowitzki,54,54,3115,3174,6289,743.766666666667,678.2,1421.96666666667,1420,1424,1424,2971,3047,95.3772070626003,-76,-12
2016,203461,Anthony Bennett,Anthony Bennett,23,23,656,666,1322,126.266666666667,136.3,262.566666666667,265,264,264,613,689,93.4451219512195,-76,-68
2016,201975,Jodie Meeks,Jodie Meeks,36,36,1709,1721,3430,368.233333333333,367.466666666667,735.7,740,738,738,1619,1696,94.733762434172,-77,-100
2016,203115,Will Barton,Will Barton,60,60,4091,3962,8053,842.233333333333,857.15,1699.38333333333,1705,1705,1705,3835,3912,93.7423612808604,-77,-86
2016,203457,Nerlens Noel,Nerlens Noel,51,51,2371,2420,4791,522.45,516.116666666667,1038.56666666667,1045,1047,1047,2199,2276,92.7456769295656,-77,-85
2016,203530,Joffrey Lauvergne,Joffrey Lauvergne,70,70,2310,2268,4578,486.933333333333,494.4,981.333333333333,983,980,980,2091,2168,90.5194805194805,-77,-91
2016,204014,Damjan Rudez,Damjan Rudez,45,45,713,699,1412,156.45,152.6,309.05,312,314,314,619,696,86.8162692847125,-77,-76
2016,201177,Josh McRoberts,Josh McRoberts,22,22,839,836,1675,200.35,178.333333333333,378.683333333333,381,381,381,739,818,88.0810488676996,-79,-72
2016,202682,Derrick Williams,Derrick Williams,50,50,1805,1873,3678,405.6,395.766666666667,801.366666666667,803,804,804,1685,1764,93.3518005540166,-79,-60
2016,2199,Tyson Chandler,Tyson Chandler,46,47,3123,3086,6209,627.683333333333,652.416666666667,1280.1,1300,1298,1298,2904,2984,92.9875120076849,-80,-74
2016,101114,Deron Williams,Deron Williams,64,64,3580,3645,7225,856.666666666667,796.683333333333,1653.35,1658,1657,1657,3394,3475,94.804469273743,-81,-89
2016,203093,Terrence Jones,Terrence Jones,54,54,2918,2991,5909,620.083333333333,648.533333333333,1268.61666666667,1272,1270,1270,2715,2796,93.0431802604524,-81,-60
2016,202391,Jeremy Lin,Jeremy Lin,36,36,2158,2210,4368,425.616666666667,455.75,881.366666666667,882,883,883,2002,2085,92.7710843373494,-83,-84
2016,201956,Omri Casspi,Omri Casspi,36,36,1522,1466,2988,329.766666666667,310.483333333333,640.25,645,643,643,1371,1455,90.0788436268068,-84,-101
2016,1626173,Rashad Vaughn,Rashad Vaughn,41,41,1020,1047,2067,226.816666666667,228.05,454.866666666667,458,458,458,909,994,89.1176470588235,-85,-77
2016,201196,Ramon Sessions,Ramon Sessions,50,50,1889,1906,3795,410.25,400.25,810.5,810,811,811,1745,1833,92.3769190047644,-88,-80
2016,203943,Noah Vonleh,Noah Vonleh,74,74,2923,2930,5853,638.833333333333,621.233333333333,1260.06666666667,1267,1265,1265,2658,2746,90.9339719466302,-88,-87
2016,1626780,Jonathan Gibson,Jonathan Gibson,17,17,519,519,1038,116.316666666667,113.383333333333,229.7,231,231,231,456,545,87.8612716763006,-89,-83
2016,2592,James Jones,James Jones,48,48,821,891,1712,183.233333333333,191,374.233333333333,380,381,381,766,860,93.3008526187576,-94,-100
2016,1627739,Kris Dunn,Kris Dunn,77,78,3071,3005,6076,669.35,641.683333333333,1311.03333333333,1331,1333,1333,2795,2889,91.0126994464344,-94,-133
2016,1627785,Isaiah Whitehead,Isaiah Whitehead,73,73,3914,4007,7921,785.983333333333,848.566666666667,1634.55,1645,1643,1643,3627,3723,92.6673479816045,-96,-118
2016,200765,Rajon Rondo,Rajon Rondo,69,69,4321,4268,8589,926.666666666667,911.066666666667,1837.73333333333,1845,1843,1843,3907,4005,90.4188845174728,-98,-60
2016,202694,Marcus Morris,Marcus Morris,79,79,5940,5712,11652,1280.98333333333,1283.96666666667,2564.95,2567,2565,2565,5348,5447,90.03367003367,-99,-106
2016,203953,Jabari Parker,Jabari Parker,51,51,3972,4042,8014,840.183333333333,885,1725.18333333333,1728,1728,1728,3775,3874,95.0402819738167,-99,-85
2016,2449,Luis Scola,Luis Scola,36,36,1106,1120,2226,222.8,234.733333333333,457.533333333333,465,461,461,1001,1101,90.5063291139241,-100,-83
2016,1627747,Caris LeVert,Caris LeVert,57,57,2989,3046,6035,592.083333333333,639.383333333333,1231.46666666667,1233,1237,1237,2815,2915,94.1786550685848,-100,-91
2016,202338,Kevin Seraphin,Kevin Seraphin,48,49,1276,1290,2566,282.7,273.066666666667,555.766666666667,561,559,559,1157,1258,90.6739811912226,-101,-101
2016,2548,Dwyane Wade,Dwyane Wade,60,60,4237,4115,8352,902.783333333333,880.633333333333,1783.41666666667,1793,1792,1792,3748,3850,88.4588151994336,-102,-73
2016,101181,Jose Calderon,Jose Calderon,41,41,1271,1228,2499,270.616666666667,263.116666666667,533.733333333333,539,539,539,1059,1161,83.3202202989772,-102,-104
2016,203145,Kent Bazemore,Kent Bazemore,73,73,4638,4675,9313,949.7,1002.75,1952.45,1963,1963,1963,4194,4296,90.4269081500647,-102,-106
2016,1627812,Yogi Ferrell,Yogi Ferrell,46,46,2637,2684,5321,618.116666666667,576.35,1194.46666666667,1201,1197,1197,2495,2597,94.6150929086083,-102,-117
2016,2730,Dwight Howard,Dwight Howard,74,74,5205,5159,10364,1069.05,1123.71666666667,2192.76666666667,2195,2199,2199,4602,4705,88.4149855907781,-103,-112
2016,202700,Donatas Motiejunas,Donatas Motiejunas,34,34,1114,1119,2233,230.616666666667,242.65,473.266666666667,479,479,479,1024,1127,91.9210053859964,-103,-121
2016,202334,Ed Davis,Ed Davis,46,46,1852,1830,3682,399.166666666667,391.416666666667,790.583333333333,786,789,789,1697,1803,91.6306695464363,-106,-129
2016,2744,Al Jefferson,Al Jefferson,66,66,2117,2126,4243,491.283333333333,437.75,929.033333333333,932,931,931,1927,2034,91.0250354274917,-107,-99
2016,203080,Thomas Robinson,Thomas Robinson,48,48,1337,1309,2646,274.333333333333,283.1,557.433333333333,559,560,560,1193,1300,89.2296185489903,-107,-84
2016,204001,Kristaps Porzingis,Kristaps Porzingis,66,66,5067,5098,10165,1080.01666666667,1077.73333333333,2157.75,2166,2164,2164,4675,4782,92.2636668640221,-107,-99
2016,203503,Tony Snell,Tony Snell,80,80,5242,5380,10622,1150,1180.15,2330.15,2336,2336,2336,5014,5122,95.6505150705838,-108,-117
2016,204025,Tim Frazier,Tim Frazier,65,65,3555,3586,7141,744.516666666667,777.1,1521.61666666667,1523,1525,1525,3289,3400,92.5175808720113,-111,-86
2016,201229,Anthony Tolliver,Anthony Tolliver,65,65,3376,3382,6758,763.233333333333,715.766666666667,1479,1481,1477,1477,3208,3320,95.0236966824645,-112,-99
2016,203471,Dennis Schroder,Dennis Schroder,79,79,5879,5903,11782,1214.75,1259.93333333333,2474.68333333333,2488,2485,2485,5341,5453,90.8487838067699,-112,-76
2016,1627852,Nicolas Brussino,Nicolas Brussino,53,54,1174,1154,2328,261.783333333333,251.466666666667,513.25,521,521,521,1055,1172,89.8637137989779,-117,-107
2016,203924,Jerami Grant,Jerami Grant,80,80,3694,3613,7307,740.883333333333,788.966666666667,1529.85,1532,1531,1531,3345,3464,90.5522468868435,-119,-187
2016,203915,Spencer Dinwiddie,Spencer Dinwiddie,59,59,3122,3176,6298,650.65,679.383333333333,1330.03333333333,1332,1334,1334,2871,2991,91.9602818705958,-120,-131
2016,203094,Andrew Nicholson,Andrew Nicholson,38,38,774,810,1584,171.216666666667,170.4,341.616666666667,342,342,342,674,797,87.0801033591731,-123,-129
2016,203463,Ben McLemore,Ben McLemore,61,61,2671,2675,5346,599.3,571.983333333333,1171.28333333333,1177,1176,1176,2451,2574,91.7633845001872,-123,-135
2016,203084,Harrison Barnes,Harrison Barnes,79,79,6015,6144,12159,1468.56666666667,1330.21666666667,2798.78333333333,2805,2803,2803,5670,5795,94.2643391521197,-125,-136
2016,203902,Semaj Christon,Semaj Christon,64,64,2259,2223,4482,477.05,491.4,968.45,972,973,973,2014,2140,89.1544931385569,-126,-141
2016,203496,Robert Covington,Robert Covington,67,67,5008,5027,10035,1056.2,1050.76666666667,2106.96666666667,2116,2119,2119,4465,4594,89.1573482428115,-129,-155
2016,201586,Serge Ibaka,Serge Ibaka,79,79,5520,5526,11046,1204.46666666667,1205.16666666667,2409.63333333333,2424,2422,2422,5124,5255,92.8260869565217,-131,-141
2016,202730,Lavoy Allen,Lavoy Allen,61,61,2038,2028,4066,450.616666666667,418.216666666667,868.833333333333,868,871,871,1831,1962,89.8429833169774,-131,-124
2016,202734,E'Twaun Moore,E'Twaun Moore,73,73,4232,4305,8537,889.233333333333,925.366666666667,1814.6,1816,1820,1820,3938,4070,93.0529300567108,-132,-111
2016,203932,Aaron Gordon,Aaron Gordon,80,80,5383,5352,10735,1125.61666666667,1162.38333333333,2288,2300,2298,2298,5013,5148,93.1265093813859,-135,-161
2016,1627735,Wade Baldwin IV,Wade Baldwin,33,33,910,927,1837,207.033333333333,192.766666666667,399.8,407,405,405,750,885,82.4175824175824,-135,-139
2016,201977,Marcus Thornton,Marcus Thornton,33,33,1343,1338,2681,290.45,285.383333333333,575.833333333333,576,575,575,1214,1350,90.3946388682055,-136,-145
2016,201149,Joakim Noah,Joakim Noah,46,46,2396,2377,4773,503.8,506.8,1010.6,1014,1015,1015,2162,2299,90.2337228714524,-137,-143
2016,201585,Kosta Koufos,Kosta Koufos,71,71,3199,3201,6400,731.4,679.333333333333,1410.73333333333,1415,1419,1419,2897,3034,90.559549859331,-137,-155
2016,101138,Brandon Bass,Brandon Bass,52,52,1291,1327,2618,293.75,279.2,572.95,574,577,577,1217,1356,94.2680092951201,-139,-145
2016,201951,Ty Lawson,Ty Lawson,69,69,3987,4056,8043,875.25,854.7,1729.95,1733,1732,1732,3710,3849,93.0524203661901,-139,-156
2016,1627755,Tyler Ulis,Tyler Ulis,60,61,2751,2718,5469,535.916666666667,567.333333333333,1103.25,1122,1123,1123,2455,2595,89.240276263177,-140,-142
2016,201954,Darren Collison,Darren Collison,68,68,4641,4657,9298,1067.5,992.533333333333,2060.03333333333,2068,2063,2063,4400,4541,94.807153630683,-141,-133
2016,203897,Zach LaVine,Zach LaVine,46,47,3950,3844,7794,862.833333333333,840.483333333333,1703.31666666667,1750,1749,1749,3643,3786,92.2278481012658,-143,-117
2016,201936,Tyreke Evans,Tyreke Evans,40,40,1785,1805,3590,387.85,393.233333333333,781.083333333333,788,788,788,1572,1716,88.0672268907563,-144,-151
2016,1626144,Emmanuel Mudiay,Emmanuel Mudiay,55,55,3422,3336,6758,698.7,704.083333333333,1402.78333333333,1411,1406,1406,3191,3335,93.249561659848,-144,-133
2016,1627826,Ivica Zubac,Ivica Zubac,38,38,1446,1507,2953,301.116666666667,304.916666666667,606.033333333333,611,609,609,1342,1486,92.8077455048409,-144,-135
2016,203504,Trey Burke,Trey Burke,57,57,1588,1632,3220,353.95,348.65,702.6,702,703,703,1409,1554,88.727959697733,-145,-161
2016,201565,Derrick Rose,Derrick Rose,64,64,4912,4925,9837,1048.55,1026.5,2075.05,2084,2082,2082,4606,4757,93.7703583061889,-151,-165
2016,203939,Dwight Powell,Dwight Powell,77,77,2923,2954,5877,684.2,644.75,1328.95,1329,1333,1333,2741,2892,93.7735203557988,-151,-168
2016,101109,Raymond Felton,Raymond Felton,80,80,3874,3981,7855,866.466666666667,829.95,1696.41666666667,1702,1700,1700,3641,3794,93.9855446566856,-153,-163
2016,203901,Elfrid Payton,Elfrid Payton,82,82,5693,5642,11335,1170.61666666667,1235.23333333333,2405.85,2415,2412,2412,5258,5413,92.3590374143685,-155,-146
2016,203484,Kentavious Caldwell-Pope,Kentavious Caldwell-Pope,76,76,5865,5676,11541,1251.63333333333,1275.15,2526.78333333333,2529,2529,2529,5357,5513,91.3384484228474,-156,-148
2016,200771,Sergio Rodriguez,Sergio Rodriguez,68,68,3552,3544,7096,762.6,747.783333333333,1510.38333333333,1517,1518,1518,3183,3341,89.6114864864865,-158,-137
2016,201150,Spencer Hawes,Spencer Hawes,54,54,1827,1864,3691,408.483333333333,388.083333333333,796.566666666667,797,797,797,1664,1824,91.0782703886152,-160,-174
2016,203124,Kyle O'Quinn,Kyle O'Quinn,79,79,2886,2877,5763,631.083333333333,601.116666666667,1232.2,1229,1229,1229,2576,2738,89.2584892584893,-162,-158
2016,202323,Evan Turner,Evan Turner,65,65,3826,3891,7717,840.783333333333,817.733333333333,1658.51666666667,1656,1658,1658,3529,3695,92.2373235755358,-166,-178
2016,1626204,Larry Nance Jr.,Larry Nance Jr.,63,63,3441,3411,6852,712.25,718.333333333333,1430.58333333333,1440,1442,1442,3110,3277,90.3807032839291,-167,-132
2016,202066,Garrett Temple,Garrett Temple,65,65,3931,3985,7916,873.883333333333,852.5,1726.38333333333,1727,1728,1728,3674,3842,93.4622233528364,-168,-178
2016,202696,Nikola Vucevic,Nikola Vucevic,75,75,5139,5057,10196,1054.11666666667,1102.91666666667,2157.03333333333,2161,2163,2163,4650,4818,90.4845300642148,-168,-141
2016,203459,Allen Crabbe,Allen Crabbe,79,79,5243,5307,10550,1136.46666666667,1120,2256.46666666667,2258,2254,2254,4963,5135,94.6595460614152,-172,-117
2016,1626161,Willie Cauley-Stein,Willie Cauley-Stein,75,75,3182,3273,6455,713.833333333333,700.5,1414.33333333333,1416,1421,1421,2937,3111,92.3004399748586,-174,-204
2016,202083,Wesley Matthews,Wesley Matthews,73,73,5367,5497,10864,1307.53333333333,1185.8,2493.33333333333,2495,2495,2495,5042,5219,93.9444754984163,-177,-193
2016,202389,Timofey Mozgov,Timofey Mozgov,54,54,2637,2564,5201,570.666666666667,541.6,1112.26666666667,1106,1104,1104,2313,2490,87.7133105802048,-177,-195
2016,2594,Kyle Korver,Kyle Korver,67,67,4076,4144,8220,866.933333333333,887.766666666667,1754.7,1751,1753,1753,3825,4005,93.8420019627085,-180,-168
2016,202339,Eric Bledsoe,Eric Bledsoe,65,66,5272,5177,10449,1047.45,1093.65,2141.1,2178,2176,2176,4884,5066,92.6403641881639,-182,-185
2016,201228,C.J. Watson,C.J. Watson,62,62,2345,2318,4663,497.516666666667,508.4,1005.91666666667,1011,1012,1012,2040,2233,86.9936034115139,-193,-185
2016,201156,Nick Young,Nick Young,60,60,3725,3709,7434,780.3,779.95,1560.25,1556,1556,1556,3467,3662,93.0738255033557,-195,-207
2016,1626147,Justin Anderson,Justin Anderson,75,75,2806,2839,5645,627.1,595.45,1222.55,1227,1228,1228,2525,2720,89.9857448325018,-195,-194
2016,202498,Lance Thomas,Lance Thomas,46,46,2237,2261,4498,486.2,474.533333333333,960.733333333333,968,968,968,1999,2195,89.3607510058114,-196,-204
2016,202704,Reggie Jackson,Reggie Jackson,52,52,3290,3125,6415,703.483333333333,710.3,1413.78333333333,1424,1424,1424,2928,3125,88.9969604863222,-197,-226
2016,2736,Luol Deng,Luol Deng,56,56,3515,3524,7039,741.916666666667,740.15,1482.06666666667,1484,1486,1486,3171,3369,90.2133712660028,-198,-195
2016,203095,Evan Fournier,Evan Fournier,68,68,5268,5193,10461,1100.8,1128.73333333333,2229.53333333333,2234,2234,2234,4748,4954,90.1290812452544,-206,-194
2016,1627741,Buddy Hield,Buddy Hield,82,82,4306,4391,8697,922.666666666667,955.316666666667,1877.98333333333,1883,1888,1888,3963,4176,92.0343706456108,-213,-212
2016,203917,Nik Stauskas,Nik Stauskas,80,80,5152,5223,10375,1089.93333333333,1092.75,2182.68333333333,2191,2188,2188,4686,4902,90.9549689440994,-216,-185
2016,1626158,Richaun Holmes,Richaun Holmes,57,57,2768,2860,5628,586.45,598.116666666667,1184.56666666667,1190,1193,1193,2548,2767,92.0520231213873,-219,-228
2016,201572,Brook Lopez,Brook Lopez,75,75,5333,5431,10764,1084.1,1131.4,2215.5,2226,2222,2222,4955,5175,92.9120570035627,-220,-158
2016,1626164,Devin Booker,Devin Booker,77,78,6692,6598,13290,1311.71666666667,1380.18333333333,2691.9,2733,2730,2730,6156,6379,91.9904363419008,-223,-226
2016,1626178,Rondae Hollis-Jefferson,Rondae Hollis-Jefferson,78,78,4227,4373,8600,852.483333333333,906.95,1759.43333333333,1762,1761,1761,3904,4135,92.3586467944168,-231,-264
2016,200751,Randy Foye,Randy Foye,69,69,3037,3128,6165,625.883333333333,650.566666666667,1276.45,1286,1284,1284,2789,3026,91.8340467566678,-237,-205
2016,203930,Sean Kilpatrick,Sean Kilpatrick,70,70,4211,4296,8507,850.866666666667,902.216666666667,1753.08333333333,1755,1754,1754,3872,4110,91.9496556637378,-238,-224
2016,201167,Arron Afflalo,Arron Afflalo,61,61,3522,3581,7103,830.216666666667,746.816666666667,1577.03333333333,1579,1580,1580,3298,3538,93.6399772856332,-240,-247
2016,2546,Carmelo Anthony,Carmelo Anthony,74,74,5962,5963,11925,1289.21666666667,1243.06666666667,2532.28333333333,2542,2538,2538,5529,5772,92.7373364642737,-243,-232
2016,201584,Courtney Lee,Courtney Lee,77,77,5682,5706,11388,1236.06666666667,1203.63333333333,2439.7,2460,2459,2459,5276,5525,92.8546286518831,-249,-233
2016,203083,Andre Drummond,Andre Drummond,81,81,5573,5333,10906,1202.86666666667,1207,2409.86666666667,2408,2409,2409,5002,5252,89.7541719002333,-250,-274
2016,202344,Trevor Booker,Trevor Booker,71,71,4184,4309,8493,855.983333333333,898.766666666667,1754.75,1757,1754,1754,3754,4023,89.7227533460803,-269,-334
2016,203925,Joe Harris,Joe Harris,52,52,2816,2857,5673,556.683333333333,584.2,1140.88333333333,1140,1138,1138,2449,2718,86.9673295454546,-269,-284
2016,202711,Bojan Bogdanovic,Bojan Bogdanovic,81,81,4934,5020,9954,1006.8,1061.2,2068,2080,2083,2083,4583,4862,92.8860964734495,-279,-269
2016,203933,T.J. Warren,T.J. Warren,66,66,5072,5008,10080,993.133333333333,1050.53333333333,2043.66666666667,2048,2048,2048,4639,4931,91.4629337539432,-292,-281
2016,1626209,Mario Hezonja,Mario Hezonja,65,65,2206,2222,4428,484.65,471.466666666667,956.116666666667,959,960,960,1847,2144,83.7262012692657,-297,-287
2016,204456,T.J. McConnell,T.J. McConnell,81,81,5033,5186,10219,1066.1,1064.86666666667,2130.96666666667,2138,2133,2133,4558,4857,90.5622888933042,-299,-312
2016,1626143,Jahlil Okafor,Jahlil Okafor,50,50,2615,2625,5240,593.583333333333,542.45,1136.03333333333,1135,1134,1134,2227,2529,85.1625239005736,-302,-322
2016,203120,Justin Hamilton,Justin Hamilton,64,64,2812,2894,5706,567.8,605,1172.8,1176,1177,1177,2489,2796,88.5135135135135,-307,-291
2016,202688,Brandon Knight,Brandon Knight,53,54,2690,2691,5381,545.35,565.966666666667,1111.31666666667,1137,1140,1140,2338,2653,86.9144981412639,-315,-325
2016,203967,Dario Saric,Dario Saric,81,81,5038,5104,10142,1078.46666666667,1049.11666666667,2127.58333333333,2128,2129,2129,4498,4818,89.2814608971814,-320,-302
2016,202687,Bismack Biyombo,Bismack Biyombo,81,81,4086,4081,8167,901.066666666667,887.083333333333,1788.15,1801,1793,1793,3569,3891,87.3470386686246,-322,-344
2016,201945,Gerald Henderson,Gerald Henderson,72,72,3949,3980,7929,847.916666666667,825.133333333333,1673.05,1669,1667,1667,3491,3820,88.4021271207901,-329,-309
2016,201145,Jeff Green,Jeff Green,69,69,3573,3599,7172,765.816666666667,775.6,1541.41666666667,1531,1534,1534,3084,3421,86.3140218303946,-337,-296
2016,1627742,Brandon Ingram,Brandon Ingram,79,79,5453,5415,10868,1139.51666666667,1137.11666666667,2276.63333333333,2280,2279,2279,5000,5339,91.6926462497708,-339,-385
2016,1627737,Marquese Chriss,Marquese Chriss,81,82,4265,4189,8454,829.983333333333,883.133333333333,1713.11666666667,1740,1743,1743,3828,4181,89.7538100820633,-353,-382
2016,1626156,D'Angelo Russell,D'Angelo Russell,63,63,4314,4334,8648,894.233333333333,906.8,1801.03333333333,1814,1811,1811,3964,4320,91.8868799258229,-356,-357
2016,203458,Alex Len,Alex Len,76,77,3773,3742,7515,743.65,784.233333333333,1527.88333333333,1559,1560,1560,3260,3650,86.4033925258415,-390,-397
2016,203944,Julius Randle,Julius Randle,74,74,5125,5103,10228,1073.93333333333,1060.8,2134.73333333333,2132,2132,2132,4654,5077,90.809756097561,-423,-453
2016,203903,Jordan Clarkson,Jordan Clarkson,82,82,5740,5715,11455,1184.9,1195.75,2380.65,2397,2397,2397,5194,5629,90.4878048780488,-435,-425
2016,201571,D.J. Augustin,D.J. Augustin,78,78,3496,3522,7018,784.5,750.316666666667,1534.81666666667,1538,1538,1538,2965,3409,84.8112128146453,-444,-446
2017,201569,Eric Gordon,Eric Gordon,69,69,5095,5037,10132,1040.05,1110.98333333333,2151.03333333333,2153,2154,2154,5216,4634,102.374877330716,582,585
2017,203496,Robert Covington,Robert Covington,80,80,6064,6002,12066,1225.16666666667,1292.81666666667,2517.98333333333,2529,2532,2532,5871,5307,96.8172823218998,564,522
2017,201935,James Harden,James Harden,72,72,5902,5913,11815,1255.81666666667,1288.3,2544.11666666667,2549,2551,2551,6067,5524,102.795662487292,543,522
2017,200782,PJ Tucker,P.J. Tucker,82,82,5303,5277,10580,1128.8,1151.08333333333,2279.88333333333,2281,2281,2281,5397,4877,101.772581557609,520,524
2017,101108,Chris Paul,Chris Paul,58,58,4222,4219,8441,914.983333333333,923.533333333333,1838.51666666667,1849,1847,1847,4427,3926,104.855518711511,501,499
2017,201939,Stephen Curry,Stephen Curry,50,51,3888,3986,7874,742.016666666667,852.55,1594.56666666667,1630,1631,1631,4205,3740,108.15329218107,465,486
2017,203954,Joel Embiid,Joel Embiid,63,63,4505,4512,9017,934.683333333333,969.816666666667,1904.5,1914,1912,1912,4435,3992,98.4461709211987,443,488
2017,201942,DeMar DeRozan,DeMar DeRozan,80,80,6445,6384,12829,1357.38333333333,1353.88333333333,2711.26666666667,2708,2711,2711,6409,5979,99.4414274631497,430,443
2017,200768,Kyle Lowry,Kyle Lowry,78,78,5911,5884,11795,1246.13333333333,1257.1,2503.23333333333,2509,2510,2510,5860,5440,99.137201827102,420,404
2017,1627732,Ben Simmons,Ben Simmons,81,81,6566,6585,13151,1321.11666666667,1398.38333333333,2719.5,2736,2732,2732,6335,5923,96.4818763326226,412,390
2017,201566,Russell Westbrook,Russell Westbrook,80,80,7176,6771,13947,1383.51666666667,1516.41666666667,2899.93333333333,2917,2914,2914,6747,6352,94.0217391304348,395,384
2017,202710,Jimmy Butler,Jimmy Butler,59,59,4964,4887,9851,1125.4,1034.68333333333,2160.08333333333,2163,2164,2164,4954,4574,99.798549556809,380,365
2017,203991,Clint Capela,Clint Capela,74,74,4706,4656,9362,999.95,1024.8,2024.75,2035,2034,2034,4725,4347,100.403739906502,378,378
2017,2772,Trevor Ariza,Trevor Ariza,67,67,5318,5298,10616,1120.58333333333,1147.91666666667,2268.5,2270,2269,2269,5315,4943,99.943587814968,372,373
2017,201950,Jrue Holiday,Jrue Holiday,80,81,6865,6999,13864,1379.25,1504.9,2884.15,2926,2927,2927,6733,6365,98.0772032046613,368,320
2017,1627832,Fred VanVleet,Fred VanVleet,76,76,3520,3541,7061,741.066666666667,775.683333333333,1516.75,1520,1520,1520,3504,3136,99.5454545454546,368,353
2017,1628378,Donovan Mitchell,Donovan Mitchell,79,79,6087,6011,12098,1343.03333333333,1286.43333333333,2629.46666666667,2639,2638,2638,5793,5431,95.1700344997536,362,359
2017,1627783,Pascal Siakam,Pascal Siakam,81,81,3901,3894,7795,823.533333333333,854.3,1677.83333333333,1673,1679,1679,3863,3518,99.0258907972315,345,304
2017,1627759,Jaylen Brown,Jaylen Brown,70,70,4947,4955,9902,1079.45,1070.16666666667,2149.61666666667,2155,2152,2152,4759,4416,96.1997170002022,343,341
2017,203497,Rudy Gobert,Rudy Gobert,56,56,4221,4138,8359,922.033333333333,885.1,1807.13333333333,1814,1816,1816,3975,3634,94.1719971570718,341,348
2017,201143,Al Horford,Al Horford,72,72,5117,5191,10308,1141.3,1124.71666666667,2266.01666666667,2275,2277,2277,5003,4664,97.7721321086574,339,345
2017,202691,Klay Thompson,Klay Thompson,72,73,5716,5947,11663,1161.06666666667,1293.98333333333,2455.05,2500,2506,2506,5810,5471,101.644506648006,339,399
2017,1626157,Karl-Anthony Towns,Karl-Anthony Towns,82,82,6725,6635,13360,1502.78333333333,1404.8,2907.58333333333,2922,2918,2918,6701,6362,99.6431226765799,339,375
2017,201601,Luc Mbah a Moute,Luc Mbah a Moute,61,61,3570,3623,7193,763.45,798.583333333333,1562.03333333333,1563,1564,1564,3606,3275,101.008403361345,331,302
2017,201142,Kevin Durant,Kevin Durant,67,68,5428,5624,11052,1083.93333333333,1202.08333333333,2286.01666666667,2329,2325,2325,5620,5295,103.537214443626,325,349
2017,201586,Serge Ibaka,Serge Ibaka,76,76,4918,4917,9835,1039.7,1044.96666666667,2084.66666666667,2094,2093,2093,4890,4567,99.4306628710858,323,310
2017,203081,Damian Lillard,Damian Lillard,73,73,6293,6217,12510,1371.11666666667,1297.9,2669.01666666667,2672,2670,2670,6063,5741,96.3451453996504,322,347
2017,203076,Anthony Davis,Anthony Davis,74,75,6386,6560,12946,1278.31666666667,1402.88333333333,2681.2,2729,2727,2727,6275,5954,98.2618227372377,321,299
2017,1628369,Jayson Tatum,Jayson Tatum,80,80,5514,5594,11108,1217.36666666667,1209.41666666667,2426.78333333333,2445,2438,2438,5291,4971,95.955749002539,320,345
2017,203500,Steven Adams,Steven Adams,76,76,6132,5727,11859,1194.86666666667,1281.66666666667,2476.53333333333,2487,2487,2487,5700,5383,92.9549902152642,317,323
2017,200755,JJ Redick,J.J. Redick,70,70,5103,5125,10228,1032.9,1076.06666666667,2108.96666666667,2114,2116,2116,4966,4654,97.3153047227121,312,313
2017,1628384,OG Anunoby,OG Anunoby,74,74,3452,3459,6911,737.283333333333,731.8,1469.08333333333,1481,1481,1481,3449,3137,99.9130938586327,312,294
2017,203110,Draymond Green,Draymond Green,69,70,5266,5485,10751,1051.16666666667,1194.36666666667,2245.53333333333,2286,2287,2287,5359,5056,101.766046334979,303,312
2017,203506,Victor Oladipo,Victor Oladipo,75,75,5859,5946,11805,1250.78333333333,1293.43333333333,2544.21666666667,2556,2552,2552,5698,5400,97.2520908004779,298,343
2017,203999,Nikola Jokic,Nikola Jokic,74,75,5602,5409,11011,1191.95,1189.86666666667,2381.81666666667,2442,2443,2443,5502,5204,98.2149232416994,298,356
2017,200746,LaMarcus Aldridge,LaMarcus Aldridge,75,75,5676,5535,11211,1303.21666666667,1194.86666666667,2498.08333333333,2513,2509,2509,5367,5074,94.5560253699789,293,282
2017,2546,Carmelo Anthony,Carmelo Anthony,78,78,6152,5771,11923,1205.93333333333,1288.43333333333,2494.36666666667,2503,2501,2501,5769,5485,93.7743823146944,284,271
2017,1627751,Jakob Poeltl,Jakob Poeltl,82,82,3583,3534,7117,750.55,769.15,1519.7,1526,1524,1524,3524,3240,98.3533351939715,284,252
2017,2403,Nene,Nene Hilario,52,52,1779,1791,3570,363.683333333333,395.133333333333,758.816666666667,759,758,758,1863,1589,104.721753794266,274,264
2017,201959,Taj Gibson,Taj Gibson,82,82,6349,6280,12629,1411.35,1315.53333333333,2726.88333333333,2722,2726,2726,6268,5997,98.7242085367775,271,226
2017,203967,Dario Saric,Dario Saric,77,78,5505,5498,11003,1117.55,1180,2297.55,2310,2310,2310,5261,4995,95.5676657584014,266,290
2017,203490,Otto Porter Jr.,Otto Porter,77,77,5613,5617,11230,1213.98333333333,1206.81666666667,2420.8,2430,2432,2432,5447,5185,97.0425797256369,262,284
2017,2738,Andre Iguodala,Andre Iguodala,63,64,3731,3856,7587,773.183333333333,828.75,1601.93333333333,1628,1622,1622,3686,3432,98.7938890377915,254,277
2017,204060,Joe Ingles,Joe Ingles,82,82,5902,5858,11760,1317.4,1244.58333333333,2561.98333333333,2580,2578,2578,5605,5352,94.9678075228736,253,276
2017,101139,CJ Miles,C.J. Miles,70,70,3162,3147,6309,663,674.2,1337.2,1335,1337,1337,3065,2819,96.932321315623,246,274
2017,201583,Ryan Anderson,Ryan Anderson,66,66,4018,3958,7976,845.05,865.85,1710.9,1725,1725,1725,4033,3788,100.373320059731,245,250
2017,201937,Ricky Rubio,Ricky Rubio,77,77,5142,5093,10235,1150.13333333333,1094.3,2244.43333333333,2251,2254,2254,4845,4600,94.2240373395566,245,219
2017,1626153,Delon Wright,Delon Wright,69,69,3327,3328,6655,709.416666666667,715.333333333333,1424.75,1436,1433,1433,3235,3001,97.2347460174331,234,234
2017,202681,Kyrie Irving,Kyrie Irving,60,60,4453,4491,8944,965.966666666667,959.75,1925.71666666667,1932,1931,1931,4333,4108,97.3051875140355,225,257
2017,2594,Kyle Korver,Kyle Korver,73,73,3666,3714,7380,764.766666666667,806.183333333333,1570.95,1574,1574,1574,3695,3471,100.791052918713,224,274
2017,203460,Andre Roberson,Andre Roberson,39,39,2468,2325,4793,496.8,535.666666666667,1032.46666666667,1040,1037,1037,2239,2019,90.7212317666126,220,190
2017,203952,Andrew Wiggins,Andrew Wiggins,82,82,6977,6873,13850,1545.03333333333,1437.65,2982.68333333333,2981,2979,2979,6825,6606,97.8214132148488,219,199
2017,202329,Al-Farouq Aminu,Al-Farouq Aminu,69,69,4847,4820,9667,1054.33333333333,1008.88333333333,2063.21666666667,2071,2072,2072,4653,4435,95.9975242417991,218,223
2017,203935,Marcus Smart,Marcus Smart,54,54,3742,3767,7509,813.366666666667,803.216666666667,1616.58333333333,1615,1614,1614,3543,3330,94.6819882415821,213,213
2017,1626220,Royce O'Neale,Royce O'Neale,69,69,2648,2617,5265,585.166666666667,563.05,1148.21666666667,1147,1150,1150,2513,2301,94.9018126888217,212,194
2017,1627750,Jamal Murray,Jamal Murray,80,81,5860,5735,11595,1251.41666666667,1259.31666666667,2510.73333333333,2564,2565,2565,5825,5613,99.4027303754266,212,226
2017,202685,Jonas Valanciunas,Jonas Valanciunas,77,77,4049,4035,8084,865.716666666667,853.6,1719.31666666667,1724,1727,1727,3999,3796,98.7651271918993,203,228
2017,201152,Thaddeus Young,Thaddeus Young,81,81,5917,6009,11926,1282.31666666667,1316.76666666667,2599.08333333333,2606,2607,2607,5723,5527,96.7213114754098,196,220
2017,202689,Kemba Walker,Kemba Walker,80,80,6515,6359,12874,1376.68333333333,1353.6,2730.28333333333,2739,2736,2736,6294,6098,96.6078280890253,196,201
2017,202331,Paul George,Paul George,79,79,7018,6722,13740,1385.03333333333,1498.26666666667,2883.3,2894,2891,2891,6536,6346,93.1319464234825,190,229
2017,1627749,Dejounte Murray,Dejounte Murray,81,81,3997,3920,7917,889.366666666667,839.483333333333,1728.85,1742,1743,1743,3644,3454,91.1683762822117,190,151
2017,203482,Kelly Olynyk,Kelly Olynyk,75,76,3898,3891,7789,869.6,864.25,1733.85,1779,1779,1779,3817,3633,97.9220112878399,184,234
2017,2585,Zaza Pachulia,Zaza Pachulia,68,69,2237,2272,4509,443.65,499.233333333333,942.883333333333,969,972,972,2336,2155,104.425569959768,181,196
2017,203382,Aron Baynes,Aron Baynes,81,81,3323,3308,6631,733.616666666667,729.566666666667,1463.18333333333,1488,1485,1485,3061,2880,92.1155582305146,181,185
2017,202734,E'Twaun Moore,E'Twaun Moore,81,82,6033,6200,12233,1219.31666666667,1328.58333333333,2547.9,2587,2586,2586,5914,5735,98.0275153323388,179,164
2017,203089,John Henson,John Henson,76,76,4482,4517,8999,941.783333333333,1014.48333333333,1956.26666666667,1968,1970,1970,4402,4228,98.215082552432,174,163
2017,203078,Bradley Beal,Bradley Beal,82,82,6883,6943,13826,1490.43333333333,1477.6,2968.03333333333,2978,2977,2977,6597,6424,95.8448351009734,173,175
2017,203937,Kyle Anderson,Kyle Anderson,74,74,4488,4450,8938,1022.38333333333,948.383333333333,1970.76666666667,1979,1978,1978,4215,4042,93.9171122994652,173,138
2017,203914,Gary Harris,Gary Harris,67,67,5417,5329,10746,1147.83333333333,1150.53333333333,2298.36666666667,2304,2304,2304,5270,5102,97.2863208417944,168,172
2017,1626145,Tyus Jones,Tyus Jones,82,82,3371,3318,6689,751.916666666667,705.516666666667,1457.43333333333,1465,1467,1467,3294,3136,97.715811331949,158,185
2017,1628395,Jordan Bell,Jordan Bell,55,57,1889,1974,3863,390.483333333333,408.966666666667,799.45,811,809,809,1939,1786,102.646903123346,153,159
2017,203507,Giannis Antetokounmpo,Giannis Antetokounmpo,75,75,6282,6351,12633,1313.41666666667,1436.11666666667,2749.53333333333,2761,2756,2756,6118,5969,97.3893664438077,149,143
2017,2733,Shaun Livingston,Shaun Livingston,70,71,2540,2660,5200,530.133333333333,579.533333333333,1109.66666666667,1137,1129,1129,2510,2364,98.8188976377953,146,112
2017,201952,Jeff Teague,Jeff Teague,70,70,5414,5353,10767,1194.96666666667,1114.15,2309.11666666667,2313,2311,2311,5327,5187,98.3930550424825,140,130
2017,202324,Derrick Favors,Derrick Favors,77,77,4891,4840,9731,1105.93333333333,1038.71666666667,2144.65,2154,2153,2153,4612,4473,94.2956450623594,139,148
2017,203962,Josh Huestis,Josh Huestis,69,69,2256,2222,4478,476.516666666667,491.933333333333,968.45,980,982,982,2154,2017,95.4787234042553,137,113
2017,203994,Jusuf Nurkic,Jusuf Nurkic,79,79,4870,4848,9718,1056.11666666667,1025.93333333333,2082.05,2090,2088,2088,4557,4423,93.5728952772074,134,162
2017,1626192,Pat Connaughton,Pat Connaughton,82,82,3471,3420,6891,774.716666666667,712.416666666667,1487.13333333333,1494,1488,1488,3319,3187,95.6208585422069,132,140
2017,202339,Eric Bledsoe,Eric Bledsoe,74,74,5368,5461,10829,1109.61666666667,1203.85,2313.46666666667,2322,2322,2322,5262,5134,98.0253353204173,128,123
2017,202322,John Wall,John Wall,41,41,3342,3370,6712,700.466666666667,703.683333333333,1404.15,1408,1410,1410,3237,3114,96.8581687612208,123,125
2017,1626167,Myles Turner,Myles Turner,65,65,4173,4242,8415,909.85,916.116666666667,1825.96666666667,1835,1836,1836,4036,3913,96.7169901749341,123,116
2017,202703,Nikola Mirotic,Nikola Mirotic,55,55,3601,3620,7221,709.516666666667,781.483333333333,1491,1496,1494,1494,3511,3390,97.5006942515968,121,149
2017,201145,Jeff Green,Jeff Green,78,78,4215,4334,8549,901.966666666667,922.433333333333,1824.4,1831,1828,1828,4171,4052,98.9561091340451,119,104
2017,202326,DeMarcus Cousins,DeMarcus Cousins,47,48,3959,3973,7932,835.016666666667,858.233333333333,1693.25,1739,1737,1737,3835,3716,96.8678959333165,119,95
2017,1626172,Kevon Looney,Kevon Looney,66,66,2126,2157,4283,452.066666666667,456.85,908.916666666667,910,910,910,2121,2005,99.7648165569144,116,121
2017,200794,Paul Millsap,Paul Millsap,37,38,2566,2571,5137,545.033333333333,550.633333333333,1095.66666666667,1143,1143,1143,2508,2394,97.7396726422447,114,96
2017,201954,Darren Collison,Darren Collison,69,69,4580,4682,9262,999.6,1011.28333333333,2010.88333333333,2019,2018,2018,4511,4397,98.4934497816594,114,137
2017,202334,Ed Davis,Ed Davis,78,78,3381,3354,6735,767.35,701.766666666667,1469.11666666667,1470,1471,1471,3179,3065,94.0254362614611,114,89
2017,203468,CJ McCollum,CJ McCollum,81,81,6811,6743,13554,1492.4,1419.36666666667,2911.76666666667,2925,2923,2923,6417,6303,94.2152400528557,114,123
2017,203115,Will Barton,Will Barton,80,81,6265,6124,12389,1317.88333333333,1313.96666666667,2631.85,2681,2683,2683,5986,5880,95.5466879489226,106,124
2017,201980,Danny Green,Danny Green,70,70,4051,4001,8052,934.316666666667,848.333333333333,1782.65,1792,1791,1791,3743,3638,92.3969390274006,105,89
2017,1626179,Terry Rozier,Terry Rozier,80,80,4737,4761,9498,1054.18333333333,1011.2,2065.38333333333,2066,2068,2068,4396,4292,92.8013510660756,104,117
2017,101112,Channing Frye,Channing Frye,53,53,1591,1635,3226,335.866666666667,357.216666666667,693.083333333333,695,695,695,1622,1519,101.948460087995,103,114
2017,101162,Marcin Gortat,Marcin Gortat,82,82,4793,4807,9600,1043.93333333333,1025,2068.93333333333,2080,2075,2075,4556,4454,95.0552889630712,102,104
2017,1627854,Bryn Forbes,Bryn Forbes,80,80,3483,3440,6923,773.016666666667,738.3,1511.31666666667,1519,1517,1517,3293,3193,94.5449325294287,100,123
2017,201988,Patty Mills,Patty Mills,82,82,4845,4805,9650,1088.43333333333,1020.96666666667,2109.4,2109,2107,2107,4593,4494,94.7987616099071,99,112
2017,202711,Bojan Bogdanovic,Bojan Bogdanovic,80,80,5619,5717,11336,1208.26666666667,1240.78333333333,2449.05,2463,2464,2464,5360,5264,95.3906389037195,96,98
2017,2734,Devin Harris,Devin Harris,70,71,3018,3051,6069,674.25,636.35,1310.6,1338,1340,1340,2962,2867,98.1444665341286,95,104
2017,203087,Jeremy Lamb,Jeremy Lamb,80,80,4669,4513,9182,1000.65,965.183333333333,1965.83333333333,1964,1967,1967,4453,4358,95.3737417005783,95,78
2017,1628379,Luke Kennard,Luke Kennard,73,73,3301,3337,6638,725.45,732.15,1457.6,1468,1463,1463,3164,3070,95.849742502272,94,121
2017,203526,Raul Neto,Raul Neto,41,41,1153,1146,2299,251.683333333333,246.566666666667,498.25,502,498,498,1101,1010,95.4900260190807,91,119
2017,101123,Gerald Green,Gerald Green,41,41,2113,2135,4248,458.15,460,918.15,929,929,929,2061,1972,97.5390440132513,89,93
2017,201961,Wayne Ellington,Wayne Ellington,76,77,4511,4509,9020,1014.03333333333,988.966666666667,2003,2037,2041,2041,4273,4184,94.7240079804921,89,126
2017,2730,Dwight Howard,Dwight Howard,81,81,5897,5735,11632,1237.36666666667,1217.7,2455.06666666667,2461,2463,2463,5579,5492,94.6074275055113,87,89
2017,203107,Tomas Satoransky,Tomas Satoransky,73,73,3807,3790,7597,827.866666666667,810.683333333333,1638.55,1644,1643,1643,3616,3532,94.9829261886,84,76
2017,101107,Marvin Williams,Marvin Williams,78,78,4783,4701,9484,1006.13333333333,989.966666666667,1996.1,2008,2006,2006,4532,4449,94.7522475433828,83,67
2017,2544,LeBron James,LeBron James,82,82,7021,7094,14115,1514.26666666667,1508.35,3022.61666666667,3024,3026,3026,7097,7015,101.082466885059,82,108
2017,203894,Shabazz Napier,Shabazz Napier,74,74,3517,3515,7032,794.116666666667,740.566666666667,1534.68333333333,1534,1535,1535,3312,3233,94.1711686096105,79,84
2017,200757,Thabo Sefolosha,Thabo Sefolosha,38,38,1811,1840,3651,405.566666666667,402.766666666667,808.333333333333,808,806,806,1754,1676,96.8525676421866,78,58
2017,202722,Davis Bertans,Davis Bertans,77,77,2466,2487,4953,538.5,538.05,1076.55,1085,1086,1086,2338,2262,94.8094079480941,76,89
2017,201163,Wilson Chandler,Wilson Chandler,73,74,5367,5298,10665,1152.81666666667,1140.41666666667,2293.23333333333,2346,2346,2346,5164,5093,96.2176262343954,71,59
2017,203077,Michael Kidd-Gilchrist,Michael Kidd-Gilchrist,74,74,4406,4294,8700,927.566666666667,914.916666666667,1842.48333333333,1851,1850,1850,4176,4106,94.7798456650023,70,48
2017,203114,Khris Middleton,Khris Middleton,82,82,6795,6908,13703,1430.18333333333,1541.75,2971.93333333333,2980,2982,2982,6665,6596,98.0868285504047,69,94
2017,204038,Langston Galloway,Langston Galloway,58,58,1972,1963,3935,423.8,436.1,859.9,865,863,863,1799,1730,91.2271805273834,69,74
2017,203512,Lucas Nogueira,Lucas Nogueira,49,49,933,986,1919,202.116666666667,214.783333333333,416.9,416,418,418,916,852,98.1779206859593,64,88
2017,204020,Tyler Johnson,Tyler Johnson,71,72,4641,4634,9275,1023.55,999.916666666667,2023.46666666667,2052,2052,2052,4360,4296,93.9452704158587,64,47
2017,1626196,Josh Richardson,Josh Richardson,80,81,6051,6011,12062,1337.58333333333,1298.86666666667,2636.45,2689,2689,2689,5613,5551,92.7615270203272,62,43
2017,201933,Blake Griffin,Blake Griffin,58,58,4618,4624,9242,991.566666666667,972.9,1964.46666666667,1969,1970,1970,4382,4322,94.889562581204,60,60
2017,1938,Manu Ginobili,Manu Ginobili,65,65,3034,3017,6051,671.716666666667,632.916666666667,1304.63333333333,1297,1299,1299,2888,2829,95.1878707976269,59,73
2017,200765,Rajon Rondo,Rajon Rondo,65,65,4094,4209,8303,816.55,881.466666666667,1698.01666666667,1704,1705,1705,3946,3887,96.3849535906204,59,17
2017,201580,JaVale McGee,JaVale McGee,64,65,1458,1468,2926,291.233333333333,310.033333333333,601.266666666667,614,615,615,1427,1370,97.8737997256516,57,39
2017,201567,Kevin Love,Kevin Love,59,59,3809,3805,7614,832.166666666667,812.033333333333,1644.2,1654,1651,1651,3823,3767,100.367550538199,56,79
2017,201956,Omri Casspi,Omri Casspi,53,53,1745,1810,3555,356.633333333333,380.216666666667,736.85,743,740,740,1685,1630,96.5616045845272,55,54
2017,1627734,Domantas Sabonis,Domantas Sabonis,74,74,4188,4179,8367,893.7,915.95,1809.65,1807,1810,1810,3945,3891,94.1977077363897,54,37
2017,1626149,Montrezl Harrell,Montrezl Harrell,76,76,3113,3154,6267,621.066666666667,671.766666666667,1292.83333333333,1297,1293,1293,3026,2973,97.2052682300032,53,56
2017,1626155,Sam Dekker,Sam Dekker,73,73,2110,2153,4263,425.183333333333,456.116666666667,881.3,881,883,883,2021,1968,95.781990521327,53,61
2017,201973,Jonas Jerebko,Jonas Jerebko,74,74,2566,2556,5122,571.4,552.683333333333,1124.08333333333,1131,1134,1134,2431,2380,94.7388932190179,51,56
2017,101181,Jose Calderon,Jose Calderon,57,57,2019,2064,4083,456.15,447.133333333333,903.283333333333,915,914,914,2052,2004,101.634472511144,48,67
2017,203957,Dante Exum,Dante Exum,14,14,544,559,1103,114.583333333333,119.216666666667,233.8,234,235,235,532,484,97.7941176470588,48,32
2017,1626224,Cedi Osman,Cedi Osman,59,61,1579,1560,3139,331.583333333333,332.533333333333,664.116666666667,669,672,672,1566,1518,99.1766941101963,48,35
2017,1626246,Boban Marjanovic,Boban Marjanovic,37,39,812,783,1595,166,169.75,335.75,336,337,337,793,745,97.6600985221675,48,55
2017,101150,Lou Williams,Lou Williams,79,79,6251,6277,12528,1265.88333333333,1317.31666666667,2583.2,2591,2589,2589,6116,6070,97.8403455447129,46,120
2017,201148,Brandan Wright,Brandan Wright,28,28,876,878,1754,192.3,187.25,379.55,380,381,381,806,761,92.0091324200913,45,42
2017,203485,Lorenzo Brown,Lorenzo Brown,13,14,301,302,603,66.3666666666667,70.75,137.116666666667,139,139,139,293,249,97.3421926910299,44,46
2017,1626159,Justise Winslow,Justise Winslow,67,68,3791,3785,7576,834.4,822.383333333333,1656.78333333333,1680,1680,1680,3488,3444,92.0073859140069,44,25
2017,202327,Ekpe Udoh,Ekpe Udoh,63,63,1809,1845,3654,402.983333333333,403.35,806.333333333333,810,810,810,1733,1691,95.7987838584854,42,61
2017,1627885,Shaquille Harrison,Shaquille Harrison,23,23,931,918,1849,185.933333333333,197.383333333333,383.316666666667,387,384,384,903,861,96.9924812030075,42,47
2017,2561,David West,David West,72,73,2170,2279,4449,473.65,502.35,976,1001,999,999,2023,1982,93.2258064516129,41,37
2017,1628401,Derrick White,Derrick White,17,17,330,346,676,67.3333333333333,69.4833333333333,136.816666666667,138,139,139,306,266,92.7272727272727,40,31
2017,202933,Julyan Stone,Julyan Stone,23,23,411,406,817,83.8166666666667,87.7333333333333,171.55,176,175,175,407,368,99.0267639902676,39,38
2017,1628380,Zach Collins,Zach Collins,66,66,2365,2353,4718,545.833333333333,494.266666666667,1040.1,1045,1045,1045,2267,2228,95.8562367864693,39,16
2017,1628462,Milos Teodosic,Milos Teodosic,45,45,2681,2726,5407,550.666666666667,580.383333333333,1131.05,1136,1134,1134,2617,2578,97.6128310331966,39,87
2017,203121,Darius Miller,Darius Miller,81,82,4545,4676,9221,929.65,994.416666666667,1924.06666666667,1947,1944,1944,4461,4423,98.1518151815182,38,-17
2017,1627812,Yogi Ferrell,Yogi Ferrell,82,82,5102,5177,10279,1162.31666666667,1113.81666666667,2276.13333333333,2282,2282,2282,4810,4772,94.2767542140337,38,3
2017,101141,Ersan Ilyasova,Ersan Ilyasova,69,69,4066,4106,8172,851.85,871.133333333333,1722.98333333333,1730,1729,1729,3847,3810,94.6138711264142,37,19
2017,201976,Patrick Beverley,Patrick Beverley,11,11,772,746,1518,166.916666666667,163.616666666667,330.533333333333,333,334,334,731,694,94.6891191709845,37,26
2017,203109,Jae Crowder,Jae Crowder,80,80,4835,4875,9710,1043.53333333333,1038.58333333333,2082.11666666667,2096,2090,2090,4677,4640,96.7321613236815,37,27
2017,1627758,Ron Baker,Ron Baker,29,29,892,901,1793,190.966666666667,190.433333333333,381.4,385,385,385,851,814,95.4035874439462,37,16
2017,2200,Pau Gasol,Pau Gasol,77,77,4103,4108,8211,928.7,877.4,1806.1,1814,1812,1812,3726,3691,90.8116012673653,35,62
2017,202693,Markieff Morris,Markieff Morris,73,73,4499,4525,9024,986.433333333333,970.683333333333,1957.11666666667,1966,1968,1968,4286,4252,95.265614581018,34,24
2017,1628393,Jawun Evans,Jawun Evans,48,48,1864,1898,3762,370.05,404.466666666667,774.516666666667,778,778,778,1782,1749,95.6008583690987,33,16
2017,202697,Iman Shumpert,Iman Shumpert,14,14,648,662,1310,138.45,134.6,273.05,277,276,276,625,593,96.4506172839506,32,29
2017,101161,Amir Johnson,Amir Johnson,74,74,2812,2805,5617,567.583333333333,601.3,1168.88333333333,1173,1171,1171,2580,2549,91.7496443812233,31,9
2017,201156,Nick Young,Nick Young,79,80,3222,3328,6550,672.333333333333,704.45,1376.78333333333,1390,1393,1393,3139,3108,97.4239602731223,31,45
2017,200752,Rudy Gay,Rudy Gay,57,57,2858,2795,5653,639.066666666667,592.933333333333,1232,1236,1231,1231,2633,2603,92.1273617914626,30,81
2017,201229,Anthony Tolliver,Anthony Tolliver,79,79,4023,4021,8044,871.733333333333,879.4,1751.13333333333,1759,1757,1757,3805,3775,94.5811583395476,30,28
2017,203186,Willie Reed,Willie Reed,41,42,1040,1032,2072,210.216666666667,217.65,427.866666666667,428,428,428,992,962,95.3846153846154,30,16
2017,1891,Jason Terry,Jason Terry,50,51,1874,1867,3741,400.833333333333,409.216666666667,810.05,813,814,814,1795,1766,95.7844183564568,29,21
2017,201609,Goran Dragic,Goran Dragic,74,75,5368,5359,10727,1174.35,1146.58333333333,2320.93333333333,2376,2378,2378,4993,4964,93.0141579731744,29,21
2017,202397,Ish Smith,Ish Smith,82,82,4719,4713,9432,1008.91666666667,1027.08333333333,2036,2044,2043,2043,4462,4433,94.5539309175673,29,43
2017,1628409,Alec Peters,Alec Peters,20,20,545,519,1064,109.883333333333,112.75,222.633333333333,224,225,225,528,499,96.8807339449541,29,35
2017,203924,Jerami Grant,Jerami Grant,81,81,3851,3826,7677,799.533333333333,844.116666666667,1643.65,1647,1647,1647,3580,3553,92.9628667878473,27,19
2017,202704,Reggie Jackson,Reggie Jackson,45,45,2778,2716,5494,611.65,582.566666666667,1194.21666666667,1201,1201,1201,2593,2567,93.3405327573794,26,18
2017,1626177,Dakari Johnson,Dakari Johnson,28,31,361,356,717,74.8166666666667,81.0166666666667,155.833333333333,163,161,161,320,294,88.6426592797784,26,32
2017,2863,Damien Wilkins,Damien Wilkins,19,19,364,349,713,79.7833333333333,70.0333333333333,149.816666666667,152,152,152,348,323,95.6043956043956,25,27
2017,1627826,Ivica Zubac,Ivica Zubac,43,43,974,978,1952,195.133333333333,212.366666666667,407.5,411,410,410,871,846,89.4250513347023,25,40
2017,203518,Alex Abrines,Alex Abrines,74,75,2687,2614,5301,549.783333333333,581.583333333333,1131.36666666667,1134,1134,1134,2497,2473,92.9289170078154,24,39
2017,203585,Rodney McGruder,Rodney McGruder,17,18,678,655,1333,145.416666666667,143.116666666667,288.533333333333,300,299,299,655,631,96.6076696165192,24,32
2017,201936,Tyreke Evans,Tyreke Evans,52,52,3653,3655,7308,819.116666666667,784.25,1603.36666666667,1609,1607,1607,3410,3387,93.3479332055845,23,27
2017,1626257,Salah Mejri,Salah Mejri,61,61,1637,1662,3299,375.983333333333,353.766666666667,729.75,731,729,729,1552,1529,94.8075748320098,23,20
2017,1626204,Larry Nance Jr.,Larry Nance Jr.,66,66,3411,3400,6811,683.916666666667,737.8,1421.71666666667,1422,1421,1421,3135,3113,91.9085312225154,22,19
2017,203469,Cody Zeller,Cody Zeller,33,33,1502,1429,2931,316.25,310.983333333333,627.233333333333,627,627,627,1397,1377,93.0093209054594,20,23
2017,203499,Shane Larkin,Shane Larkin,54,54,1741,1751,3492,390.933333333333,377.216666666667,768.15,776,775,775,1558,1539,89.488799540494,19,12
2017,1628492,Gian Clavell,Gian Clavell,7,7,153,149,302,32.4166666666667,33.5666666666667,65.9833333333333,65,64,64,150,131,98.0392156862745,19,19
2017,2548,Dwyane Wade,Dwyane Wade,67,67,3643,3625,7268,768.133333333333,770.683333333333,1538.81666666667,1537,1536,1536,3427,3409,94.0708207521274,18,23
2017,203090,Maurice Harkless,Maurice Harkless,59,59,2928,2919,5847,651.6,606.766666666667,1258.36666666667,1267,1264,1264,2734,2716,93.3743169398907,18,10
2017,1628365,Markelle Fultz,Markelle Fultz,14,14,619,644,1263,124.933333333333,127.9,252.833333333333,252,253,253,569,551,91.9224555735057,18,20
2017,1628444,Jabari Bird,Jabari Bird,13,13,272,271,543,58.0666666666667,55.3833333333333,113.45,115,115,115,265,247,97.4264705882353,18,18
2017,1628475,Matt Williams Jr.,Matt Williams,3,3,25,24,49,5.18333333333333,5.4,10.5833333333333,11,11,11,31,13,124,18,16
2017,101133,Ian Mahinmi,Ian Mahinmi,77,77,2684,2645,5329,576.033333333333,568.133333333333,1144.16666666667,1147,1145,1145,2488,2471,92.6974664679583,17,14
2017,201281,Andre Ingram,Andre Ingram,2,2,152,156,308,30.1166666666667,34.1,64.2166666666667,64,64,64,155,138,101.973684210526,17,20
2017,1627852,Nicolas Brussino,Nicolas Brussino,3,4,23,21,44,4.81666666666667,4.95,9.76666666666667,10,10,10,25,8,108.695652173913,17,17
2017,1627856,Matt Costello,Matt Costello,4,4,69,72,141,15.6333333333333,16.0166666666667,31.65,33,32,32,81,64,117.391304347826,17,15
2017,1627863,Danuel House Jr.,"",23,,948,942,1890,203.05,198.816666666667,401.866666666667,402,,,899,882,94.831223628692,17,19
2017,201949,James Johnson,James Johnson,72,73,4347,4393,8740,952.866666666667,938.516666666667,1891.38333333333,1946,1943,1943,4077,4061,93.7888198757764,16,0
2017,202695,Kawhi Leonard,Kawhi Leonard,9,9,472,477,949,107.616666666667,101.516666666667,209.133333333333,211,210,210,427,412,90.4661016949153,15,17
2017,203505,Vander Blue,Vander Blue,5,5,105,97,202,21.0666666666667,23.7333333333333,44.8,45,45,45,98,83,93.3333333333333,15,15
2017,201587,Nicolas Batum,Nicolas Batum,64,64,4738,4631,9369,990.9,984.533333333333,1975.43333333333,1984,1981,1981,4511,4497,95.2089489235965,14,5
2017,203546,Ian Clark,Ian Clark,73,74,3354,3466,6820,685.4,738.6,1424,1455,1455,1455,3246,3232,96.7799642218247,14,26
2017,203939,Dwight Powell,Dwight Powell,79,79,3737,3765,7502,849.216666666667,812.866666666667,1662.08333333333,1670,1672,1672,3578,3564,95.7452502006958,14,6
2017,203481,Jeff Withey,Jeff Withey,8,9,89,82,171,17.8166666666667,17.35,35.1666666666667,39,39,39,79,66,88.7640449438202,13,21
2017,1628451,Jacob Wiley,Jacob Wiley,5,5,83,73,156,16.5,15.8833333333333,32.3833333333333,33,33,33,68,55,81.9277108433735,13,13
2017,203493,Reggie Bullock,Reggie Bullock,62,62,4035,4008,8043,872.65,854.6,1727.25,1731,1732,1732,3806,3794,94.3246592317224,12,21
2017,201578,Marreese Speights,Marreese Speights,50,52,1541,1592,3133,340.583333333333,331.066666666667,671.65,674,675,675,1463,1452,94.9383517196626,11,14
2017,204179,Omari Johnson,Omari Johnson,4,4,176,170,346,38.3166666666667,36.25,74.5666666666667,75,75,75,192,181,109.090909090909,11,10
2017,1626199,Darrun Hilliard,Darrun Hilliard,14,14,214,214,428,46.8333333333333,46.2666666666667,93.1,95,95,95,223,213,104.205607476636,10,10
2017,1627780,Gary Payton II,Gary Payton II,23,23,527,523,1050,101.933333333333,116.75,218.683333333333,218,221,221,502,492,95.2561669829222,10,12
2017,1628421,Devin Robinson,Devin Robinson,1,1,39,30,69,6.61666666666667,6.46666666666667,13.0833333333333,13,13,13,33,23,84.6153846153846,10,10
2017,1628502,Nigel Hayes,Nigel Hayes,9,9,272,266,538,61.55,59.95,121.5,123,122,122,235,225,86.3970588235294,10,9
2017,1626259,Malcolm Miller,Malcolm Miller,14,15,303,286,589,65.8666666666667,57.95,123.816666666667,128,126,126,274,265,90.4290429042904,9,7
2017,204001,Kristaps Porzingis,Kristaps Porzingis,48,48,3627,3612,7239,782.15,765.366666666667,1547.51666666667,1552,1553,1553,3369,3361,92.8866832092639,8,14
2017,1627779,Marcus Paige,Marcus Paige,5,5,65,59,124,13.7,13.25,26.95,27,28,28,69,61,106.153846153846,8,8
2017,201568,Danilo Gallinari,Danilo Gallinari,21,21,1551,1531,3082,337.666666666667,327.6,665.266666666667,670,671,671,1430,1423,92.1985815602837,7,11
2017,203092,Tyler Zeller,Tyler Zeller,66,66,2629,2581,5210,556.4,546.983333333333,1103.38333333333,1112,1109,1109,2461,2454,93.6097375427919,7,26
2017,203920,Khem Birch,Khem Birch,42,42,1343,1313,2656,294.066666666667,282.85,576.916666666667,582,578,578,1242,1235,92.4795234549516,7,8
2017,1626168,Trey Lyles,Trey Lyles,73,73,3297,3197,6494,705.383333333333,684.216666666667,1389.6,1389,1391,1391,3118,3111,94.570821959357,7,10
2017,2731,Emeka Okafor,Emeka Okafor,26,26,859,891,1750,167.333333333333,182.883333333333,350.216666666667,352,353,353,790,784,91.9674039580908,6,0
2017,1627735,Wade Baldwin IV,Wade Baldwin,7,7,182,177,359,39.3833333333333,40.8666666666667,80.25,81,80,80,176,170,96.7032967032967,6,5
2017,1627936,Alex Caruso,Alex Caruso,37,37,1336,1348,2684,266.116666666667,293.966666666667,560.083333333333,562,562,562,1227,1221,91.8413173652695,6,-3
2017,1626205,Vincent Hunter,Vince Hunter,4,4,24,15,39,3.86666666666667,3.43333333333333,7.3,7,7,7,20,15,83.3333333333333,5,6
2017,202779,Dwight Buycks,Dwight Buycks,29,29,959,964,1923,215.15,212.766666666667,427.916666666667,426,427,427,885,881,92.2836287799791,4,4
2017,203705,Josh Magette,Josh Magette,18,18,494,487,981,107.966666666667,107.316666666667,215.283333333333,216,216,216,473,469,95.748987854251,4,7
2017,204037,Travis Wear,Travis Wear,17,17,517,532,1049,103.85,121.866666666667,225.716666666667,229,228,228,498,494,96.3249516441006,4,11
2017,2570,Kendrick Perkins,Kendrick Perkins,1,1,34,34,68,6.86666666666667,7.6,14.4666666666667,15,15,15,39,36,114.705882352941,3,3
2017,202330,Gordon Hayward,Gordon Hayward,1,1,13,12,25,2.61666666666667,2.63333333333333,5.25,5,5,5,12,9,92.3076923076923,3,3
2017,203489,Nate Wolters,Nate Wolters,5,5,43,37,80,9,8.66666666666667,17.6666666666667,19,19,19,39,36,90.6976744186047,3,3
2017,1626148,Anthony Brown,Anthony Brown,1,1,9,10,19,1.35,2.05,3.4,4,4,4,12,9,133.333333333333,3,3
2017,1626780,Jonathan Gibson,Jonathan Gibson,4,4,93,95,188,20.0666666666667,18.8833333333333,38.95,40,40,40,100,97,107.52688172043,3,-1
2017,1628383,Justin Patton,Justin Patton,1,1,9,10,19,1.35,2.05,3.4,4,4,4,12,9,133.333333333333,3,3
2017,1628396,Tony Bradley,Tony Bradley,9,9,69,66,135,13.8,14.3333333333333,28.1333333333333,29,29,29,63,60,91.304347826087,3,1
2017,1628464,Daniel Theis,Daniel Theis,63,63,2180,2188,4368,475.816666666667,468.316666666667,944.133333333333,934,936,936,1987,1984,91.1467889908257,3,1
2017,1628493,Mangok Mathiang,Mangok Mathiang,4,4,51,45,96,10.5333333333333,9.03333333333333,19.5666666666667,19,20,20,43,40,84.3137254901961,3,1
2017,202705,MarShon Brooks,MarShon Brooks,7,7,470,440,910,101.8,90.15,191.95,193,193,193,459,457,97.6595744680851,2,10
2017,202713,Kyle Singler,Kyle Singler,11,12,126,120,246,26.6,27.65,54.25,60,59,59,107,105,84.9206349206349,2,-1
2017,203922,Glenn Robinson III,Glenn Robinson III,23,23,789,773,1562,174.366666666667,163.25,337.616666666667,339,338,338,723,721,91.6349809885932,2,-1
2017,204067,Jarell Eddie,Jarell Eddie,3,3,20,16,36,4.5,3.88333333333333,8.38333333333333,9,9,9,19,17,95,2,1
2017,1626210,Alan Williams,Alan Williams,5,5,159,164,323,35.6333333333333,34.45,70.0833333333334,71,70,70,132,130,83.0188679245283,2,1
2017,1628513,Naz Mitrou-Long,Naz Mitrou-Long,1,1,1,2,3,0.233333333333333,0.25,0.483333333333333,1,1,1,3,1,300,2,5
2017,202720,Jon Leuer,Jon Leuer,8,8,322,323,645,66.9,69.2833333333333,136.183333333333,136,136,136,285,284,88.5093167701863,1,12
2017,202918,Xavier Silas,Xavier Silas,2,2,21,18,39,3.15,4.03333333333333,7.18333333333333,7,7,7,18,17,85.7142857142857,1,1
2017,201177,Josh McRoberts,Josh McRoberts,2,2,12,12,24,2.96666666666667,2.7,5.66666666666667,6,6,6,12,12,100,0,0
2017,203590,Trey McKinney-Jones,Trey McKinney-Jones,1,1,3,3,6,0.783333333333333,0.416666666666667,1.2,1,1,1,4,4,133.333333333333,0,0
2017,1626154,RJ Hunter,R.J. Hunter,5,5,101,102,203,21.1833333333333,22.25,43.4333333333333,45,45,45,89,89,88.1188118811881,0,1
2017,1626195,Willy Hernangomez,Willy Hernangomez,48,48,1172,1140,2312,242.916666666667,244.333333333333,487.25,494,495,495,1079,1079,92.0648464163822,0,-1
2017,1626643,Jacob Pullen,Jacob Pullen,3,3,14,17,31,2.56666666666667,2.83333333333333,5.4,7,6,6,10,10,71.4285714285714,0,0
2017,1627851,Mindaugas Kuzminskas,Mindaugas Kuzminskas,1,1,4,3,7,1,0.75,1.75,2,2,2,0,0,0,0,0
2017,201149,Joakim Noah,Joakim Noah,7,7,100,89,189,19.55,20.0666666666667,39.6166666666667,41,40,40,74,75,74,-1,0
2017,203949,James Michael McAdoo,James Michael McAdoo,3,3,41,44,85,9.3,8.28333333333333,17.5833333333333,18,18,18,38,39,92.6829268292683,-1,1
2017,203998,Bruno Caboclo,Bruno Caboclo,12,12,240,233,473,52.9666666666667,52.15,105.116666666667,107,107,107,213,214,88.75,-1,11
2017,1627824,Guerschon Yabusele,Guerschon Yabusele,32,33,552,535,1087,117.566666666667,112.5,230.066666666667,237,235,235,503,504,91.1231884057971,-1,-7
2017,1627866,Jameel Warney,Jameel Warney,3,3,63,58,121,14.35,12.2333333333333,26.5833333333333,27,27,27,59,60,93.6507936507937,-1,-5
2017,202682,Derrick Williams,Derrick Williams,2,2,24,20,44,4.43333333333334,4.25,8.68333333333334,8,9,9,10,12,41.6666666666667,-2,-5
2017,203464,Brandon Paul,Brandon Paul,62,64,1335,1344,2679,286.533333333333,283.35,569.883333333333,572,576,576,1205,1207,90.2621722846442,-2,-11
2017,203960,JaKarr Sampson,JaKarr Sampson,22,22,777,776,1553,173.65,170.5,344.15,345,344,344,684,686,88.030888030888,-2,1
2017,1627850,Marshall Plumlee,Marshall Plumlee,8,8,125,129,254,26.2666666666667,24.85,51.1166666666667,52,52,52,103,105,82.4,-2,-1
2017,1627855,Okaro White,Okaro White,5,6,179,180,359,40.4166666666667,38.65,79.0666666666667,80,80,80,164,166,91.6201117318436,-2,-1
2017,1628449,Chris Boucher,Chris Boucher,1,1,2,2,4,0.516666666666667,0.433333333333334,0.950000000000001,1,1,1,0,2,0,-2,-2
2017,202344,Trevor Booker,Trevor Booker,68,68,2748,2736,5484,589.383333333333,568.566666666667,1157.95,1164,1158,1158,2585,2588,94.0684133915575,-3,-28
2017,1628408,PJ Dozier,PJ Dozier,2,2,6,9,15,1.38333333333333,1.7,3.08333333333334,3,3,3,4,7,66.6666666666667,-3,-3
2017,1628470,Torrey Craig,Torrey Craig,38,39,1453,1431,2884,312.716666666667,306.283333333333,619,628,629,629,1417,1420,97.5223675154852,-3,-61
2017,1626242,Luis Montero,Luis Montero,2,2,17,16,33,3.83333333333333,3.73333333333333,7.56666666666667,7,8,8,12,16,70.5882352941177,-4,-5
2017,1628469,Antonio Blakeney,Antonio Blakeney,19,19,746,730,1476,146.566666666667,166.933333333333,313.5,313,314,314,710,714,95.1742627345845,-4,-6
2017,201144,Mike Conley,Mike Conley,12,12,815,853,1668,186.416666666667,185.283333333333,371.7,374,373,373,766,771,93.9877300613497,-5,-16
2017,202332,Cole Aldrich,Cole Aldrich,21,21,119,115,234,22.7666666666667,21.9,44.6666666666667,51,49,49,112,117,94.1176470588235,-5,-2
2017,202379,Jeremy Evans,Jeremy Evans,1,1,15,15,30,2.66666666666667,2.65,5.31666666666667,5,5,5,12,17,80,-5,-4
2017,203687,Reggie Hearn,Reggie Hearn,3,3,17,18,35,3.25,3.06666666666667,6.31666666666667,7,7,7,10,15,58.8235294117647,-5,-5
2017,203966,Jamil Wilson,Jamil Wilson,15,15,627,633,1260,130.266666666667,142.3,272.566666666667,274,274,274,584,589,93.1419457735247,-5,5
2017,1627745,Damian Jones,Damian Jones,15,15,195,214,409,44.9166666666667,42.7333333333333,87.65,89,89,89,186,191,95.3846153846154,-5,0
2017,2555,Nick Collison,Nick Collison,14,15,170,167,337,37.8,36.35,74.15,75,75,75,151,157,88.8235294117647,-6,-5
2017,200826,J.J. Barea,J.J. Barea,69,69,3583,3640,7223,827.333333333333,773.7,1601.03333333333,1608,1603,1603,3498,3504,97.6276862963997,-6,18
2017,201162,Jared Dudley,Jared Dudley,48,48,1631,1624,3255,327.933333333333,359.416666666667,687.35,689,686,686,1539,1545,94.3592887798896,-6,3
2017,1628399,Tyler Lydon,Tyler Lydon,1,1,5,5,10,1.23333333333333,0.916666666666667,2.15,2,2,2,3,9,60,-6,-6
2017,1628410,Edmond Sumner,Edmond Sumner,1,1,4,6,10,1,0.916666666666666,1.91666666666667,2,2,2,2,8,50,-6,-6
2017,1628571,Erik McCree,Erik McCree,4,4,18,20,38,3.46666666666667,4.18333333333333,7.65,8,8,8,17,23,94.4444444444444,-6,-9
2017,1962937798,"","",1,,20,16,36,4.65,3.53333333333333,8.18333333333333,,,,14,20,70,-6,
2017,2736,Luol Deng,Luol Deng,1,1,34,37,71,5.91666666666667,7.16666666666667,13.0833333333333,13,13,13,26,33,76.4705882352941,-7,-7
2017,202694,Marcus Morris,Marcus Morris,54,54,3351,3347,6698,731.35,707.016666666667,1438.36666666667,1441,1447,1447,3117,3124,93.0170098478066,-7,23
2017,203477,Isaiah Canaan,Isaiah Canaan,20,20,965,964,1929,210.833333333333,210.683333333333,421.516666666667,423,422,422,934,941,96.7875647668394,-7,23
2017,1628403,Caleb Swanigan,Caleb Swanigan,27,27,448,428,876,97.2,91.5,188.7,192,189,189,382,389,85.2678571428571,-7,-11
2017,1628407,Dwayne Bacon,Dwayne Bacon,53,53,1699,1681,3380,357.05,351.183333333333,708.233333333333,711,713,713,1578,1585,92.8781636256622,-7,13
2017,1628420,Monte Morris,Monte Morris,3,3,59,60,119,12.4333333333333,12.8333333333333,25.2666666666667,26,25,25,55,62,93.2203389830508,-7,-7
2017,1628935,Aaron Jackson,Aaron Jackson,1,1,76,77,153,17.0833333333333,18.55,35.6333333333333,35,35,35,61,68,80.2631578947368,-7,-10
2017,202391,Jeremy Lin,Jeremy Lin,1,1,70,72,142,13.0666666666667,12.1333333333333,25.2,25,25,25,67,75,95.7142857142857,-8,-6
2017,203961,Eric Moreland,Eric Moreland,67,67,1791,1828,3619,399.733333333333,406.516666666667,806.25,807,805,805,1629,1637,90.9547738693467,-8,3
2017,1627778,Chinanu Onuaku,Chinanu Onuaku,1,1,44,47,91,9.53333333333333,11.3333333333333,20.8666666666667,22,22,22,32,40,72.7272727272727,-8,-8
2017,1626191,Chris McCullough,Chris McCullough,19,19,225,218,443,45.0333333333333,42.35,87.3833333333334,91,90,90,208,217,92.4444444444445,-9,-16
2017,1627823,Juancho Hernangomez,James Webb,25,10,664,630,1294,138.633333333333,134.883333333333,273.516666666667,278,120,120,614,623,92.4698795180723,-9,-24
2017,2617,Udonis Haslem,Udonis Haslem,14,14,154,158,312,36.2,35.7666666666667,71.9666666666667,71,72,72,129,139,83.7662337662338,-10,-4
2017,1627785,Isaiah Whitehead,Isaiah Whitehead,16,16,434,420,854,88.9833333333333,88.0666666666667,177.05,181,180,180,372,382,85.7142857142857,-10,-5
2017,1627817,Tim Quarterman,Tim Quarterman,3,3,33,32,65,7.13333333333333,5.26666666666667,12.4,13,13,13,17,27,51.5151515151515,-10,-10
2017,1628503,Jamel Artis,Jamel Artis,15,15,647,628,1275,138.45,138.733333333333,277.183333333333,279,279,279,580,590,89.644513137558,-10,-6
2017,2746,Josh Smith,Josh Smith,3,3,31,28,59,5.38333333333334,6.25,11.6333333333333,12,12,12,18,29,58.0645161290323,-11,-10
2017,2754,Tony Allen,Tony Allen,21,22,628,665,1293,128.8,137.45,266.25,271,273,273,583,594,92.8343949044586,-11,-5
2017,204065,David Stockton,David Stockton,3,3,21,20,41,4.23333333333333,3.9,8.13333333333333,9,9,9,17,28,80.952380952381,-11,-11
2017,1627740,Henry Ellenson,Henry Ellenson,37,38,744,759,1503,157.633333333333,168.383333333333,326.016666666667,326,329,329,665,676,89.3817204301075,-11,-5
2017,1628035,Alfonzo McKinnie,Alfonzo McKinnie,13,14,115,138,253,23.4166666666667,27.9666666666667,51.3833333333334,54,53,53,122,133,106.086956521739,-11,-14
2017,1628418,Thomas Bryant,Thomas Bryant,15,15,167,173,340,34.55,36.5666666666667,71.1166666666667,71,72,72,156,167,93.4131736526946,-11,-9
2017,202357,Nemanja Bjelica,Nemanja Bjelica,67,67,3176,3165,6341,701.583333333333,658.483333333333,1360.06666666667,1372,1371,1371,3053,3065,96.1272040302267,-12,15
2017,203816,Scotty Hopson,Scotty Hopson,1,1,25,22,47,4.35,3.9,8.25,8,8,8,17,29,68,-12,-8
2017,1627820,Tyrone Wallace,Tyrone Wallace,29,30,2073,2088,4161,412.683333333333,432.8,845.483333333333,850,851,851,1947,1959,93.9218523878437,-12,-24
2017,204022,Jack Cooley,Jack Cooley,7,7,207,199,406,45.35,42.0833333333333,87.4333333333333,87,87,87,166,179,80.1932367149759,-13,-3
2017,1627772,Daniel Hamilton,Daniel Hamilton,6,6,58,65,123,13.3,13.5833333333333,26.8833333333333,29,28,28,45,58,77.5862068965517,-13,-12
2017,1627777,Georges Niang,Georges Niang,9,9,72,78,150,14.2166666666667,15.7166666666667,29.9333333333333,33,32,32,61,74,84.7222222222222,-13,-13
2017,1628429,Charles Cooke,Charles Cooke,12,13,94,88,182,19.4666666666667,16.45,35.9166666666667,38,38,38,73,86,77.6595744680851,-13,-9
2017,203710,C.J. Williams,C.J. Williams,38,38,1672,1678,3350,348.766666666667,355.266666666667,704.033333333333,704,707,707,1563,1577,93.4808612440191,-14,-33
2017,1627834,Georgios Papagiannis,Georgios Papagiannis,17,17,290,276,566,58.8,60.7666666666667,119.566666666667,122,122,122,281,295,96.8965517241379,-14,-2
2017,1628443,Kadeem Allen,Kadeem Allen,14,18,256,240,496,52.8666666666667,51.3166666666667,104.183333333333,106,107,107,214,228,83.59375,-14,-18
2017,203580,Larry Drew II,"",10,,150,155,305,34.1,34.45,68.55,69,,,143,158,95.3333333333333,-15,-13
2017,203940,Adreian Payne,Adreian Payne,5,5,102,94,196,20.75,21.0166666666667,41.7666666666667,43,43,43,89,104,87.2549019607843,-15,-13
2017,204098,Xavier Munford,Xavier Munford,6,6,47,47,94,10.05,9.45,19.5,22,21,21,37,52,78.7234042553192,-15,-12
2017,1627762,Joel Bolomboy,Joel Bolomboy,6,6,92,83,175,20.1666666666667,16.85,37.0166666666667,37,38,38,64,79,69.5652173913044,-15,-13
2017,1628500,Ben Moore,Ben Moore,2,2,24,23,47,5.25,4.03333333333334,9.28333333333333,9,9,9,20,35,83.3333333333333,-15,-15
2017,203900,Markel Brown,Markel Brown,4,4,65,76,141,14.4833333333333,15.55,30.0333333333333,31,31,31,59,75,90.7692307692308,-16,-17
2017,1626181,Norman Powell,Norman Powell,70,70,2450,2487,4937,515.55,538.983333333333,1054.53333333333,1061,1062,1062,2318,2334,94.6122448979592,-16,-15
2017,1627736,Malik Beasley,Malik Beasley,61,62,1409,1398,2807,289.066666666667,290.666666666667,579.733333333333,583,583,583,1308,1324,92.8317955997161,-16,-29
2017,1628366,Lonzo Ball,Lonzo Ball,52,52,4346,4305,8651,845.983333333333,927.066666666667,1773.05,1781,1780,1780,3984,4000,91.6705016106765,-16,-19
2017,1628387,Ike Anigbogu,Ike Anigbogu,11,11,73,76,149,14.7833333333333,13.85,28.6333333333333,30,30,30,68,84,93.1506849315068,-16,-14
2017,202348,Jordan Crawford,Jordan Crawford,4,5,77,79,156,14.35,13.65,28,54,53,53,71,88,92.2077922077922,-17,-19
2017,203898,Tyler Ennis,Tyler Ennis,54,54,1607,1641,3248,326.516666666667,354.033333333333,680.55,679,683,683,1460,1478,90.8525202240199,-18,-20
2017,1627215,Walter Lemon Jr.,"Walt Lemon, Jr.",5,5,79,91,170,17,17.95,34.95,35,35,35,84,102,106.329113924051,-18,-15
2017,1627744,Brice Johnson,Brice Johnson,18,18,248,238,486,46.25,50.65,96.9,99,98,98,213,231,85.8870967741936,-18,-8
2017,1627853,Ryan Arcidiacono,Ryan Arcidiacono,24,24,720,711,1431,144.466666666667,158.316666666667,302.783333333333,305,304,304,636,654,88.3333333333333,-18,-24
2017,101106,Andrew Bogut,Andrew Bogut,23,23,532,513,1045,110.316666666667,105.316666666667,215.633333333333,217,216,216,436,455,81.9548872180451,-19,-29
2017,1627875,Marcus Georges-Hunt,Marcus Georges-Hunt,40,42,525,530,1055,111.916666666667,110.216666666667,222.133333333333,226,224,224,512,531,97.5238095238095,-19,-34
2017,202709,Cory Joseph,Cory Joseph,82,82,5108,5109,10217,1109.5,1099.66666666667,2209.16666666667,2210,2210,2210,4777,4797,93.5199686765858,-20,-50
2017,1628405,Johnathan Motley,Johnathan Motley,11,11,401,392,793,88.1,88.4666666666667,176.566666666667,174,176,176,349,369,87.0324189526185,-20,-17
2017,1628506,London Perrantes,London Perrantes,13,14,149,140,289,32.4166666666667,30.1166666666667,62.5333333333334,66,66,66,141,161,94.6308724832215,-20,-20
2017,1626173,Rashad Vaughn,Rashad Vaughn,26,28,472,497,969,106.75,104.5,211.25,211,212,212,450,471,95.3389830508475,-21,-12
2017,1627827,Dorian Finney-Smith,Dorian Finney-Smith,21,21,1049,1032,2081,236.266666666667,221.833333333333,458.1,449,448,448,940,961,89.6091515729266,-21,-24
2017,1627858,Kyle Collinsworth,Kyle Collinsworth,31,32,1111,1077,2188,242.7,235.65,478.35,478,480,480,1027,1048,92.4392439243925,-21,-29
2017,1627819,Isaiah Taylor,Isaiah Taylor,66,67,2760,2757,5517,583.166666666667,578.666666666667,1161.83333333333,1166,1167,1167,2570,2592,93.1159420289855,-22,-33
2017,1627814,Damion Lee,Damion Lee,15,15,974,954,1928,205.666666666667,196.5,402.166666666667,403,404,404,869,892,89.2197125256674,-23,-24
2017,1627816,Alex Poythress,Alex Poythress,24,25,238,242,480,52.9833333333333,49.35,102.333333333333,103,104,104,224,247,94.1176470588235,-23,-21
2017,1628463,Tyler Cavanaugh,Tyler Cavanaugh,38,39,1247,1225,2472,265.516666666667,256.8,522.316666666667,521,518,518,1168,1191,93.6647955092221,-23,-23
2017,203104,Marquis Teague,Marquis Teague,3,3,172,170,342,38.3333333333333,35.7,74.0333333333333,73,74,74,147,171,85.4651162790698,-24,-24
2017,1628495,Milton Doyle,Milton Doyle,10,10,288,286,574,62.5666666666667,60.4333333333333,123,124,125,125,250,274,86.8055555555556,-24,-12
2017,2225,Tony Parker,Tony Parker,55,55,2422,2430,4852,560.7,509.15,1069.85,1067,1071,1071,2253,2278,93.0222956234517,-25,-10
2017,203524,Solomon Hill,Solomon Hill,12,12,460,475,935,90.05,98.6166666666667,188.666666666667,187,187,187,422,447,91.7391304347826,-25,-26
2017,1626169,Stanley Johnson,Stanley Johnson,69,69,4373,4342,8715,952.383333333333,934.733333333333,1887.11666666667,1892,1894,1894,4034,4060,92.2478847473131,-26,-43
2017,1626175,Jordan Mickey,Jordan Mickey,23,23,630,636,1266,143.733333333333,137.416666666667,281.15,284,284,284,578,604,91.7460317460318,-26,-31
2017,1627884,Derrick Jones Jr.,Derrick Jones,20,20,578,554,1132,124.15,119.266666666667,243.416666666667,247,245,245,483,509,83.5640138408305,-26,-36
2017,2744,Al Jefferson,Al Jefferson,36,36,1105,1124,2229,253.616666666667,229.933333333333,483.55,480,484,484,1039,1066,94.027149321267,-27,-12
2017,203926,Doug McDermott,Doug McDermott,81,81,4121,4104,8225,893.916666666667,869.55,1763.46666666667,1767,1768,1768,3813,3840,92.5260859014802,-27,-36
2017,1627786,Troy Williams,Troy Williams,21,21,741,727,1468,153.316666666667,152.516666666667,305.833333333333,307,307,307,701,728,94.6018893387314,-27,-31
2017,1628499,Antonius Cleveland,Antonius Cleveland,16,17,283,291,574,61.1833333333333,60.3833333333333,121.566666666667,122,123,123,232,259,81.9787985865724,-27,-45
2017,201600,Omer Asik,Omer Asik,18,18,416,425,841,89.5666666666667,92.6833333333333,182.25,180,182,182,401,429,96.3942307692308,-28,-32
2017,203486,Mason Plumlee,Mason Plumlee,73,74,3362,3348,6710,706.683333333333,707.916666666667,1414.6,1439,1439,1439,3156,3184,93.8726948245092,-28,-52
2017,203503,Tony Snell,Tony Snell,75,75,4658,4753,9411,978.883333333333,1065.7,2044.58333333333,2051,2053,2053,4568,4596,98.0678402747961,-28,-62
2017,203923,James Young,James Young,6,6,133,146,279,30,30.4833333333333,60.4833333333333,61,61,61,113,141,84.9624060150376,-28,-26
2017,1627789,Timothe Luwawu-Cabarrot,Timothe Luwawu-Cabarrot,52,52,1938,1969,3907,394.066666666667,406.25,800.316666666667,808,807,807,1759,1787,90.7636738906089,-28,-2
2017,1628439,Isaiah Hicks,Isaiah Hicks,18,18,548,578,1126,119.816666666667,119.3,239.116666666667,238,240,240,522,550,95.2554744525547,-28,-47
2017,201589,Darrell Arthur,Darrell Arthur,18,19,326,341,667,69.8166666666667,70.7333333333333,140.55,141,141,141,305,335,93.558282208589,-30,-33
2017,101127,Jarrett Jack,Jarrett Jack,62,62,3611,3582,7193,784.283333333333,756,1540.28333333333,1550,1548,1548,3416,3447,94.5998338410413,-31,-16
2017,202696,Nikola Vucevic,Nikola Vucevic,57,57,3933,3987,7920,832.766666666667,842.233333333333,1675,1687,1683,1683,3762,3793,95.6521739130435,-31,-39
2017,203943,Noah Vonleh,Noah Vonleh,54,54,2044,2004,4048,430.15,442.933333333333,873.083333333334,876,875,875,1838,1869,89.9217221135029,-31,-41
2017,1626158,Richaun Holmes,Richaun Holmes,48,48,1792,1832,3624,367.933333333333,377.666666666667,745.6,746,746,746,1668,1699,93.0803571428571,-31,-38
2017,1627774,Jake Layman,Jake Layman,34,35,366,360,726,82.95,74.85,157.8,161,160,160,327,358,89.344262295082,-31,-21
2017,201967,Dante Cunningham,Dante Cunningham,72,73,3607,3707,7314,762.5,771.916666666667,1534.41666666667,1560,1562,1562,3471,3503,96.229553645689,-32,-74
2017,1626188,Quinn Cook,Quinn Cook,33,33,1687,1739,3426,367.183333333333,369.883333333333,737.066666666667,741,740,740,1622,1654,96.1470065204505,-32,-39
2017,1628476,Derrick Walton Jr.,Derrick Walton,16,16,318,332,650,74.9166666666667,71.5666666666667,146.483333333333,148,147,147,296,328,93.0817610062893,-32,-30
2017,204066,John Holland,John Holland,23,24,399,417,816,86.8,84.3333333333334,171.133333333333,176,174,174,389,422,97.4937343358396,-33,-29
2017,1628389,Bam Adebayo,Bam Adebayo,68,69,3004,3002,6006,685.833333333333,654.833333333333,1340.66666666667,1369,1368,1368,2745,2778,91.3781624500666,-33,-31
2017,203141,Mirza Teletovic,Mirza Teletovic,10,10,353,364,717,76.8666666666667,81.85,158.716666666667,160,159,159,322,356,91.2181303116147,-34,-38
2017,1627790,Ante Zizic,Ante Zizic,32,32,509,503,1012,107.5,102.65,210.15,217,214,214,486,520,95.4813359528487,-34,-39
2017,202692,Alec Burks,Alec Burks,64,64,2364,2400,4764,536.283333333333,518.316666666667,1054.6,1059,1059,1059,2259,2295,95.5583756345178,-36,-16
2017,1627883,Jalen Jones,Jalen Jones,14,16,428,400,828,89.5666666666667,90.3833333333333,179.95,180,181,181,398,435,92.9906542056075,-37,-32
2017,1628412,Frank Mason,Frank Mason,52,52,2189,2172,4361,494.183333333333,486.416666666667,980.6,988,984,984,2004,2041,91.5486523526724,-37,-31
2017,1627763,Malcolm Brogdon,Malcolm Brogdon,48,48,3243,3287,6530,698.05,738.583333333333,1436.63333333333,1440,1436,1436,3127,3165,96.4230650632131,-38,-67
2017,1627821,James Webb III,Juan Hernangomez,10,25,278,269,547,56.4166666666667,61.2833333333333,117.7,120,277,277,245,283,88.1294964028777,-38,-26
2017,1627988,Myke Henry,Myke Henry,20,20,889,867,1756,193.216666666667,182.916666666667,376.133333333333,380,378,378,817,855,91.9010123734533,-38,-30
2017,2210,Richard Jefferson,Richard Jefferson,20,20,382,373,755,84,78.05,162.05,163,163,163,337,376,88.2198952879581,-39,-43
2017,203484,Kentavious Caldwell-Pope,Kentavious Caldwell-Pope,74,74,5934,5872,11806,1176.9,1272.6,2449.5,2456,2458,2458,5529,5568,93.1749241658241,-39,-52
2017,203083,Andre Drummond,Andre Drummond,78,78,6134,6014,12148,1318.38333333333,1291.31666666667,2609.7,2629,2625,2625,5695,5735,92.8431692207369,-40,-49
2017,1627743,Demetrius Jackson,Demetrius Jackson,15,15,181,179,360,39.0833333333333,39.9666666666667,79.05,83,80,80,144,184,79.5580110497238,-40,-38
2017,202323,Evan Turner,Evan Turner,79,79,4743,4725,9468,1045.41666666667,983.083333333333,2028.5,2035,2034,2034,4349,4390,91.6930212945393,-41,-50
2017,203082,Terrence Ross,Terrence Ross,24,24,1408,1459,2867,287.116666666667,311.3,598.416666666667,598,600,600,1319,1360,93.6789772727273,-41,-58
2017,1628537,Jaylen Morris,Jaylen Morris,6,6,247,251,498,51.05,48.0333333333333,99.0833333333333,100,98,98,193,234,78.1376518218624,-41,-42
2017,1628425,Sterling Brown,Sterling Brown,54,54,1781,1823,3604,376.816666666667,393.7,770.516666666667,777,776,776,1625,1669,91.2408759124088,-44,-48
2017,201960,DeMarre Carroll,DeMarre Carroll,73,73,5150,5163,10313,1110.85,1063.68333333333,2174.53333333333,2181,2180,2180,4829,4875,93.7669902912621,-46,-66
2017,1627770,Kay Felder,Kay Felder,15,16,327,324,651,68.6166666666667,70.3666666666667,138.983333333333,141,140,140,272,318,83.1804281345566,-46,-48
2017,203487,Michael Carter-Williams,Michael Carter-Williams,52,52,1965,1878,3843,428.833333333333,404.35,833.183333333333,835,835,835,1772,1819,90.178117048346,-47,-61
2017,1627788,Furkan Korkmaz,Furkan Korkmaz,14,14,194,193,387,41.1666666666667,36.9,78.0666666666667,80,80,80,161,208,82.9896907216495,-47,-44
2017,1628422,Damyean Dotson,Damyean Dotson,44,44,1104,1126,2230,234.666666666667,235.7,470.366666666667,473,474,474,971,1019,87.9528985507247,-48,-39
2017,101109,Raymond Felton,Raymond Felton,82,82,3080,3079,6159,663.7,695.333333333333,1359.03333333333,1364,1365,1365,2803,2852,91.0064935064935,-49,-44
2017,202337,Luke Babbitt,Luke Babbitt,50,50,1645,1680,3325,355.916666666667,352.85,708.766666666667,717,715,715,1561,1610,94.8936170212766,-49,-33
2017,1627761,DeAndre' Bembry,DeAndre' Bembry,26,26,1058,1098,2156,227.483333333333,233.95,461.433333333333,454,455,455,974,1023,92.0604914933837,-49,-76
2017,1628391,D.J. Wilson,D.J. Wilson,21,22,152,162,314,34.3833333333333,34.9333333333333,69.3166666666667,72,71,71,124,173,81.5789473684211,-49,-41
2017,1628455,Mike James,Mike James,36,36,1702,1688,3390,345.35,340.55,685.9,688,687,687,1563,1612,91.8331374853114,-49,-40
2017,203086,Meyers Leonard,Meyers Leonard,33,33,581,577,1158,134.066666666667,118.466666666667,252.533333333333,253,254,254,554,604,95.3528399311532,-50,-35
2017,203918,Rodney Hood,Rodney Hood,60,60,3660,3685,7345,811.9,799.666666666667,1611.56666666667,1614,1616,1616,3533,3583,96.5300546448088,-50,-62
2017,201565,Derrick Rose,Derrick Rose,25,25,1001,1016,2017,202.966666666667,214.25,417.216666666667,420,420,420,967,1019,96.6033966033966,-52,-53
2017,203124,Kyle O'Quinn,Kyle O'Quinn,77,77,3200,3245,6445,703.183333333333,681.183333333333,1384.36666666667,1392,1387,1387,3018,3070,94.3125,-52,-42
2017,201147,Corey Brewer,Corey Brewer,72,72,3014,2939,5953,587.616666666667,619.383333333333,1207,1209,1208,1208,2763,2816,91.672196416722,-53,-56
2017,201158,Marco Belinelli,Marco Belinelli,80,80,4635,4637,9272,962.733333333333,985.5,1948.23333333333,1945,1947,1947,4334,4387,93.5059331175836,-53,-27
2017,202355,Hassan Whiteside,Hassan Whiteside,54,54,3187,3145,6332,704.533333333333,655.966666666667,1360.5,1363,1364,1364,2855,2909,89.5826796360213,-54,-79
2017,203944,Julius Randle,Julius Randle,82,82,5233,5229,10462,1054.41666666667,1129.98333333333,2184.4,2191,2190,2190,4942,4997,94.4391362507166,-55,-80
2017,1628404,Josh Hart,Josh Hart,63,63,3478,3492,6970,699,756.35,1455.35,1460,1461,1461,3260,3315,93.7320299022427,-55,-71
2017,202325,Wesley Johnson,Wesley Johnson,74,74,3539,3593,7132,733.266666666667,746.333333333333,1479.6,1491,1486,1486,3318,3374,93.7552981068098,-56,-63
2017,202702,Kenneth Faried,Kenneth Faried,32,32,1104,1051,2155,233.566666666667,224.483333333333,458.05,463,461,461,973,1029,88.1340579710145,-56,-42
2017,1628681,Rodney Purvis,Rodney Purvis,16,16,659,679,1338,146.583333333333,141.783333333333,288.366666666667,291,290,290,580,639,88.0121396054628,-59,-58
2017,201628,Bobby Brown,Bobby Brown,20,20,265,274,539,57.15,56.2333333333333,113.383333333333,113,115,115,228,288,86.0377358490566,-60,-59
2017,201943,Brandon Jennings,Brandon Jennings,14,14,494,483,977,103.533333333333,101.4,204.933333333333,208,205,205,424,484,85.82995951417,-60,-63
2017,203530,Joffrey Lauvergne,Joffrey Lauvergne,55,55,1247,1264,2511,268.383333333333,261.666666666667,530.05,534,534,534,1140,1200,91.4194065757819,-60,-70
2017,203504,Trey Burke,Trey Burke,36,36,1827,1853,3680,389.016666666667,392.366666666667,781.383333333333,785,785,785,1796,1858,98.3032293377121,-62,-81
2017,1628504,Xavier Rathan-Mayes,Xavier Rathan-Mayes,5,5,276,277,553,59.1166666666667,58.1166666666667,117.233333333333,118,118,118,225,287,81.5217391304348,-62,-59
2017,203079,Dion Waiters,Dion Waiters,30,30,2067,2066,4133,468.9,445.85,914.75,920,918,918,1872,1936,90.5660377358491,-64,-85
2017,203917,Nik Stauskas,Nik Stauskas,41,41,1196,1223,2419,258.05,260.566666666667,518.616666666667,521,523,523,1085,1149,90.7190635451505,-64,-57
2017,204456,T.J. McConnell,T.J. McConnell,76,76,4088,4149,8237,845.316666666667,863.066666666667,1708.38333333333,1705,1706,1706,3770,3834,92.2211350293542,-64,-71
2017,203501,Tim Hardaway Jr.,Tim Hardaway Jr.,57,57,4524,4411,8935,951.7,928.15,1879.85,1885,1885,1885,4190,4255,92.6171529619806,-65,-74
2017,203953,Jabari Parker,Jabari Parker,31,31,1767,1777,3544,364.8,378.3,743.1,743,743,743,1646,1712,93.1522354272779,-66,-65
2017,1628373,Frank Ntilikina,Frank Ntilikina,78,78,3981,3957,7938,862.75,838.933333333334,1701.68333333333,1704,1706,1706,3601,3667,90.454659633258,-66,-102
2017,1626202,Joe Young,Joe Young,53,53,1292,1293,2585,284.2,267.866666666667,552.066666666667,560,558,558,1161,1228,89.8606811145511,-67,-53
2017,1627775,Patrick McCaw,Patrick McCaw,56,57,2245,2329,4574,469.583333333333,486.666666666667,956.25,962,961,961,2142,2209,95.4120267260579,-67,-85
2017,1627781,Malachi Richardson,Malachi Richardson,26,26,740,740,1480,164.483333333333,155.166666666667,319.65,323,324,324,660,728,89.1891891891892,-68,-55
2017,1713,Vince Carter,Vince Carter,58,58,2332,2323,4655,528.733333333333,500.45,1029.18333333333,1027,1026,1026,2127,2196,91.2092624356775,-69,-67
2017,201596,Mario Chalmers,Mario Chalmers,66,66,3347,3327,6674,728.033333333333,694.8,1422.83333333333,1426,1421,1421,3026,3095,90.4093217806991,-69,-60
2017,1626151,Aaron Harrison,Aaron Harrison,9,9,532,537,1069,118.6,114.7,233.3,235,233,233,472,541,88.7218045112782,-69,-72
2017,1627982,Josh Gray,Josh Gray,5,5,218,210,428,45.1333333333334,41.6333333333333,86.7666666666667,87,86,86,158,227,72.4770642201835,-69,-69
2017,1626147,Justin Anderson,Justin Anderson,38,38,1219,1255,2474,261.783333333333,258.45,520.233333333333,519,519,519,1103,1174,90.4840032813782,-71,-82
2017,203085,Austin Rivers,Austin Rivers,61,61,4785,4776,9561,1034.51666666667,1010.56666666667,2045.08333333333,2059,2057,2057,4600,4672,96.1337513061651,-72,-56
2017,201166,Aaron Brooks,Aaron Brooks,30,32,428,438,866,96.9833333333333,88.5,185.483333333333,189,189,189,392,465,91.588785046729,-73,-75
2017,201573,Jerryd Bayless,Jerryd Bayless,39,39,2230,2237,4467,455.133333333333,467.4,922.533333333333,925,925,925,2029,2102,90.9865470852018,-73,-69
2017,1627753,Zhou Qi,Zhou Qi,18,18,291,302,593,61.4,59.7833333333333,121.183333333333,123,124,124,218,291,74.9140893470791,-73,-67
2017,204028,Tarik Black,Tarik Black,51,51,1266,1270,2536,264.316666666667,268.033333333333,532.35,534,536,536,1109,1185,87.5987361769352,-76,-74
2017,1628390,Terrance Ferguson,Terrance Ferguson,60,61,1789,1736,3525,373.75,382.5,756.25,765,763,763,1614,1690,90.217998882057,-76,-84
2017,202714,Shelvin Mack,Shelvin Mack,69,69,3110,3156,6266,687.516666666667,674.733333333333,1362.25,1364,1365,1365,2860,2937,91.9614147909968,-77,-93
2017,1626203,Treveon Graham,Treveon Graham,63,63,2471,2387,4858,538.3,507.866666666667,1046.16666666667,1049,1050,1050,2258,2335,91.3800080938891,-77,-94
2017,201196,Ramon Sessions,Ramon Sessions,28,28,920,919,1839,198.033333333333,192.65,390.683333333333,393,392,392,816,895,88.6956521739131,-79,-83
2017,1628414,Sindarius Thornwell,Sindarius Thornwell,69,73,2731,2779,5510,561.683333333333,593.066666666667,1154.75,1157,1156,1156,2522,2601,92.3471255950201,-79,-94
2017,1626171,Bobby Portis,Bobby Portis,73,73,3941,3850,7791,789.716666666667,856.1,1645.81666666667,1641,1643,1643,3698,3778,93.8340522709972,-80,-83
2017,203948,Johnny O'Bryant III,Johnny O'Bryant,36,36,886,892,1778,193.683333333333,182.666666666667,376.35,380,379,379,753,834,84.9887133182844,-81,-87
2017,202718,Chandler Parsons,Chandler Parsons,36,36,1555,1568,3123,352.366666666667,337.566666666667,689.933333333333,692,691,691,1487,1570,95.6270096463023,-83,-85
2017,201572,Brook Lopez,Brook Lopez,74,74,4185,4146,8331,839.633333333333,886.766666666667,1726.4,1736,1735,1735,3884,3968,92.8076463560335,-84,-79
2017,201160,Jason Smith,Jason Smith,33,33,665,683,1348,136.95,145.3,282.25,290,285,285,583,668,87.6691729323308,-85,-83
2017,1628411,Wes Iwundu,Wesley Iwundu,62,62,2344,2334,4678,522.733333333333,492.383333333333,1015.11666666667,1017,1020,1020,2086,2171,88.9931740614335,-85,-105
2017,1628510,Andrew White III,Andrew White,15,15,495,503,998,104.866666666667,104.1,208.966666666667,208,209,209,415,500,83.8383838383838,-85,-70
2017,203118,Mike Scott,Mike Scott,76,76,3267,3297,6564,704.666666666667,697.783333333333,1402.45,1404,1406,1406,3058,3144,93.6026936026936,-86,-80
2017,204025,Tim Frazier,Tim Frazier,59,59,1908,1909,3817,413.966666666667,420.05,834.016666666667,840,838,838,1762,1848,92.3480083857442,-86,-84
2017,203932,Aaron Gordon,Aaron Gordon,58,58,4482,4520,9002,936.966666666667,965.7,1902.66666666667,1915,1909,1909,4218,4305,94.1097724230254,-87,-92
2017,1628436,Luke Kornet,Luke Kornet,20,20,751,773,1524,163.966666666667,163.35,327.316666666667,326,326,326,690,777,91.8774966711052,-87,-71
2017,203903,Jordan Clarkson,Jordan Clarkson,81,81,4533,4536,9069,927.683333333333,962.133333333333,1889.81666666667,1885,1888,1888,4171,4259,92.0141186851975,-88,-38
2017,203915,Spencer Dinwiddie,Spencer Dinwiddie,80,80,5358,5370,10728,1178.98333333333,1121.96666666667,2300.95,2306,2306,2306,5093,5181,95.0541246733856,-88,-100
2017,1628432,Davon Reed,Davon Reed,21,21,580,582,1162,116.483333333333,123.066666666667,239.55,242,242,242,470,558,81.0344827586207,-88,-75
2017,2207,Joe Johnson,Joe Johnson,55,55,2725,2763,5488,611.916666666667,589.616666666667,1201.53333333333,1204,1205,1205,2495,2584,91.5596330275229,-89,-77
2017,1626163,Frank Kaminsky,Frank Kaminsky,79,79,4313,4187,8500,931.433333333333,902.133333333333,1833.56666666667,1838,1835,1835,4076,4165,94.5049849292836,-89,-55
2017,1626166,Cameron Payne,Cameron Payne,25,25,1406,1352,2758,278.366666666667,301.45,579.816666666667,584,582,582,1258,1349,89.4736842105263,-91,-89
2017,1717,Dirk Nowitzki,Dirk Nowitzki,77,77,4213,4270,8483,980.6,905.45,1886.05,1900,1900,1900,4095,4187,97.1991455020176,-92,-55
2017,203521,Matthew Dellavedova,Matthew Dellavedova,38,38,1566,1618,3184,347.366666666667,365.933333333333,713.3,709,712,712,1495,1587,95.4661558109834,-92,-79
2017,202347,Quincy Pondexter,Quincy Pondexter,23,23,452,443,895,94.65,100.133333333333,194.783333333333,195,196,196,360,454,79.6460176991151,-94,-90
2017,203459,Allen Crabbe,Allen Crabbe,75,75,5203,5243,10446,1107.5,1080.56666666667,2188.06666666667,2197,2197,2197,4914,5008,94.4455122044974,-94,-81
2017,202335,Patrick Patterson,Patrick Patterson,82,82,2877,2910,5787,611.916666666667,655.633333333333,1267.55,1271,1270,1270,2612,2707,90.7890163364616,-95,-74
2017,202389,Timofey Mozgov,Timofey Mozgov,31,31,864,858,1722,182.65,174.1,356.75,358,359,359,732,827,84.7222222222222,-95,-86
2017,1628388,TJ Leaf,T.J. Leaf,53,53,1091,1082,2173,234.95,220.166666666667,455.116666666667,458,459,459,990,1086,90.7424381301558,-96,-75
2017,201167,Arron Afflalo,Arron Afflalo,53,53,1508,1610,3118,346.55,333.4,679.95,681,682,682,1399,1500,92.7718832891247,-101,-97
2017,202684,Tristan Thompson,Tristan Thompson,53,53,2535,2467,5002,538.933333333333,528.866666666667,1067.8,1072,1072,1072,2401,2502,94.7140039447732,-101,-137
2017,1627362,Briante Weber,Briante Weber,18,18,567,550,1117,118.6,116.766666666667,235.366666666667,235,237,237,500,601,88.1834215167549,-101,-109
2017,1626162,Kelly Oubre Jr.,Kelly Oubre,81,81,5238,5279,10517,1118.35,1108.58333333333,2226.93333333333,2233,2231,2231,4902,5004,93.5853379152348,-102,-113
2017,1627767,Cheick Diallo,Cheick Diallo,52,52,1375,1419,2794,281.55,294.6,576.15,582,581,581,1276,1378,92.8,-102,-106
2017,1627846,Abdel Nader,Abdel Nader,47,48,1202,1201,2403,267.3,248.85,516.15,522,522,522,1072,1174,89.1846921797005,-102,-110
2017,202340,Avery Bradley,Avery Bradley,46,46,3337,3275,6612,721.766666666667,703.666666666667,1425.43333333333,1431,1433,1433,3028,3132,90.7401857956248,-104,-119
2017,203488,Mike Muscala,Mike Muscala,53,53,2535,2558,5093,535.45,523.45,1058.9,1062,1060,1060,2342,2447,92.3865877712032,-105,-75
2017,1628371,Jonathan Isaac,Jonathan Isaac,27,27,1207,1285,2492,265.35,269.016666666667,534.366666666667,537,536,536,1042,1149,86.3297431648716,-107,-108
2017,1628397,Ivan Rabb,Ivan Rabb,35,36,1227,1193,2420,263.066666666667,250.85,513.916666666667,518,516,516,1087,1194,88.5900570497148,-107,-96
2017,203112,Quincy Acy,Quincy Acy,70,70,3148,3213,6361,688.366666666667,669.616666666667,1357.98333333333,1362,1359,1359,2972,3080,94.4091486658196,-108,-55
2017,1628467,Maxi Kleber,Maxi Kleber,71,72,2701,2734,5435,621.266666666667,586.75,1208.01666666667,1209,1206,1206,2489,2601,92.1510551647538,-112,-130
2017,201571,D.J. Augustin,D.J. Augustin,75,75,4078,4143,8221,905.2,851.583333333333,1756.78333333333,1759,1760,1760,3754,3868,92.0549288867092,-114,-129
2017,201588,George Hill,George Hill,67,67,4124,4065,8189,931.216666666667,873.966666666667,1805.18333333333,1811,1812,1812,3937,4052,95.4655674102813,-115,-123
2017,201599,DeAndre Jordan,DeAndre Jordan,77,77,5678,5658,11336,1211.71666666667,1196.63333333333,2408.35,2423,2424,2424,5348,5463,94.1880943994364,-115,-122
2017,2749,Jameer Nelson,Jameer Nelson,50,50,2321,2403,4724,501.55,509.833333333333,1011.38333333333,1016,1013,1013,2194,2314,94.5282205945713,-120,-93
2017,202699,Tobias Harris,Tobias Harris,80,80,6241,6160,12401,1344.3,1314.71666666667,2659.01666666667,2670,2668,2668,5895,6015,94.4560166639962,-120,-115
2017,1627782,Wayne Selden,Wayne Selden,35,35,1622,1622,3244,352.1,338.283333333333,690.383333333334,693,692,692,1470,1590,90.6288532675709,-120,-102
2017,1627742,Brandon Ingram,Brandon Ingram,59,59,4811,4753,9564,958.083333333333,1009.3,1967.38333333333,1978,1975,1975,4347,4468,90.3554354604032,-121,-127
2017,1627746,Skal Labissiere,Skal Labissiere,60,60,2860,2826,5686,620.466666666667,612.55,1233.01666666667,1239,1240,1240,2622,2743,91.6783216783217,-121,-118
2017,203095,Evan Fournier,Evan Fournier,57,57,4305,4415,8720,892.783333333333,942.466666666667,1835.25,1837,1837,1837,4147,4271,96.3298490127758,-124,-121
2017,203498,Shabazz Muhammad,Shabazz Muhammad,43,43,965,989,1954,207.616666666667,206.866666666667,414.483333333333,417,418,418,883,1007,91.5025906735751,-124,-117
2017,1628386,Jarrett Allen,Jarrett Allen,72,72,3357,3458,6815,734.666666666667,703.05,1437.71666666667,1437,1441,1441,3131,3255,93.2677986297289,-124,-144
2017,203457,Nerlens Noel,Nerlens Noel,29,30,1085,1072,2157,244.716666666667,228.1,472.816666666667,472,472,472,916,1041,84.4239631336406,-125,-119
2017,1627098,Malcolm Delaney,Malcolm Delaney,54,54,2352,2417,4769,510.216666666667,504.783333333333,1015,1015,1014,1014,2149,2275,91.3690476190476,-126,-110
2017,1628400,Semi Ojeleye,Semi Ojeleye,73,73,2598,2660,5258,583.3,564.8,1148.1,1153,1150,1150,2324,2452,89.4534257120862,-128,-183
2017,203930,Sean Kilpatrick,Sean Kilpatrick,52,52,1501,1494,2995,308.416666666667,327.45,635.866666666667,638,640,640,1354,1483,90.2065289806796,-129,-114
2017,202362,Lance Stephenson,Lance Stephenson,82,82,4275,4252,8527,938.666666666667,911.016666666667,1849.68333333333,1848,1850,1850,4006,4136,93.7076023391813,-130,-108
2017,202738,Isaiah Thomas,Isaiah Thomas,32,32,2084,2103,4187,424.8,435.883333333333,860.683333333333,863,862,862,1997,2127,95.8253358925144,-130,-116
2017,2747,JR Smith,J.R. Smith,80,80,5186,5237,10423,1124.71666666667,1110.05,2234.76666666667,2249,2244,2244,5113,5250,98.5923640570768,-137,-114
2017,201975,Jodie Meeks,Jodie Meeks,77,77,2627,2618,5245,562.883333333333,551.3,1114.18333333333,1118,1119,1119,2394,2531,91.1305671869052,-137,-153
2017,1627738,Deyonta Davis,Deyonta Davis,62,62,2205,2253,4458,471.85,466.766666666667,938.616666666667,942,943,943,2000,2137,90.702947845805,-137,-160
2017,1628398,Kyle Kuzma,Kyle Kuzma,77,77,5796,5813,11609,1148.78333333333,1242.2,2390.98333333333,2402,2401,2401,5350,5489,92.3050379572119,-139,-123
2017,203473,Dewayne Dedmon,Dewayne Dedmon,62,62,3578,3632,7210,774.183333333333,760.416666666667,1534.6,1544,1542,1542,3298,3440,92.1743991056456,-142,-159
2017,1626143,Jahlil Okafor,Jahlil Okafor,28,28,778,791,1569,181.033333333333,166.066666666667,347.1,355,353,353,668,819,85.8611825192802,-151,-163
2017,203101,Miles Plumlee,Miles Plumlee,55,55,2133,2145,4278,464.083333333333,447.466666666667,911.55,918,918,918,1900,2054,89.0764181903422,-154,-158
2017,1627748,Thon Maker,Thon Maker,74,74,2759,2859,5618,601.05,635.383333333333,1236.43333333333,1239,1238,1238,2645,2799,95.8680681406307,-154,-165
2017,201563,Michael Beasley,Michael Beasley,73,74,3918,3874,7792,842.266666666667,806.5,1648.76666666667,1658,1653,1653,3618,3773,92.3430321592649,-155,-137
2017,1627741,Buddy Hield,Buddy Hield,80,80,4579,4574,9153,1013.66666666667,1008.2,2021.86666666667,2027,2024,2024,4204,4359,91.8104389604717,-155,-155
2017,203145,Kent Bazemore,Kent Bazemore,65,65,4147,4259,8406,889.883333333333,891.7,1781.58333333333,1791,1789,1789,3840,3997,92.5970581142995,-157,-169
2017,1626178,Rondae Hollis-Jefferson,Rondae Hollis-Jefferson,68,68,4531,4628,9159,964.566666666667,950.65,1915.21666666667,1921,1920,1920,4275,4434,94.3500331052748,-159,-192
2017,203925,Joe Harris,Joe Harris,78,78,4628,4660,9288,1004.93333333333,965.45,1970.38333333333,1973,1975,1975,4322,4482,93.3880726015557,-160,-122
2017,1628416,Tyler Dorsey,Tyler Dorsey,56,56,2298,2293,4591,496,474.633333333333,970.633333333333,978,974,974,2081,2242,90.5570060922541,-161,-142
2017,202498,Lance Thomas,Lance Thomas,73,73,3112,3111,6223,688.366666666667,660.4,1348.76666666667,1352,1353,1353,2821,2985,90.6491002570694,-164,-184
2017,203476,Gorgui Dieng,Gorgui Dieng,79,79,3101,3090,6191,691.516666666667,638.916666666667,1330.43333333333,1334,1333,1333,2895,3062,93.3569816188326,-167,-202
2017,203897,Zach LaVine,Zach LaVine,24,24,1531,1512,3043,322.016666666667,329.866666666667,651.883333333333,653,656,656,1396,1572,91.1822338340954,-176,-172
2017,2037,Jamal Crawford,Jamal Crawford,80,80,3799,3815,7614,855.8,791.133333333333,1646.93333333333,1658,1653,1653,3634,3818,95.6567517767834,-184,-144
2017,1626150,Andrew Harrison,Andrew Harrison,56,56,2950,2928,5878,685.616666666667,632.366666666667,1317.98333333333,1325,1326,1326,2644,2828,89.6271186440678,-184,-202
2017,202683,Enes Kanter,Enes Kanter,71,71,4328,4229,8557,931.5,892.316666666667,1823.81666666667,1830,1830,1830,3957,4145,91.4279112754159,-188,-182
2017,203200,Justin Holiday,Justin Holiday,72,72,5325,5244,10569,1106.1,1153.46666666667,2259.56666666667,2269,2265,2265,4924,5112,92.4694835680751,-188,-180
2017,1627835,Paul Zipser,Paul Zipser,53,54,1844,1875,3719,394.65,423.966666666667,818.616666666667,823,824,824,1641,1833,88.9913232104122,-192,-218
2017,203516,James Ennis III,James Ennis,72,72,3643,3692,7335,805.866666666667,796.816666666667,1602.68333333333,1602,1604,1604,3321,3514,91.1611309360417,-193,-183
2017,202732,DeAndre Liggins,DeAndre Liggins,56,58,1600,1674,3274,352.166666666667,367.683333333333,719.85,727,724,724,1454,1654,90.875,-200,-211
2017,1628382,Justin Jackson,Justin Jackson,68,68,3432,3421,6853,753.95,740.633333333333,1494.58333333333,1507,1506,1506,3103,3310,90.4137529137529,-207,-237
2017,1626156,D'Angelo Russell,D'Angelo Russell,48,48,2963,3053,6016,622.083333333333,607.733333333333,1229.81666666667,1233,1234,1234,2771,2979,93.5200809989875,-208,-186
2017,1628021,David Nwaba,David Nwaba,70,70,3902,3848,7750,792.633333333333,850.433333333333,1643.06666666667,1647,1646,1646,3547,3761,90.9021014864172,-214,-238
2017,1628370,Malik Monk,Malik Monk,63,63,2033,2025,4058,429.866666666667,416.666666666667,846.533333333333,853,854,854,1825,2039,89.7688145597639,-214,-188
2017,1628415,Dillon Brooks,Dillon Brooks,82,82,5297,5294,10591,1193.86666666667,1145.46666666667,2339.33333333333,2352,2350,2350,4805,5019,90.7117236171418,-214,-243
2017,1628424,Kobi Simmons,Kobi Simmons,32,32,1490,1465,2955,330.416666666667,309.083333333333,639.5,645,643,643,1327,1542,89.0604026845638,-215,-213
2017,203210,JaMychal Green,JaMychal Green,55,55,3468,3402,6870,785.766666666667,748.883333333333,1534.65,1538,1542,1542,3124,3344,90.080738177624,-220,-250
2017,1626209,Mario Hezonja,Mario Hezonja,75,75,3808,3886,7694,829.533333333333,817.6,1647.13333333333,1655,1657,1657,3513,3733,92.2531512605042,-220,-205
2017,1628381,John Collins,John Collins,74,74,4172,4246,8418,894.766666666667,888,1782.76666666667,1785,1785,1785,3764,3988,90.2205177372963,-224,-219
2017,1627747,Caris LeVert,Caris LeVert,71,71,4442,4478,8920,947.6,916.166666666667,1863.76666666667,1865,1864,1864,4070,4295,91.6253939666817,-225,-263
2017,201577,Robin Lopez,Robin Lopez,64,64,3882,3838,7720,828.9,855.25,1684.15,1694,1690,1690,3515,3741,90.5461102524472,-226,-199
2017,201585,Kosta Koufos,Kosta Koufos,71,71,3145,3123,6268,702.216666666667,686.716666666667,1388.93333333333,1390,1391,1391,2752,2980,87.5039745627981,-228,-224
2017,202328,Greg Monroe,Greg Monroe,51,51,2435,2446,4881,531.383333333333,507.516666666667,1038.9,1040,1040,1040,2155,2404,88.5010266940452,-249,-213
2017,202066,Garrett Temple,Garrett Temple,65,65,3692,3638,7330,830.566666666667,779.583333333333,1610.15,1615,1615,1615,3261,3514,88.3261105092091,-253,-265
2017,1626185,Jarell Martin,Jarell Martin,73,73,3773,3789,7562,845.416666666667,810.316666666667,1655.73333333333,1663,1661,1661,3370,3626,89.3188444208852,-256,-264
2017,1627739,Kris Dunn,Kris Dunn,52,52,3561,3533,7094,740.133333333333,779.716666666667,1519.85,1525,1525,1525,3246,3504,91.1541701769166,-258,-274
2017,203471,Dennis Schroder,Dennis Schroder,67,67,4850,4915,9765,1039.4,1030.1,2069.5,2076,2078,2078,4489,4749,92.5567010309278,-260,-283
2017,2199,Tyson Chandler,Tyson Chandler,46,46,2749,2721,5470,576.466666666667,568.766666666667,1145.23333333333,1154,1151,1151,2396,2666,87.1589668970535,-270,-244
2017,1626170,Jerian Grant,Jerian Grant,74,74,3893,3840,7733,822.4,858.666666666667,1681.06666666667,1685,1686,1686,3515,3790,90.2902645774467,-275,-254
2017,1627737,Marquese Chriss,Marquese Chriss,72,72,3711,3694,7405,750.816666666667,768.383333333333,1519.2,1524,1527,1527,3286,3561,88.5475613042307,-275,-297
2017,203458,Alex Len,Alex Len,69,69,3405,3406,6811,694.833333333333,699.933333333333,1394.76666666667,1395,1395,1395,3051,3328,89.6035242290749,-277,-253
2017,1626144,Emmanuel Mudiay,Emmanuel Mudiay,64,64,3002,2976,5978,625.333333333333,615.6,1240.93333333333,1244,1245,1245,2669,2947,88.9073950699534,-278,-265
2017,203463,Ben McLemore,Ben McLemore,56,56,2522,2531,5053,545.566666666667,545.1,1090.66666666667,1090,1091,1091,2178,2466,86.3600317208565,-288,-317
2017,1627756,Denzel Valentine,Denzel Valentine,77,77,4927,4801,9728,1019.76666666667,1070.33333333333,2090.1,2098,2095,2095,4404,4694,89.3850213111427,-290,-271
2017,203613,Jonathon Simmons,Jonathon Simmons,69,69,4710,4807,9517,1003.48333333333,1020.08333333333,2023.56666666667,2030,2029,2029,4416,4709,93.7579617834395,-293,-312
2017,201584,Courtney Lee,Courtney Lee,76,76,5372,5388,10760,1176.65,1126.76666666667,2303.41666666667,2311,2310,2310,4936,5237,91.8838421444527,-301,-256
2017,1626161,Willie Cauley-Stein,Willie Cauley-Stein,73,73,4644,4601,9245,1032.35,1005.18333333333,2037.53333333333,2047,2044,2044,4184,4497,90.0947459086994,-313,-323
2017,1627752,Taurean Prince,Taurean Waller-Prince,82,82,5777,5869,11646,1241.65,1217.2,2458.85,2466,2464,2464,5344,5659,92.5047602561883,-315,-368
2017,1627755,Tyler Ulis,Tyler Ulis,71,71,3967,3940,7907,816.133333333333,835.4,1651.53333333333,1657,1658,1658,3500,3817,88.2278800100832,-317,-316
2017,1628372,Dennis Smith Jr.,"",69,,4651,4683,9334,1051.63333333333,994.566666666667,2046.2,2052,,,4304,4630,92.5392388733606,-326,-325
2017,203084,Harrison Barnes,Harrison Barnes,77,77,5913,6001,11914,1361.31666666667,1275.4,2636.71666666667,2638,2634,2634,5513,5842,93.2352443767969,-329,-327
2017,201188,Marc Gasol,Marc Gasol,73,73,5387,5381,10768,1243.71666666667,1158.96666666667,2402.68333333333,2409,2408,2408,4879,5211,90.5698904770744,-332,-313
2017,202083,Wesley Matthews,Wesley Matthews,63,63,4761,4834,9595,1104.13333333333,1022.61666666667,2126.75,2134,2131,2131,4457,4791,93.6147868094938,-334,-325
2017,1626245,Cristiano Felicio,Cristiano Felicio,55,55,2284,2240,4524,470.4,501.116666666667,971.516666666667,980,977,977,1909,2244,83.5814360770578,-335,-335
2017,2216,Zach Randolph,Zach Randolph,59,59,3427,3360,6787,788.283333333333,712.533333333333,1500.81666666667,1508,1508,1508,3077,3437,89.78698570178,-360,-354
2017,203992,Bogdan Bogdanovic,Bogdan Bogdanovic,78,78,4958,4900,9858,1101.85,1068.3,2170.15,2175,2175,2175,4498,4861,90.722065348931,-363,-362
2017,1628374,Lauri Markkanen,Lauri Markkanen,68,68,4696,4624,9320,994.55,1016.03333333333,2010.58333333333,2022,2020,2020,4237,4616,90.2257240204429,-379,-387
2017,1628368,De'Aaron Fox,De'Aaron Fox,73,73,4690,4668,9358,1015.51666666667,1001.46666666667,2016.98333333333,2023,2026,2026,4206,4611,89.680170575693,-405,-413
2017,1626164,Devin Booker,Devin Booker,54,54,4610,4587,9197,929.55,930.483333333333,1860.03333333333,1864,1865,1865,4104,4511,89.0238611713666,-407,-358
2017,203584,Troy Daniels,Troy Daniels,79,79,3859,3894,7753,801.916666666667,815.5,1617.41666666667,1620,1622,1622,3475,3892,90.0492355532521,-417,-406
2017,202687,Bismack Biyombo,Bismack Biyombo,82,82,3436,3540,6976,743.233333333333,751.916666666667,1495.15,1491,1495,1495,2975,3397,86.5832363213039,-422,-429
2017,203933,T.J. Warren,T.J. Warren,65,65,5178,5187,10365,1064.91666666667,1069.15,2134.06666666667,2139,2142,2142,4634,5080,89.4940131324836,-446,-430
2017,203901,Elfrid Payton,Elfrid Payton,63,63,4286,4380,8666,858.05,935.966666666667,1794.01666666667,1807,1808,1808,3943,4399,91.9972001866542,-456,-462
2017,1628367,Josh Jackson,Josh Jackson,77,77,4773,4796,9569,960.4,994.85,1955.25,1960,1959,1959,4166,4639,87.282631468678,-473,-529
2017,1627733,Dragan Bender,Dragan Bender,82,82,4934,4988,9922,1019.56666666667,1040.36666666667,2059.93333333333,2072,2069,2069,4401,4879,89.1974057559789,-478,-469
