id_player,name_player,name_player_summary_nbastatr,gp_calc_total,gp_summary_nbastatr,poss_calc_o,poss_calc_d,poss_calc_total,mp_calc_o,mp_calc_d,mp_calc_total,mp_game_logs_nbastatr,mp_summary1_nbastatr,mp_summary2_nbastatr,pts_calc_o,pts_calc_d,pts_o_per100_calc,pm_calc,pm_game_logs_nbastatr
201939,Stephen Curry,Stephen Curry,79,79,6475,6539,13014,1231.01666666667,1402.08333333333,2633.1,2636,2638,2638,6801,5819,105.034749034749,982,1017
203110,Draymond Green,Draymond Green,76,76,5923,6045,11968,1144.7,1311.91666666667,2456.61666666667,2475,2471,2471,6079,5293,102.633800438967,786,822
202691,Klay Thompson,Klay Thompson,78,78,6252,6461,12713,1239.06666666667,1398,2637.06666666667,2647,2649,2649,6465,5690,103.406909788868,775,793
201142,Kevin Durant,Kevin Durant,62,62,4956,5079,10035,967.55,1096.28333333333,2063.83333333333,2072,2070,2070,5207,4536,105.064568200161,671,711
101108,Chris Paul,Chris Paul,61,61,4426,4415,8841,959.666666666667,954.216666666667,1913.88333333333,1921,1921,1921,4527,3983,102.281970176231,544,581
2738,Andre Iguodala,Andre Iguodala,76,76,4744,4923,9667,950.116666666667,1050.61666666667,2000.73333333333,2001,1998,1998,4834,4325,101.897133220911,509,526
201599,DeAndre Jordan,DeAndre Jordan,81,81,5937,5943,11880,1284.83333333333,1276.31666666667,2561.15,2569,2570,2570,5935,5463,99.9663129526697,472,455
2544,LeBron James,LeBron James,74,74,6476,6424,12900,1407.65,1374.21666666667,2781.86666666667,2796,2794,2794,6567,6107,101.405188387894,460,482
2585,Zaza Pachulia,Zaza Pachulia,70,70,3039,3038,6077,581.85,676.25,1258.1,1265,1268,1268,3128,2687,102.928594932544,441,419
203497,Rudy Gobert,Rudy Gobert,81,81,5994,5959,11953,1418.16666666667,1315.93333333333,2734.1,2737,2744,2744,5775,5334,96.3463463463464,441,434
201933,Blake Griffin,Blake Griffin,61,61,4812,4799,9611,1034.45,1036.68333333333,2071.13333333333,2078,2076,2076,4891,4457,101.641729010806,434,442
200755,JJ Redick,J.J. Redick,78,78,5092,5116,10208,1092.3,1096.15,2188.45,2199,2198,2198,5156,4743,101.256873527101,413,473
202695,Kawhi Leonard,Kawhi Leonard,74,74,5536,5533,11069,1259.46666666667,1201,2460.46666666667,2478,2474,2474,5509,5101,99.5122832369942,408,434
201935,James Harden,James Harden,81,81,7106,7105,14211,1411.71666666667,1534.38333333333,2946.1,2955,2947,2947,7192,6792,101.210244863496,400,424
201988,Patty Mills,Patty Mills,80,80,4101,4093,8194,878.3,884.2,1762.5,1754,1754,1754,4047,3653,98.6832479882955,394,408
200768,Kyle Lowry,Kyle Lowry,60,60,5100,5079,10179,1116.3,1108.65,2224.95,2245,2244,2244,5057,4684,99.156862745098,373,354
203109,Jae Crowder,Jae Crowder,72,72,5369,5524,10893,1137.96666666667,1182.76666666667,2320.73333333333,2337,2335,2335,5412,5058,100.800894021233,354,353
201583,Ryan Anderson,Ryan Anderson,72,72,5047,5010,10057,1013.73333333333,1095.13333333333,2108.86666666667,2113,2116,2116,5067,4733,100.39627501486,334,408
2772,Trevor Ariza,Trevor Ariza,80,80,6671,6673,13344,1327.48333333333,1441.66666666667,2769.15,2773,2773,2773,6691,6362,100.299805126668,329,366
201976,Patrick Beverley,Patrick Beverley,67,67,4922,4915,9837,971.65,1066.63333333333,2038.28333333333,2055,2058,2058,4901,4573,99.573344169037,328,353
202335,Patrick Patterson,Patrick Patterson,65,65,3671,3668,7339,798.933333333334,799.483333333333,1598.41666666667,1601,1599,1599,3670,3343,99.9727594660855,327,347
202330,Gordon Hayward,Gordon Hayward,73,73,5510,5499,11009,1299.21666666667,1210.96666666667,2510.18333333333,2519,2516,2516,5340,5017,96.9147005444646,323,348
201601,Luc Mbah a Moute,Luc Mbah a Moute,80,80,4083,4170,8253,883.133333333333,896.583333333333,1779.71666666667,1784,1787,1787,4082,3761,99.9755082047514,321,263
202681,Kyrie Irving,Kyrie Irving,72,72,5933,5881,11814,1273.68333333333,1251.16666666667,2524.85,2524,2525,2525,5987,5667,100.910163492331,320,330
203078,Bradley Beal,Bradley Beal,77,77,6301,6325,12626,1299.58333333333,1370.71666666667,2670.3,2689,2684,2684,6243,5926,99.0795111887002,317,332
201567,Kevin Love,Kevin Love,60,60,4494,4392,8886,956.05,931.733333333333,1887.78333333333,1887,1885,1885,4456,4142,99.1544281263907,314,336
201569,Eric Gordon,Eric Gordon,75,75,5628,5696,11324,1101.05,1224.38333333333,2325.43333333333,2322,2323,2323,5535,5232,98.3475479744136,303,295
201580,JaVale McGee,JaVale McGee,77,77,1871,1853,3724,352.916666666667,388.95,741.866666666667,739,739,739,1973,1671,105.451630144308,302,312
101161,Amir Johnson,Amir Johnson,80,80,3646,3721,7367,785.216666666667,815.2,1600.41666666667,1609,1608,1608,3647,3364,100.027427317608,283,207
203999,Nikola Jokic,Nikola Jokic,73,73,4890,4726,9616,1006.33333333333,1023,2029.33333333333,2033,2038,2038,4925,4643,100.715746421268,282,297
101135,David Lee,David Lee,79,79,3381,3415,6796,739.716666666667,736.716666666667,1476.43333333333,1480,1477,1477,3299,3021,97.5746820467317,278,315
200746,LaMarcus Aldridge,LaMarcus Aldridge,72,72,5186,5169,10355,1207.5,1128.11666666667,2335.61666666667,2335,2335,2335,5001,4737,96.4327034323178,264,272
201980,Danny Green,Danny Green,68,68,3987,4015,8002,928.7,871.45,1800.15,1806,1807,1807,3837,3573,96.2377727614748,264,268
1938,Manu Ginobili,Manu Ginobili,69,69,3062,3053,6115,644.483333333333,645.883333333333,1290.36666666667,1295,1291,1291,3019,2756,98.5956890920967,263,258
201588,George Hill,George Hill,49,49,3381,3298,6679,803.266666666667,732.283333333333,1535.55,1545,1544,1544,3269,3013,96.6873706004141,256,258
202322,John Wall,John Wall,78,78,6728,6733,13461,1372.16666666667,1449.81666666667,2821.98333333333,2836,2836,2836,6624,6370,98.4542211652794,254,247
201566,Russell Westbrook,Russell Westbrook,81,81,6936,6632,13568,1319.31666666667,1475.03333333333,2794.35,2802,2802,2802,6443,6200,92.8921568627451,243,247
203613,Jonathon Simmons,Jonathon Simmons,78,78,3194,3212,6406,711.65,688.216666666667,1399.86666666667,1396,1392,1392,3013,2773,94.3331246086412,240,211
202738,Isaiah Thomas,Isaiah Thomas,76,76,5935,6102,12037,1258.71666666667,1297,2555.71666666667,2572,2569,2569,6024,5786,101.499578770008,238,274
203469,Cody Zeller,Cody Zeller,62,62,3930,3841,7771,861.633333333333,853.5,1715.13333333333,1723,1725,1725,3797,3569,96.6157760814249,228,210
2200,Pau Gasol,Pau Gasol,64,64,3603,3626,7229,827.716666666667,787.4,1615.11666666667,1627,1627,1627,3559,3341,98.7787954482376,218,227
203473,Dewayne Dedmon,Dewayne Dedmon,76,76,3038,3019,6057,676.516666666667,656.983333333333,1333.5,1329,1330,1330,2820,2603,92.8242264647795,217,191
2403,Nene,Nene Hilario,67,67,2976,2929,5905,572.716666666667,631.833333333333,1204.55,1198,1198,1198,2902,2686,97.5134408602151,216,195
202689,Kemba Walker,Kemba Walker,79,79,6246,6214,12460,1378.63333333333,1352.53333333333,2731.16666666667,2743,2739,2739,6101,5889,97.6785142491194,212,186
202693,Markieff Morris,Markieff Morris,76,76,5545,5544,11089,1157.16666666667,1193.68333333333,2350.85,2372,2374,2374,5373,5162,96.8981064021641,211,177
202710,Jimmy Butler,Jimmy Butler,76,76,6597,6438,13035,1430.08333333333,1374.71666666667,2804.8,2808,2809,2809,6107,5902,92.5723813854782,205,205
203506,Victor Oladipo,Victor Oladipo,67,67,5384,5177,10561,1062.96666666667,1148.66666666667,2211.63333333333,2225,2222,2222,4926,4721,91.4933135215453,205,173
203937,Kyle Anderson,Kyle Anderson,72,72,2285,2303,4588,507.25,502,1009.25,1019,1020,1020,2197,1995,96.1487964989059,202,179
203991,Clint Capela,Clint Capela,65,65,3658,3668,7326,731.3,811.983333333333,1543.28333333333,1554,1551,1551,3663,3464,100.136686714051,199,215
2225,Tony Parker,Tony Parker,63,63,3498,3483,6981,828.233333333333,757.266666666667,1585.5,1588,1587,1587,3350,3154,95.7690108633505,196,178
202703,Nikola Mirotic,Nikola Mirotic,70,70,3944,3872,7816,836.483333333333,839.783333333333,1676.26666666667,1681,1679,1679,3699,3512,93.7880324543611,187,198
101162,Marcin Gortat,Marcin Gortat,82,82,5995,5979,11974,1241.06666666667,1308.61666666667,2549.68333333333,2561,2556,2556,5851,5677,97.5979983319433,174,202
201144,Mike Conley,Mike Conley,69,69,5169,5055,10224,1198.18333333333,1086.93333333333,2285.11666666667,2295,2292,2292,4906,4732,94.9119752369898,174,187
203500,Steven Adams,Steven Adams,80,80,5849,5579,11428,1132.91666666667,1248.18333333333,2381.1,2390,2389,2389,5358,5184,91.6054026329287,174,193
203512,Lucas Nogueira,Lucas Nogueira,55,57,2494,2563,5057,540.716666666667,546.683333333333,1087.4,1091,1088,1088,2489,2316,99.7995188452285,173,178
203460,Andre Roberson,Andre Roberson,79,79,5782,5574,11356,1121.8,1249.8,2371.6,2380,2376,2376,5310,5144,91.8367346938775,166,147
1626167,Myles Turner,Myles Turner,81,81,5740,5909,11649,1246.61666666667,1288.8,2535.41666666667,2543,2541,2541,5616,5451,97.8397212543554,165,144
201143,Al Horford,Al Horford,68,68,5002,5140,10142,1076.75,1105.2,2181.95,2199,2193,2193,4962,4798,99.2003198720512,164,215
204060,Joe Ingles,Joe Ingles,82,82,4350,4346,8696,1011.61666666667,954.333333333333,1965.95,1975,1972,1972,4223,4065,97.0804597701149,158,159
2733,Shaun Livingston,Shaun Livingston,76,76,3067,3171,6238,648.633333333333,691.816666666667,1340.45,1345,1345,1345,2935,2778,95.6961199869579,157,151
203490,Otto Porter Jr.,Otto Porter,80,80,6136,6119,12255,1259.2,1326.21666666667,2585.41666666667,2602,2605,2605,5969,5812,97.2783572359844,157,190
2207,Joe Johnson,Joe Johnson,78,78,4016,4020,8036,958.883333333333,884.416666666667,1843.3,1842,1843,1843,3899,3744,97.0866533864542,155,115
1713,Vince Carter,Vince Carter,73,73,4058,3959,8017,941.716666666667,858.683333333334,1800.4,1801,1799,1799,3831,3677,94.4061113849187,154,157
2561,David West,David West,68,68,1879,1974,3853,411.35,440.566666666667,851.916666666667,855,854,854,1851,1697,98.5098456625865,154,119
202331,Paul George,Paul George,75,75,6106,6241,12347,1336.15,1357.46666666667,2693.61666666667,2687,2689,2689,5980,5827,97.9364559449722,153,169
202684,Tristan Thompson,Tristan Thompson,78,78,5457,5396,10853,1183.08333333333,1151.78333333333,2334.86666666667,2337,2336,2336,5307,5156,97.2512369433755,151,131
2210,Richard Jefferson,Richard Jefferson,79,79,3678,3702,7380,809.716666666667,792.016666666667,1601.73333333333,1617,1614,1614,3630,3480,98.694942903752,150,132
201949,James Johnson,James Johnson,76,76,4853,4826,9679,1072.91666666667,1011.38333333333,2084.3,2086,2085,2085,4521,4376,93.158870801566,145,143
201942,DeMar DeRozan,DeMar DeRozan,74,74,6031,6082,12113,1339.95,1284.46666666667,2624.41666666667,2621,2620,2620,5880,5736,97.4962692754104,144,149
201568,Danilo Gallinari,Danilo Gallinari,63,63,5103,4998,10101,1056.95,1070.65,2127.6,2134,2134,2134,5003,4861,98.0403684107388,142,159
2749,Jameer Nelson,Jameer Nelson,75,75,4943,4708,9651,1020.06666666667,1015.93333333333,2036,2049,2045,2045,4768,4627,96.4596398948007,141,133
203082,Terrence Ross,Terrence Ross,78,78,4599,4589,9188,954.75,996.116666666667,1950.86666666667,1954,1955,1955,4512,4371,98.1082844096543,141,125
203918,Rodney Hood,Rodney Hood,59,59,3447,3467,6914,829.366666666667,756.816666666667,1586.18333333333,1591,1593,1593,3293,3167,95.5323469683783,126,109
203501,Tim Hardaway Jr.,Tim Hardaway Jr.,79,79,5098,5084,10182,1042.75,1106.91666666667,2149.66666666667,2150,2154,2154,4782,4657,93.8014907806983,125,158
203935,Marcus Smart,Marcus Smart,79,79,5639,5691,11330,1198.31666666667,1208.41666666667,2406.73333333333,2403,2399,2399,5407,5283,95.8857953537861,124,130
1891,Jason Terry,Jason Terry,74,74,3051,3101,6152,675.583333333333,688.483333333333,1364.06666666667,1366,1365,1365,2913,2794,95.4768928220256,119,107
1626155,Sam Dekker,Sam Dekker,77,77,3406,3441,6847,670.983333333333,746.366666666667,1417.35,1420,1419,1419,3321,3202,97.5044039929536,119,76
201960,DeMarre Carroll,DeMarre Carroll,72,72,4278,4295,8573,952.533333333333,922.516666666667,1875.05,1885,1882,1882,4128,4011,96.4936886395512,117,116
203079,Dion Waiters,Dion Waiters,46,46,3174,3201,6375,706.983333333333,674.533333333333,1381.51666666667,1384,1384,1384,3015,2903,94.9905482041588,112,83
203090,Maurice Harkless,Maurice Harkless,77,77,5194,5260,10454,1113.13333333333,1105.41666666667,2218.55,2219,2223,2223,5105,4993,98.2864844050828,112,45
203382,Aron Baynes,Aron Baynes,75,75,2624,2615,5239,575.45,583.983333333333,1159.43333333333,1163,1163,1163,2432,2322,92.6829268292683,110,136
201147,Corey Brewer,Corey Brewer,82,82,3064,3050,6114,606.316666666667,668.283333333333,1274.6,1282,1281,1281,2915,2809,95.1370757180157,106,72
202328,Greg Monroe,Greg Monroe,81,81,4132,4163,8295,911.2,920.783333333333,1831.98333333333,1820,1823,1823,4052,3948,98.0638915779284,104,137
203081,Damian Lillard,Damian Lillard,75,75,6362,6308,12670,1362.56666666667,1325.61666666667,2688.18333333333,2692,2694,2694,6164,6060,96.8877711411506,104,79
1626149,Montrezl Harrell,Montrezl Harrell,58,58,2552,2606,5158,508.516666666667,547.066666666667,1055.58333333333,1068,1064,1064,2557,2453,100.19592476489,104,106
202722,Davis Bertans,Davis Bertans,67,67,1859,1860,3719,400.816666666667,403.116666666667,803.933333333333,803,808,808,1766,1664,94.9973103819258,102,116
202355,Hassan Whiteside,Hassan Whiteside,77,77,5791,5724,11515,1289.8,1214.23333333333,2504.03333333333,2516,2513,2513,5429,5330,93.7489207390779,99,96
202685,Jonas Valanciunas,Jonas Valanciunas,80,80,4705,4665,9370,1058.2,1000.78333333333,2058.98333333333,2066,2066,2066,4526,4427,96.1955366631243,99,107
201152,Thaddeus Young,Thaddeus Young,74,74,5077,5259,10336,1105.68333333333,1125.41666666667,2231.1,2241,2237,2237,4924,4827,96.9864092968288,97,63
201961,Wayne Ellington,Wayne Ellington,62,62,3449,3453,6902,775.216666666667,719.733333333333,1494.95,1496,1500,1500,3266,3171,94.6941142360104,95,86
200794,Paul Millsap,Paul Millsap,69,69,5498,5529,11027,1148.33333333333,1188.88333333333,2337.21666666667,2343,2343,2343,5108,5020,92.9065114587123,88,136
203526,Raul Neto,Raul Neto,40,40,775,789,1564,173.083333333333,172.8,345.883333333333,346,346,346,762,676,98.3225806451613,86,84
1626153,Delon Wright,Delon Wright,27,27,1018,981,1999,224.3,223.416666666667,447.716666666667,449,446,446,942,857,92.5343811394892,85,90
1627763,Malcolm Brogdon,Malcolm Brogdon,75,75,4456,4522,8978,973.8,1000.93333333333,1974.73333333333,1979,1982,1982,4323,4242,97.0152603231598,81,89
203141,Mirza Teletovic,Mirza Teletovic,70,70,2549,2579,5128,559.166666666667,568.583333333333,1127.75,1137,1133,1133,2419,2341,94.899960768929,78,72
2754,Tony Allen,Tony Allen,71,71,4299,4214,8513,992.566666666667,912.866666666667,1905.43333333333,1917,1914,1914,3948,3871,91.8353105373343,77,-9
203914,Gary Harris,Gary Harris,57,57,4262,4148,8410,887.766666666667,889.4,1777.16666666667,1782,1782,1782,4293,4216,100.727358047865,77,81
201609,Goran Dragic,Goran Dragic,73,73,5725,5685,11410,1269.25,1183.76666666667,2453.01666666667,2459,2459,2459,5378,5302,93.938864628821,76,67
203114,Khris Middleton,Khris Middleton,29,29,1943,1990,3933,440.416666666667,448.633333333333,889.05,892,889,889,1913,1838,98.4559958826557,75,90
203954,Joel Embiid,Joel Embiid,31,31,1847,1847,3694,387.233333333333,395.15,782.383333333333,786,786,786,1690,1615,91.4997292907417,75,71
201587,Nicolas Batum,Nicolas Batum,77,77,5985,5995,11980,1311.83333333333,1297.98333333333,2609.81666666667,2618,2617,2617,5786,5714,96.6750208855472,72,69
1626181,Norman Powell,Norman Powell,76,76,3123,3160,6283,688.65,675.816666666667,1364.46666666667,1367,1368,1368,3025,2953,96.8619916746718,72,83
203210,JaMychal Green,JaMychal Green,77,77,4673,4621,9294,1084.85,1006.1,2090.95,2102,2101,2101,4326,4255,92.574363364006,71,-28
1627832,Fred VanVleet,Fred VanVleet,34,37,681,690,1371,147.183333333333,144.383333333333,291.566666666667,294,294,294,629,559,92.3641703377386,70,63
1626163,Frank Kaminsky,Frank Kaminsky,75,75,4439,4460,8899,994.85,958.8,1953.65,1956,1954,1954,4348,4279,97.9499887362019,69,43
203516,James Ennis III,James Ennis,64,64,3411,3360,6771,792.35,707.516666666667,1499.86666666667,1503,1501,1501,3120,3052,91.4687774846086,68,45
201188,Marc Gasol,Marc Gasol,74,74,5664,5567,11231,1324.93333333333,1200.11666666667,2525.05,2526,2531,2531,5290,5223,93.3968926553672,67,64
202340,Avery Bradley,Avery Bradley,55,55,4223,4340,8563,899.8,927.766666666667,1827.56666666667,1837,1835,1835,4126,4059,97.7030547004499,67,73
1627855,Okaro White,Okaro White,35,35,1070,1086,2156,246,222.85,468.85,470,471,471,1046,980,97.7570093457944,66,68
1627736,Malik Beasley,Malik Beasley,22,22,397,399,796,78.9666666666667,85.4166666666667,164.383333333333,165,165,165,407,342,102.518891687657,65,58
2747,JR Smith,J.R. Smith,41,41,2757,2806,5563,605.666666666667,585.5,1191.16666666667,1188,1187,1187,2735,2671,99.2020311933261,64,71
101112,Channing Frye,Channing Frye,74,74,3156,3229,6385,699.5,696.083333333333,1395.58333333333,1400,1398,1398,3146,3084,99.6831432192649,62,60
2757,Beno Udrih,Beno Udrih,37,39,1248,1219,2467,282.516666666667,274.233333333333,556.75,561,560,560,1145,1084,91.7467948717949,61,86
202709,Cory Joseph,Cory Joseph,80,80,4595,4621,9216,1011.63333333333,990.283333333333,2001.91666666667,2004,2003,2003,4418,4357,96.1479869423286,61,46
202732,DeAndre Liggins,DeAndre Liggins,61,62,1773,1772,3545,387.016666666667,379.433333333333,766.45,776,777,777,1704,1643,96.1082910321489,61,53
202697,Iman Shumpert,Iman Shumpert,76,76,4371,4463,8834,973.25,952.466666666667,1925.71666666667,1937,1937,1937,4318,4258,98.7874628231526,60,43
1626170,Jerian Grant,Jerian Grant,63,63,2377,2333,4710,517.25,507.05,1024.3,1029,1028,1028,2202,2142,92.637778712663,60,52
203546,Ian Clark,Ian Clark,77,77,2686,2786,5472,558.833333333333,579.7,1138.53333333333,1137,1137,1137,2543,2484,94.6760982874162,59,36
2734,Devin Harris,Devin Harris,65,65,2404,2420,4824,567.083333333333,517.7,1084.78333333333,1089,1087,1087,2275,2217,94.6339434276206,58,39
203493,Reggie Bullock,Reggie Bullock,31,31,1102,1038,2140,234.316666666667,229.183333333333,463.5,466,467,467,1010,952,91.6515426497278,58,55
202324,Derrick Favors,Derrick Favors,50,50,2570,2548,5118,613.45,567.516666666667,1180.96666666667,1188,1186,1186,2400,2344,93.3852140077821,56,57
1627098,Malcolm Delaney,Malcolm Delaney,73,73,2883,2876,5759,613.066666666667,636.3,1249.36666666667,1247,1248,1248,2646,2590,91.7793964620187,56,30
203510,Pierre Jackson,Pierre Jackson,8,8,203,195,398,42.15,41.6166666666667,83.7666666666667,83,84,84,205,152,100.985221674877,53,55
201952,Jeff Teague,Jeff Teague,82,82,6069,6246,12315,1323.11666666667,1337.41666666667,2660.53333333333,2659,2657,2657,5905,5853,97.2977426264624,52,50
1627750,Jamal Murray,Jamal Murray,82,82,4237,4178,8415,865.75,894.183333333333,1759.93333333333,1765,1764,1764,4066,4014,95.9641255605381,52,76
203507,Giannis Antetokounmpo,Giannis Antetokounmpo,80,80,6400,6485,12885,1389.08333333333,1445.6,2834.68333333333,2847,2845,2845,6095,6044,95.234375,51,46
1627884,Derrick Jones Jr.,Derrick Jones,32,32,1338,1336,2674,260.266666666667,283.783333333333,544.05,544,545,545,1261,1211,94.2451420029895,50,33
200752,Rudy Gay,Rudy Gay,30,30,2374,2324,4698,520.85,488.366666666667,1009.21666666667,1013,1013,1013,2202,2155,92.7548441449031,47,68
1626191,Chris McCullough,Chris McCullough,16,16,197,190,387,35.15,42.6166666666667,77.7666666666667,82,80,80,210,163,106.598984771574,47,52
203076,Anthony Davis,Anthony Davis,75,75,6271,6404,12675,1299.03333333333,1405.25,2704.28333333333,2704,2708,2708,5841,5797,93.1430393876575,44,50
203957,Dante Exum,Dante Exum,66,66,2699,2721,5420,629.75,595.9,1225.65,1230,1228,1228,2486,2444,92.1081882178585,42,-2
204020,Tyler Johnson,Tyler Johnson,73,73,5076,5010,10086,1112.2,1056.2,2168.4,2178,2178,2178,4653,4612,91.6666666666667,41,33
101139,CJ Miles,C.J. Miles,76,76,4044,4055,8099,889.916666666667,877.916666666667,1767.83333333333,1779,1776,1776,3866,3826,95.5984174085064,40,76
203077,Michael Kidd-Gilchrist,Michael Kidd-Gilchrist,81,81,5329,5316,10645,1184.98333333333,1154.55,2339.53333333333,2356,2349,2349,5006,4966,93.9388252955526,40,-5
201577,Robin Lopez,Robin Lopez,81,81,5319,5168,10487,1159.86666666667,1101.86666666667,2261.73333333333,2273,2271,2271,4840,4801,90.9945478473397,39,74
202329,Al-Farouq Aminu,Al-Farouq Aminu,61,61,4021,4123,8144,891.333333333333,882.266666666667,1773.6,1775,1773,1773,3898,3859,96.9410594379508,39,21
203584,Troy Daniels,Troy Daniels,67,67,2743,2634,5377,620.05,561.266666666667,1181.31666666667,1188,1183,1183,2499,2460,91.1046299671892,39,89
203085,Austin Rivers,Austin Rivers,74,74,4720,4755,9475,1046.51666666667,1002.35,2048.86666666667,2055,2054,2054,4547,4510,96.3347457627119,37,-10
1626246,Boban Marjanovic,Boban Marjanovic,34,35,695,640,1335,148.433333333333,141.883333333333,290.316666666667,292,293,293,637,601,91.6546762589928,36,32
1627835,Paul Zipser,Paul Zipser,44,44,1970,1956,3926,421.9,419.483333333333,841.383333333333,839,843,843,1788,1752,90.761421319797,36,15
101133,Ian Mahinmi,Ian Mahinmi,31,31,1309,1294,2603,269.2,285.216666666667,554.416666666667,556,555,555,1211,1177,92.5133689839572,34,31
203524,Solomon Hill,Solomon Hill,80,80,5518,5626,11144,1144.6,1222.56666666667,2367.16666666667,2375,2374,2374,5167,5135,93.6389996375498,32,5
201973,Jonas Jerebko,Jonas Jerebko,78,78,2807,2912,5719,619.316666666667,610.866666666667,1230.18333333333,1235,1232,1232,2736,2706,97.4706091913075,30,39
101150,Lou Williams,Lou Williams,81,81,4870,4847,9717,971.383333333333,1013.3,1984.68333333333,1992,1994,1994,4667,4639,95.8316221765914,28,49
201959,Taj Gibson,Taj Gibson,78,78,4771,4560,9331,1001.25,984.9,1986.15,1988,1989,1989,4291,4264,89.9392160972542,27,2
1718,Paul Pierce,Paul Pierce,25,25,625,636,1261,144.333333333333,131.083333333333,275.416666666667,278,277,277,611,585,97.76,26,28
201950,Jrue Holiday,Jrue Holiday,67,67,5084,5168,10252,1047.66666666667,1139.35,2187.01666666667,2185,2190,2190,4721,4695,92.8599527930763,26,38
1626174,Christian Wood,Christian Wood,13,13,248,237,485,57.1666666666667,51.3333333333333,108.5,106,107,107,231,205,93.1451612903226,26,19
203186,Willie Reed,Willie Reed,71,71,2376,2420,4796,527.666666666667,506.566666666667,1034.23333333333,1028,1031,1031,2199,2174,92.5505050505051,25,35
203107,Tomas Satoransky,Tomas Satoransky,57,57,1616,1659,3275,357.883333333333,360.633333333333,718.516666666667,721,719,719,1506,1483,93.1930693069307,23,15
202397,Ish Smith,Ish Smith,81,81,4532,4414,8946,974,983.45,1957.45,1957,1955,1955,4180,4159,92.2330097087379,21,50
201148,Brandan Wright,Brandan Wright,28,28,989,1008,1997,236.916666666667,209.55,446.466666666667,446,447,447,918,898,92.8210313447927,20,35
202713,Kyle Singler,Kyle Singler,32,32,932,889,1821,181.333333333333,203.216666666667,384.55,384,385,385,825,805,88.519313304721,20,8
203486,Mason Plumlee,Mason Plumlee,81,81,4984,5021,10005,1062.76666666667,1068.6,2131.36666666667,2148,2148,2148,4903,4885,98.3747993579454,18,-1
1626199,Darrun Hilliard,Darrun Hilliard,38,39,853,820,1673,187.783333333333,182.95,370.733333333333,380,381,381,760,742,89.0973036342321,18,13
203898,Tyler Ennis,Tyler Ennis,53,53,1403,1350,2753,283.35,298.016666666667,581.366666666667,587,588,588,1279,1262,91.1617961511048,17,-2
1628021,David Nwaba,David Nwaba,20,20,970,974,1944,197.95,211.383333333333,409.333333333333,398,397,397,901,884,92.8865979381443,17,11
1627848,Shawn Long,Shawn Long,17,18,580,570,1150,115.183333333333,118.733333333333,233.916666666667,233,234,234,555,539,95.6896551724138,16,20
203468,CJ McCollum,CJ McCollum,80,80,6479,6563,13042,1404.33333333333,1380.63333333333,2784.96666666667,2788,2796,2796,6258,6243,96.5889797808304,15,62
201962,Toney Douglas,Toney Douglas,24,24,944,874,1818,212.783333333333,183.316666666667,396.1,395,394,394,865,851,91.6313559322034,14,11
202348,Jordan Crawford,Jordan Crawford,19,19,1014,1025,2039,218,224.25,442.25,442,442,442,1031,1017,101.676528599606,14,16
1626169,Stanley Johnson,Stanley Johnson,77,77,3180,3056,6236,685.466666666667,682.8,1368.26666666667,1374,1371,1371,2898,2884,91.1320754716981,14,3
203934,Lamar Patterson,Lamar Patterson,5,5,91,90,181,17.85,22.6666666666667,40.5166666666667,41,40,40,79,66,86.8131868131868,13,13
1627734,Domantas Sabonis,Domantas Sabonis,81,81,3824,3755,7579,764.616666666667,847.866666666667,1612.48333333333,1631,1632,1632,3426,3414,89.592050209205,12,18
1627762,Joel Bolomboy,Joel Bolomboy,12,12,119,120,239,26.4333333333333,25.2666666666667,51.7,54,53,53,113,101,94.9579831932773,12,14
101249,John Lucas III,John Lucas III,5,5,24,25,49,5.98333333333333,4.05,10.0333333333333,10,11,11,26,16,108.333333333333,10,12
204002,Edy Tavares,Edy Tavares,2,2,65,58,123,13.7833333333333,13.5333333333333,27.3166666666667,28,28,28,57,47,87.6923076923077,10,10
1626168,Trey Lyles,Trey Lyles,71,71,2571,2567,5138,591.133333333333,563.133333333333,1154.26666666667,1160,1158,1158,2359,2349,91.754181252431,10,26
1626210,Alan Williams,Alan Williams,47,47,1768,1734,3502,337.85,368.583333333333,706.433333333333,705,708,708,1620,1610,91.6289592760181,10,2
1627751,Jakob Poeltl,Jakob Poeltl,54,54,1446,1402,2848,318.033333333333,306.95,624.983333333333,624,626,626,1291,1281,89.2807745504841,10,-8
2365,Chris Andersen,Chris Andersen,12,12,256,282,538,53.55,59.2166666666667,112.766666666667,115,114,114,262,253,102.34375,9,8
201941,Jordan Hill,Jordan Hill,7,7,104,108,212,21.9,23.5833333333333,45.4833333333333,48,47,47,94,85,90.3846153846154,9,12
1626179,Terry Rozier,Terry Rozier,74,74,2916,2944,5860,634.6,628.15,1262.75,1269,1263,1263,2670,2661,91.5637860082304,9,-13
202357,Nemanja Bjelica,Nemanja Bjelica,64,65,2740,2714,5454,594.05,581.933333333333,1175.98333333333,1189,1190,1190,2508,2500,91.5328467153285,8,-13
202362,Lance Stephenson,Lance Stephenson,18,18,843,826,1669,182.766666666667,178.616666666667,361.383333333333,362,361,361,752,744,89.2052194543298,8,10
203527,Ryan Kelly,Ryan Kelly,16,16,243,253,496,51.4333333333333,57.3833333333333,108.816666666667,111,110,110,220,212,90.5349794238683,8,4
203894,Shabazz Napier,Shabazz Napier,51,53,1123,1166,2289,260.116666666667,248.883333333333,509,514,512,512,1115,1107,99.2876224398931,8,17
1626254,Maurice Ndour,Maurice Ndour,32,32,781,751,1532,160.95,167.95,328.9,334,331,331,703,695,90.0128040973111,8,-2
1627850,Marshall Plumlee,Marshall Plumlee,21,21,416,403,819,85.5833333333333,83.9166666666667,169.5,171,170,170,382,374,91.8269230769231,8,-3
101123,Gerald Green,Gerald Green,47,47,1231,1257,2488,264.383333333333,270.65,535.033333333333,539,538,538,1177,1170,95.6133225020309,7,9
202683,Enes Kanter,Enes Kanter,72,72,3682,3568,7250,747.466666666667,783.25,1530.71666666667,1534,1533,1533,3413,3406,92.6941879413362,7,52
203098,John Jenkins,John Jenkins,4,4,35,29,64,5.38333333333334,6.85,12.2333333333333,13,13,13,37,30,105.714285714286,7,9
1627744,Brice Johnson,Brice Johnson,3,3,20,20,40,3.66666666666667,4.93333333333333,8.6,10,9,9,22,15,110,7,7
203940,Adreian Payne,Adreian Payne,18,18,326,318,644,67.6666666666667,65.9166666666667,133.583333333333,134,135,135,284,278,87.1165644171779,6,9
203585,Rodney McGruder,Rodney McGruder,78,78,4489,4475,8964,1003.23333333333,952.983333333333,1956.21666666667,1965,1966,1966,4173,4168,92.9605702829138,5,7
1627749,Dejounte Murray,Dejounte Murray,37,38,711,742,1453,159.383333333333,157.5,316.883333333333,318,322,322,662,657,93.1082981715893,5,1
1627756,Denzel Valentine,Denzel Valentine,57,57,2259,2260,4519,484.533333333333,489.016666666667,973.55,975,976,976,2082,2077,92.1646746347942,5,-18
202087,Alonzo Gee,Alonzo Gee,12,13,214,227,441,44.1,44.4833333333333,88.5833333333333,87,89,89,212,208,99.0654205607477,4,-18
202337,Luke Babbitt,Luke Babbitt,68,68,2385,2444,4829,530.633333333333,526.6,1057.23333333333,1067,1065,1065,2197,2194,92.1174004192872,3,-10
203476,Gorgui Dieng,Gorgui Dieng,81,82,6071,5912,11983,1347.83333333333,1267.55,2615.38333333333,2656,2653,2653,5709,5706,94.0372261571405,3,32
203962,Josh Huestis,Josh Huestis,2,2,79,72,151,15.4,15.4,30.8,31,31,31,77,74,97.4683544303798,3,3
203998,Bruno Caboclo,Bruno Caboclo,8,9,97,95,192,20.9,18.5166666666667,39.4166666666667,40,40,40,78,75,80.4123711340206,3,1
1627740,Henry Ellenson,Henry Ellenson,19,19,341,332,673,73.8,70.9833333333333,144.783333333333,145,146,146,304,301,89.1495601173021,3,-3
2563,Dahntay Jones,Dahntay Jones,1,1,29,23,52,6.63333333333333,5.3,11.9333333333333,12,12,12,25,23,86.2068965517242,2,2
203950,Jarnell Stokes,Jarnell Stokes,2,2,18,16,34,2.9,3.81666666666666,6.71666666666666,7,7,7,17,16,94.4444444444444,1,0
1626148,Anthony Brown,Anthony Brown,11,11,358,360,718,74.1333333333333,82.3,156.433333333333,159,159,159,319,318,89.1061452513967,1,4
2564,Boris Diaw,Boris Diaw,73,73,2774,2798,5572,663.45,614.1,1277.55,1287,1283,1283,2608,2608,94.0158615717376,0,18
202692,Alec Burks,Alec Burks,42,42,1493,1458,2951,336.916666666667,316.166666666667,653.083333333333,656,653,653,1368,1368,91.6275954454119,0,0
1627863,Danuel House Jr.,,1,,1,1,2,0.316666666666667,0.366666666666667,0.683333333333334,1,,,0,0,0,0,0
1627777,Georges Niang,Georges Niang,22,23,227,214,441,45.4166666666667,43.65,89.0666666666667,94,93,93,199,200,87.6651982378855,-1,3
203092,Tyler Zeller,Tyler Zeller,51,51,1229,1262,2491,258.566666666667,269.383333333333,527.95,525,525,525,1148,1150,93.4092758340114,-2,-4
1627771,Michael Gbinije,Michael Gbinije,9,9,75,71,146,16.6166666666667,14.8166666666667,31.4333333333333,31,32,32,69,71,92,-2,-3
201627,Anthony Morrow,Anthony Morrow,49,49,1753,1679,3432,349.8,364.55,714.35,711,714,714,1571,1574,89.6177980604678,-3,21
202336,Larry Sanders,Larry Sanders,5,5,30,31,61,6.13333333333334,6.08333333333334,12.2166666666667,12,13,13,25,28,83.3333333333333,-3,-1
1627752,Taurean Prince,Taurean Waller-Prince,59,59,2331,2309,4640,477.166666666667,500.516666666667,977.683333333333,982,981,981,2011,2014,86.2719862719863,-3,-29
2037,Jamal Crawford,Jamal Crawford,82,82,4976,4990,9966,1106.71666666667,1043.1,2149.81666666667,2158,2157,2157,4755,4759,95.5586816720257,-4,21
203487,Michael Carter-Williams,Michael Carter-Williams,45,45,2015,1935,3950,428.533333333333,417.25,845.783333333333,845,846,846,1801,1805,89.3796526054591,-4,-28
204067,Jarell Eddie,Jarell Eddie,5,5,155,162,317,29.6,31.2333333333333,60.8333333333334,62,62,62,127,131,81.9354838709677,-4,-5
1627743,Demetrius Jackson,Demetrius Jackson,3,5,39,38,77,6.51666666666667,9.15,15.6666666666667,17,17,17,37,41,94.8717948717949,-4,1
1626151,Aaron Harrison,Aaron Harrison,5,5,33,35,68,7.78333333333334,8.38333333333333,16.1666666666667,16,17,17,27,32,81.8181818181818,-5,-5
1627817,Tim Quarterman,Tim Quarterman,15,16,183,195,378,39.55,38.2333333333333,77.7833333333333,79,80,80,162,167,88.5245901639344,-5,1
101127,Jarrett Jack,Jarrett Jack,2,2,77,73,150,15.4833333333333,17.2833333333333,32.7666666666667,33,33,33,61,67,79.2207792207792,-6,-6
200779,Steve Novak,Steve Novak,8,8,41,49,90,10.1333333333333,11,21.1333333333333,24,22,22,39,45,95.1219512195122,-6,0
202407,Elijah Millsap,Elijah Millsap,2,2,51,55,106,11.1,11.8,22.9,23,23,23,39,45,76.4705882352941,-6,-6
1626196,Josh Richardson,Josh Richardson,53,53,3708,3696,7404,824.616666666667,788.183333333333,1612.8,1615,1614,1614,3403,3409,91.7745415318231,-6,8
101141,Ersan Ilyasova,Ersan Ilyasova,82,82,5105,5136,10241,1052.21666666667,1083.36666666667,2135.58333333333,2143,2142,2142,4651,4658,91.1067580803134,-7,-29
200770,Jordan Farmar,Jordan Farmar,2,2,79,88,167,17.2333333333333,17.9333333333333,35.1666666666667,36,35,35,81,88,102.53164556962,-7,-1
202390,Gary Neal,Gary Neal,2,2,45,40,85,8.3,9.95,18.25,19,18,18,31,38,68.8888888888889,-7,-5
202712,Justin Harper,Justin Harper,3,3,67,68,135,13.8333333333333,13.7,27.5333333333333,32,31,31,57,64,85.0746268656716,-7,-11
202714,Shelvin Mack,Shelvin Mack,55,55,2646,2659,5305,623.616666666667,578.8,1202.41666666667,1204,1205,1205,2459,2466,92.9327286470144,-7,16
1626150,Andrew Harrison,Andrew Harrison,72,72,3322,3308,6630,776.616666666667,696.533333333333,1473.15,1474,1474,1474,2983,2990,89.7953040337146,-7,-26
1627773,AJ Hammons,A.J. Hammons,21,22,372,370,742,81.6166666666667,78,159.616666666667,160,163,163,333,341,89.5161290322581,-8,-5
2034,Mike Miller,Mike Miller,20,20,362,352,714,71.2166666666667,77.3166666666667,148.533333333333,152,151,151,338,347,93.3701657458564,-9,-5
200826,J.J. Barea,J.J. Barea,35,35,1668,1701,3369,398.616666666667,371,769.616666666667,770,771,771,1579,1588,94.6642685851319,-9,10
1626245,Cristiano Felicio,Cristiano Felicio,66,66,2415,2375,4790,510.15,527.8,1037.95,1039,1040,1040,2165,2174,89.648033126294,-9,-34
1626253,Axel Toupane,Axel Toupane,4,4,105,117,222,22.85,24.5,47.35,49,47,47,92,101,87.6190476190476,-9,-11
202708,Norris Cole,Norris Cole,13,13,299,284,583,59.2833333333334,63.4666666666667,122.75,124,125,125,256,266,85.61872909699,-10,-16
1626154,RJ Hunter,R.J. Hunter,3,3,24,23,47,4.4,4.68333333333333,9.08333333333333,10,9,9,5,15,20.8333333333333,-10,-10
201163,Wilson Chandler,Wilson Chandler,71,71,5299,5132,10431,1099.7,1094.23333333333,2193.93333333333,2194,2197,2197,5097,5108,96.1879599924514,-11,-34
203482,Kelly Olynyk,Kelly Olynyk,75,75,3554,3623,7177,767.783333333333,770.4,1538.18333333333,1534,1538,1538,3305,3316,92.9938097917839,-11,16
1626162,Kelly Oubre Jr.,Kelly Oubre,79,79,3720,3803,7523,787.5,808.25,1595.75,1608,1605,1605,3514,3525,94.4623655913979,-11,-42
1627774,Jake Layman,Jake Layman,35,35,575,595,1170,124.65,119.866666666667,244.516666666667,252,249,249,511,522,88.8695652173913,-11,-1
1626184,Chasson Randle,Chasson Randle,26,26,709,705,1414,143.283333333333,153.416666666667,296.7,300,299,299,655,667,92.3836389280677,-12,-11
1626145,Tyus Jones,Tyus Jones,57,60,1765,1750,3515,381.466666666667,366.4,747.866666666667,772,774,774,1675,1688,94.9008498583569,-13,34
1627791,Ben Bentil,Ben Bentil,3,3,22,27,49,5.21666666666667,4.76666666666667,9.98333333333333,10,10,10,19,32,86.3636363636364,-13,-12
202349,Greivis Vasquez,Greivis Vasquez,3,3,93,93,186,19.7,18.7833333333333,38.4833333333333,39,39,39,80,94,86.0215053763441,-14,-13
202620,Arinze Onuaku,Arinze Onuaku,8,8,61,62,123,13.7666666666667,14.1,27.8666666666667,29,28,28,48,62,78.6885245901639,-14,-15
1627868,Patricio Garino,Patricio Garino,5,5,96,99,195,23.7166666666667,18.8166666666667,42.5333333333333,43,43,43,82,96,85.4166666666667,-14,-14
201168,Tiago Splitter,Tiago Splitter,8,8,199,184,383,39.6333333333333,37.2,76.8333333333333,77,76,76,167,182,83.9195979899498,-15,-4
201202,Joel Anthony,Joel Anthony,18,19,276,273,549,62.75,57.6666666666667,120.416666666667,123,122,122,232,247,84.0579710144928,-15,-13
1626159,Justise Winslow,Justise Winslow,18,18,1429,1439,2868,313.116666666667,310.516666666667,623.633333333333,627,625,625,1282,1297,89.7130860741778,-15,-6
202699,Tobias Harris,Tobias Harris,82,82,5865,5691,11556,1270.08333333333,1281.81666666667,2551.9,2566,2567,2567,5428,5444,92.5490196078431,-16,0
203912,CJ Wilcox,C.J. Wilcox,22,22,258,248,506,51.7333333333333,53.3666666666667,105.1,111,108,108,218,236,84.4961240310078,-18,-17
1627861,Mike Tobey,Mike Tobey,2,2,48,53,101,13.4,11.7166666666667,25.1166666666667,25,25,25,32,50,66.6666666666667,-18,-17
1627733,Dragan Bender,Dragan Bender,42,43,1352,1334,2686,269.966666666667,291.316666666667,561.283333333333,574,574,574,1245,1264,92.085798816568,-19,-25
201158,Marco Belinelli,Marco Belinelli,74,74,4021,4034,8055,905.15,870.3,1775.45,1777,1778,1778,3893,3913,96.8167122606317,-20,43
1627775,Patrick McCaw,Patrick McCaw,70,71,2590,2619,5209,525.133333333333,548.016666666667,1073.15,1077,1074,1074,2398,2418,92.5868725868726,-20,-37
1627781,Malachi Richardson,Malachi Richardson,22,22,442,447,889,99.6666666666667,96.1833333333333,195.85,198,198,198,396,416,89.5927601809955,-20,-17
201937,Ricky Rubio,Ricky Rubio,74,75,5690,5543,11233,1256.48333333333,1181.33333333333,2437.81666666667,2468,2469,2469,5387,5408,94.6748681898067,-21,-7
202412,Manny Harris,Manny Harris,4,4,66,58,124,12.7,11.8166666666667,24.5166666666667,25,25,25,43,64,65.1515151515152,-21,-21
1626257,Salah Mejri,Salah Mejri,73,73,1949,1956,3905,478.55,428.983333333333,907.533333333333,905,905,905,1775,1796,91.0723447922011,-21,-18
1627819,Isaiah Taylor,Isaiah Taylor,4,4,124,132,256,25.7166666666667,25.9166666666667,51.6333333333333,52,52,52,118,139,95.1612903225806,-21,-19
203552,Seth Curry,Seth Curry,70,70,4347,4413,8760,1066.5,959.6,2026.1,2029,2029,2029,4144,4166,95.3301127214171,-22,-37
1627748,Thon Maker,Thon Maker,56,57,1208,1244,2452,268.35,285.633333333333,553.983333333333,565,562,562,1158,1180,95.8609271523179,-22,-27
201573,Jerryd Bayless,Jerryd Bayless,3,3,164,171,335,36.2666666666667,35.2333333333333,71.5,71,71,71,134,157,81.7073170731707,-23,-21
1627761,DeAndre' Bembry,DeAndre' Bembry,37,38,846,845,1691,182.983333333333,185.2,368.183333333333,370,371,371,761,784,89.9527186761229,-23,-47
101145,Monta Ellis,Monta Ellis,74,74,4513,4653,9166,997.633333333333,991.466666666667,1989.1,1997,1998,1998,4339,4363,96.1444715267007,-24,-70
1627875,Marcus Georges-Hunt,Marcus Georges-Hunt,5,5,109,112,221,25.6333333333333,21.5833333333333,47.2166666666667,47,48,48,90,114,82.5688073394495,-24,-27
2216,Zach Randolph,Zach Randolph,73,73,4094,3925,8019,949.666666666667,840.183333333333,1789.85,1786,1786,1786,3661,3686,89.4235466536395,-25,75
2756,Sasha Vujacic,Sasha Vujacic,42,42,975,958,1933,205.15,204.883333333333,410.033333333333,408,408,408,848,873,86.974358974359,-25,-9
201160,Jason Smith,Jason Smith,74,74,2494,2526,5020,532.85,540.783333333333,1073.63333333333,1067,1068,1068,2344,2369,93.9855653568565,-25,-10
202332,Cole Aldrich,Cole Aldrich,61,62,1207,1182,2389,257.733333333333,255.583333333333,513.316666666667,535,531,531,1120,1145,92.7920463960232,-25,-31
202130,Reggie Williams,Reggie Williams,6,6,203,179,382,40.5666666666667,39.5666666666667,80.1333333333333,79,79,79,155,181,76.3546798029557,-26,-24
1626188,Quinn Cook,Quinn Cook,13,14,402,412,814,90.6333333333333,87.8,178.433333333333,188,188,188,393,419,97.7611940298507,-26,-41
1627745,Damian Jones,Damian Jones,10,10,200,193,393,43.3166666666667,41.1333333333333,84.45,86,85,85,158,184,79,-26,-28
1627816,Alex Poythress,Alex Poythress,6,6,380,376,756,76.1833333333333,80.4666666666667,156.65,157,157,157,347,373,91.3157894736842,-26,-35
203948,Johnny O'Bryant III,Johnny O'Bryant,11,11,190,185,375,41.6,41.6666666666667,83.2666666666667,81,80,80,178,205,93.6842105263158,-27,-26
1626172,Kevon Looney,Kevon Looney,53,53,1087,1093,2180,226.483333333333,217.766666666667,444.25,445,447,447,966,993,88.8684452621895,-27,-19
1627823,Juancho Hernangomez,,62,,2060,1969,4029,412.566666666667,426.633333333333,839.2,841,,,1942,1969,94.2718446601942,-27,-34
1627851,Mindaugas Kuzminskas,Mindaugas Kuzminskas,68,68,2446,2414,4860,506.966666666667,511,1017.96666666667,1019,1016,1016,2204,2231,90.1062959934587,-27,-3
203087,Jeremy Lamb,Jeremy Lamb,62,62,2574,2572,5146,591.783333333333,546.933333333333,1138.71666666667,1142,1143,1143,2455,2483,95.3768453768454,-28,-40
1626192,Pat Connaughton,Pat Connaughton,39,39,712,724,1436,159.633333333333,151.6,311.233333333333,318,316,316,666,694,93.5393258426966,-28,-17
1627738,Deyonta Davis,Deyonta Davis,34,36,549,546,1095,119.183333333333,116.716666666667,235.9,237,238,238,469,497,85.4280510018215,-28,-42
201628,Bobby Brown,Bobby Brown,24,25,291,308,599,61.1666666666667,59.5166666666667,120.683333333333,124,123,123,279,309,95.8762886597938,-30,-34
204028,Tarik Black,Tarik Black,67,67,2644,2559,5203,537.533333333333,548.483333333333,1086.01666666667,1090,1091,1091,2357,2387,89.1452344931921,-30,-49
1627754,Diamond Stone,Diamond Stone,7,7,51,58,109,12.7166666666667,11.0833333333333,23.8,25,24,24,29,59,56.8627450980392,-30,-27
2760,Anderson Varejao,Anderson Varejao,14,14,224,224,448,45.2166666666667,46.5833333333333,91.8,91,92,92,193,224,86.1607142857143,-31,-30
201589,Darrell Arthur,Darrell Arthur,41,41,1480,1492,2972,310.616666666667,326.883333333333,637.5,641,639,639,1422,1454,96.0810810810811,-32,-22
203200,Justin Holiday,Justin Holiday,82,82,3887,3863,7750,816.8,829.15,1645.95,1635,1639,1639,3524,3556,90.6611782865964,-32,-41
203089,John Henson,John Henson,58,58,2557,2597,5154,550.566666666667,565.45,1116.01666666667,1124,1123,1123,2375,2408,92.8822839264763,-33,-52
203481,Jeff Withey,Jeff Withey,51,51,980,991,1971,224.566666666667,207.233333333333,431.8,431,432,432,921,954,93.9795918367347,-33,-21
203909,KJ McDaniels,K.J. McDaniels,49,49,1207,1215,2422,245.9,258.05,503.95,506,505,505,1115,1148,92.3777961888981,-33,-44
203949,James Michael McAdoo,James Michael McAdoo,52,52,1072,1111,2183,223.783333333333,229.633333333333,453.416666666667,458,457,457,946,980,88.2462686567164,-34,-40
101106,Andrew Bogut,Andrew Bogut,27,27,1236,1268,2504,310.283333333333,271.6,581.883333333333,584,583,583,1062,1097,85.9223300970874,-35,-34
203118,Mike Scott,Mike Scott,18,18,440,451,891,90.95,100.933333333333,191.883333333333,198,195,195,375,410,85.2272727272727,-35,-42
1627757,Stephen Zimmerman,Stephen Zimmerman,19,19,247,248,495,53.0166666666667,53.4,106.416666666667,110,108,108,208,243,84.2105263157895,-35,-40
1627783,Pascal Siakam,Pascal Siakam,55,55,1942,1964,3906,430.983333333333,421.116666666667,852.1,860,859,859,1816,1851,93.5118434603502,-35,-53
1627849,Daniel Ochefu,Daniel Ochefu,19,19,172,176,348,38.0166666666667,36.6166666666667,74.6333333333334,76,75,75,154,189,89.5348837209303,-35,-28
101107,Marvin Williams,Marvin Williams,76,76,5185,5153,10338,1154.03333333333,1122.5,2276.53333333333,2298,2295,2295,4910,4946,94.6962391513983,-36,-31
1626203,Treveon Graham,Treveon Graham,27,27,419,422,841,98.2666666666667,91.4333333333333,189.7,187,189,189,366,402,87.3508353221957,-36,-39
1627787,Kyle Wiltjer,Kyle Wiltjer,14,14,107,116,223,22.2,21.05,43.25,45,44,44,82,118,76.6355140186916,-36,-38
201578,Marreese Speights,Marreese Speights,82,82,2889,2981,5870,655.033333333333,628.05,1283.08333333333,1285,1286,1286,2776,2813,96.0886119764625,-37,-32
203952,Andrew Wiggins,Andrew Wiggins,81,82,7080,6870,13950,1549.25,1460.83333333333,3010.08333333333,3050,3048,3048,6741,6778,95.2118644067797,-37,-17
1627782,Wayne Selden,Wayne Selden,14,14,498,535,1033,119.766666666667,114.783333333333,234.55,236,236,236,457,494,91.7670682730924,-37,-42
200782,PJ Tucker,P.J. Tucker,80,81,5309,5201,10510,1100.1,1108.06666666667,2208.16666666667,2234,2236,2236,4871,4909,91.7498587304577,-38,-77
203462,Archie Goodwin,Archie Goodwin,15,15,490,517,1007,102.883333333333,109.283333333333,212.166666666667,213,214,214,453,492,92.4489795918367,-39,-36
1626273,Marcelo Huertas,Marcelo Huertas,23,23,562,555,1117,116.15,119.2,235.35,238,237,237,514,553,91.4590747330961,-39,-43
2555,Nick Collison,Nick Collison,20,20,311,302,613,62.4833333333333,65.5833333333333,128.066666666667,128,128,128,231,271,74.2765273311897,-40,-39
1627879,Nicolas Laprovittola,Nicolas Laprovittola,18,18,382,402,784,89.6333333333333,84.4333333333333,174.066666666667,173,174,174,328,368,85.8638743455497,-40,-44
1627834,Georgios Papagiannis,Georgios Papagiannis,22,22,808,820,1628,179.766666666667,176.35,356.116666666667,355,355,355,762,803,94.3069306930693,-41,-30
203498,Shabazz Muhammad,Shabazz Muhammad,77,78,3550,3460,7010,766.233333333333,739.9,1506.13333333333,1515,1516,1516,3258,3300,91.7746478873239,-42,-76
201166,Aaron Brooks,Aaron Brooks,65,65,2035,2031,4066,457.933333333333,430.666666666667,888.6,893,894,894,1832,1876,90.02457002457,-44,-33
203096,Jared Sullinger,Jared Sullinger,11,11,270,263,533,62.25,55.9833333333333,118.233333333333,119,118,118,210,254,77.7777777777778,-44,-29
1627778,Chinanu Onuaku,Chinanu Onuaku,5,5,121,125,246,25.8833333333333,25.0166666666667,50.9,50,52,52,108,152,89.2561983471074,-44,-45
101179,Ronnie Price,Ronnie Price,14,14,335,327,662,64.2166666666667,69.8333333333333,134.05,135,134,134,275,320,82.089552238806,-45,-43
201155,Rodney Stuckey,Rodney Stuckey,39,39,1583,1612,3195,354.933333333333,342.566666666667,697.5,692,696,696,1467,1513,92.6721415034744,-46,-33
202718,Chandler Parsons,Chandler Parsons,34,34,1482,1478,2960,351.466666666667,318.066666666667,669.533333333333,675,675,675,1368,1414,92.3076923076923,-46,-47
203926,Doug McDermott,Doug McDermott,66,66,3568,3430,6998,747.733333333333,755.666666666667,1503.4,1507,1508,1508,3253,3299,91.1715246636771,-46,-29
1627770,Kay Felder,Kay Felder,42,42,855,901,1756,186.45,192.366666666667,378.816666666667,386,386,386,794,840,92.8654970760234,-46,-52
203112,Quincy Acy,Quincy Acy,38,38,1323,1324,2647,275.35,281.716666666667,557.066666666667,559,558,558,1215,1262,91.8367346938775,-47,-39
1626176,Rakeem Christmas,Rakeem Christmas,28,29,524,515,1039,111.05,107.216666666667,218.266666666667,217,219,219,441,489,84.1603053435115,-48,-34
201967,Dante Cunningham,Dante Cunningham,66,66,3823,3888,7711,798.6,851.566666666667,1650.16666666667,1648,1649,1649,3626,3675,94.846978812451,-49,-51
203923,James Young,James Young,29,29,510,520,1030,109.616666666667,108.433333333333,218.05,221,220,220,455,504,89.2156862745098,-49,-38
1897,Metta World Peace,Metta World Peace,25,25,373,359,732,79.2833333333334,79.6333333333333,158.916666666667,162,160,160,308,358,82.573726541555,-50,-59
200757,Thabo Sefolosha,Thabo Sefolosha,62,62,3741,3756,7497,786.266666666667,810.4,1596.66666666667,1595,1596,1596,3397,3447,90.8045977011494,-50,-65
201579,Roy Hibbert,Roy Hibbert,48,48,1570,1601,3171,345.45,334.316666666667,679.766666666667,684,682,682,1450,1500,92.3566878980892,-50,-22
203148,Brian Roberts,Brian Roberts,41,41,903,901,1804,215.85,197.683333333333,413.533333333333,412,416,416,813,863,90.0332225913621,-50,-55
1627758,Ron Baker,Ron Baker,52,52,1983,1971,3954,425.116666666667,430.466666666667,855.583333333333,858,857,857,1793,1843,90.4185577407968,-50,-55
1627767,Cheick Diallo,Cheick Diallo,15,17,459,471,930,93.1,99.15,192.25,198,199,199,418,468,91.0675381263617,-50,-53
1627789,Timothe Luwawu-Cabarrot,Timothe Luwawu-Cabarrot,69,69,2821,2860,5681,580.7,604.183333333333,1184.88333333333,1189,1190,1190,2564,2614,90.8897554058844,-50,-58
2440,Matt Barnes,Matt Barnes,74,74,4083,4109,8192,897.216666666667,879.133333333333,1776.35,1780,1777,1777,3807,3859,93.2402645113887,-52,-66
202326,DeMarcus Cousins,DeMarcus Cousins,72,72,5636,5575,11211,1262.61666666667,1197.48333333333,2460.1,2466,2465,2465,5330,5382,94.5706174591909,-52,-28
202325,Wesley Johnson,Wesley Johnson,68,68,1824,1884,3708,404.383333333333,399.866666666667,804.25,818,810,810,1683,1736,92.2697368421053,-53,-56
201582,Alexis Ajinca,Alexis Ajinca,39,39,1364,1408,2772,281.466666666667,303.7,585.166666666667,584,584,584,1227,1282,89.9560117302053,-55,-59
1627362,Briante Weber,Briante Weber,20,20,449,440,889,108.166666666667,95.9833333333333,204.15,206,205,205,399,454,88.8641425389755,-55,-50
2399,Mike Dunleavy,Mike Dunleavy,53,53,1936,1945,3881,416.366666666667,421.866666666667,838.233333333333,845,841,841,1703,1759,87.9648760330579,-56,-36
201600,Omer Asik,Omer Asik,31,31,1132,1136,2268,239.983333333333,239.9,479.883333333333,483,482,482,988,1045,87.2791519434629,-57,-60
203518,Alex Abrines,Alex Abrines,68,68,2583,2493,5076,515.266666666667,536.633333333333,1051.9,1056,1055,1055,2363,2420,91.4827719705769,-57,-1
1627780,Gary Payton II,Gary Payton II,6,6,220,223,443,49.6166666666667,48.6166666666667,98.2333333333333,100,99,99,176,233,80,-57,-58
2743,Kris Humphries,Kris Humphries,56,56,1562,1573,3135,342.566666666667,338.916666666667,681.483333333333,689,689,689,1375,1433,88.0281690140845,-58,-67
201563,Michael Beasley,Michael Beasley,56,56,2151,2176,4327,454.633333333333,475.583333333333,930.216666666667,934,935,935,2026,2084,94.1887494188749,-58,-41
201943,Brandon Jennings,Brandon Jennings,81,81,4290,4302,8592,893,910.7,1803.7,1802,1802,1802,3981,4039,92.7972027972028,-58,-63
1626175,Jordan Mickey,Jordan Mickey,23,25,327,322,649,65.4833333333333,73.7,139.183333333333,142,141,141,287,346,87.7675840978593,-59,-58
1627746,Skal Labissiere,Skal Labissiere,33,33,1381,1408,2789,302.666666666667,300.633333333333,603.3,612,612,612,1270,1329,91.9623461259957,-59,-41
201575,Brandon Rush,Brandon Rush,46,47,2368,2364,4732,531.1,489.866666666667,1020.96666666667,1031,1030,1030,2227,2287,94.0456081081081,-60,-40
203895,Jordan McRae,Jordan McRae,37,37,856,894,1750,192.316666666667,185.966666666667,378.283333333333,385,384,384,813,873,94.9766355140187,-60,-60
1627815,Sheldon Mac,Sheldon Mac,30,30,656,668,1324,137.483333333333,146.316666666667,283.8,287,287,287,562,622,85.6707317073171,-60,-55
202702,Kenneth Faried,Kenneth Faried,61,61,3176,3045,6221,649.4,648.466666666667,1297.86666666667,1300,1296,1296,2996,3058,94.3324937027708,-62,-59
1627784,Jarrod Uthoff,Jarrod Uthoff,9,9,259,261,520,57.05,56.7,113.75,116,115,115,214,276,82.6254826254826,-62,-62
1627854,Bryn Forbes,Bryn Forbes,36,36,635,650,1285,143.566666666667,139.866666666667,283.433333333333,285,285,285,537,599,84.5669291338583,-62,-51
101187,Alan Anderson,Alan Anderson,30,30,680,700,1380,160.95,146.266666666667,307.216666666667,309,308,308,638,701,93.8235294117647,-63,-77
2571,Leandro Barbosa,Leandro Barbosa,66,67,2265,2284,4549,460.216666666667,490.166666666667,950.383333333333,960,963,963,2102,2166,92.80353200883,-64,-66
1626157,Karl-Anthony Towns,Karl-Anthony Towns,81,82,7000,6803,13803,1537.7,1448.35,2986.05,3033,3030,3030,6644,6708,94.9142857142857,-64,-26
203086,Meyers Leonard,Meyers Leonard,74,74,2792,2851,5643,627.783333333333,589.566666666667,1217.35,1224,1222,1222,2657,2722,95.1647564469914,-65,-28
1626202,Joe Young,Joe Young,32,33,327,310,637,68.85,61.75,130.6,137,135,135,251,316,76.7584097859327,-65,-57
202720,Jon Leuer,Jon Leuer,75,75,4492,4323,8815,965.816666666667,973.983333333333,1939.8,1943,1944,1944,4012,4078,89.3143365983972,-66,-75
1626195,Willy Hernangomez,Willy Hernangomez,72,72,3121,3124,6245,659.7,658.816666666667,1318.51666666667,1324,1324,1324,2861,2928,91.6693367510413,-67,-59
203922,Glenn Robinson III,Glenn Robinson III,69,69,3255,3351,6606,714.466666666667,706.316666666667,1420.78333333333,1426,1427,1427,3046,3115,93.57910906298,-69,-74
1626185,Jarell Martin,Jarell Martin,42,42,1277,1294,2571,283.516666666667,270.816666666667,554.333333333333,555,558,558,1073,1142,84.0250587314017,-69,-69
1627827,Dorian Finney-Smith,Dorian Finney-Smith,80,81,3540,3607,7147,847.433333333333,785.933333333333,1633.36666666667,1642,1642,1642,3318,3387,93.728813559322,-69,-120
203488,Mike Muscala,Mike Muscala,70,70,2920,2876,5796,604.516666666667,635.05,1239.56666666667,1237,1237,1237,2634,2704,90.2054794520548,-70,-79
204038,Langston Galloway,Langston Galloway,74,74,3452,3502,6954,724.533333333333,771.116666666667,1495.65,1494,1495,1495,3202,3272,92.7578215527231,-70,-59
1626171,Bobby Portis,Bobby Portis,64,64,2321,2295,4616,499.533333333333,500.1,999.633333333333,1002,1000,1000,2084,2154,89.7888841016803,-70,-80
2617,Udonis Haslem,Udonis Haslem,16,16,293,317,610,69.1666666666667,63.2333333333333,132.4,131,130,130,225,296,76.7918088737202,-71,-68
203994,Jusuf Nurkic,Jusuf Nurkic,65,65,3351,3281,6632,696.833333333333,686.933333333333,1383.76666666667,1393,1391,1391,3030,3101,90.420769919427,-71,-52
1627759,Jaylen Brown,Jaylen Brown,78,78,3063,3134,6197,659.633333333333,673.916666666667,1333.55,1342,1341,1341,2857,2928,93.2745674175645,-71,-124
203477,Isaiah Canaan,Isaiah Canaan,39,39,1382,1368,2750,291.333333333333,300.1,591.433333333333,594,592,592,1200,1272,86.8306801736614,-72,-84
203138,Hollis Thompson,Hollis Thompson,40,40,1728,1771,3499,379.966666666667,367.9,747.866666666667,753,752,752,1530,1603,88.5416666666667,-73,-73
1627786,Troy Williams,Troy Williams,29,30,1279,1319,2598,277.6,274.683333333333,552.283333333333,557,557,557,1142,1215,89.2885066458171,-73,-76
203521,Matthew Dellavedova,Matthew Dellavedova,76,76,4541,4586,9127,971.416666666667,1010.96666666667,1982.38333333333,1987,1986,1986,4268,4342,93.9881083461793,-74,-74
201162,Jared Dudley,Jared Dudley,63,64,3259,3271,6530,652.483333333333,684.566666666667,1337.05,1364,1362,1362,2940,3015,90.2117213869285,-75,-44
203101,Miles Plumlee,Miles Plumlee,45,45,1090,1119,2209,239.133333333333,244.216666666667,483.35,486,484,484,975,1050,89.4495412844037,-75,-65
1626166,Cameron Payne,Cameron Payne,31,31,1077,1068,2145,225.833333333333,233.6,459.433333333333,464,462,462,921,996,85.5153203342618,-75,-70
1717,Dirk Nowitzki,Dirk Nowitzki,54,54,3115,3174,6289,743.766666666667,678.2,1421.96666666667,1420,1424,1424,2971,3047,95.3772070626003,-76,-12
203461,Anthony Bennett,Anthony Bennett,23,23,656,666,1322,126.266666666667,136.3,262.566666666667,265,264,264,613,689,93.4451219512195,-76,-68
201975,Jodie Meeks,Jodie Meeks,36,36,1709,1721,3430,368.233333333333,367.466666666667,735.7,740,738,738,1619,1696,94.733762434172,-77,-100
203115,Will Barton,Will Barton,60,60,4091,3962,8053,842.233333333333,857.15,1699.38333333333,1705,1705,1705,3835,3912,93.7423612808604,-77,-86
203457,Nerlens Noel,Nerlens Noel,51,51,2371,2420,4791,522.45,516.116666666667,1038.56666666667,1045,1047,1047,2199,2276,92.7456769295656,-77,-85
203530,Joffrey Lauvergne,Joffrey Lauvergne,70,70,2310,2268,4578,486.933333333333,494.4,981.333333333333,983,980,980,2091,2168,90.5194805194805,-77,-91
204014,Damjan Rudez,Damjan Rudez,45,45,713,699,1412,156.45,152.6,309.05,312,314,314,619,696,86.8162692847125,-77,-76
201177,Josh McRoberts,Josh McRoberts,22,22,839,836,1675,200.35,178.333333333333,378.683333333333,381,381,381,739,818,88.0810488676996,-79,-72
202682,Derrick Williams,Derrick Williams,50,50,1805,1873,3678,405.6,395.766666666667,801.366666666667,803,804,804,1685,1764,93.3518005540166,-79,-60
2199,Tyson Chandler,Tyson Chandler,46,47,3123,3086,6209,627.683333333333,652.416666666667,1280.1,1300,1298,1298,2904,2984,92.9875120076849,-80,-74
101114,Deron Williams,Deron Williams,64,64,3580,3645,7225,856.666666666667,796.683333333333,1653.35,1658,1657,1657,3394,3475,94.804469273743,-81,-89
203093,Terrence Jones,Terrence Jones,54,54,2918,2991,5909,620.083333333333,648.533333333333,1268.61666666667,1272,1270,1270,2715,2796,93.0431802604524,-81,-60
202391,Jeremy Lin,Jeremy Lin,36,36,2158,2210,4368,425.616666666667,455.75,881.366666666667,882,883,883,2002,2085,92.7710843373494,-83,-84
201956,Omri Casspi,Omri Casspi,36,36,1522,1466,2988,329.766666666667,310.483333333333,640.25,645,643,643,1371,1455,90.0788436268068,-84,-101
1626173,Rashad Vaughn,Rashad Vaughn,41,41,1020,1047,2067,226.816666666667,228.05,454.866666666667,458,458,458,909,994,89.1176470588235,-85,-77
201196,Ramon Sessions,Ramon Sessions,50,50,1889,1906,3795,410.25,400.25,810.5,810,811,811,1745,1833,92.3769190047644,-88,-80
203943,Noah Vonleh,Noah Vonleh,74,74,2923,2930,5853,638.833333333333,621.233333333333,1260.06666666667,1267,1265,1265,2658,2746,90.9339719466302,-88,-87
1626780,Jonathan Gibson,Jonathan Gibson,17,17,519,519,1038,116.316666666667,113.383333333333,229.7,231,231,231,456,545,87.8612716763006,-89,-83
2592,James Jones,James Jones,48,48,821,891,1712,183.233333333333,191,374.233333333333,380,381,381,766,860,93.3008526187576,-94,-100
1627739,Kris Dunn,Kris Dunn,77,78,3071,3005,6076,669.35,641.683333333333,1311.03333333333,1331,1333,1333,2795,2889,91.0126994464344,-94,-133
1627785,Isaiah Whitehead,Isaiah Whitehead,73,73,3914,4007,7921,785.983333333333,848.566666666667,1634.55,1645,1643,1643,3627,3723,92.6673479816045,-96,-118
200765,Rajon Rondo,Rajon Rondo,69,69,4321,4268,8589,926.666666666667,911.066666666667,1837.73333333333,1845,1843,1843,3907,4005,90.4188845174728,-98,-60
202694,Marcus Morris,Marcus Morris,79,79,5940,5712,11652,1280.98333333333,1283.96666666667,2564.95,2567,2565,2565,5348,5447,90.03367003367,-99,-106
203953,Jabari Parker,Jabari Parker,51,51,3972,4042,8014,840.183333333333,885,1725.18333333333,1728,1728,1728,3775,3874,95.0402819738167,-99,-85
2449,Luis Scola,Luis Scola,36,36,1106,1120,2226,222.8,234.733333333333,457.533333333333,465,461,461,1001,1101,90.5063291139241,-100,-83
1627747,Caris LeVert,Caris LeVert,57,57,2989,3046,6035,592.083333333333,639.383333333333,1231.46666666667,1233,1237,1237,2815,2915,94.1786550685848,-100,-91
202338,Kevin Seraphin,Kevin Seraphin,48,49,1276,1290,2566,282.7,273.066666666667,555.766666666667,561,559,559,1157,1258,90.6739811912226,-101,-101
2548,Dwyane Wade,Dwyane Wade,60,60,4237,4115,8352,902.783333333333,880.633333333333,1783.41666666667,1793,1792,1792,3748,3850,88.4588151994336,-102,-73
101181,Jose Calderon,Jose Calderon,41,41,1271,1228,2499,270.616666666667,263.116666666667,533.733333333333,539,539,539,1059,1161,83.3202202989772,-102,-104
203145,Kent Bazemore,Kent Bazemore,73,73,4638,4675,9313,949.7,1002.75,1952.45,1963,1963,1963,4194,4296,90.4269081500647,-102,-106
1627812,Yogi Ferrell,Yogi Ferrell,46,46,2637,2684,5321,618.116666666667,576.35,1194.46666666667,1201,1197,1197,2495,2597,94.6150929086083,-102,-117
2730,Dwight Howard,Dwight Howard,74,74,5205,5159,10364,1069.05,1123.71666666667,2192.76666666667,2195,2199,2199,4602,4705,88.4149855907781,-103,-112
202700,Donatas Motiejunas,Donatas Motiejunas,34,34,1114,1119,2233,230.616666666667,242.65,473.266666666667,479,479,479,1024,1127,91.9210053859964,-103,-121
202334,Ed Davis,Ed Davis,46,46,1852,1830,3682,399.166666666667,391.416666666667,790.583333333333,786,789,789,1697,1803,91.6306695464363,-106,-129
2744,Al Jefferson,Al Jefferson,66,66,2117,2126,4243,491.283333333333,437.75,929.033333333333,932,931,931,1927,2034,91.0250354274917,-107,-99
203080,Thomas Robinson,Thomas Robinson,48,48,1337,1309,2646,274.333333333333,283.1,557.433333333333,559,560,560,1193,1300,89.2296185489903,-107,-84
204001,Kristaps Porzingis,Kristaps Porzingis,66,66,5067,5098,10165,1080.01666666667,1077.73333333333,2157.75,2166,2164,2164,4675,4782,92.2636668640221,-107,-99
203503,Tony Snell,Tony Snell,80,80,5242,5380,10622,1150,1180.15,2330.15,2336,2336,2336,5014,5122,95.6505150705838,-108,-117
204025,Tim Frazier,Tim Frazier,65,65,3555,3586,7141,744.516666666667,777.1,1521.61666666667,1523,1525,1525,3289,3400,92.5175808720113,-111,-86
201229,Anthony Tolliver,Anthony Tolliver,65,65,3376,3382,6758,763.233333333333,715.766666666667,1479,1481,1477,1477,3208,3320,95.0236966824645,-112,-99
203471,Dennis Schroder,Dennis Schroder,79,79,5879,5903,11782,1214.75,1259.93333333333,2474.68333333333,2488,2485,2485,5341,5453,90.8487838067699,-112,-76
1627852,Nicolas Brussino,Nicolas Brussino,53,54,1174,1154,2328,261.783333333333,251.466666666667,513.25,521,521,521,1055,1172,89.8637137989779,-117,-107
203924,Jerami Grant,Jerami Grant,80,80,3694,3613,7307,740.883333333333,788.966666666667,1529.85,1532,1531,1531,3345,3464,90.5522468868435,-119,-187
203915,Spencer Dinwiddie,Spencer Dinwiddie,59,59,3122,3176,6298,650.65,679.383333333333,1330.03333333333,1332,1334,1334,2871,2991,91.9602818705958,-120,-131
203094,Andrew Nicholson,Andrew Nicholson,38,38,774,810,1584,171.216666666667,170.4,341.616666666667,342,342,342,674,797,87.0801033591731,-123,-129
203463,Ben McLemore,Ben McLemore,61,61,2671,2675,5346,599.3,571.983333333333,1171.28333333333,1177,1176,1176,2451,2574,91.7633845001872,-123,-135
203084,Harrison Barnes,Harrison Barnes,79,79,6015,6144,12159,1468.56666666667,1330.21666666667,2798.78333333333,2805,2803,2803,5670,5795,94.2643391521197,-125,-136
203902,Semaj Christon,Semaj Christon,64,64,2259,2223,4482,477.05,491.4,968.45,972,973,973,2014,2140,89.1544931385569,-126,-141
203496,Robert Covington,Robert Covington,67,67,5008,5027,10035,1056.2,1050.76666666667,2106.96666666667,2116,2119,2119,4465,4594,89.1573482428115,-129,-155
201586,Serge Ibaka,Serge Ibaka,79,79,5520,5526,11046,1204.46666666667,1205.16666666667,2409.63333333333,2424,2422,2422,5124,5255,92.8260869565217,-131,-141
202730,Lavoy Allen,Lavoy Allen,61,61,2038,2028,4066,450.616666666667,418.216666666667,868.833333333333,868,871,871,1831,1962,89.8429833169774,-131,-124
202734,E'Twaun Moore,E'Twaun Moore,73,73,4232,4305,8537,889.233333333333,925.366666666667,1814.6,1816,1820,1820,3938,4070,93.0529300567108,-132,-111
203932,Aaron Gordon,Aaron Gordon,80,80,5383,5352,10735,1125.61666666667,1162.38333333333,2288,2300,2298,2298,5013,5148,93.1265093813859,-135,-161
1627735,Wade Baldwin IV,Wade Baldwin,33,33,910,927,1837,207.033333333333,192.766666666667,399.8,407,405,405,750,885,82.4175824175824,-135,-139
201977,Marcus Thornton,Marcus Thornton,33,33,1343,1338,2681,290.45,285.383333333333,575.833333333333,576,575,575,1214,1350,90.3946388682055,-136,-145
201149,Joakim Noah,Joakim Noah,46,46,2396,2377,4773,503.8,506.8,1010.6,1014,1015,1015,2162,2299,90.2337228714524,-137,-143
201585,Kosta Koufos,Kosta Koufos,71,71,3199,3201,6400,731.4,679.333333333333,1410.73333333333,1415,1419,1419,2897,3034,90.559549859331,-137,-155
101138,Brandon Bass,Brandon Bass,52,52,1291,1327,2618,293.75,279.2,572.95,574,577,577,1217,1356,94.2680092951201,-139,-145
201951,Ty Lawson,Ty Lawson,69,69,3987,4056,8043,875.25,854.7,1729.95,1733,1732,1732,3710,3849,93.0524203661901,-139,-156
1627755,Tyler Ulis,Tyler Ulis,60,61,2751,2718,5469,535.916666666667,567.333333333333,1103.25,1122,1123,1123,2455,2595,89.240276263177,-140,-142
201954,Darren Collison,Darren Collison,68,68,4641,4657,9298,1067.5,992.533333333333,2060.03333333333,2068,2063,2063,4400,4541,94.807153630683,-141,-133
203897,Zach LaVine,Zach LaVine,46,47,3950,3844,7794,862.833333333333,840.483333333333,1703.31666666667,1750,1749,1749,3643,3786,92.2278481012658,-143,-117
201936,Tyreke Evans,Tyreke Evans,40,40,1785,1805,3590,387.85,393.233333333333,781.083333333333,788,788,788,1572,1716,88.0672268907563,-144,-151
1626144,Emmanuel Mudiay,Emmanuel Mudiay,55,55,3422,3336,6758,698.7,704.083333333333,1402.78333333333,1411,1406,1406,3191,3335,93.249561659848,-144,-133
1627826,Ivica Zubac,Ivica Zubac,38,38,1446,1507,2953,301.116666666667,304.916666666667,606.033333333333,611,609,609,1342,1486,92.8077455048409,-144,-135
203504,Trey Burke,Trey Burke,57,57,1588,1632,3220,353.95,348.65,702.6,702,703,703,1409,1554,88.727959697733,-145,-161
201565,Derrick Rose,Derrick Rose,64,64,4912,4925,9837,1048.55,1026.5,2075.05,2084,2082,2082,4606,4757,93.7703583061889,-151,-165
203939,Dwight Powell,Dwight Powell,77,77,2923,2954,5877,684.2,644.75,1328.95,1329,1333,1333,2741,2892,93.7735203557988,-151,-168
101109,Raymond Felton,Raymond Felton,80,80,3874,3981,7855,866.466666666667,829.95,1696.41666666667,1702,1700,1700,3641,3794,93.9855446566856,-153,-163
203901,Elfrid Payton,Elfrid Payton,82,82,5693,5642,11335,1170.61666666667,1235.23333333333,2405.85,2415,2412,2412,5258,5413,92.3590374143685,-155,-146
203484,Kentavious Caldwell-Pope,Kentavious Caldwell-Pope,76,76,5865,5676,11541,1251.63333333333,1275.15,2526.78333333333,2529,2529,2529,5357,5513,91.3384484228474,-156,-148
200771,Sergio Rodriguez,Sergio Rodriguez,68,68,3552,3544,7096,762.6,747.783333333333,1510.38333333333,1517,1518,1518,3183,3341,89.6114864864865,-158,-137
201150,Spencer Hawes,Spencer Hawes,54,54,1827,1864,3691,408.483333333333,388.083333333333,796.566666666667,797,797,797,1664,1824,91.0782703886152,-160,-174
203124,Kyle O'Quinn,Kyle O'Quinn,79,79,2886,2877,5763,631.083333333333,601.116666666667,1232.2,1229,1229,1229,2576,2738,89.2584892584893,-162,-158
202323,Evan Turner,Evan Turner,65,65,3826,3891,7717,840.783333333333,817.733333333333,1658.51666666667,1656,1658,1658,3529,3695,92.2373235755358,-166,-178
1626204,Larry Nance Jr.,Larry Nance Jr.,63,63,3441,3411,6852,712.25,718.333333333333,1430.58333333333,1440,1442,1442,3110,3277,90.3807032839291,-167,-132
202066,Garrett Temple,Garrett Temple,65,65,3931,3985,7916,873.883333333333,852.5,1726.38333333333,1727,1728,1728,3674,3842,93.4622233528364,-168,-178
202696,Nikola Vucevic,Nikola Vucevic,75,75,5139,5057,10196,1054.11666666667,1102.91666666667,2157.03333333333,2161,2163,2163,4650,4818,90.4845300642148,-168,-141
203459,Allen Crabbe,Allen Crabbe,79,79,5243,5307,10550,1136.46666666667,1120,2256.46666666667,2258,2254,2254,4963,5135,94.6595460614152,-172,-117
1626161,Willie Cauley-Stein,Willie Cauley-Stein,75,75,3182,3273,6455,713.833333333333,700.5,1414.33333333333,1416,1421,1421,2937,3111,92.3004399748586,-174,-204
202083,Wesley Matthews,Wesley Matthews,73,73,5367,5497,10864,1307.53333333333,1185.8,2493.33333333333,2495,2495,2495,5042,5219,93.9444754984163,-177,-193
202389,Timofey Mozgov,Timofey Mozgov,54,54,2637,2564,5201,570.666666666667,541.6,1112.26666666667,1106,1104,1104,2313,2490,87.7133105802048,-177,-195
2594,Kyle Korver,Kyle Korver,67,67,4076,4144,8220,866.933333333333,887.766666666667,1754.7,1751,1753,1753,3825,4005,93.8420019627085,-180,-168
202339,Eric Bledsoe,Eric Bledsoe,65,66,5272,5177,10449,1047.45,1093.65,2141.1,2178,2176,2176,4884,5066,92.6403641881639,-182,-185
201228,C.J. Watson,C.J. Watson,62,62,2345,2318,4663,497.516666666667,508.4,1005.91666666667,1011,1012,1012,2040,2233,86.9936034115139,-193,-185
201156,Nick Young,Nick Young,60,60,3725,3709,7434,780.3,779.95,1560.25,1556,1556,1556,3467,3662,93.0738255033557,-195,-207
1626147,Justin Anderson,Justin Anderson,75,75,2806,2839,5645,627.1,595.45,1222.55,1227,1228,1228,2525,2720,89.9857448325018,-195,-194
202498,Lance Thomas,Lance Thomas,46,46,2237,2261,4498,486.2,474.533333333333,960.733333333333,968,968,968,1999,2195,89.3607510058114,-196,-204
202704,Reggie Jackson,Reggie Jackson,52,52,3290,3125,6415,703.483333333333,710.3,1413.78333333333,1424,1424,1424,2928,3125,88.9969604863222,-197,-226
2736,Luol Deng,Luol Deng,56,56,3515,3524,7039,741.916666666667,740.15,1482.06666666667,1484,1486,1486,3171,3369,90.2133712660028,-198,-195
203095,Evan Fournier,Evan Fournier,68,68,5268,5193,10461,1100.8,1128.73333333333,2229.53333333333,2234,2234,2234,4748,4954,90.1290812452544,-206,-194
1627741,Buddy Hield,Buddy Hield,82,82,4306,4391,8697,922.666666666667,955.316666666667,1877.98333333333,1883,1888,1888,3963,4176,92.0343706456108,-213,-212
203917,Nik Stauskas,Nik Stauskas,80,80,5152,5223,10375,1089.93333333333,1092.75,2182.68333333333,2191,2188,2188,4686,4902,90.9549689440994,-216,-185
1626158,Richaun Holmes,Richaun Holmes,57,57,2768,2860,5628,586.45,598.116666666667,1184.56666666667,1190,1193,1193,2548,2767,92.0520231213873,-219,-228
201572,Brook Lopez,Brook Lopez,75,75,5333,5431,10764,1084.1,1131.4,2215.5,2226,2222,2222,4955,5175,92.9120570035627,-220,-158
1626164,Devin Booker,Devin Booker,77,78,6692,6598,13290,1311.71666666667,1380.18333333333,2691.9,2733,2730,2730,6156,6379,91.9904363419008,-223,-226
1626178,Rondae Hollis-Jefferson,Rondae Hollis-Jefferson,78,78,4227,4373,8600,852.483333333333,906.95,1759.43333333333,1762,1761,1761,3904,4135,92.3586467944168,-231,-264
200751,Randy Foye,Randy Foye,69,69,3037,3128,6165,625.883333333333,650.566666666667,1276.45,1286,1284,1284,2789,3026,91.8340467566678,-237,-205
203930,Sean Kilpatrick,Sean Kilpatrick,70,70,4211,4296,8507,850.866666666667,902.216666666667,1753.08333333333,1755,1754,1754,3872,4110,91.9496556637378,-238,-224
201167,Arron Afflalo,Arron Afflalo,61,61,3522,3581,7103,830.216666666667,746.816666666667,1577.03333333333,1579,1580,1580,3298,3538,93.6399772856332,-240,-247
2546,Carmelo Anthony,Carmelo Anthony,74,74,5962,5963,11925,1289.21666666667,1243.06666666667,2532.28333333333,2542,2538,2538,5529,5772,92.7373364642737,-243,-232
201584,Courtney Lee,Courtney Lee,77,77,5682,5706,11388,1236.06666666667,1203.63333333333,2439.7,2460,2459,2459,5276,5525,92.8546286518831,-249,-233
203083,Andre Drummond,Andre Drummond,81,81,5573,5333,10906,1202.86666666667,1207,2409.86666666667,2408,2409,2409,5002,5252,89.7541719002333,-250,-274
202344,Trevor Booker,Trevor Booker,71,71,4184,4309,8493,855.983333333333,898.766666666667,1754.75,1757,1754,1754,3754,4023,89.7227533460803,-269,-334
203925,Joe Harris,Joe Harris,52,52,2816,2857,5673,556.683333333333,584.2,1140.88333333333,1140,1138,1138,2449,2718,86.9673295454546,-269,-284
202711,Bojan Bogdanovic,Bojan Bogdanovic,81,81,4934,5020,9954,1006.8,1061.2,2068,2080,2083,2083,4583,4862,92.8860964734495,-279,-269
203933,T.J. Warren,T.J. Warren,66,66,5072,5008,10080,993.133333333333,1050.53333333333,2043.66666666667,2048,2048,2048,4639,4931,91.4629337539432,-292,-281
1626209,Mario Hezonja,Mario Hezonja,65,65,2206,2222,4428,484.65,471.466666666667,956.116666666667,959,960,960,1847,2144,83.7262012692657,-297,-287
204456,T.J. McConnell,T.J. McConnell,81,81,5033,5186,10219,1066.1,1064.86666666667,2130.96666666667,2138,2133,2133,4558,4857,90.5622888933042,-299,-312
1626143,Jahlil Okafor,Jahlil Okafor,50,50,2615,2625,5240,593.583333333333,542.45,1136.03333333333,1135,1134,1134,2227,2529,85.1625239005736,-302,-322
203120,Justin Hamilton,Justin Hamilton,64,64,2812,2894,5706,567.8,605,1172.8,1176,1177,1177,2489,2796,88.5135135135135,-307,-291
202688,Brandon Knight,Brandon Knight,53,54,2690,2691,5381,545.35,565.966666666667,1111.31666666667,1137,1140,1140,2338,2653,86.9144981412639,-315,-325
203967,Dario Saric,Dario Saric,81,81,5038,5104,10142,1078.46666666667,1049.11666666667,2127.58333333333,2128,2129,2129,4498,4818,89.2814608971814,-320,-302
202687,Bismack Biyombo,Bismack Biyombo,81,81,4086,4081,8167,901.066666666667,887.083333333333,1788.15,1801,1793,1793,3569,3891,87.3470386686246,-322,-344
201945,Gerald Henderson,Gerald Henderson,72,72,3949,3980,7929,847.916666666667,825.133333333333,1673.05,1669,1667,1667,3491,3820,88.4021271207901,-329,-309
201145,Jeff Green,Jeff Green,69,69,3573,3599,7172,765.816666666667,775.6,1541.41666666667,1531,1534,1534,3084,3421,86.3140218303946,-337,-296
1627742,Brandon Ingram,Brandon Ingram,79,79,5453,5415,10868,1139.51666666667,1137.11666666667,2276.63333333333,2280,2279,2279,5000,5339,91.6926462497708,-339,-385
1627737,Marquese Chriss,Marquese Chriss,81,82,4265,4189,8454,829.983333333333,883.133333333333,1713.11666666667,1740,1743,1743,3828,4181,89.7538100820633,-353,-382
1626156,D'Angelo Russell,D'Angelo Russell,63,63,4314,4334,8648,894.233333333333,906.8,1801.03333333333,1814,1811,1811,3964,4320,91.8868799258229,-356,-357
203458,Alex Len,Alex Len,76,77,3773,3742,7515,743.65,784.233333333333,1527.88333333333,1559,1560,1560,3260,3650,86.4033925258415,-390,-397
203944,Julius Randle,Julius Randle,74,74,5125,5103,10228,1073.93333333333,1060.8,2134.73333333333,2132,2132,2132,4654,5077,90.809756097561,-423,-453
203903,Jordan Clarkson,Jordan Clarkson,82,82,5740,5715,11455,1184.9,1195.75,2380.65,2397,2397,2397,5194,5629,90.4878048780488,-435,-425
201571,D.J. Augustin,D.J. Augustin,78,78,3496,3522,7018,784.5,750.316666666667,1534.81666666667,1538,1538,1538,2965,3409,84.8112128146453,-444,-446
