id_player,name_player,gp_calc_total,poss_calc_o,poss_calc_d,poss_calc_total,mp_calc_o,mp_calc_d,mp_calc_total,pts_calc_o,pts_calc_d,pts_o_per100_calc,pm_calc
203110,Draymond Green,81,6725,6866,13591,1307.9,1496.45,2804.35,6992,5913,103.970260223048,1079
201939,Stephen Curry,79,6517,6645,13162,1256.28333333333,1438.91666666667,2695.2,6775,5754,103.958876783796,1021
202691,Klay Thompson,80,6258,6477,12735,1242.7,1407.73333333333,2650.43333333333,6495,5651,103.787152444871,844
202695,Kawhi Leonard,72,5323,5293,10616,1231.1,1144.61666666667,2375.71666666667,5172,4490,97.1632538042457,682
201566,Russell Westbrook,80,6698,6548,13246,1322.56666666667,1423.7,2746.26666666667,6497,5842,96.999104210212,655
201142,Kevin Durant,72,6243,6148,12391,1250.91666666667,1326.61666666667,2577.53333333333,6113,5475,97.9176677879225,638
2544,LeBron James,76,6211,6058,12269,1384.83333333333,1319.8,2704.63333333333,6069,5477,97.7137336982773,592
201980,Danny Green,79,4595,4528,9123,1062.48333333333,984.916666666667,2047.4,4379,3856,95.2992383025027,523
200746,LaMarcus Aldridge,74,5013,5007,10020,1171.03333333333,1086.86666666667,2257.9,4851,4339,96.7684021543986,512
101108,Chris Paul,74,5556,5673,11229,1193.38333333333,1220.78333333333,2414.16666666667,5503,4992,99.0460763138949,511
201586,Serge Ibaka,78,6001,5935,11936,1203.31666666667,1287.83333333333,2491.15,5802,5309,96.6838860189968,493
201599,DeAndre Jordan,77,5936,6066,12002,1277.85,1312.48333333333,2590.33333333333,5812,5335,97.911051212938,477
200755,JJ Redick,75,4803,4904,9707,1031.28333333333,1058.2,2089.48333333333,4736,4278,98.6050385175932,458
203500,Steven Adams,80,4821,4712,9533,969.366666666667,1040.05,2009.41666666667,4559,4101,94.5654428541796,458
2738,Andre Iguodala,65,4152,4251,8403,823.366666666667,906.25,1729.61666666667,4129,3679,99.4460500963391,450
101106,Andrew Bogut,70,3361,3441,6802,680.016666666667,762.2,1442.21666666667,3378,2941,100.505801844689,437
2225,Tony Parker,72,4376,4378,8754,1034.38333333333,938.25,1972.63333333333,4192,3782,95.7952468007313,410
203084,Harrison Barnes,66,4810,4882,9692,982.116666666667,1059.33333333333,2041.45,4787,4380,99.5218295218295,407
1495,Tim Duncan,61,3437,3384,6821,798.683333333333,734.35,1533.03333333333,3248,2851,94.5010183299389,397
201988,Patty Mills,81,3788,3808,7596,846.15,819.783333333333,1665.93333333333,3685,3293,97.2808870116156,392
201567,Kevin Love,77,5474,5329,10803,1231.03333333333,1179.71666666667,2410.75,5270,4883,96.2732919254658,387
200768,Kyle Lowry,77,6446,6338,12784,1473.55,1363.25,2836.8,6142,5758,95.2838969903816,384
202335,Patrick Patterson,79,4548,4530,9078,1038.48333333333,977.883333333333,2016.36666666667,4384,4019,96.3940193491645,365
203521,Matthew Dellavedova,76,4258,4179,8437,947.766666666667,926,1873.76666666667,4096,3735,96.195396899953,361
202684,Tristan Thompson,81,5197,5058,10255,1164.7,1104.48333333333,2269.18333333333,4957,4597,95.3819511256494,360
2561,David West,78,3139,3140,6279,716.85,679.75,1396.6,3012,2665,95.9541255176808,347
1938,Manu Ginobili,58,2613,2646,5259,584.2,558.016666666667,1142.21666666667,2543,2215,97.3210868733257,328
2747,JR Smith,77,5411,5274,10685,1216.85,1141.95,2358.8,5204,4895,96.1744594344853,309
2594,Kyle Korver,80,5490,5643,11133,1159.38333333333,1218.71666666667,2378.1,5142,4862,93.6612021857924,280
2564,Boris Diaw,76,3147,3175,6322,712.883333333333,675.1,1387.98333333333,3029,2752,96.250397203686,277
203460,Andre Roberson,70,3676,3648,7324,738.466666666667,804.583333333333,1543.05,3499,3225,95.1849836779108,274
202709,Cory Joseph,80,4652,4631,9283,1062.75,978.9,2041.65,4366,4100,93.8521066208083,266
202340,Avery Bradley,76,6057,6078,12135,1199.11666666667,1322.86666666667,2521.98333333333,5684,5430,93.841835892356,254
203471,Dennis Schroder,80,3671,3762,7433,779.35,840.166666666667,1619.51666666667,3440,3192,93.7074366657587,248
101107,Marvin Williams,81,5269,5283,10552,1184.81666666667,1140.01666666667,2324.83333333333,5072,4826,96.2611501233631,246
202738,Isaiah Thomas,82,6412,6372,12784,1259.08333333333,1383.76666666667,2642.85,5985,5740,93.3406113537118,245
201601,Luc Mbah a Moute,73,2836,2961,5797,620.283333333333,651.883333333333,1272.16666666667,2776,2537,97.8843441466855,239
202689,Kemba Walker,81,6538,6560,13098,1465.63333333333,1413.71666666667,2879.35,6226,5997,95.2278984398899,229
201609,Goran Dragic,72,5402,5386,10788,1205.91666666667,1148.91666666667,2354.83333333333,5017,4798,92.8730099962977,219
203079,Dion Waiters,78,5244,5109,10353,1069.31666666667,1082.4,2151.71666666667,4926,4708,93.9359267734554,218
201587,Nicolas Batum,70,5524,5582,11106,1233.33333333333,1204.71666666667,2438.05,5305,5090,96.0354815351195,215
203082,Terrence Ross,73,3918,3892,7810,900.766666666667,843.45,1744.21666666667,3679,3464,93.8999489535477,215
203105,Festus Ezeli,46,1849,1833,3682,361.166666666667,406.616666666667,767.783333333333,1800,1590,97.3499188750676,210
202681,Kyrie Irving,53,3788,3686,7474,853.583333333333,801.65,1655.23333333333,3642,3433,96.1457233368532,209
202697,Iman Shumpert,54,2983,2960,5943,676.95,637.65,1314.6,2848,2639,95.4743546765002,209
200794,Paul Millsap,81,6108,6290,12398,1290.45,1345.06666666667,2635.51666666667,5696,5488,93.2547478716437,208
2733,Shaun Livingston,78,3534,3608,7142,730.466666666667,784.966666666667,1515.43333333333,3405,3203,96.3497453310696,202
101161,Amir Johnson,79,4257,4260,8517,838.933333333334,943.75,1782.68333333333,3956,3754,92.9292929292929,202
203937,Kyle Anderson,78,2737,2785,5522,643.25,593.983333333333,1237.23333333333,2632,2431,96.1636828644501,201
203109,Jae Crowder,73,5551,5570,11121,1086.55,1205.51666666667,2292.06666666667,5132,4935,92.4518104845974,197
201143,Al Horford,82,5977,6229,12206,1258.46666666667,1354.73333333333,2613.2,5567,5373,93.1403714237912,194
202331,Paul George,81,6614,6652,13266,1391.66666666667,1423.98333333333,2815.65,6055,5874,91.5482310250983,181
202730,Lavoy Allen,79,3677,3649,7326,789.633333333333,804.733333333333,1594.36666666667,3351,3170,91.1340766929562,181
203469,Cody Zeller,73,4032,4007,8039,880.333333333334,882.416666666667,1762.75,3889,3715,96.453373015873,174
201942,DeMar DeRozan,78,6370,6282,12652,1464.41666666667,1337.86666666667,2802.28333333333,6005,5833,94.2700156985871,172
203083,Andre Drummond,81,6306,5998,12304,1331.21666666667,1329.65,2660.86666666667,5656,5485,89.6923564858865,171
203484,Kentavious Caldwell-Pope,76,6640,6341,12981,1392.15,1393.98333333333,2786.13333333333,5979,5811,90.0451807228916,168
201976,Patrick Beverley,71,4813,4779,9592,973.483333333333,1057.48333333333,2030.96666666667,4536,4372,94.2447537918138,164
201933,Blake Griffin,35,2716,2726,5442,579.333333333333,585.983333333333,1165.31666666667,2573,2410,94.7349042709867,163
203497,Rudy Gobert,61,4236,4179,8415,1000.48333333333,924.133333333333,1924.61666666667,3868,3705,91.3125590179415,163
203096,Jared Sullinger,81,4590,4542,9132,907.966666666667,1000.55,1908.51666666667,4207,4048,91.6557734204793,159
1717,Dirk Nowitzki,75,5267,5346,10613,1217.38333333333,1142.43333333333,2359.81666666667,5045,4888,95.7850768938675,157
202687,Bismack Biyombo,82,4080,4067,8147,929.75,879.183333333333,1808.93333333333,3747,3594,91.8382352941177,153
202704,Reggie Jackson,79,5732,5466,11198,1207.9,1202.76666666667,2410.66666666667,5232,5079,91.2770411723657,153
203087,Jeremy Lamb,66,2801,2818,5619,621.05,604.666666666667,1225.71666666667,2549,2399,91.0032131381649,150
203468,CJ McCollum,80,6519,6419,12938,1408.4,1360.55,2768.95,6079,5933,93.2504985427213,146
202683,Enes Kanter,82,4154,4030,8184,864.6,853.216666666667,1717.81666666667,3881,3737,93.4280211844006,144
201584,Courtney Lee,79,5184,5252,10436,1195.01666666667,1126.86666666667,2321.88333333333,4933,4792,95.1581790123457,141
202694,Marcus Morris,80,6670,6425,13095,1431.41666666667,1411.58333333333,2843,6061,5921,90.8695652173913,140
203118,Mike Scott,75,2630,2684,5314,554.883333333333,593.033333333333,1147.91666666667,2401,2268,91.2927756653992,133
203482,Kelly Olynyk,69,3352,3366,6718,676.133333333333,713.4,1389.53333333333,3031,2900,90.4236276849642,131
101133,Ian Mahinmi,71,4178,4208,8386,886.95,918.55,1805.5,3824,3694,91.5270464337003,130
1626159,Justise Winslow,78,5041,5061,10102,1127.9,1101.9,2229.8,4612,4483,91.4897837730609,129
203503,Tony Snell,64,3051,3081,6132,640.816666666667,655.966666666667,1296.78333333333,2731,2604,89.5116355293346,127
201168,Tiago Splitter,36,1340,1355,2695,285.35,295.066666666667,580.416666666667,1246,1122,92.9850746268657,124
203935,Marcus Smart,61,4117,4061,8178,805.216666666667,875.033333333333,1680.25,3717,3596,90.284187515181,121
101145,Monta Ellis,81,6413,6474,12887,1347.91666666667,1382.61666666667,2730.53333333333,5829,5713,90.8934975830345,116
201935,James Harden,82,7462,7411,14873,1502.43333333333,1620.7,3123.13333333333,6988,6872,93.6478155990351,116
202685,Jonas Valanciunas,60,3509,3422,6931,817.933333333333,728.9,1546.83333333333,3349,3238,95.4402963807352,111
202391,Jeremy Lin,78,4682,4730,9412,1043.65,1005.96666666667,2049.61666666667,4328,4218,92.439128577531,110
201588,George Hill,74,5768,5825,11593,1247.65,1260.66666666667,2508.31666666667,5268,5159,91.3314840499307,109
203501,Tim Hardaway Jr.,51,1968,2013,3981,413.35,450.55,863.9,1856,1747,94.3089430894309,109
203918,Rodney Hood,79,5511,5419,10930,1323.03333333333,1197.43333333333,2520.46666666667,5064,4955,91.8889493739793,109
202714,Shelvin Mack,52,2381,2312,4693,548.65,511.766666666667,1060.41666666667,2191,2084,92.0201595968081,107
203991,Clint Capela,77,3558,3505,7063,700.683333333333,766.916666666667,1467.6,3242,3135,91.1186059584036,107
201627,Anthony Morrow,67,2176,2164,4340,459.35,461.2,920.55,2099,1996,96.4613970588236,103
202083,Wesley Matthews,78,5852,5956,11808,1350.46666666667,1287.18333333333,2637.65,5650,5548,96.5481886534518,102
202344,Trevor Booker,79,3709,3618,7327,856.8,788.016666666667,1644.81666666667,3308,3207,89.1884605014829,101
203526,Raul Neto,81,3235,3230,6465,777.883333333333,712.583333333333,1490.46666666667,2967,2866,91.7156105100464,101
203999,Nikola Jokic,80,4066,3868,7934,850.583333333333,873.166666666667,1723.75,3678,3577,90.4574520413182,101
202325,Wesley Johnson,80,3861,3952,7813,830.666666666667,832.2,1662.86666666667,3550,3451,91.9450919450919,99
201596,Mario Chalmers,61,3161,3177,6338,694.533333333333,677.216666666667,1371.75,2889,2791,91.3951281240114,98
203613,Jonathon Simmons,55,1828,1860,3688,418.366666666667,390.766666666667,809.133333333333,1769,1672,96.7724288840263,97
201973,Jonas Jerebko,78,2819,2803,5622,576.583333333333,596.583333333333,1173.16666666667,2516,2422,89.251507626818,94
202323,Evan Turner,81,5457,5430,10887,1095.78333333333,1170.85,2266.63333333333,4882,4789,89.463074949606,93
101112,Channing Frye,70,2664,2658,5322,598.616666666667,594.816666666667,1193.43333333333,2499,2408,93.8063063063063,91
202355,Hassan Whiteside,73,4796,4802,9598,1086.08333333333,1034.95,2121.03333333333,4384,4296,91.4095079232694,88
203909,KJ McDaniels,35,578,587,1165,103.333333333333,129.5,232.833333333333,561,474,97.0588235294118,87
200757,Thabo Sefolosha,75,3995,4152,8147,844.266666666667,910.483333333333,1754.75,3660,3574,91.6145181476846,86
203086,Meyers Leonard,61,3097,3016,6113,681.05,647.783333333333,1328.83333333333,2924,2842,94.4139489828867,82
203081,Damian Lillard,75,6347,6294,12641,1353.58333333333,1320.21666666667,2673.8,6000,5921,94.5328501654325,79
202330,Gordon Hayward,80,6461,6337,12798,1498.5,1388.13333333333,2886.63333333333,5874,5796,90.9147190837332,78
203145,Kent Bazemore,75,4763,4982,9745,1000.25,1065.5,2065.75,4385,4309,92.0638253201764,76
1626181,Norman Powell,49,1639,1618,3257,377.166666666667,342.95,720.116666666667,1555,1480,94.8749237339841,75
203187,Chris Johnson,70,1890,1902,3792,436.516666666667,409.816666666667,846.333333333333,1708,1636,90.3703703703704,72
203486,Mason Plumlee,82,4845,4837,9682,1040.6,1034.85,2075.45,4598,4527,94.9019607843137,71
2446,Rasual Butler,46,933,962,1895,221.116666666667,199.333333333333,420.45,916,847,98.1779206859593,69
202329,Al-Farouq Aminu,82,5501,5500,11001,1174.88333333333,1159.55,2334.43333333333,5180,5111,94.1646973277586,69
203524,Solomon Hill,58,2044,2039,4083,426.45,437.5,863.95,1862,1795,91.0958904109589,67
202322,John Wall,77,6503,6505,13008,1321.68333333333,1453.81666666667,2775.5,6053,5987,93.0801168691373,66
202324,Derrick Favors,62,4394,4274,8668,1037.75,937.883333333333,1975.63333333333,4012,3946,91.3063268092854,66
201960,DeMarre Carroll,26,1837,1756,3593,421.966666666667,364.116666666667,786.083333333333,1664,1599,90.5824714207948,65
200751,Randy Foye,81,3857,3814,7671,820.566666666667,815.15,1635.71666666667,3478,3415,90.1737101374125,63
2744,Al Jefferson,47,2455,2511,4966,565.216666666667,530.55,1095.76666666667,2305,2243,93.8900203665988,62
202326,DeMarcus Cousins,65,5469,5453,10922,1082.78333333333,1157.36666666667,2240.15,5066,5006,92.6311940025599,60
2588,Matt Bonner,29,439,449,888,108.95,95.0833333333333,204.033333333333,455,397,103.644646924829,58
203895,Jordan McRae,22,426,441,867,93.7166666666667,99.8833333333333,193.6,420,363,98.5915492957746,57
1626245,Cristiano Felicio,31,749,721,1470,158.733333333333,160,318.733333333333,705,648,94.1255006675567,57
2403,Nene,57,2520,2558,5078,515.383333333333,573.55,1088.93333333333,2374,2318,94.2063492063492,56
203077,Michael Kidd-Gilchrist,7,474,457,931,101.35,102.666666666667,204.016666666667,455,399,95.9915611814346,56
201937,Ricky Rubio,76,5379,5407,10786,1143.41666666667,1171.96666666667,2315.38333333333,5055,5002,93.9765755716676,53
708,Kevin Garnett,38,1231,1258,2489,263.316666666667,287.133333333333,550.45,1128,1076,91.6328188464663,52
2736,Luol Deng,74,5441,5434,10875,1230.56666666667,1155.96666666667,2386.53333333333,5019,4968,92.2440727807388,51
201162,Jared Dudley,81,4857,4895,9752,995.733333333333,1099.46666666667,2095.2,4542,4492,93.514515132798,50
2037,Jamal Crawford,79,4867,4983,9850,1068.25,1051.83333333333,2120.08333333333,4541,4492,93.3018286418738,49
202389,Timofey Mozgov,76,2944,2939,5883,669.366666666667,647.766666666667,1317.13333333333,2736,2687,92.9347826086957,49
1626196,Josh Richardson,52,2482,2499,4981,563.983333333333,537.566666666667,1101.55,2289,2242,92.2240128928284,47
203481,Jeff Withey,51,1431,1427,2858,337.1,316.633333333333,653.733333333333,1286,1243,89.8672257162823,43
1626257,Salah Mejri,33,883,912,1795,201.9,192.033333333333,393.933333333333,852,809,96.4892412231031,43
201150,Spencer Hawes,57,2350,2378,4728,527.466666666667,509.15,1036.61666666667,2132,2090,90.7234042553192,42
201952,Jeff Teague,79,5203,5406,10609,1094.65,1147.58333333333,2242.23333333333,4777,4735,91.8124159138958,42
2571,Leandro Barbosa,68,2585,2588,5173,522.5,555.033333333333,1077.53333333333,2427,2387,93.8878143133462,40
203934,Lamar Patterson,35,939,925,1864,199.083333333333,201.1,400.183333333333,893,854,95.1011714589989,39
1626246,Boban Marjanovic,54,1145,1124,2269,265.016666666667,238.066666666667,503.083333333333,1076,1037,93.9737991266376,39
202700,Donatas Motiejunas,37,1278,1310,2588,258.65,283.683333333333,542.333333333333,1201,1163,93.9749608763693,38
203094,Andrew Nicholson,56,1860,1879,3739,415.116666666667,406.016666666667,821.133333333333,1674,1636,90,38
203490,Otto Porter Jr.,75,5332,5307,10639,1066.03333333333,1197.26666666667,2263.3,4939,4901,92.629407351838,38
101187,Alan Anderson,13,453,440,893,91.4333333333333,101.416666666667,192.85,427,390,94.2604856512141,37
201144,Mike Conley,56,3901,3910,7811,907.433333333333,844.866666666667,1752.3,3625,3590,92.924891053576,35
203463,Ben McLemore,68,3540,3504,7044,688.1,744.666666666667,1432.76666666667,3269,3234,92.3446327683616,35
202334,Ed Davis,81,3959,3907,7866,865.433333333333,821.416666666667,1686.85,3589,3555,90.6542056074766,34
203459,Allen Crabbe,81,4991,4952,9943,1069.56666666667,1032.23333333333,2101.8,4639,4605,92.9473051492687,34
1626149,Montrezl Harrell,39,915,924,1839,172.816666666667,201.866666666667,374.683333333333,860,827,93.9890710382514,33
201945,Gerald Henderson,72,3355,3331,6686,734.083333333333,698.066666666667,1432.15,3090,3058,92.1013412816692,32
201950,Jrue Holiday,65,4302,4191,8493,869.983333333333,954.866666666667,1824.85,4023,3991,93.5146443514645,32
201956,Omri Casspi,69,4579,4593,9172,907.966666666667,973.033333333333,1881,4238,4206,92.552959161389,32
2555,Nick Collison,59,1656,1598,3254,349.316666666667,347.016666666667,696.333333333333,1457,1426,87.9830917874396,31
2772,Trevor Ariza,81,6780,6733,13513,1369.28333333333,1482.73333333333,2852.01666666667,6341,6310,93.5250737463127,31
1889,Andre Miller,39,993,1009,2002,233.283333333333,227.016666666667,460.3,971,941,97.7844914400806,30
101114,Deron Williams,65,4691,4796,9487,1070.91666666667,1031.1,2102.01666666667,4395,4366,93.6900447665743,29
203512,Lucas Nogueira,29,514,522,1036,114.45,109.516666666667,223.966666666667,507,479,98.6381322957198,28
2760,Anderson Varejao,53,1182,1145,2327,253.716666666667,242.5,496.216666666667,1061,1035,89.7631133671743,26
203492,Ray McCallum,40,1089,1060,2149,245,225.45,470.45,993,967,91.1845730027548,26
1718,Paul Pierce,68,2708,2835,5543,609.466666666667,610.816666666667,1220.28333333333,2585,2560,95.4579025110783,25
2730,Dwight Howard,71,5391,5321,10712,1091.55,1179.45,2271,4945,4922,91.726952327954,23
101123,Gerald Green,69,3475,3504,6979,783.783333333333,769.333333333333,1553.11666666667,3197,3175,92,22
201977,Marcus Thornton,61,2681,2662,5343,537.066666666667,568.7,1105.76666666667,2460,2438,91.7568071615069,22
1626153,Delon Wright,27,517,516,1033,122.433333333333,107.733333333333,230.166666666667,485,463,93.8104448742747,22
202407,Elijah Millsap,20,401,395,796,88.5166666666667,84.75,173.266666666667,360,339,89.7755610972569,21
201941,Jordan Hill,73,3493,3500,6993,768.7,746.483333333333,1515.18333333333,3134,3114,89.7223017463499,20
1626147,Justin Anderson,55,1488,1495,2983,327.55,316.383333333333,643.933333333333,1345,1325,90.3897849462366,20
1626273,Marcelo Huertas,53,1984,1959,3943,429.433333333333,437.2,866.633333333333,1784,1764,89.9193548387097,20
203912,CJ Wilcox,23,361,398,759,82.65,81.5,164.15,358,339,99.1689750692521,19
2547,Chris Bosh,53,3882,3964,7846,898.283333333333,874.616666666667,1772.9,3550,3533,91.4477073673364,17
2550,Kirk Hinrich,46,1452,1459,2911,315.566666666667,315.516666666667,631.083333333333,1277,1260,87.9476584022039,17
202699,Tobias Harris,76,5773,5650,11423,1254.6,1248.08333333333,2502.68333333333,5233,5217,90.6461112073445,16
203090,Maurice Harkless,78,3455,3452,6907,737.7,715.366666666667,1453.06666666667,3182,3166,92.0984081041968,16
202703,Nikola Mirotic,66,3792,3837,7629,813.533333333333,824.75,1638.28333333333,3522,3507,92.879746835443,15
203951,Keith Appling,5,60,55,115,12.7166666666667,13.4666666666667,26.1833333333333,56,42,93.3333333333333,14
204028,Tarik Black,39,1142,1115,2257,240.633333333333,254.216666666667,494.85,1030,1016,90.1926444833625,14
204001,Kristaps Porzingis,72,4591,4600,9191,1037.83333333333,992.133333333333,2029.96666666667,4207,4194,91.6358091918972,13
202718,Chandler Parsons,61,3946,4094,8040,909.066666666667,882.216666666667,1791.28333333333,3749,3738,95.0076026355803,11
101162,Marcin Gortat,75,5279,5272,10551,1066.05,1189.65,2255.7,4867,4857,92.1954915703732,10
201975,Jodie Meeks,3,93,92,185,20.2166666666667,22.2,42.4166666666667,86,76,92.4731182795699,10
202726,Andrew Goudelock,7,122,143,265,20.1333333333333,28.65,48.7833333333333,114,105,93.4426229508197,9
2405,Amar'e Stoudemire,52,1680,1704,3384,391.6,365.3,756.9,1561,1553,92.9166666666667,8
201578,Marreese Speights,72,1932,1986,3918,403.85,423.783333333333,827.633333333333,1814,1806,93.8923395445135,8
1626210,Alan Williams,10,191,167,358,32.5833333333333,34.65,67.2333333333334,175,167,91.6230366492147,8
202066,Garrett Temple,79,4498,4549,9047,918.433333333333,1024.13333333333,1942.56666666667,4112,4105,91.418408181414,7
203921,Cleanthony Early,16,344,351,695,74.7666666666667,77.35,152.116666666667,295,288,85.7558139534884,7
203950,Jarnell Stokes,7,41,38,79,8.81666666666667,8.51666666666667,17.3333333333333,38,31,92.6829268292683,7
1626175,Jordan Mickey,16,135,129,264,27.5333333333333,27.1833333333333,54.7166666666667,111,105,82.2222222222222,6
1626199,Darrun Hilliard,38,873,865,1738,186.566666666667,193.633333333333,380.2,793,787,90.836197021764,6
201149,Joakim Noah,29,1514,1480,2994,312.616666666667,323.65,636.266666666667,1299,1294,85.7992073976222,5
203268,Jorge Gutierrez,12,145,154,299,30.15,31.4333333333333,61.5833333333333,148,143,102.068965517241,5
204020,Tyler Johnson,36,1908,1931,3839,438.066666666667,423.8,861.866666666667,1696,1691,88.8888888888889,5
201188,Marc Gasol,52,3993,3975,7968,930.566666666667,857.583333333333,1788.15,3616,3612,90.5584773353369,4
203919,Jordan Adams,2,38,34,72,7.41666666666667,7.21666666666667,14.6333333333333,34,30,89.4736842105263,4
1626262,Coty Clarke,3,14,12,26,3.23333333333333,2.53333333333333,5.76666666666667,18,14,128.571428571429,4
200779,Steve Novak,10,106,116,222,21.6,22.5333333333333,44.1333333333333,107,104,100.943396226415,3
201943,Brandon Jennings,48,2049,2022,4071,427.216666666667,441.116666666667,868.333333333333,1875,1872,91.5080527086384,3
2563,Dahntay Jones,1,92,88,180,21.9666666666667,20.1166666666667,42.0833333333333,88,86,95.6521739130435,2
201177,Josh McRoberts,42,1306,1333,2639,297.45,292.616666666667,590.066666666667,1211,1209,92.7258805513017,2
202332,Cole Aldrich,60,1761,1860,3621,401.95,394.566666666667,796.516666666667,1600,1598,90.8574673480977,2
203527,Ryan Kelly,36,1115,1113,2228,226.466666666667,242.2,468.666666666667,976,974,87.5336322869955,2
1626155,Sam Dekker,3,17,17,34,2.58333333333334,3.41666666666667,6,21,19,123.529411764706,2
203508,Sergey Karasev,40,930,938,1868,198.483333333333,199.633333333333,398.116666666667,886,885,95.2688172043011,1
202710,Jimmy Butler,67,5736,5773,11509,1244.68333333333,1229.08333333333,2473.76666666667,5184,5184,90.3765690376569,0
203123,Kostas Papanikolaou,26,648,654,1302,143.616666666667,147.7,291.316666666667,576,576,88.8888888888889,0
101236,Chuck Hayes,2,54,62,116,11.6333333333333,12.5333333333333,24.1666666666667,45,46,83.3333333333333,-1
203475,Erick Green,9,91,87,178,22.2666666666667,18.6333333333333,40.9,91,92,100,-1
203961,Eric Moreland,8,112,123,235,22.1166666666667,25.7,47.8166666666667,110,111,98.2142857142857,-1
203962,Josh Huestis,5,132,129,261,26.8,28.5166666666667,55.3166666666667,122,123,92.4242424242424,-1
202343,Elliot Williams,5,99,99,198,21.8,23.3666666666667,45.1666666666667,90,92,90.9090909090909,-2
201583,Ryan Anderson,66,4767,4652,9419,980.566666666667,1031.3,2011.86666666667,4439,4443,93.1193622823579,-4
1627293,Alex Stepheson,8,194,170,364,40.1,32.25,72.35,141,145,72.680412371134,-4
201155,Rodney Stuckey,58,2907,2962,5869,630.066666666667,649.533333333333,1279.6,2623,2628,90.2304781561748,-5
201619,Sasha Kaun,23,217,224,441,48.9,44.5166666666667,93.4166666666667,183,188,84.331797235023,-5
203648,Thanasis Antetokounmpo,2,15,18,33,2.8,3.21666666666667,6.01666666666667,15,20,100,-5
203998,Bruno Caboclo,6,103,99,202,23.5666666666667,19.0666666666667,42.6333333333333,82,87,79.6116504854369,-5
1626151,Aaron Harrison,21,212,230,442,44.3833333333333,46.3833333333333,90.7666666666667,201,206,94.811320754717,-5
201936,Tyreke Evans,25,1731,1707,3438,376.55,386.65,763.2,1586,1592,91.6233391103408,-6
201949,James Johnson,57,2083,2066,4149,476.716666666667,451.133333333333,927.85,1914,1920,91.8867018722996,-6
203994,Jusuf Nurkic,32,1299,1257,2556,271.066666666667,273.566666666667,544.633333333333,1168,1174,89.9153194765204,-6
204002,Edy Tavares,11,199,197,396,40.8833333333333,42.5666666666667,83.45,194,200,97.4874371859297,-6
1626266,JJ O'Brien,2,12,16,28,2.98333333333333,3.11666666666667,6.1,12,18,100,-6
201166,Aaron Brooks,69,2569,2551,5120,553.316666666667,554.733333333333,1108.05,2317,2324,90.1907356948229,-7
1737,Nazr Mohammed,5,42,45,87,9.2,9.18333333333334,18.3833333333333,31,39,73.8095238095238,-8
203963,Shayne Whittington,7,93,91,184,20.4833333333333,20.2333333333333,40.7166666666667,70,78,75.2688172043011,-8
2585,Zaza Pachulia,76,4417,4463,8880,1023.4,973.933333333333,1997.33333333333,4080,4089,92.3703871405932,-9
203946,Cameron Bairstow,18,246,244,490,48.3666666666667,54.1,102.466666666667,205,214,83.3333333333333,-9
1626251,Duje Dukan,1,63,60,123,13.9,10.45,24.35,45,54,71.4285714285714,-9
201575,Brandon Rush,72,2448,2558,5006,499.75,546.516666666667,1046.26666666667,2413,2423,98.5702614379085,-10
203078,Bradley Beal,55,4048,4000,8048,816.266666666667,887.65,1703.91666666667,3740,3750,92.3913043478261,-10
1626176,Rakeem Christmas,1,13,13,26,3.05,2.8,5.85,14,24,107.692307692308,-10
202353,Tibor Pleiss,12,178,190,368,42.1833333333333,41.8666666666667,84.05,164,176,92.1348314606742,-12
202692,Alec Burks,31,1823,1780,3603,412.216666666667,385.2,797.416666666667,1612,1624,88.4256719692814,-12
203461,Anthony Bennett,19,211,188,399,44.2333333333333,39.9,84.1333333333333,185,197,87.6777251184834,-12
1626146,Cliff Alexander,8,76,84,160,17.3,17.4333333333333,34.7333333333333,67,80,88.1578947368421,-13
1626253,Axel Toupane,21,685,694,1379,149.466666666667,153.45,302.916666666667,661,674,96.4963503649635,-13
203928,Cory Jefferson,6,118,126,244,25.2333333333333,24.9166666666667,50.15,104,118,88.135593220339,-14
204014,Damjan Rudez,33,650,646,1296,134.05,142.083333333333,276.133333333333,598,612,92,-14
1626183,Branden Dawson,6,58,68,126,14.6666666666667,13.1833333333333,27.85,56,70,96.551724137931,-14
201574,Jason Thompson,47,1073,1101,2174,246.216666666667,222.7,468.916666666667,1002,1017,93.3830382106244,-15
2548,Dwyane Wade,74,5070,5127,10197,1157.98333333333,1089.38333333333,2247.36666666667,4695,4711,92.603550295858,-16
2617,Udonis Haslem,37,542,580,1122,132.566666666667,126.266666666667,258.833333333333,508,525,93.7269372693727,-17
101139,CJ Miles,64,3448,3513,6961,723.683333333333,738.933333333333,1462.61666666667,3150,3167,91.3573085846868,-17
201202,Joel Anthony,18,214,205,419,47.5833333333333,46.2,93.7833333333333,174,191,81.3084112149533,-17
1626192,Pat Connaughton,33,328,337,665,72.4,64.1,136.5,266,283,81.0975609756098,-17
202498,Lance Thomas,59,2988,3081,6069,675.583333333333,652.45,1328.03333333333,2766,2784,92.570281124498,-18
202713,Kyle Singler,67,2395,2326,4721,494.733333333333,479.066666666667,973.8,2106,2124,87.9331941544885,-18
203906,Devyn Marble,28,590,591,1181,121.1,126.2,247.3,508,526,86.1016949152542,-18
101126,Nate Robinson,2,55,58,113,11.9333333333333,11.05,22.9833333333333,38,58,69.0909090909091,-20
203506,Victor Oladipo,72,5527,5590,11117,1176,1199.38333333333,2375.38333333333,5090,5110,92.0933598697304,-20
1626154,RJ Hunter,36,743,734,1477,153.283333333333,159,312.283333333333,604,624,81.2920592193809,-20
1626172,Kevon Looney,5,56,52,108,11.5,8.85,20.35,49,69,87.5,-20
1891,Jason Terry,72,2992,2979,5971,592.166666666667,659.566666666667,1251.73333333333,2766,2787,92.4465240641711,-21
203552,Seth Curry,44,1657,1648,3305,333.316666666667,355.233333333333,688.55,1535,1556,92.6372963186482,-21
202734,E'Twaun Moore,59,2907,2973,5880,626.583333333333,632.8,1259.38333333333,2676,2698,92.0536635706914,-22
203114,Khris Middleton,79,6558,6643,13201,1403.36666666667,1442.48333333333,2845.85,6045,6067,92.1774931381519,-22
203923,James Young,29,460,466,926,94,103.85,197.85,420,442,91.304347826087,-22
201571,D.J. Augustin,62,2750,2734,5484,600.233333333333,573.166666666667,1173.4,2518,2541,91.5636363636364,-23
202379,Jeremy Evans,29,583,600,1183,127.616666666667,121.3,248.916666666667,519,542,89.0222984562607,-23
202690,Jimmer Fredette,6,40,39,79,9.55,7.76666666666667,17.3166666666667,19,42,47.5,-23
201229,Anthony Tolliver,72,3109,2996,6105,672.916666666667,664.516666666667,1337.43333333333,2741,2765,88.1633965905436,-24
203925,Joe Harris,5,35,41,76,8.1,6.7,14.8,30,54,85.7142857142857,-24
204060,Joe Ingles,81,2794,2739,5533,648.15,592.783333333333,1240.93333333333,2456,2480,87.9026485325698,-24
203955,Bryce Cotton,8,86,93,179,18.7666666666667,19.25,38.0166666666667,80,105,93.0232558139535,-25
1626185,Jarell Martin,27,934,862,1796,196.65,185.883333333333,382.533333333333,794,819,85.0107066381156,-25
204098,Xavier Munford,14,594,546,1140,125.716666666667,122.283333333333,248,518,545,87.2053872053872,-27
203485,Lorenzo Brown,8,141,133,274,30.7166666666667,29.0666666666667,59.7833333333334,116,144,82.2695035460993,-28
204025,Tim Frazier,49,1714,1701,3415,365.1,372.783333333333,737.883333333333,1562,1590,91.1318553092182,-28
2754,Tony Allen,64,3685,3610,7295,826.216666666667,784.55,1610.76666666667,3267,3296,88.6567164179104,-29
203893,Russ Smith,15,155,162,317,32.4166666666667,33.15,65.5666666666667,137,166,88.3870967741936,-29
2756,Sasha Vujacic,61,2109,2079,4188,465.333333333333,441.866666666667,907.2,1874,1904,88.8572783309625,-30
201978,Chase Budinger,66,2209,2154,4363,457.983333333333,464.816666666667,922.8,1952,1982,88.3657763693979,-30
2549,Chris Kaman,16,250,249,499,57.4666666666667,53.2333333333333,110.7,211,242,84.4,-31
203473,Dewayne Dedmon,58,1636,1650,3286,334.95,366.25,701.2,1458,1490,89.119804400978,-32
203922,Glenn Robinson III,45,1181,1159,2340,262.433333333333,243.3,505.733333333333,1017,1049,86.1134631668078,-32
2592,James Jones,47,1038,1053,2091,235.3,227.733333333333,463.033333333333,900,933,86.7052023121387,-33
202712,Justin Harper,4,74,69,143,16.5833333333333,17.0666666666667,33.65,55,88,74.3243243243243,-33
203111,Orlando Johnson,7,254,236,490,52.75,49.4166666666667,102.166666666667,206,239,81.1023622047244,-33
2546,Carmelo Anthony,72,5736,5758,11494,1298.33333333333,1229.45,2527.78333333333,5293,5327,92.2768479776848,-34
203996,Damien Inglis,20,344,372,716,74.9166666666667,81.2333333333333,156.15,280,314,81.3953488372093,-34
1626214,Bryce Dejean-Jones,14,652,616,1268,133.183333333333,143.316666666667,276.5,563,597,86.3496932515337,-34
1882,Elton Brand,17,515,546,1061,113.666666666667,111.583333333333,225.25,433,468,84.0776699029126,-35
202339,Eric Bledsoe,31,2532,2541,5073,517.733333333333,539.233333333333,1056.96666666667,2293,2328,90.5608214849921,-35
1626166,Cameron Payne,57,1655,1619,3274,350.8,341.833333333333,692.633333333333,1493,1528,90.2114803625378,-35
203099,Jared Cunningham,41,918,940,1858,203.116666666667,205.9,409.016666666667,828,864,90.1960784313726,-36
203210,JaMychal Green,78,3401,3272,6673,720.866666666667,715.15,1436.01666666667,3032,3068,89.1502499264922,-36
1626148,Anthony Brown,29,1396,1349,2745,305.483333333333,292.133333333333,597.616666666667,1208,1244,86.5329512893983,-36
1626202,Joe Young,40,916,891,1807,195.166666666667,188.016666666667,383.183333333333,786,822,85.8078602620087,-36
2406,Caron Butler,17,423,422,845,89.8333333333333,86.95,176.783333333333,357,394,84.3971631205674,-37
201160,Jason Smith,76,2691,2706,5397,587.6,590.283333333333,1177.88333333333,2473,2511,91.8989223337049,-38
203516,James Ennis III,21,757,740,1497,163.483333333333,160,323.483333333333,695,733,91.8097754293263,-38
1626163,Frank Kaminsky,81,3890,3904,7794,861.316666666667,842.1,1703.41666666667,3503,3541,90.0514138817481,-38
201971,DeJuan Blair,29,532,524,1056,105.916666666667,110.8,216.716666666667,468,507,87.9699248120301,-39
203092,Tyler Zeller,60,1729,1743,3472,342.666666666667,371.25,713.916666666667,1499,1539,86.6975130133025,-40
203476,Gorgui Dieng,82,5054,5139,10193,1107.83333333333,1108,2215.83333333333,4748,4788,93.9453897902651,-40
1626242,Luis Montero,11,90,90,180,21.75,17.6333333333333,39.3833333333333,54,94,60,-40
200811,Lou Amundson,29,474,470,944,100.95,103.6,204.55,373,414,78.6919831223629,-41
1626162,Kelly Oubre Jr.,62,1603,1617,3220,326.3,341.533333333333,667.833333333333,1449,1490,90.3930131004367,-41
201946,Tyler Hansbrough,44,790,795,1585,172.916666666667,166.933333333333,339.85,721,763,91.2658227848101,-42
203894,Shabazz Napier,55,1358,1351,2709,294.75,302.15,596.9,1209,1251,89.0279823269514,-42
2210,Richard Jefferson,74,2944,2948,5892,671.35,647.116666666667,1318.46666666667,2649,2692,89.9796195652174,-43
203135,Robert Sacre,25,773,743,1516,162.633333333333,158.316666666667,320.95,654,697,84.6054333764554,-43
203939,Dwight Powell,68,2266,2309,4575,505.083333333333,483.4,988.483333333333,2016,2059,88.9673433362754,-43
203943,Noah Vonleh,78,2696,2660,5356,587.5,573.4,1160.9,2415,2458,89.5771513353116,-43
1626174,Christian Wood,17,346,362,708,72.1166666666667,70.7333333333333,142.85,304,347,87.8612716763006,-43
1626178,Rondae Hollis-Jefferson,29,1457,1426,2883,308.116666666667,306.433333333333,614.55,1248,1291,85.6554564172958,-43
1626179,Terry Rozier,38,753,747,1500,154.9,153.6,308.5,618,661,82.0717131474104,-43
101109,Raymond Felton,80,4928,5054,9982,1131.98333333333,1059.46666666667,2191.45,4618,4662,93.7094155844156,-44
201145,Jeff Green,80,5013,5129,10142,1141.83333333333,1106.68333333333,2248.51666666667,4630,4676,92.359864352683,-46
201582,Alexis Ajinca,59,1982,1963,3945,416.25,438.85,855.1,1752,1798,88.3955600403633,-46
203200,Justin Holiday,53,1819,1844,3663,381.533333333333,403.416666666667,784.95,1661,1707,91.3139087410665,-46
203515,Phil Pressey,23,704,702,1406,139.9,142.016666666667,281.916666666667,605,651,85.9375,-46
201564,O.J. Mayo,41,2481,2534,5015,528.3,555.65,1083.95,2218,2266,89.3994357114067,-48
201965,Jeff Ayres,17,225,264,489,52.85,52.2333333333333,105.083333333333,211,259,93.7777777777778,-48
204067,Jarell Eddie,25,352,355,707,72.05,72.25,144.3,292,340,82.9545454545455,-48
203143,Pablo Prigioni,59,1823,1902,3725,415.883333333333,401.516666666667,817.4,1613,1662,88.4805266044981,-49
2590,Mo Williams,41,1698,1671,3369,385.666666666667,358.883333333333,744.55,1471,1521,86.6313309776207,-50
2757,Beno Udrih,44,1541,1568,3109,356.9,347.85,704.75,1390,1440,90.2011680726801,-50
201228,C.J. Watson,33,1534,1585,3119,318.733333333333,339,657.733333333333,1446,1497,94.2633637548892,-51
201580,JaVale McGee,34,836,848,1684,187.85,179.75,367.6,718,769,85.8851674641148,-51
203124,Kyle O'Quinn,65,1764,1812,3576,395.966666666667,381.716666666667,777.683333333333,1580,1631,89.5691609977324,-51
202337,Luke Babbitt,47,1985,1967,3952,410.266666666667,430.7,840.966666666667,1864,1916,93.904282115869,-52
203504,Trey Burke,64,3100,3035,6135,710.35,659.45,1369.8,2715,2767,87.5806451612903,-52
203915,Spencer Dinwiddie,12,362,351,713,80.7,77.5333333333333,158.233333333333,261,313,72.0994475138122,-52
203956,Mitch McGary,20,172,185,357,36.6,34,70.6,144,196,83.7209302325582,-52
2449,Luis Scola,76,3684,3614,7298,858.066666666667,772.6,1630.66666666667,3380,3433,91.7480998914224,-53
201147,Corey Brewer,82,4056,4085,8141,797.45,874.783333333333,1672.23333333333,3643,3697,89.8175542406312,-54
202362,Lance Stephenson,69,3200,3175,6375,691,677.566666666667,1368.56666666667,2892,2946,90.375,-54
1626209,Mario Hezonja,79,3250,3236,6486,699.75,707.65,1407.4,2959,3013,91.0461538461538,-54
202341,James Anderson,51,1755,1811,3566,352.1,366.733333333333,718.833333333333,1578,1634,89.9145299145299,-56
101179,Ronnie Price,62,2910,2829,5739,601.35,610.15,1211.5,2490,2547,85.5670103092784,-57
201148,Brandan Wright,12,479,495,974,108.016666666667,104.8,212.816666666667,427,484,89.1440501043841,-57
201593,Nikola Pekovic,12,338,341,679,79.15,76.6166666666667,155.766666666667,287,344,84.9112426035503,-57
203098,John Jenkins,43,1176,1166,2342,239.266666666667,238.683333333333,477.95,1030,1087,87.5850340136054,-57
203186,Willie Reed,38,983,971,1954,217.45,205.75,423.2,847,904,86.1648016276704,-57
203488,Mike Muscala,59,1280,1309,2589,274.183333333333,290.75,564.933333333333,1139,1196,88.984375,-57
203584,Troy Daniels,43,1085,1121,2206,240.316666666667,232.733333333333,473.05,990,1047,91.2442396313364,-57
1626168,Trey Lyles,80,3007,3014,6021,725.716666666667,653.716666666667,1379.43333333333,2701,2759,89.8237445959428,-58
201589,Darrell Arthur,70,3530,3529,7059,755.866666666667,757.883333333333,1513.75,3147,3206,89.1501416430595,-59
202696,Nikola Vucevic,65,4711,4631,9342,1025.23333333333,1006.95,2032.18333333333,4295,4354,91.1696030566759,-59
101138,Brandon Bass,66,3124,3118,6242,674.733333333333,667.283333333333,1342.01666666667,2874,2934,91.9974391805378,-60
1626161,Willie Cauley-Stein,66,3387,3401,6788,682.266666666667,721.933333333333,1404.2,3128,3188,92.3531148509005,-60
1897,Metta World Peace,35,1360,1334,2694,295.316666666667,295.25,590.566666666667,1145,1207,84.1911764705882,-62
1626167,Myles Turner,60,3170,3270,6440,677.816666666667,689.833333333333,1367.65,2827,2889,89.1798107255521,-62
2734,Devin Harris,64,2949,3041,5990,658.5,621.016666666667,1279.51666666667,2672,2736,90.606985418786,-64
203493,Reggie Bullock,37,991,943,1934,217.85,210.883333333333,428.733333333333,877,942,88.4964682139253,-65
1627362,Briante Weber,7,432,372,804,91.0833333333333,76.3166666666667,167.4,328,393,75.9259259259259,-65
2207,Joe Johnson,81,6122,6108,12230,1372.11666666667,1322.13333333333,2694.25,5704,5770,93.172165958837,-66
200770,Jordan Farmar,12,685,648,1333,146.666666666667,142.25,288.916666666667,579,645,84.5255474452555,-66
201563,Michael Beasley,20,887,895,1782,169.616666666667,193.816666666667,363.433333333333,773,839,87.1476888387824,-66
202706,Jordan Hamilton,11,700,703,1403,149.783333333333,152.316666666667,302.1,648,714,92.5714285714286,-66
203952,Andrew Wiggins,81,6593,6591,13184,1409.75,1430.26666666667,2840.01666666667,6123,6189,92.871227059002,-66
2200,Pau Gasol,72,5308,5420,10728,1148.15,1139.61666666667,2287.76666666667,4800,4867,90.4295403165034,-67
2581,Steve Blake,58,2293,2217,4510,500.55,486.416666666667,986.966666666667,1997,2064,87.0911469690362,-67
201581,JJ Hickson,35,1055,1047,2102,219.866666666667,216.816666666667,436.683333333333,891,958,84.4549763033175,-67
201196,Ramon Sessions,82,3914,3950,7864,794.583333333333,872.35,1666.93333333333,3583,3652,91.543178334185,-69
1626158,Richaun Holmes,51,1675,1693,3368,350.933333333333,348.783333333333,699.716666666667,1521,1590,90.8059701492537,-69
203100,Tony Wroten,8,355,354,709,70.6166666666667,73.7666666666667,144.383333333333,264,334,74.3661971830986,-70
203898,Tyler Ennis,46,1492,1501,2993,328.866666666667,328.483333333333,657.35,1305,1375,87.4664879356569,-70
203901,Elfrid Payton,73,5030,4935,9965,1058.68333333333,1078.6,2137.28333333333,4505,4575,89.5626242544732,-70
203932,Aaron Gordon,78,4355,4351,8706,915.733333333333,946.066666666667,1861.8,3939,4010,90.4477611940299,-71
2365,Chris Andersen,27,906,886,1792,198.966666666667,198.2,397.166666666667,790,862,87.19646799117,-72
201569,Eric Gordon,45,3405,3438,6843,722.7,755.9,1478.6,3140,3213,92.2173274596182,-73
1713,Vince Carter,60,2361,2333,4694,508.466666666667,497.683333333333,1006.15,2108,2182,89.2842016094875,-74
200826,J.J. Barea,74,3783,3857,7640,851.216666666667,808.716666666667,1659.93333333333,3553,3627,93.9201691779011,-74
202720,Jon Leuer,67,3015,3013,6028,615.766666666667,637.966666666667,1253.73333333333,2699,2777,89.5190713101161,-78
203142,Chris Copeland,24,347,361,708,76.6833333333333,78.3333333333333,155.016666666667,284,366,81.8443804034582,-82
2399,Mike Dunleavy,31,1611,1623,3234,353.85,343.516666666667,697.366666666667,1492,1575,92.6132836747362,-83
2216,Zach Randolph,68,4565,4493,9058,1044.31666666667,967.083333333333,2011.4,4111,4195,90.0547645125958,-84
2400,Drew Gooden,30,714,719,1433,151.416666666667,150.333333333333,301.75,617,701,86.4145658263305,-84
101135,David Lee,55,2105,2145,4250,450.083333333333,455.083333333333,905.166666666667,1854,1938,88.0760095011877,-84
202962,Greg Smith,18,442,440,882,95,95.95,190.95,370,455,83.710407239819,-85
203949,James Michael McAdoo,40,619,618,1237,129.616666666667,129.7,259.316666666667,545,631,88.0452342487884,-86
203148,Brian Roberts,51,1083,1088,2171,236.75,228.466666666667,465.216666666667,940,1027,86.7959372114497,-87
203546,Ian Clark,66,1324,1392,2716,289.516666666667,283.266666666667,572.783333333333,1237,1324,93.429003021148,-87
2570,Kendrick Perkins,37,1241,1251,2492,267.883333333333,274.383333333333,542.266666666667,1165,1253,93.8759065269944,-88
202693,Markieff Morris,64,3852,3764,7616,796.433333333333,820.966666666667,1617.4,3438,3527,89.2523364485981,-89
2746,Josh Smith,55,2064,2095,4159,429.95,450.583333333333,880.533333333333,1805,1895,87.4515503875969,-90
201603,Sonny Weems,43,1227,1186,2413,245.25,252.033333333333,497.283333333333,1040,1130,84.759576202119,-90
202338,Kevin Seraphin,48,1183,1201,2384,266.05,260.25,526.3,995,1085,84.1081994928149,-90
2034,Mike Miller,44,885,861,1746,187.833333333333,184.25,372.083333333333,744,835,84.0677966101695,-91
2743,Kris Humphries,53,1986,1992,3978,397.083333333333,435.85,832.933333333333,1786,1877,89.9295065458207,-91
200752,Rudy Gay,70,5713,5723,11436,1148.16666666667,1221.23333333333,2369.4,5251,5343,91.9131804656048,-92
203156,Henry Sims,14,619,618,1237,131.2,131.966666666667,263.166666666667,524,616,84.6526655896608,-92
203085,Austin Rivers,67,3339,3535,6874,734.433333333333,733.883333333333,1468.31666666667,3055,3149,91.4944594189877,-94
202349,Greivis Vasquez,23,1038,1073,2111,227.2,232.166666666667,459.366666666667,894,989,86.1271676300578,-95
2419,Tayshaun Prince,77,3254,3334,6588,724.766666666667,731.933333333333,1456.7,2927,3023,89.9508297480025,-96
1626191,Chris McCullough,24,857,844,1701,179.7,179.983333333333,359.683333333333,757,857,88.3313885647608,-100
101111,Charlie Villanueva,61,1545,1539,3084,332.516666666667,325.9,658.416666666667,1357,1460,87.831715210356,-103
101181,Jose Calderon,72,4509,4564,9073,1036.15,980.366666666667,2016.51666666667,4148,4251,91.993790197383,-103
201959,Taj Gibson,73,4438,4523,8961,960.783333333333,969.866666666667,1930.65,3970,4073,89.4547093285264,-103
203101,Miles Plumlee,61,2002,2045,4047,431.7,437.316666666667,869.016666666667,1728,1832,86.3136863136863,-104
203088,Kendall Marshall,30,949,968,1917,199.7,200.316666666667,400.016666666667,842,947,88.7249736564805,-105
203382,Aron Baynes,81,2857,2786,5643,620.616666666667,607.45,1228.06666666667,2535,2640,88.7294364718236,-105
1626169,Stanley Johnson,73,3994,3849,7843,847.433333333333,839.733333333333,1687.16666666667,3481,3586,87.1557336004006,-105
204038,Langston Galloway,82,4631,4655,9286,1025.11666666667,998.566666666667,2023.68333333333,4122,4228,89.0088533793997,-106
101141,Ersan Ilyasova,74,4503,4274,8777,943.233333333333,933.95,1877.18333333333,3959,4068,87.9191650011104,-109
1626204,Larry Nance Jr.,63,2915,2903,5818,649.383333333333,617.333333333333,1266.71666666667,2574,2683,88.3018867924528,-109
201954,Darren Collison,74,5331,5387,10718,1080.25,1139.31666666667,2219.56666666667,4918,5031,92.2528606265241,-113
203487,Michael Carter-Williams,54,3816,3847,7663,809.883333333333,833.15,1643.03333333333,3409,3525,89.3343815513627,-116
1626157,Karl-Anthony Towns,82,6063,6076,12139,1291.48333333333,1326.15,2617.63333333333,5647,5763,93.1387102094673,-116
203948,Johnny O'Bryant III,65,1915,1959,3874,424.466666666667,432.666666666667,857.133333333333,1692,1809,88.355091383812,-117
201568,Danilo Gallinari,53,4356,4222,8578,928.8,908,1836.8,3892,4011,89.3480257116621,-119
202357,Nemanja Bjelica,60,2505,2490,4995,539.15,534.266666666667,1073.41666666667,2263,2382,90.3393213572854,-119
203933,T.J. Warren,47,2576,2506,5082,537.066666666667,530.316666666667,1067.38333333333,2292,2411,88.9751552795031,-119
202702,Kenneth Faried,67,4029,3871,7900,853.35,835.45,1688.8,3628,3749,90.0471581037478,-121
202708,Norris Cole,45,2783,2753,5536,576,615.133333333333,1191.13333333333,2529,2650,90.8731584620913,-121
203112,Quincy Acy,59,2117,2111,4228,430.75,439.116666666667,869.866666666667,1831,1955,86.4903164855928,-124
202328,Greg Monroe,79,5273,5301,10574,1143.91666666667,1163.41666666667,2307.33333333333,4858,4983,92.1297174284089,-125
202388,Donald Sloan,61,2967,3007,5974,662.783333333333,652.583333333333,1315.36666666667,2753,2878,92.7873272665993,-125
201577,Robin Lopez,82,4963,4975,9938,1129.28333333333,1070.13333333333,2199.41666666667,4480,4606,90.2679830747532,-126
1626144,Emmanuel Mudiay,68,4913,4790,9703,1032.81666666667,1027.65,2060.46666666667,4421,4547,89.9857520863016,-126
203940,Adreian Payne,52,1103,1137,2240,241.416666666667,241.583333333333,483,986,1117,89.3925657298277,-131
201962,Toney Douglas,61,2971,2914,5885,623.35,637.166666666667,1260.51666666667,2744,2876,92.3594749242679,-132
201171,Carl Landry,36,1329,1348,2677,288.316666666667,280.016666666667,568.333333333333,1210,1343,91.04589917231,-133
2755,Kevin Martin,55,2530,2524,5054,557.833333333333,534.95,1092.78333333333,2262,2396,89.4071146245059,-134
200797,Ryan Hollins,37,1068,1016,2084,234.5,223,457.5,867,1004,81.1797752808989,-137
2749,Jameer Nelson,39,2399,2344,4743,517.816666666667,516.233333333333,1034.05,2109,2247,87.9116298457691,-138
203089,John Henson,57,2176,2235,4411,467.3,489.066666666667,956.366666666667,1855,1993,85.2481617647059,-138
101127,Jarrett Jack,32,2411,2373,4784,520.766666666667,504.283333333333,1025.05,2120,2261,87.9303193695562,-141
203930,Sean Kilpatrick,31,1470,1454,2924,304.083333333333,309.083333333333,613.166666666667,1342,1483,91.2925170068027,-141
1626145,Tyus Jones,37,1331,1344,2675,281.133333333333,291.166666666667,572.3,1172,1313,88.0540946656649,-141
202087,Alonzo Gee,73,3817,3808,7625,794.166666666667,835.25,1629.41666666667,3395,3545,88.9441970133613,-150
1626173,Rashad Vaughn,70,2312,2307,4619,496.6,503.583333333333,1000.18333333333,2005,2158,86.7214532871972,-153
1626170,Jerian Grant,76,2880,2923,5803,640.916666666667,627.65,1268.56666666667,2495,2651,86.6319444444445,-156
201167,Arron Afflalo,71,5258,5331,10589,1209.46666666667,1146.71666666667,2356.18333333333,4811,4968,91.4986686953214,-157
203926,Doug McDermott,81,4342,4354,8696,922.25,938.766666666667,1861.01666666667,3869,4026,89.1064025794565,-157
203115,Will Barton,82,5535,5457,10992,1174.73333333333,1177.21666666667,2351.95,4969,5127,89.7741644083108,-158
201951,Ty Lawson,66,3380,3400,6780,688.683333333333,723.75,1412.43333333333,2983,3142,88.2544378698225,-159
203960,JaKarr Sampson,73,2693,2717,5410,572.033333333333,575.433333333333,1147.46666666667,2344,2503,87.0404753063498,-159
200765,Rajon Rondo,72,6167,6221,12388,1225.9,1306.01666666667,2531.91666666667,5645,5807,91.5355926706665,-162
203095,Evan Fournier,79,5885,5893,11778,1269.56666666667,1292.33333333333,2561.9,5381,5544,91.4358538657604,-163
203798,PJ Hairston,66,2959,2978,5937,658.9,645.333333333333,1304.23333333333,2677,2845,90.4697532950321,-168
1626171,Bobby Portis,62,2556,2545,5101,551.133333333333,551.533333333333,1102.66666666667,2263,2431,88.5367762128326,-168
202390,Gary Neal,40,1852,1913,3765,386.15,424.466666666667,810.616666666667,1699,1872,91.7386609071274,-173
201565,Derrick Rose,66,4883,4964,9847,1034.93333333333,1051.76666666667,2086.7,4371,4547,89.5146426377227,-176
203507,Giannis Antetokounmpo,80,6445,6481,12926,1386.33333333333,1428.26666666667,2814.6,5873,6049,91.1249030256012,-176
2440,Matt Barnes,76,5068,4973,10041,1116.56666666667,1072.55,2189.11666666667,4503,4682,88.8516179952644,-179
201573,Jerryd Bayless,52,3379,3455,6834,748.016666666667,750.633333333333,1498.65,3052,3233,90.3225806451613,-181
201572,Brook Lopez,73,5573,5527,11100,1237.6,1205.48333333333,2443.08333333333,5043,5225,90.4898618338417,-182
203141,Mirza Teletovic,79,4072,4048,8120,837.416666666667,846.5,1683.91666666667,3707,3890,91.0363457760314,-183
200745,Andrea Bargnani,46,1451,1436,2887,326.283333333333,310.65,636.933333333333,1224,1413,84.355616815989,-189
203076,Anthony Davis,61,5029,4961,9990,1053.93333333333,1102.65,2156.58333333333,4582,4771,91.1115529926427,-189
203914,Gary Harris,76,5800,5622,11422,1217.76666666667,1211.21666666667,2428.98333333333,5205,5396,89.7413793103448,-191
203953,Jabari Parker,76,5484,5541,11025,1179.31666666667,1214,2393.31666666667,4962,5154,90.4814004376368,-192
201156,Nick Young,54,2367,2365,4732,522.766666666667,511,1033.76666666667,2061,2258,87.0722433460076,-197
201152,Thaddeus Young,73,5476,5447,10923,1214.75,1183.36666666667,2398.11666666667,4978,5195,90.9057706355004,-217
201600,Omer Asik,68,2722,2636,5358,584.1,587.783333333333,1171.88333333333,2344,2561,86.1131520940485,-217
202688,Brandon Knight,52,4479,4426,8905,927.166666666667,943.366666666667,1870.53333333333,3977,4195,88.7921411029248,-218
203530,Joffrey Lauvergne,59,2387,2416,4803,530.116666666667,507.983333333333,1038.1,2107,2326,88.2697947214076,-219
201158,Marco Belinelli,68,3990,4025,8015,826.466666666667,845.866666666667,1672.33333333333,3537,3757,88.6466165413534,-220
203462,Archie Goodwin,57,2695,2633,5328,557.316666666667,551.466666666667,1108.78333333333,2373,2593,88.0519480519481,-220
203900,Markel Brown,61,2296,2290,4586,484.466666666667,496.866666666667,981.333333333333,2064,2289,89.8954703832753,-225
203093,Terrence Jones,50,2474,2495,4969,507.65,536.466666666667,1044.11666666667,2205,2436,89.1269199676637,-231
202682,Derrick Williams,80,3242,3304,6546,729.75,700.383333333333,1430.13333333333,2832,3071,87.3534855027761,-239
201585,Kosta Koufos,78,3537,3563,7100,730.583333333333,751.383333333333,1481.96666666667,3127,3374,88.4082555838281,-247
201967,Dante Cunningham,80,4541,4466,9007,957.466666666667,1012.05,1969.51666666667,4142,4400,91.2133891213389,-258
203458,Alex Len,78,4343,4265,8608,907.7,903.466666666667,1811.16666666667,3708,3967,85.3787704351831,-259
203080,Thomas Robinson,70,2170,2142,4312,470.266666666667,445.683333333333,915.95,1831,2095,84.3778801843318,-264
203496,Robert Covington,67,4456,4499,8955,956.266666666667,938.716666666667,1894.98333333333,3885,4149,87.1858168761221,-264
203498,Shabazz Muhammad,82,3882,3925,7807,832.133333333333,848.483333333333,1680.61666666667,3487,3758,89.8248325605358,-271
204456,T.J. McConnell,81,3716,3781,7497,824.616666666667,781.533333333333,1606.15,3288,3570,88.4822389666308,-282
203897,Zach LaVine,82,5284,5382,10666,1125.95,1161.18333333333,2287.13333333333,4881,5183,92.3732021196064,-302
201961,Wayne Ellington,76,3679,3680,7359,821.316666666667,787.9,1609.21666666667,3158,3462,85.8385430823593,-304
200782,PJ Tucker,82,6054,5964,12018,1262.35,1261.88333333333,2524.23333333333,5269,5596,87.0333663693426,-327
203499,Shane Larkin,78,4049,4024,8073,881.266666666667,862.85,1744.11666666667,3547,3886,87.6018770066683,-339
202397,Ish Smith,77,5236,5350,10586,1115.93333333333,1117.91666666667,2233.85,4691,5038,89.5912910618793,-347
2199,Tyson Chandler,66,3838,3759,7597,816.85,798.216666666667,1615.06666666667,3204,3577,83.4809796769151,-373
101150,Lou Williams,67,4445,4486,8931,966.75,939.6,1906.35,3950,4333,88.8638920134983,-383
1626164,Devin Booker,76,5029,5000,10029,1051.3,1047.98333333333,2099.28333333333,4372,4765,86.9357725193876,-393
203138,Hollis Thompson,77,5058,5197,10255,1090.16666666667,1062.61666666667,2152.78333333333,4457,4858,88.1178331356267,-401
202711,Bojan Bogdanovic,79,4846,4887,9733,1072.51666666667,1041.81666666667,2114.33333333333,4297,4704,88.6710689228229,-407
203924,Jerami Grant,77,4773,4941,9714,1038.78333333333,1017.95,2056.73333333333,4131,4543,86.5493400377121,-412
203457,Nerlens Noel,67,4561,4674,9235,999.116666666667,963.65,1962.76666666667,3869,4306,84.8278886209165,-437
203917,Nik Stauskas,73,4260,4331,8591,923.116666666667,895.283333333333,1818.4,3649,4099,85.6572769953052,-450
1626143,Jahlil Okafor,53,3615,3655,7270,828.716666666667,752.866666666667,1581.58333333333,2973,3480,82.240663900415,-507
203477,Isaiah Canaan,77,4579,4641,9220,1003.98333333333,952.55,1956.53333333333,3885,4396,84.843852369513,-511
1626156,D'Angelo Russell,80,5225,5224,10449,1161.48333333333,1095.45,2256.93333333333,4499,5062,86.1052631578948,-563
977,Kobe Bryant,66,4340,4400,8740,957.816666666667,894.5,1852.31666666667,3792,4358,87.3732718894009,-566
201579,Roy Hibbert,81,4296,4358,8654,974.866666666667,890.716666666667,1865.58333333333,3617,4250,84.1945996275605,-633
203903,Jordan Clarkson,79,5915,5920,11835,1310.46666666667,1224.33333333333,2534.8,5123,5756,86.6103127641589,-633
203944,Julius Randle,81,5313,5268,10581,1179.01666666667,1095.96666666667,2274.98333333333,4573,5239,86.0718991153774,-666
