id_player,name_player,orapm,drapm,rapm,orapm_rnk,drapm_rnk,rapm_rnk,gp_calc_total,poss_calc_o,poss_calc_d,poss_calc_total,mp_calc_o,mp_calc_d,mp_calc_total,pts_calc_o,pts_calc_d,pts_o_per100_calc,pm_calc
202738,Isaiah Thomas,4.02105438821346,0.959152277764303,4.98020666597777,2,28,1,76,5935,6102,12037,1258.71666666667,1297,2555.71666666667,6024,5786,101.499578770008,238
202695,Kawhi Leonard,4.11417210160418,0.360349944473813,4.47452204607799,1,83,2,74,5536,5533,11069,1259.46666666667,1201,2460.46666666667,5509,5101,99.5122832369942,408
200755,JJ Redick,2.36294085493888,1.51719446350558,3.88013531844445,23,3,3,78,5092,5116,10208,1092.3,1096.15,2188.45,5156,4743,101.256873527101,413
101108,Chris Paul,3.79522917658153,-0.183102355734675,3.61212682084686,3,166,4,61,4426,4415,8841,959.666666666667,954.216666666667,1913.88333333333,4527,3983,102.281970176231,544
203914,Gary Harris,1.95684513479515,1.51522812300865,3.47207325780381,33,4,5,57,4262,4148,8410,887.766666666667,889.4,1777.16666666667,4293,4216,100.727358047865,77
202681,Kyrie Irving,3.29046287432005,0.103450547381786,3.39391342170183,4,121,6,72,5933,5881,11814,1273.68333333333,1251.16666666667,2524.85,5987,5667,100.910163492331,320
101150,Lou Williams,2.74787167403202,0.543798530530822,3.29167020456284,15,62,7,81,4870,4847,9717,971.383333333333,1013.3,1984.68333333333,4667,4639,95.8316221765914,28
201578,Marreese Speights,3.00815668156131,0.238688043196087,3.2468447247574,9,100,8,82,2889,2981,5870,655.033333333333,628.05,1283.08333333333,2776,2813,96.0886119764625,-37
201935,James Harden,2.28286940181384,0.823108488827497,3.10597789064134,24,38,9,81,7106,7105,14211,1411.71666666667,1534.38333333333,2946.1,7192,6792,101.210244863496,400
202689,Kemba Walker,2.86652862858842,0.220698133865278,3.0872267624537,14,105,10,79,6246,6214,12460,1378.63333333333,1352.53333333333,2731.16666666667,6101,5889,97.6785142491194,212
203486,Mason Plumlee,2.48972930646078,0.576892472780611,3.06662177924139,20,58,11,81,4984,5021,10005,1062.76666666667,1068.6,2131.36666666667,4903,4885,98.3747993579454,18
204060,Joe Ingles,2.69256050049774,0.310751297513934,3.00331179801168,16,92,12,82,4350,4346,8696,1011.61666666667,954.333333333333,1965.95,4223,4065,97.0804597701149,158
202322,John Wall,2.58367944652781,0.343850559517171,2.92753000604498,19,87,13,78,6728,6733,13461,1372.16666666667,1449.81666666667,2821.98333333333,6624,6370,98.4542211652794,254
203952,Andrew Wiggins,1.69038633493338,1.21529757161647,2.90568390654985,42,10,14,81,7080,6870,13950,1549.25,1460.83333333333,3010.08333333333,6741,6778,95.2118644067797,-37
201568,Danilo Gallinari,2.90527580906422,-0.0660059179837995,2.83926989108042,12,149,15,63,5103,4998,10101,1056.95,1070.65,2127.6,5003,4861,98.0403684107388,142
1626157,Karl-Anthony Towns,2.46925382190521,0.299593959343388,2.7688477812486,21,93,16,81,7000,6803,13803,1537.7,1448.35,2986.05,6644,6708,94.9142857142857,-64
202328,Greg Monroe,2.43871861339126,0.295363478541917,2.73408209193318,22,94,17,81,4132,4163,8295,911.2,920.783333333333,1831.98333333333,4052,3948,98.0638915779284,104
201142,Kevin Durant,3.02138369087665,-0.326682442746528,2.69470124813012,8,184,18,62,4956,5079,10035,967.55,1096.28333333333,2063.83333333333,5207,4536,105.064568200161,671
203999,Nikola Jokic,3.04662676536401,-0.37249280720933,2.67413395815468,6,190,19,73,4890,4726,9616,1006.33333333333,1023,2029.33333333333,4925,4643,100.715746421268,282
2544,LeBron James,3.19781686493475,-0.535131337563634,2.66268552737111,5,215,20,74,6476,6424,12900,1407.65,1374.21666666667,2781.86666666667,6567,6107,101.405188387894,460
203085,Austin Rivers,1.59219149637175,0.912762092445087,2.50495358881683,45,31,21,74,4720,4755,9475,1046.51666666667,1002.35,2048.86666666667,4547,4510,96.3347457627119,37
201144,Mike Conley,2.6803483237858,-0.25923724270107,2.42111108108473,17,174,22,69,5169,5055,10224,1198.18333333333,1086.93333333333,2285.11666666667,4906,4732,94.9119752369898,174
201939,Stephen Curry,2.92208576299206,-0.63327342397873,2.28881233901333,11,223,23,79,6475,6539,13014,1231.01666666667,1402.08333333333,2633.1,6801,5819,105.034749034749,982
201566,Russell Westbrook,1.72040261742885,0.563207255048708,2.28360987247756,38,60,24,81,6936,6632,13568,1319.31666666667,1475.03333333333,2794.35,6443,6200,92.8921568627451,243
201156,Nick Young,1.16061738555079,1.09402942525116,2.25464681080196,64,18,25,60,3725,3709,7434,780.3,779.95,1560.25,3467,3662,93.0738255033557,-195
203078,Bradley Beal,2.63621249905242,-0.38746415028699,2.24874834876543,18,197,26,77,6301,6325,12626,1299.58333333333,1370.71666666667,2670.3,6243,5926,99.0795111887002,317
201973,Jonas Jerebko,1.52420285170247,0.6905975049679,2.21480035667037,48,47,27,78,2807,2912,5719,619.316666666667,610.866666666667,1230.18333333333,2736,2706,97.4706091913075,30
202329,Al-Farouq Aminu,3.04536679289766,-0.86209258864995,2.18327420424771,7,244,28,61,4021,4123,8144,891.333333333333,882.266666666667,1773.6,3898,3859,96.9410594379508,39
201586,Serge Ibaka,1.99236590433986,0.155691245638518,2.14805714997838,31,115,29,79,5520,5526,11046,1204.46666666667,1205.16666666667,2409.63333333333,5124,5255,92.8260869565217,-131
203090,Maurice Harkless,1.97889976729876,0.0796821301779809,2.05858189747674,32,124,30,77,5194,5260,10454,1113.13333333333,1105.41666666667,2218.55,5105,4993,98.2864844050828,112
202326,DeMarcus Cousins,1.40006335190083,0.616890550640677,2.01695390254151,50,52,31,72,5636,5575,11211,1262.61666666667,1197.48333333333,2460.1,5330,5382,94.5706174591909,-52
201942,DeMar DeRozan,1.78471234132728,0.223497032931831,2.00820937425911,36,104,32,74,6031,6082,12113,1339.95,1284.46666666667,2624.41666666667,5880,5736,97.4962692754104,144
1938,Manu Ginobili,2.89632665110839,-0.949508051748756,1.94681859935964,13,248,33,69,3062,3053,6115,644.483333333333,645.883333333333,1290.36666666667,3019,2756,98.5956890920967,263
201954,Darren Collison,1.65107929493621,0.248590552103642,1.89966984703986,44,99,34,68,4641,4657,9298,1067.5,992.533333333333,2060.03333333333,4400,4541,94.807153630683,-141
201933,Blake Griffin,1.12363666000363,0.772957457111789,1.89659411711542,67,42,35,61,4812,4799,9611,1034.45,1036.68333333333,2071.13333333333,4891,4457,101.641729010806,434
2207,Joe Johnson,1.90409319157899,-0.03885680458961,1.86523638698938,34,146,36,78,4016,4020,8036,958.883333333333,884.416666666667,1843.3,3899,3744,97.0866533864542,155
201961,Wayne Ellington,2.24272561766248,-0.380433026784812,1.86229259087767,25,193,37,62,3449,3453,6902,775.216666666667,719.733333333333,1494.95,3266,3171,94.6941142360104,95
101161,Amir Johnson,2.96707261190904,-1.10518050477154,1.86189210713751,10,259,38,80,3646,3721,7367,785.216666666667,815.2,1600.41666666667,3647,3364,100.027427317608,283
203521,Matthew Dellavedova,0.767903307268834,1.03273295220756,1.80063625947639,87,23,39,76,4541,4586,9127,971.416666666667,1010.96666666667,1982.38333333333,4268,4342,93.9881083461793,-74
201584,Courtney Lee,1.2862298159884,0.463253124777622,1.74948294076602,54,71,40,77,5682,5706,11388,1236.06666666667,1203.63333333333,2439.7,5276,5525,92.8546286518831,-249
203501,Tim Hardaway Jr.,1.69663215622062,0.0362879190438826,1.7329200752645,40,132,41,79,5098,5084,10182,1042.75,1106.91666666667,2149.66666666667,4782,4657,93.8014907806983,125
203939,Dwight Powell,0.460478005621025,1.24728874409362,1.70776674971465,106,9,42,77,2923,2954,5877,684.2,644.75,1328.95,2741,2892,93.7735203557988,-151
1626163,Frank Kaminsky,1.23290760306789,0.397005604895175,1.62991320796307,57,80,43,75,4439,4460,8899,994.85,958.8,1953.65,4348,4279,97.9499887362019,69
201967,Dante Cunningham,1.23131027557191,0.38035498848836,1.61166526406027,58,81,44,66,3823,3888,7711,798.6,851.566666666667,1650.16666666667,3626,3675,94.846978812451,-49
101145,Monta Ellis,2.06505765429441,-0.508450790497317,1.5566068637971,29,212,45,74,4513,4653,9166,997.633333333333,991.466666666667,1989.1,4339,4363,96.1444715267007,-24
1626181,Norman Powell,1.37262879433819,0.149583048798376,1.52221184313657,52,116,46,76,3123,3160,6283,688.65,675.816666666667,1364.46666666667,3025,2953,96.8619916746718,72
201583,Ryan Anderson,1.6965623455826,-0.177041531995433,1.51952081358717,41,165,47,72,5047,5010,10057,1013.73333333333,1095.13333333333,2108.86666666667,5067,4733,100.39627501486,334
201229,Anthony Tolliver,0.964565136299142,0.528901983193749,1.49346711949289,73,64,48,65,3376,3382,6758,763.233333333333,715.766666666667,1479,3208,3320,95.0236966824645,-112
203086,Meyers Leonard,0.493188512200113,0.965138131746009,1.45832664394612,103,27,49,74,2792,2851,5643,627.783333333333,589.566666666667,1217.35,2657,2722,95.1647564469914,-65
101139,CJ Miles,1.26652400909717,0.173755480471877,1.44027948956904,56,110,50,76,4044,4055,8099,889.916666666667,877.916666666667,1767.83333333333,3866,3826,95.5984174085064,40
101107,Marvin Williams,0.00529881058742018,1.43289128213447,1.43819009272189,148,5,51,76,5185,5153,10338,1154.03333333333,1122.5,2276.53333333333,4910,4946,94.6962391513983,-36
204038,Langston Galloway,1.40287812596563,-0.0138377760940427,1.38904034987159,49,143,52,74,3452,3502,6954,724.533333333333,771.116666666667,1495.65,3202,3272,92.7578215527231,-70
201952,Jeff Teague,0.343196717524019,1.0403184263807,1.38351514390472,120,22,53,82,6069,6246,12315,1323.11666666667,1337.41666666667,2660.53333333333,5905,5853,97.2977426264624,52
1717,Dirk Nowitzki,1.28153919508907,0.0552030100530262,1.3367422051421,55,126,54,54,3115,3174,6289,743.766666666667,678.2,1421.96666666667,2971,3047,95.3772070626003,-76
201158,Marco Belinelli,0.961485353402669,0.334580341601812,1.29606569500448,74,89,55,74,4021,4034,8055,905.15,870.3,1775.45,3893,3913,96.8167122606317,-20
203926,Doug McDermott,0.321705730204822,0.974239972183669,1.29594570238849,123,26,56,66,3568,3430,6998,747.733333333333,755.666666666667,1503.4,3253,3299,91.1715246636771,-46
202083,Wesley Matthews,0.35555676844955,0.935584431207342,1.29114119965689,118,30,57,73,5367,5497,10864,1307.53333333333,1185.8,2493.33333333333,5042,5219,93.9444754984163,-177
1627812,Yogi Ferrell,0.449057388561117,0.824303881580458,1.27336127014157,110,37,58,46,2637,2684,5321,618.116666666667,576.35,1194.46666666667,2495,2597,94.6150929086083,-102
201588,George Hill,1.33513173423219,-0.0876629383715474,1.24746879586064,53,151,59,49,3381,3298,6679,803.266666666667,732.283333333333,1535.55,3269,3013,96.6873706004141,256
1627737,Marquese Chriss,-0.436562204606878,1.64962281302515,1.21306060841828,196,2,60,81,4265,4189,8454,829.983333333333,883.133333333333,1713.11666666667,3828,4181,89.7538100820633,-353
1627747,Caris LeVert,0.412861343038295,0.797961439638969,1.21082278267726,114,40,61,57,2989,3046,6035,592.083333333333,639.383333333333,1231.46666666667,2815,2915,94.1786550685848,-100
101135,David Lee,2.18754466641647,-0.978323513082224,1.20922115333425,28,249,62,79,3381,3415,6796,739.716666666667,736.716666666667,1476.43333333333,3299,3021,97.5746820467317,278
101114,Deron Williams,-0.0133184657827532,1.21181527866731,1.19849681288455,152,11,63,64,3580,3645,7225,856.666666666667,796.683333333333,1653.35,3394,3475,94.804469273743,-81
202697,Iman Shumpert,0.983030849767881,0.212945891843653,1.19597674161153,72,107,64,76,4371,4463,8834,973.25,952.466666666667,1925.71666666667,4318,4258,98.7874628231526,60
2210,Richard Jefferson,2.01650506502231,-0.837975026152297,1.17853003887001,30,241,65,79,3678,3702,7380,809.716666666667,792.016666666667,1601.73333333333,3630,3480,98.694942903752,150
202330,Gordon Hayward,1.38688966875824,-0.219332910554167,1.16755675820407,51,173,66,73,5510,5499,11009,1299.21666666667,1210.96666666667,2510.18333333333,5340,5017,96.9147005444646,323
203468,CJ McCollum,1.17966262208843,-0.0126242947305327,1.1670383273579,60,142,67,80,6479,6563,13042,1404.33333333333,1380.63333333333,2784.96666666667,6258,6243,96.5889797808304,15
2037,Jamal Crawford,0.0655560514899918,1.09304824584771,1.1586042973377,141,19,68,82,4976,4990,9966,1106.71666666667,1043.1,2149.81666666667,4755,4759,95.5586816720257,-4
203484,Kentavious Caldwell-Pope,0.306712944206191,0.83844109625843,1.14515404046462,125,35,69,76,5865,5676,11541,1251.63333333333,1275.15,2526.78333333333,5357,5513,91.3384484228474,-156
200768,Kyle Lowry,2.21133451582197,-1.06827055272355,1.14306396309842,27,256,70,60,5100,5079,10179,1116.3,1108.65,2224.95,5057,4684,99.156862745098,373
203933,T.J. Warren,0.230235818421969,0.908745926830537,1.13898174525251,134,33,71,66,5072,5008,10080,993.133333333333,1050.53333333333,2043.66666666667,4639,4931,91.4629337539432,-292
201587,Nicolas Batum,0.666550396261506,0.460934064432376,1.12748446069388,92,72,72,77,5985,5995,11980,1311.83333333333,1297.98333333333,2609.81666666667,5786,5714,96.6750208855472,72
201188,Marc Gasol,0.901183477932263,0.204636395827748,1.10581987376001,79,108,73,74,5664,5567,11231,1324.93333333333,1200.11666666667,2525.05,5290,5223,93.3968926553672,67
201565,Derrick Rose,1.12604829828071,-0.0286942927936292,1.09735400548708,66,144,74,64,4912,4925,9837,1048.55,1026.5,2075.05,4606,4757,93.7703583061889,-151
1626164,Devin Booker,0.663330151920077,0.41261218793425,1.07594233985433,94,78,75,77,6692,6598,13290,1311.71666666667,1380.18333333333,2691.9,6156,6379,91.9904363419008,-223
203503,Tony Snell,0.75803132961696,0.317767551025551,1.07579888064251,88,91,76,80,5242,5380,10622,1150,1180.15,2330.15,5014,5122,95.6505150705838,-108
202397,Ish Smith,0.994036298799892,0.0802600937835173,1.07429639258341,71,123,77,81,4532,4414,8946,974,983.45,1957.45,4180,4159,92.2330097087379,21
203109,Jae Crowder,2.23194602836058,-1.17570182902612,1.05624419933446,26,263,78,72,5369,5524,10893,1137.96666666667,1182.76666666667,2320.73333333333,5412,5058,100.800894021233,354
203087,Jeremy Lamb,0.795596423067534,0.250798190055585,1.04639461312312,85,98,79,62,2574,2572,5146,591.783333333333,546.933333333333,1138.71666666667,2455,2483,95.3768453768454,-28
203084,Harrison Barnes,0.898874760356323,0.132722849491254,1.03159760984758,80,117,80,79,6015,6144,12159,1468.56666666667,1330.21666666667,2798.78333333333,5670,5795,94.2643391521197,-125
201960,DeMarre Carroll,1.70380097432572,-0.686213345457374,1.01758762886834,39,228,81,72,4278,4295,8573,952.533333333333,922.516666666667,1875.05,4128,4011,96.4936886395512,117
1626156,D'Angelo Russell,-0.738930020989991,1.75007884456404,1.01114882357405,209,1,82,63,4314,4334,8648,894.233333333333,906.8,1801.03333333333,3964,4320,91.8868799258229,-356
203546,Ian Clark,1.19263946811774,-0.200599561320513,0.992039906797224,59,168,83,77,2686,2786,5472,558.833333333333,579.7,1138.53333333333,2543,2484,94.6760982874162,59
1627742,Brandon Ingram,0.254497965664676,0.725445336026928,0.979943301691604,128,43,84,79,5453,5415,10868,1139.51666666667,1137.11666666667,2276.63333333333,5000,5339,91.6926462497708,-339
203459,Allen Crabbe,-0.0599278564124804,1.00694039694887,0.947012540536394,157,24,85,79,5243,5307,10550,1136.46666666667,1120,2256.46666666667,4963,5135,94.6595460614152,-172
202711,Bojan Bogdanovic,-0.0358688782298516,0.975590263666173,0.939721385436322,154,25,86,81,4934,5020,9954,1006.8,1061.2,2068,4583,4862,92.8860964734495,-279
101162,Marcin Gortat,-0.243153873369172,1.17965366113295,0.936499787763781,176,13,87,82,5995,5979,11974,1241.06666666667,1308.61666666667,2549.68333333333,5851,5677,97.5979983319433,174
203471,Dennis Schroder,0.434675654523457,0.497313869209682,0.93198952373314,112,68,88,79,5879,5903,11782,1214.75,1259.93333333333,2474.68333333333,5341,5453,90.8487838067699,-112
201943,Brandon Jennings,0.571900273655172,0.352261720133765,0.924161993788937,98,84,89,81,4290,4302,8592,893,910.7,1803.7,3981,4039,92.7972027972028,-58
1627750,Jamal Murray,1.13223894240878,-0.214455376407987,0.917783566000794,65,171,90,82,4237,4178,8415,865.75,894.183333333333,1759.93333333333,4066,4014,95.9641255605381,52
203082,Terrence Ross,0.874974897328407,0.0426736729965238,0.917648570324931,81,129,91,78,4599,4589,9188,954.75,996.116666666667,1950.86666666667,4512,4371,98.1082844096543,141
1626149,Montrezl Harrell,0.939932331625348,-0.0526242507829211,0.887308080842426,75,148,92,58,2552,2606,5158,508.516666666667,547.066666666667,1055.58333333333,2557,2453,100.19592476489,104
1713,Vince Carter,1.16325933718456,-0.295174032160097,0.868085305024465,63,179,93,73,4058,3959,8017,941.716666666667,858.683333333334,1800.4,3831,3677,94.4061113849187,154
202683,Enes Kanter,0.202154830950369,0.660054280034747,0.862209110985116,136,49,94,72,3682,3568,7250,747.466666666667,783.25,1530.71666666667,3413,3406,92.6941879413362,7
202339,Eric Bledsoe,0.012442780248743,0.83239826841183,0.844841048660573,147,36,95,65,5272,5177,10449,1047.45,1093.65,2141.1,4884,5066,92.6403641881639,-182
202331,Paul George,1.11358114743406,-0.269552696677051,0.844028450757006,68,175,96,75,6106,6241,12347,1336.15,1357.46666666667,2693.61666666667,5980,5827,97.9364559449722,153
203930,Sean Kilpatrick,0.241837073607725,0.59801993140485,0.839857005012575,130,57,97,70,4211,4296,8507,850.866666666667,902.216666666667,1753.08333333333,3872,4110,91.9496556637378,-238
1626155,Sam Dekker,0.911782343209517,-0.0759941590529807,0.835788184156536,76,150,98,77,3406,3441,6847,670.983333333333,746.366666666667,1417.35,3321,3202,97.5044039929536,119
203953,Jabari Parker,-0.291373999539496,1.12153726120178,0.830163261662284,183,17,99,51,3972,4042,8014,840.183333333333,885,1725.18333333333,3775,3874,95.0402819738167,-99
202710,Jimmy Butler,1.57947107185725,-0.770222239766354,0.809248832090896,46,233,100,76,6597,6438,13035,1430.08333333333,1374.71666666667,2804.8,6107,5902,92.5723813854782,205
202335,Patrick Patterson,1.67159659683901,-0.871766248206014,0.799830348632994,43,246,101,65,3671,3668,7339,798.933333333334,799.483333333333,1598.41666666667,3670,3343,99.9727594660855,327
203901,Elfrid Payton,0.453296226410669,0.340465875548696,0.793762101959365,109,88,102,82,5693,5642,11335,1170.61666666667,1235.23333333333,2405.85,5258,5413,92.3590374143685,-155
203524,Solomon Hill,0.560611416359744,0.228256801599015,0.788868217958758,99,102,103,80,5518,5626,11144,1144.6,1222.56666666667,2367.16666666667,5167,5135,93.6389996375498,32
101112,Channing Frye,1.16742218424043,-0.384613987690292,0.782808196550139,62,196,104,74,3156,3229,6385,699.5,696.083333333333,1395.58333333333,3146,3084,99.6831432192649,62
201988,Patty Mills,1.90094143580054,-1.12619404749399,0.774747388306551,35,261,105,80,4101,4093,8194,878.3,884.2,1762.5,4047,3653,98.6832479882955,394
201143,Al Horford,0.90608229131475,-0.1385612105099,0.767521080804849,78,160,106,68,5002,5140,10142,1076.75,1105.2,2181.95,4962,4798,99.2003198720512,164
2594,Kyle Korver,0.057448037752604,0.708149061208314,0.765597098960918,144,45,107,67,4076,4144,8220,866.933333333333,887.766666666667,1754.7,3825,4005,93.8420019627085,-180
202702,Kenneth Faried,0.23278773029332,0.518440786759,0.751228517052319,133,66,108,61,3176,3045,6221,649.4,648.466666666667,1297.86666666667,2996,3058,94.3324937027708,-62
2772,Trevor Ariza,0.130798909645117,0.60848724685782,0.739286156502938,138,56,109,80,6671,6673,13344,1327.48333333333,1441.66666666667,2769.15,6691,6362,100.299805126668,329
201976,Patrick Beverley,0.839807340462411,-0.102539608537963,0.737267731924448,83,154,110,67,4922,4915,9837,971.65,1066.63333333333,2038.28333333333,4901,4573,99.573344169037,328
203081,Damian Lillard,0.467009804820482,0.257846035008919,0.724855839829401,105,97,111,75,6362,6308,12670,1362.56666666667,1325.61666666667,2688.18333333333,6164,6060,96.8877711411506,104
1627785,Isaiah Whitehead,1.17476570767746,-0.475717907080759,0.699047800596704,61,209,112,73,3914,4007,7921,785.983333333333,848.566666666667,1634.55,3627,3723,92.6673479816045,-96
1627763,Malcolm Brogdon,0.908478709211183,-0.212190624099167,0.696288085112017,77,170,113,75,4456,4522,8978,973.8,1000.93333333333,1974.73333333333,4323,4242,97.0152603231598,81
2546,Carmelo Anthony,0.233058284082692,0.442975385400631,0.676033669483324,132,74,114,74,5962,5963,11925,1289.21666666667,1243.06666666667,2532.28333333333,5529,5772,92.7373364642737,-243
201951,Ty Lawson,0.666672678210392,-0.0290509592771316,0.637621718933261,91,145,115,69,3987,4056,8043,875.25,854.7,1729.95,3710,3849,93.0524203661901,-139
1627741,Buddy Hield,-0.465431650792975,1.06816811278447,0.602736461991499,198,20,116,82,4306,4391,8697,922.666666666667,955.316666666667,1877.98333333333,3963,4176,92.0343706456108,-213
201609,Goran Dragic,0.691196232768593,-0.0898154389186747,0.601380793849918,90,152,117,73,5725,5685,11410,1269.25,1183.76666666667,2453.01666666667,5378,5302,93.938864628821,76
2738,Andre Iguodala,1.75708717640084,-1.16489797237209,0.592189204028748,37,262,118,76,4744,4923,9667,950.116666666667,1050.61666666667,2000.73333333333,4834,4325,101.897133220911,509
201167,Arron Afflalo,-0.23425722565206,0.816953341692126,0.582696116040066,174,39,119,61,3522,3581,7103,830.216666666667,746.816666666667,1577.03333333333,3298,3538,93.6399772856332,-240
1627827,Dorian Finney-Smith,0.53930245927993,0.0321591564906136,0.571461615770544,100,133,120,80,3540,3607,7147,847.433333333333,785.933333333333,1633.36666666667,3318,3387,93.728813559322,-69
1626147,Justin Anderson,0.182341365274627,0.376294854393764,0.558636219668391,137,82,121,75,2806,2839,5645,627.1,595.45,1222.55,2525,2720,89.9857448325018,-195
202340,Avery Bradley,-0.22034166278869,0.776875576490127,0.556533913701437,172,41,122,55,4223,4340,8563,899.8,927.766666666667,1827.56666666667,4126,4059,97.7030547004499,67
201145,Jeff Green,-0.0600980943106083,0.608727812180976,0.548629717870368,158,54,123,69,3573,3599,7172,765.816666666667,775.6,1541.41666666667,3084,3421,86.3140218303946,-337
202699,Tobias Harris,0.665528174600993,-0.121787956019918,0.543740218581075,93,159,124,82,5865,5691,11556,1270.08333333333,1281.81666666667,2551.9,5428,5444,92.5490196078431,-16
203552,Seth Curry,0.410566654011908,0.126501328204758,0.537067982216666,115,118,125,70,4347,4413,8760,1066.5,959.6,2026.1,4144,4166,95.3301127214171,-22
203944,Julius Randle,-0.442545201614514,0.9559076388227,0.513362437208185,197,29,126,74,5125,5103,10228,1073.93333333333,1060.8,2134.73333333333,4654,5077,90.809756097561,-423
1626158,Richaun Holmes,-0.396632195445665,0.909386167835471,0.512753972389806,193,32,127,57,2768,2860,5628,586.45,598.116666666667,1184.56666666667,2548,2767,92.0520231213873,-219
203991,Clint Capela,0.708522179966949,-0.215423230894323,0.493098949072626,89,172,128,65,3658,3668,7326,731.3,811.983333333333,1543.28333333333,3663,3464,100.136686714051,199
203585,Rodney McGruder,1.03102141524973,-0.542776997748168,0.48824441750156,70,217,129,78,4489,4475,8964,1003.23333333333,952.983333333333,1956.21666666667,4173,4168,92.9605702829138,5
202066,Garrett Temple,-0.0186307002516136,0.505637138662085,0.487006438410472,153,67,130,65,3931,3985,7916,873.883333333333,852.5,1726.38333333333,3674,3842,93.4622233528364,-168
1627755,Tyler Ulis,-0.00195125042922963,0.465453376479407,0.463502126050178,150,70,131,60,2751,2718,5469,535.916666666667,567.333333333333,1103.25,2455,2595,89.240276263177,-140
201599,DeAndre Jordan,0.611131319363681,-0.172844673388374,0.438286645975307,96,163,132,81,5937,5943,11880,1284.83333333333,1276.31666666667,2561.15,5935,5463,99.9663129526697,472
201937,Ricky Rubio,-0.24973535567934,0.651736698393242,0.402001342713902,177,50,133,74,5690,5543,11233,1256.48333333333,1181.33333333333,2437.81666666667,5387,5408,94.6748681898067,-21
203915,Spencer Dinwiddie,0.5179282613236,-0.118837915590205,0.399090345733395,101,157,134,59,3122,3176,6298,650.65,679.383333333333,1330.03333333333,2871,2991,91.9602818705958,-120
201147,Corey Brewer,0.459043164560302,-0.169942390231871,0.289100774328431,107,162,135,82,3064,3050,6114,606.316666666667,668.283333333333,1274.6,2915,2809,95.1370757180157,106
200794,Paul Millsap,0.845204103802072,-0.563650643801538,0.281553460000533,82,220,136,69,5498,5529,11027,1148.33333333333,1188.88333333333,2337.21666666667,5108,5020,92.9065114587123,88
2199,Tyson Chandler,-0.287575532103814,0.56169531876637,0.274119786662556,182,61,137,46,3123,3086,6209,627.683333333333,652.416666666667,1280.1,2904,2984,92.9875120076849,-80
1626169,Stanley Johnson,0.233917682531882,0.0100590594524589,0.243976741984341,131,138,138,77,3180,3056,6236,685.466666666667,682.8,1368.26666666667,2898,2884,91.1320754716981,14
203500,Steven Adams,0.0589639749981394,0.168840801377242,0.227804776375382,143,111,139,80,5849,5579,11428,1132.91666666667,1248.18333333333,2381.1,5358,5184,91.6054026329287,174
200751,Randy Foye,-0.349609421459189,0.542720945516542,0.193111524057353,186,63,140,69,3037,3128,6165,625.883333333333,650.566666666667,1276.45,2789,3026,91.8340467566678,-237
202324,Derrick Favors,0.590176202701173,-0.43075169038169,0.159424512319483,97,203,141,50,2570,2548,5118,613.45,567.516666666667,1180.96666666667,2400,2344,93.3852140077821,56
201572,Brook Lopez,-0.0105688886061431,0.164463271388728,0.153894382782585,151,112,142,75,5333,5431,10764,1084.1,1131.4,2215.5,4955,5175,92.9120570035627,-220
2749,Jameer Nelson,0.0643165952366133,0.089134982042346,0.153451577278959,142,122,143,75,4943,4708,9651,1020.06666666667,1015.93333333333,2036,4768,4627,96.4596398948007,141
202709,Cory Joseph,-0.116244582192507,0.226355958044928,0.110111375852421,163,103,144,80,4595,4621,9216,1011.63333333333,990.283333333333,2001.91666666667,4418,4357,96.1479869423286,61
202703,Nikola Mirotic,0.422146768128687,-0.321974521753758,0.100172246374929,113,182,145,70,3944,3872,7816,836.483333333333,839.783333333333,1676.26666666667,3699,3512,93.7880324543611,187
203918,Rodney Hood,0.054054152247192,0.0144521692348973,0.0685063214820893,145,137,146,59,3447,3467,6914,829.366666666667,756.816666666667,1586.18333333333,3293,3167,95.5323469683783,126
204025,Tim Frazier,-0.151106102482732,0.218014673615162,0.0669085711324305,169,106,147,65,3555,3586,7141,744.516666666667,777.1,1521.61666666667,3289,3400,92.5175808720113,-111
2200,Pau Gasol,0.805820132960966,-0.74789268270683,0.0579274502541357,84,232,148,64,3603,3626,7229,827.716666666667,787.4,1615.11666666667,3559,3341,98.7787954482376,218
203145,Kent Bazemore,0.326268318616269,-0.271406219286118,0.054862099330151,122,176,149,73,4638,4675,9313,949.7,1002.75,1952.45,4194,4296,90.4269081500647,-102
203903,Jordan Clarkson,-1.28801853542234,1.3390629836246,0.0510444482022616,237,8,150,82,5740,5715,11455,1184.9,1195.75,2380.65,5194,5629,90.4878048780488,-435
201160,Jason Smith,-0.140581669462386,0.187126581382925,0.0465449119205387,165,109,151,74,2494,2526,5020,532.85,540.783333333333,1073.63333333333,2344,2369,93.9855653568565,-25
2736,Luol Deng,-0.527430230087392,0.568192009873266,0.0407617797858749,201,59,152,56,3515,3524,7039,741.916666666667,740.15,1482.06666666667,3171,3369,90.2133712660028,-198
202691,Klay Thompson,1.08416191847547,-1.05310429466458,0.0310576238108891,69,255,153,78,6252,6461,12713,1239.06666666667,1398,2637.06666666667,6465,5690,103.406909788868,775
203490,Otto Porter Jr.,-1.38266755364904,1.40612817714279,0.023460623493748,239,6,154,80,6136,6119,12255,1259.2,1326.21666666667,2585.41666666667,5969,5812,97.2783572359844,157
203932,Aaron Gordon,0.347086324139936,-0.354184796975566,-0.0070984728356292,119,188,155,80,5383,5352,10735,1125.61666666667,1162.38333333333,2288,5013,5148,93.1265093813859,-135
202355,Hassan Whiteside,0.456113522096485,-0.472488306150887,-0.0163747840544017,108,208,156,77,5791,5724,11515,1289.8,1214.23333333333,2504.03333333333,5429,5330,93.7489207390779,99
1626161,Willie Cauley-Stein,-0.138398787701094,0.115396871273967,-0.0230019164271267,164,120,157,75,3182,3273,6455,713.833333333333,700.5,1414.33333333333,2937,3111,92.3004399748586,-174
2585,Zaza Pachulia,0.488262107399377,-0.513604346449504,-0.0253422390501269,104,213,158,70,3039,3038,6077,581.85,676.25,1258.1,3128,2687,102.928594932544,441
201163,Wilson Chandler,-0.690683920765951,0.663091034754972,-0.0275928860109789,208,48,159,71,5299,5132,10431,1099.7,1094.23333333333,2193.93333333333,5097,5108,96.1879599924514,-11
200746,LaMarcus Aldridge,0.33998663014862,-0.383856335826902,-0.0438697056782815,121,195,160,72,5186,5169,10355,1207.5,1128.11666666667,2335.61666666667,5001,4737,96.4327034323178,264
203079,Dion Waiters,0.78493122483119,-0.832111777968883,-0.0471805531376923,86,238,161,46,3174,3201,6375,706.983333333333,674.533333333333,1381.51666666667,3015,2903,94.9905482041588,112
203210,JaMychal Green,0.511881109353996,-0.559979567986363,-0.0480984586323674,102,219,162,77,4673,4621,9294,1084.85,1006.1,2090.95,4326,4255,92.574363364006,71
2747,JR Smith,0.126587061570177,-0.196331432212771,-0.0697443706425938,139,167,163,41,2757,2806,5563,605.666666666667,585.5,1191.16666666667,2735,2671,99.2020311933261,64
2564,Boris Diaw,-0.508175330964745,0.408557678599215,-0.0996176523655299,199,79,164,73,2774,2798,5572,663.45,614.1,1277.55,2608,2608,94.0158615717376,0
203512,Lucas Nogueira,1.54776451272323,-1.66007543933286,-0.112310926609626,47,269,165,55,2494,2563,5057,540.716666666667,546.683333333333,1087.4,2489,2316,99.7995188452285,173
202685,Jonas Valanciunas,-0.191577110286584,0.0708788312092842,-0.120698279077299,171,125,166,80,4705,4665,9370,1058.2,1000.78333333333,2058.98333333333,4526,4427,96.1955366631243,99
204456,T.J. McConnell,-0.14914032260738,0.0267539535755439,-0.122386369031836,168,134,167,81,5033,5186,10219,1066.1,1064.86666666667,2130.96666666667,4558,4857,90.5622888933042,-299
101109,Raymond Felton,-0.191108776548383,0.0397493569155489,-0.151359419632834,170,130,168,80,3874,3981,7855,866.466666666667,829.95,1696.41666666667,3641,3794,93.9855446566856,-153
203967,Dario Saric,-0.373744792896733,0.157501648559946,-0.216243144336787,189,113,169,81,5038,5104,10142,1078.46666666667,1049.11666666667,2127.58333333333,4498,4818,89.2814608971814,-320
203897,Zach LaVine,-1.26135465404002,1.04125721736219,-0.22009743667783,236,21,170,46,3950,3844,7794,862.833333333333,840.483333333333,1703.31666666667,3643,3786,92.2278481012658,-143
200771,Sergio Rodriguez,-0.0428184161822784,-0.206866190723407,-0.249684606905685,155,169,171,68,3552,3544,7096,762.6,747.783333333333,1510.38333333333,3183,3341,89.6114864864865,-158
201949,James Johnson,0.650622297568134,-0.90768394752624,-0.257061649958107,95,247,172,76,4853,4826,9679,1072.91666666667,1011.38333333333,2084.3,4521,4376,93.158870801566,145
203093,Terrence Jones,-0.386670093390289,0.11728520860159,-0.2693848847887,192,119,173,54,2918,2991,5909,620.083333333333,648.533333333333,1268.61666666667,2715,2796,93.0431802604524,-81
1626167,Myles Turner,0.29173156164247,-0.568623612568409,-0.276892050925939,126,221,174,81,5740,5909,11649,1246.61666666667,1288.8,2535.41666666667,5616,5451,97.8397212543554,165
203507,Giannis Antetokounmpo,-0.296658827799684,0.0185620565847241,-0.27809677121496,184,135,175,80,6400,6485,12885,1389.08333333333,1445.6,2834.68333333333,6095,6044,95.234375,51
101141,Ersan Ilyasova,0.445662414332739,-0.738070546994333,-0.292408132661594,111,231,176,82,5105,5136,10241,1052.21666666667,1083.36666666667,2135.58333333333,4651,4658,91.1067580803134,-7
203482,Kelly Olynyk,0.0204115374918933,-0.349791756694278,-0.329380219202385,146,187,177,75,3554,3623,7177,767.783333333333,770.4,1538.18333333333,3305,3316,92.9938097917839,-11
202734,E'Twaun Moore,-0.543904117453821,0.156289092295887,-0.387615025157934,203,114,178,73,4232,4305,8537,889.233333333333,925.366666666667,1814.6,3938,4070,93.0529300567108,-132
203124,Kyle O'Quinn,-1.03505506544708,0.608505840255941,-0.42654922519114,223,55,179,79,2886,2877,5763,631.083333333333,601.116666666667,1232.2,2576,2738,89.2584892584893,-162
203516,James Ennis III,0.225098864927125,-0.651965174954496,-0.426866310027371,135,225,180,64,3411,3360,6771,792.35,707.516666666667,1499.86666666667,3120,3052,91.4687774846086,68
1891,Jason Terry,0.401356437882112,-0.835924833325496,-0.434568395443384,116,239,181,74,3051,3101,6152,675.583333333333,688.483333333333,1364.06666666667,2913,2794,95.4768928220256,119
203077,Michael Kidd-Gilchrist,-0.283469204950795,-0.176893915058728,-0.460363120009523,181,164,182,81,5329,5316,10645,1184.98333333333,1154.55,2339.53333333333,5006,4966,93.9388252955526,40
203141,Mirza Teletovic,-0.0889341555841622,-0.415448884923432,-0.504383040507594,159,200,183,70,2549,2579,5128,559.166666666667,568.583333333333,1127.75,2419,2341,94.899960768929,78
201945,Gerald Henderson,-0.979241317001455,0.470852676791097,-0.508388640210358,218,69,184,72,3949,3980,7929,847.916666666667,825.133333333333,1673.05,3491,3820,88.4021271207901,-329
203518,Alex Abrines,-1.8946343264398,1.38517572520884,-0.509458601230952,253,7,185,68,2583,2493,5076,515.266666666667,536.633333333333,1051.9,2363,2420,91.4827719705769,-57
1626178,Rondae Hollis-Jefferson,-0.799902243700315,0.262678614638839,-0.537223629061476,213,96,186,78,4227,4373,8600,852.483333333333,906.95,1759.43333333333,3904,4135,92.3586467944168,-231
202704,Reggie Jackson,-1.72248295521444,1.183492035249,-0.538990919965449,246,12,187,52,3290,3125,6415,703.483333333333,710.3,1413.78333333333,2928,3125,88.9969604863222,-197
203584,Troy Daniels,0.244080901457585,-0.78866427918742,-0.544583377729835,129,235,188,67,2743,2634,5377,620.05,561.266666666667,1181.31666666667,2499,2460,91.1046299671892,39
203935,Marcus Smart,-0.114826303343933,-0.4322193842551,-0.547045687599033,162,204,189,79,5639,5691,11330,1198.31666666667,1208.41666666667,2406.73333333333,5407,5283,95.8857953537861,124
202323,Evan Turner,-0.993767486381768,0.442777361037593,-0.550990125344175,221,75,190,65,3826,3891,7717,840.783333333333,817.733333333333,1658.51666666667,3529,3695,92.2373235755358,-166
1626144,Emmanuel Mudiay,-1.72135631547835,1.13989742066468,-0.581458894813669,245,16,191,55,3422,3336,6758,698.7,704.083333333333,1402.78333333333,3191,3335,93.249561659848,-144
201152,Thaddeus Young,-0.226342546827031,-0.378143914327827,-0.604486461154858,173,192,192,74,5077,5259,10336,1105.68333333333,1125.41666666667,2231.1,4924,4827,96.9864092968288,97
203506,Victor Oladipo,-0.987250244352949,0.347495425515719,-0.63975481883723,219,86,193,67,5384,5177,10561,1062.96666666667,1148.66666666667,2211.63333333333,4926,4721,91.4933135215453,205
202688,Brandon Knight,-1.79747582838601,1.14488149300263,-0.652594335383373,249,15,194,53,2690,2691,5381,545.35,565.966666666667,1111.31666666667,2338,2653,86.9144981412639,-315
2403,Nene,0.317855750617946,-0.993901681854287,-0.676045931236341,124,250,195,67,2976,2929,5905,572.716666666667,631.833333333333,1204.55,2902,2686,97.5134408602151,216
203095,Evan Fournier,-1.22356582750052,0.5234852673248,-0.700080560175718,233,65,196,68,5268,5193,10461,1100.8,1128.73333333333,2229.53333333333,4748,4954,90.1290812452544,-206
201567,Kevin Love,0.119466765606749,-0.820494971048826,-0.701028205442077,140,237,197,60,4494,4392,8886,956.05,931.733333333333,1887.78333333333,4456,4142,99.1544281263907,314
2440,Matt Barnes,-0.0479829285413919,-0.682164659102386,-0.730147587643778,156,227,198,74,4083,4109,8192,897.216666666667,879.133333333333,1776.35,3807,3859,93.2402645113887,-52
1627789,Timothe Luwawu-Cabarrot,0.388102163857399,-1.1191164169423,-0.731014253084903,117,260,199,69,2821,2860,5681,580.7,604.183333333333,1184.88333333333,2564,2614,90.8897554058844,-50
201577,Robin Lopez,-1.43893022385061,0.706063325156082,-0.732866898694524,240,46,200,81,5319,5168,10487,1159.86666666667,1101.86666666667,2261.73333333333,4840,4801,90.9945478473397,39
1626162,Kelly Oubre Jr.,-0.972164699114819,0.238258203258739,-0.73390649585608,217,101,201,79,3720,3803,7523,787.5,808.25,1595.75,3514,3525,94.4623655913979,-11
203488,Mike Muscala,-1.45973229835873,0.716520298085706,-0.743212000273023,242,44,202,70,2920,2876,5796,604.516666666667,635.05,1239.56666666667,2634,2704,90.2054794520548,-70
1626179,Terry Rozier,-0.42300118258387,-0.321502481696022,-0.744503664279892,194,181,203,74,2916,2944,5860,634.6,628.15,1262.75,2670,2661,91.5637860082304,9
2225,Tony Parker,-0.31395134721214,-0.43755789757195,-0.751509244784091,185,205,204,63,3498,3483,6981,828.233333333333,757.266666666667,1585.5,3350,3154,95.7690108633505,196
203463,Ben McLemore,-0.434384239590835,-0.323966164920451,-0.758350404511286,195,183,205,61,2671,2675,5346,599.3,571.983333333333,1171.28333333333,2451,2574,91.7633845001872,-123
203076,Anthony Davis,-0.00122109744113185,-0.79597581687091,-0.797196914312042,149,236,206,75,6271,6404,12675,1299.03333333333,1405.25,2704.28333333333,5841,5797,93.1430393876575,44
201959,Taj Gibson,-1.24414276422497,0.439922351025573,-0.804220413199399,235,76,207,78,4771,4560,9331,1001.25,984.9,1986.15,4291,4264,89.9392160972542,27
2733,Shaun Livingston,-0.364926483329708,-0.461407077493639,-0.826333560823347,188,206,208,76,3067,3171,6238,648.633333333333,691.816666666667,1340.45,2935,2778,95.6961199869579,157
203200,Justin Holiday,-0.382979229643369,-0.47985060772301,-0.862829837366378,191,211,209,82,3887,3863,7750,816.8,829.15,1645.95,3524,3556,90.6611782865964,-32
203498,Shabazz Muhammad,-0.2585027144517,-0.66026025401589,-0.91876296846759,179,226,210,77,3550,3460,7010,766.233333333333,739.9,1506.13333333333,3258,3300,91.7746478873239,-42
201601,Luc Mbah a Moute,-0.382328473301469,-0.543903880067453,-0.926232353368922,190,218,211,80,4083,4170,8253,883.133333333333,896.583333333333,1779.71666666667,4082,3761,99.9755082047514,321
1627759,Jaylen Brown,-1.55352686102157,0.615927990896186,-0.937598870125379,243,53,212,78,3063,3134,6197,659.633333333333,673.916666666667,1333.55,2857,2928,93.2745674175645,-71
1626204,Larry Nance Jr.,-0.988844936629822,0.0498245377622892,-0.939020398867533,220,127,213,63,3441,3411,6852,712.25,718.333333333333,1430.58333333333,3110,3277,90.3807032839291,-167
203496,Robert Covington,-0.109993212225679,-0.837117423076676,-0.947110635302355,160,240,214,67,5008,5027,10035,1056.2,1050.76666666667,2106.96666666667,4465,4594,89.1573482428115,-129
201950,Jrue Holiday,-0.583344468774969,-0.391597533269649,-0.974942002044619,204,198,215,67,5084,5168,10252,1047.66666666667,1139.35,2187.01666666667,4721,4695,92.8599527930763,26
203460,Andre Roberson,-0.886287220041706,-0.111444768454399,-0.997731988496106,216,156,216,79,5782,5574,11356,1121.8,1249.8,2371.6,5310,5144,91.8367346938775,166
200782,PJ Tucker,-0.531877502154054,-0.476400741691473,-1.00827824384553,202,210,217,80,5309,5201,10510,1100.1,1108.06666666667,2208.16666666667,4871,4909,91.7498587304577,-38
1627098,Malcolm Delaney,-0.148906176319602,-0.86430862851223,-1.01321480483183,167,245,218,73,2883,2876,5759,613.066666666667,636.3,1249.36666666667,2646,2590,91.7793964620187,56
1626195,Willy Hernangomez,-1.03600186555801,0.00927818107428907,-1.02672368448372,224,139,219,72,3121,3124,6245,659.7,658.816666666667,1318.51666666667,2861,2928,91.6693367510413,-67
203115,Will Barton,-1.45330468865311,0.424476714638879,-1.02882797401424,241,77,220,60,4091,3962,8053,842.233333333333,857.15,1699.38333333333,3835,3912,93.7423612808604,-77
203917,Nik Stauskas,-0.770454107508217,-0.292670307532573,-1.06312441504079,210,177,221,80,5152,5223,10375,1089.93333333333,1092.75,2182.68333333333,4686,4902,90.9549689440994,-216
203497,Rudy Gobert,0.286518019932034,-1.36777459612774,-1.0812565761957,127,266,222,81,5994,5959,11953,1418.16666666667,1315.93333333333,2734.1,5775,5334,96.3463463463464,441
203957,Dante Exum,-0.618635961665129,-0.467135247016863,-1.08577120868199,206,207,223,66,2699,2721,5420,629.75,595.9,1225.65,2486,2444,92.1081882178585,42
201585,Kosta Koufos,-0.249927886261182,-0.840658934989102,-1.09058682125028,178,242,224,71,3199,3201,6400,731.4,679.333333333333,1410.73333333333,2897,3034,90.559549859331,-137
204020,Tyler Johnson,-0.783567191229317,-0.327662105469938,-1.11122929669926,212,185,225,73,5076,5010,10086,1112.2,1056.2,2168.4,4653,4612,91.6666666666667,41
203083,Andre Drummond,-1.17186786588953,0.0176880810678528,-1.15417978482168,229,136,226,81,5573,5333,10906,1202.86666666667,1207,2409.86666666667,5002,5252,89.7541719002333,-250
203110,Draymond Green,-0.237596382898329,-0.997344707160188,-1.23494109005852,175,251,227,76,5923,6045,11968,1144.7,1311.91666666667,2456.61666666667,6079,5293,102.633800438967,786
202687,Bismack Biyombo,-1.1630371105164,-0.0935312670601336,-1.25656837757654,228,153,228,81,4086,4081,8167,901.066666666667,887.083333333333,1788.15,3569,3891,87.3470386686246,-322
201569,Eric Gordon,-0.625098443883063,-0.64091917677789,-1.26601762066095,207,224,229,75,5628,5696,11324,1101.05,1224.38333333333,2325.43333333333,5535,5232,98.3475479744136,303
1626143,Jahlil Okafor,-1.3044988203739,0.0375727514542916,-1.26692606891961,238,131,230,50,2615,2625,5240,593.583333333333,542.45,1136.03333333333,2227,2529,85.1625239005736,-302
201980,Danny Green,-0.279937853262745,-1.02375851257761,-1.30369636584036,180,253,231,68,3987,4015,8002,928.7,871.45,1800.15,3837,3573,96.2377727614748,264
2548,Dwyane Wade,-1.58670414496351,0.266788546549035,-1.31991559841448,244,95,232,60,4237,4115,8352,902.783333333333,880.633333333333,1783.41666666667,3748,3850,88.4588151994336,-102
203089,John Henson,-1.0236034616907,-0.356632222163667,-1.38023568385437,222,189,233,58,2557,2597,5154,550.566666666667,565.45,1116.01666666667,2375,2408,92.8822839264763,-33
201571,D.J. Augustin,-2.53467356521558,1.15250760975786,-1.38216595545773,264,14,234,78,3496,3522,7018,784.5,750.316666666667,1534.81666666667,2965,3409,84.8112128146453,-444
202693,Markieff Morris,-1.08503460838847,-0.329786971672133,-1.4148215800606,226,186,235,76,5545,5544,11089,1157.16666666667,1193.68333333333,2350.85,5373,5162,96.8981064021641,211
202694,Marcus Morris,-0.357891906300956,-1.09380299669324,-1.4516949029942,187,258,236,79,5940,5712,11652,1280.98333333333,1283.96666666667,2564.95,5348,5447,90.03367003367,-99
1626150,Andrew Harrison,-0.613509252103899,-0.852772543633675,-1.46628179573757,205,243,237,72,3322,3308,6630,776.616666666667,696.533333333333,1473.15,2983,2990,89.7953040337146,-7
203469,Cody Zeller,-0.783452650912531,-0.718309484218082,-1.50176213513061,211,229,238,62,3930,3841,7771,861.633333333333,853.5,1715.13333333333,3797,3569,96.6157760814249,228
203382,Aron Baynes,-0.143064575292069,-1.40480482413513,-1.5478693994272,166,267,239,75,2624,2615,5239,575.45,583.983333333333,1159.43333333333,2432,2322,92.6829268292683,110
202714,Shelvin Mack,-1.15531464757207,-0.398475264571854,-1.55378991214392,227,199,240,55,2646,2659,5305,623.616666666667,578.8,1202.41666666667,2459,2466,92.9327286470144,-7
202357,Nemanja Bjelica,-0.827269371964859,-0.729054448465675,-1.55632382043053,214,230,241,64,2740,2714,5454,594.05,581.933333333333,1175.98333333333,2508,2500,91.5328467153285,8
203120,Justin Hamilton,-1.91082262289994,0.351125221065908,-1.55969740183403,255,85,242,64,2812,2894,5706,567.8,605,1172.8,2489,2796,88.5135135135135,-307
202720,Jon Leuer,-1.21800311075921,-0.373237503558143,-1.59124061431735,232,191,243,75,4492,4323,8815,965.816666666667,973.983333333333,1939.8,4012,4078,89.3143365983972,-66
203476,Gorgui Dieng,-1.23653491171205,-0.38175068734981,-1.61828559906186,234,194,244,81,6071,5912,11983,1347.83333333333,1267.55,2615.38333333333,5709,5706,94.0372261571405,3
1627775,Patrick McCaw,-2.13131823647897,0.458828843744712,-1.67248939273426,259,73,245,70,2590,2619,5209,525.133333333333,548.016666666667,1073.15,2398,2418,92.5868725868726,-20
203943,Noah Vonleh,-2.05103471487982,0.321840123696815,-1.72919459118301,257,90,246,74,2923,2930,5853,638.833333333333,621.233333333333,1260.06666666667,2658,2746,90.9339719466302,-88
203613,Jonathon Simmons,-0.112088124292527,-1.64537076705915,-1.75745889135168,161,268,247,78,3194,3212,6406,711.65,688.216666666667,1399.86666666667,3013,2773,94.3331246086412,240
204001,Kristaps Porzingis,-0.518887337722591,-1.23999877696257,-1.75888611468516,200,264,248,66,5067,5098,10165,1080.01666666667,1077.73333333333,2157.75,4675,4782,92.2636668640221,-107
203924,Jerami Grant,-1.80739206607912,-0.0124302227249045,-1.81982228880403,250,141,249,80,3694,3613,7307,740.883333333333,788.966666666667,1529.85,3345,3464,90.5522468868435,-119
1627739,Kris Dunn,-1.87627938888698,0.00815859497824545,-1.86812079390874,252,140,250,77,3071,3005,6076,669.35,641.683333333333,1311.03333333333,2795,2889,91.0126994464344,-94
2754,Tony Allen,-0.843877519174937,-1.03558207239386,-1.8794595915688,215,254,251,71,4299,4214,8513,992.566666666667,912.866666666667,1905.43333333333,3948,3871,91.8353105373343,77
203994,Jusuf Nurkic,-1.7475455940537,-0.166145676799058,-1.91369127085276,248,161,252,65,3351,3281,6632,696.833333333333,686.933333333333,1383.76666666667,3030,3101,90.420769919427,-71
202344,Trevor Booker,-1.18820667611367,-0.778443034082343,-1.96664971019601,230,234,253,71,4184,4309,8493,855.983333333333,898.766666666667,1754.75,3754,4023,89.7227533460803,-269
201162,Jared Dudley,-1.05803667792463,-1.08021981470058,-2.13825649262521,225,257,254,63,3259,3271,6530,652.483333333333,684.566666666667,1337.05,2940,3015,90.2117213869285,-75
204028,Tarik Black,-1.19420605069999,-1.01508906731922,-2.20929511801921,231,252,255,67,2644,2559,5203,537.533333333333,548.483333333333,1086.01666666667,2357,2387,89.1452344931921,-30
1626168,Trey Lyles,-1.80746323990619,-0.424214342089072,-2.23167758199527,251,202,256,71,2571,2567,5138,591.133333333333,563.133333333333,1154.26666666667,2359,2349,91.754181252431,10
200757,Thabo Sefolosha,-1.73944985570366,-0.541955102039114,-2.28140495774278,247,216,257,62,3741,3756,7497,786.266666666667,810.4,1596.66666666667,3397,3447,90.8045977011494,-50
2216,Zach Randolph,-2.22668303724591,-0.304340121724507,-2.53102315897042,260,180,258,73,4094,3925,8019,949.666666666667,840.183333333333,1789.85,3661,3686,89.4235466536395,-25
203458,Alex Len,-3.22038894532498,0.638014186034732,-2.58237475929025,268,51,259,76,3773,3742,7515,743.65,784.233333333333,1527.88333333333,3260,3650,86.4033925258415,-390
203922,Glenn Robinson III,-2.49761059759769,-0.103522235617996,-2.60113283321568,263,155,260,69,3255,3351,6606,714.466666666667,706.316666666667,1420.78333333333,3046,3115,93.57910906298,-69
1626196,Josh Richardson,-2.1087761962359,-0.514255364227607,-2.62303156046351,258,214,261,53,3708,3696,7404,824.616666666667,788.183333333333,1612.8,3403,3409,91.7745415318231,-6
2730,Dwight Howard,-2.02406447677059,-0.599111076663931,-2.62317555343452,256,222,262,74,5205,5159,10364,1069.05,1123.71666666667,2192.76666666667,4602,4705,88.4149855907781,-103
1627734,Domantas Sabonis,-2.28152572210389,-0.420123115739378,-2.70164883784327,261,201,263,81,3824,3755,7579,764.616666666667,847.866666666667,1612.48333333333,3426,3414,89.592050209205,12
202684,Tristan Thompson,-2.44464542371374,-0.295148951289086,-2.73979437500283,262,178,264,78,5457,5396,10853,1183.08333333333,1151.78333333333,2334.86666666667,5307,5156,97.2512369433755,151
203925,Joe Harris,-2.72765084133586,-0.0421615352004368,-2.7698123765363,265,147,265,52,2816,2857,5673,556.683333333333,584.2,1140.88333333333,2449,2718,86.9673295454546,-269
200765,Rajon Rondo,-2.92856605943704,0.0492064897653127,-2.87935956967173,266,128,266,69,4321,4268,8589,926.666666666667,911.066666666667,1837.73333333333,3907,4005,90.4188845174728,-98
202389,Timofey Mozgov,-3.82209999840976,0.868387468370641,-2.95371253003912,269,34,267,54,2637,2564,5201,570.666666666667,541.6,1112.26666666667,2313,2490,87.7133105802048,-177
203473,Dewayne Dedmon,-1.90210809962614,-1.29869383534306,-3.20080193496919,254,265,268,76,3038,3019,6057,676.516666666667,656.983333333333,1333.5,2820,2603,92.8242264647795,217
202696,Nikola Vucevic,-3.20514606710399,-0.119760572873558,-3.32490663997755,267,158,269,75,5139,5057,10196,1054.11666666667,1102.91666666667,2157.03333333333,4650,4818,90.4845300642148,-168
