id_player,name_player,orapm,drapm,rapm,orapm_rnk,drapm_rnk,rapm_rnk,gp_calc_total,poss_calc_o,poss_calc_d,poss_calc_total,mp_calc_o,mp_calc_d,mp_calc_total,pts_calc_o,pts_calc_d,pts_o_per100_calc,pm_calc
201939,Stephen Curry,7.46308845384572,-0.35970500566344,7.10338344818228,1,158,1,50,3888,3986,7874,742.016666666667,852.55,1594.56666666667,4205,3740,108.15329218107,465
1626157,Karl-Anthony Towns,3.39109182553566,3.43682010624891,6.82791193178456,10,1,2,82,6725,6635,13360,1502.78333333333,1404.8,2907.58333333333,6701,6362,99.6431226765799,339
203482,Kelly Olynyk,4.58837526888104,1.52866277420847,6.1170380430895,4,42,3,75,3898,3891,7789,869.6,864.25,1733.85,3817,3633,97.9220112878399,184
203081,Damian Lillard,4.1842080261303,1.40580353321699,5.59001155934729,6,47,4,73,6293,6217,12510,1371.11666666667,1297.9,2669.01666666667,6063,5741,96.3451453996504,322
2544,LeBron James,3.95271534421456,1.42767504089739,5.38039038511196,7,46,5,82,7021,7094,14115,1514.26666666667,1508.35,3022.61666666667,7097,7015,101.082466885059,82
101108,Chris Paul,5.45890712648649,-0.215683339132589,5.2432237873539,2,144,6,58,4222,4219,8441,914.983333333333,923.533333333333,1838.51666666667,4427,3926,104.855518711511,501
1717,Dirk Nowitzki,2.53574341778176,2.50013343887103,5.03587685665279,21,16,7,77,4213,4270,8483,980.6,905.45,1886.05,4095,4187,97.1991455020176,-92
201935,James Harden,5.2502850390566,-0.349708133732833,4.90057690532377,3,155,8,72,5902,5913,11815,1255.81666666667,1288.3,2544.11666666667,6067,5524,102.795662487292,543
201567,Kevin Love,3.16246196025856,1.61398393797691,4.77644589823547,12,35,9,59,3809,3805,7614,832.166666666667,812.033333333333,1644.2,3823,3767,100.367550538199,56
203918,Rodney Hood,1.94086506807969,2.78399673170378,4.72486179978348,37,9,10,60,3660,3685,7345,811.9,799.666666666667,1611.56666666667,3533,3583,96.5300546448088,-50
201588,George Hill,3.48103119646427,0.916690498834173,4.39772169529844,8,66,11,67,4124,4065,8189,931.216666666667,873.966666666667,1805.18333333333,3937,4052,95.4655674102813,-115
1627750,Jamal Murray,2.09636841651713,2.27028932613745,4.36665774265457,33,19,12,80,5860,5735,11595,1251.41666666667,1259.31666666667,2510.73333333333,5825,5613,99.4027303754266,212
2747,JR Smith,1.12958665218187,3.22963862383943,4.3592252760213,73,4,13,80,5186,5237,10423,1124.71666666667,1110.05,2234.76666666667,5113,5250,98.5923640570768,-137
1627751,Jakob Poeltl,2.6046263877995,1.601267722234,4.2058941100335,20,37,14,82,3583,3534,7117,750.55,769.15,1519.7,3524,3240,98.3533351939715,284
203992,Bogdan Bogdanovic,0.89078814451854,3.30569512002051,4.19648326453905,91,2,15,78,4958,4900,9858,1101.85,1068.3,2170.15,4498,4861,90.722065348931,-363
203085,Austin Rivers,1.42153491257078,2.77346361676875,4.19499852933952,61,10,16,61,4785,4776,9561,1034.51666666667,1010.56666666667,2045.08333333333,4600,4672,96.1337513061651,-72
202689,Kemba Walker,4.38321599708174,-0.330360433916238,4.0528555631655,5,154,17,80,6515,6359,12874,1376.68333333333,1353.6,2730.28333333333,6294,6098,96.6078280890253,196
202734,E'Twaun Moore,1.67693186809353,2.15483969298851,3.83177156108204,45,22,18,81,6033,6200,12233,1219.31666666667,1328.58333333333,2547.9,5914,5735,98.0275153323388,179
1626163,Frank Kaminsky,1.01804095101148,2.70683164478255,3.72487259579403,82,11,19,79,4313,4187,8500,931.433333333333,902.133333333333,1833.56666666667,4076,4165,94.5049849292836,-89
201954,Darren Collison,2.82002780894532,0.88195580890241,3.70198361784773,18,73,20,69,4580,4682,9262,999.6,1011.28333333333,2010.88333333333,4511,4397,98.4934497816594,114
2216,Zach Randolph,0.237175100494912,3.28335347750683,3.52052857800174,128,3,21,59,3427,3360,6787,788.283333333333,712.533333333333,1500.81666666667,3077,3437,89.78698570178,-360
201952,Jeff Teague,2.13859569995864,1.19538026316635,3.33397596312498,32,52,22,70,5414,5353,10767,1194.96666666667,1114.15,2309.11666666667,5327,5187,98.3930550424825,140
203584,Troy Daniels,0.341442228162551,2.95352480802093,3.29496703618349,120,8,23,79,3859,3894,7753,801.916666666667,815.5,1617.41666666667,3475,3892,90.0492355532521,-417
202329,Al-Farouq Aminu,2.82283041173854,0.466392458591052,3.2892228703296,17,98,24,69,4847,4820,9667,1054.33333333333,1008.88333333333,2063.21666666667,4653,4435,95.9975242417991,218
201988,Patty Mills,1.45343237366545,1.82982702193888,3.28325939560433,59,30,25,82,4845,4805,9650,1088.43333333333,1020.96666666667,2109.4,4593,4494,94.7987616099071,99
2594,Kyle Korver,3.08697552662755,0.143052879942891,3.23002840657044,15,118,26,73,3666,3714,7380,764.766666666667,806.183333333333,1570.95,3695,3471,100.791052918713,224
202326,DeMarcus Cousins,1.55261734732867,1.59602764823171,3.14864499556038,53,38,27,47,3959,3973,7932,835.016666666667,858.233333333333,1693.25,3835,3716,96.8678959333165,119
203915,Spencer Dinwiddie,1.0616011705682,2.07667373390234,3.13827490447054,77,23,28,80,5358,5370,10728,1178.98333333333,1121.96666666667,2300.95,5093,5181,95.0541246733856,-88
1626149,Montrezl Harrell,1.50751111533753,1.6033382444302,3.11084935976773,55,36,29,76,3113,3154,6267,621.066666666667,671.766666666667,1292.83333333333,3026,2973,97.2052682300032,53
1627748,Thon Maker,1.41668066241814,1.68751497313403,3.10419563555217,62,33,30,74,2759,2859,5618,601.05,635.383333333333,1236.43333333333,2645,2799,95.8680681406307,-154
2734,Devin Harris,3.44947145109236,-0.661088013392628,2.78838343769973,9,178,31,70,3018,3051,6069,674.25,636.35,1310.6,2962,2867,98.1444665341286,95
201583,Ryan Anderson,-0.418009336384223,3.0291571841694,2.61114784778518,168,7,32,66,4018,3958,7976,845.05,865.85,1710.9,4033,3788,100.373320059731,245
202699,Tobias Harris,0.945977273182556,1.62660432431604,2.57258159749859,88,34,33,80,6241,6160,12401,1344.3,1314.71666666667,2659.01666666667,5895,6015,94.4560166639962,-120
202703,Nikola Mirotic,2.48850208134996,-0.000937259171237705,2.48756482217872,23,130,34,55,3601,3620,7221,709.516666666667,781.483333333333,1491,3511,3390,97.5006942515968,121
202710,Jimmy Butler,3.14614636075257,-0.667109512734866,2.4790368480177,13,179,35,59,4964,4887,9851,1125.4,1034.68333333333,2160.08333333333,4954,4574,99.798549556809,380
1627732,Ben Simmons,1.00259417242151,1.45724139319668,2.45983556561819,86,45,36,81,6566,6585,13151,1321.11666666667,1398.38333333333,2719.5,6335,5923,96.4818763326226,412
203124,Kyle O'Quinn,0.830974657863406,1.56630425939761,2.39727891726102,96,40,37,77,3200,3245,6445,703.183333333333,681.183333333333,1384.36666666667,3018,3070,94.3125,-52
200755,JJ Redick,1.66440557225619,0.716950874099393,2.38135644635558,48,85,38,70,5103,5125,10228,1032.9,1076.06666666667,2108.96666666667,4966,4654,97.3153047227121,312
1627739,Kris Dunn,0.331910997344423,2.01668981126757,2.34860080861199,121,26,39,52,3561,3533,7094,740.133333333333,779.716666666667,1519.85,3246,3504,91.1541701769166,-258
203503,Tony Snell,0.00599696623516378,2.33907404382302,2.34507101005818,140,18,40,75,4658,4753,9411,978.883333333333,1065.7,2044.58333333333,4568,4596,98.0678402747961,-28
201569,Eric Gordon,3.38557368738965,-1.05345329623071,2.33212039115894,11,202,41,69,5095,5037,10132,1040.05,1110.98333333333,2151.03333333333,5216,4634,102.374877330716,582
202322,John Wall,1.43086142159526,0.900689256179495,2.33155067777475,60,67,42,41,3342,3370,6712,700.466666666667,703.683333333333,1404.15,3237,3114,96.8581687612208,123
1626156,D'Angelo Russell,-0.344804039656129,2.64940100563992,2.30459696598379,163,12,43,48,2963,3053,6016,622.083333333333,607.733333333333,1229.81666666667,2771,2979,93.5200809989875,-208
203110,Draymond Green,3.03386513951259,-0.73037451839155,2.30349062112104,16,182,44,69,5266,5485,10751,1051.16666666667,1194.36666666667,2245.53333333333,5359,5056,101.766046334979,303
1626171,Bobby Portis,2.44009590294877,-0.167585433673736,2.27251046927504,26,139,45,73,3941,3850,7791,789.716666666667,856.1,1645.81666666667,3698,3778,93.8340522709972,-80
203118,Mike Scott,2.4848850825975,-0.23426805738675,2.25061702521075,24,145,46,76,3267,3297,6564,704.666666666667,697.783333333333,1402.45,3058,3144,93.6026936026936,-86
101150,Lou Williams,1.9040328148523,0.346473180176182,2.25050599502848,38,106,47,79,6251,6277,12528,1265.88333333333,1317.31666666667,2583.2,6116,6070,97.8403455447129,46
201143,Al Horford,2.28221980872803,-0.0579639022123635,2.22425590651567,28,133,48,72,5117,5191,10308,1141.3,1124.71666666667,2266.01666666667,5003,4664,97.7721321086574,339
2546,Carmelo Anthony,0.111489323990303,2.01474307686767,2.12623240085797,136,27,49,78,6152,5771,11923,1205.93333333333,1288.43333333333,2494.36666666667,5769,5485,93.7743823146944,284
201156,Nick Young,1.11383900913117,1.00669870452839,2.12053771365956,74,61,50,79,3222,3328,6550,672.333333333333,704.45,1376.78333333333,3139,3108,97.4239602731223,31
1626162,Kelly Oubre Jr.,0.9426415195081,1.1548299236027,2.0974714431108,89,55,51,81,5238,5279,10517,1118.35,1108.58333333333,2226.93333333333,4902,5004,93.5853379152348,-102
201152,Thaddeus Young,2.79686487297711,-0.732764480917152,2.06410039205996,19,183,52,81,5917,6009,11926,1282.31666666667,1316.76666666667,2599.08333333333,5723,5527,96.7213114754098,196
203114,Khris Middleton,1.63365009816321,0.40936082326079,2.043010921424,49,102,53,82,6795,6908,13703,1430.18333333333,1541.75,2971.93333333333,6665,6596,98.0868285504047,69
203613,Jonathon Simmons,0.722038882566636,1.27079007074281,1.99282895330945,102,50,54,69,4710,4807,9517,1003.48333333333,1020.08333333333,2023.56666666667,4416,4709,93.7579617834395,-293
1626209,Mario Hezonja,1.19628591433395,0.763196528549905,1.95948244288386,70,83,55,75,3808,3886,7694,829.533333333333,817.6,1647.13333333333,3513,3733,92.2531512605042,-220
203471,Dennis Schroder,-0.129834650652068,2.03198828428292,1.90215363363085,150,25,56,67,4850,4915,9765,1039.4,1030.1,2069.5,4489,4749,92.5567010309278,-260
203493,Reggie Bullock,1.52959720832739,0.36215461062654,1.89175181895393,54,105,57,62,4035,4008,8043,872.65,854.6,1727.25,3806,3794,94.3246592317224,12
202681,Kyrie Irving,0.772242778373829,1.11701896977317,1.889261748147,98,56,58,60,4453,4491,8944,965.966666666667,959.75,1925.71666666667,4333,4108,97.3051875140355,225
203507,Giannis Antetokounmpo,1.62705019120582,0.230555531002772,1.8576057222086,50,111,59,75,6282,6351,12633,1313.41666666667,1436.11666666667,2749.53333333333,6118,5969,97.3893664438077,149
202083,Wesley Matthews,-0.662122738789016,2.47328867158443,1.81116593279542,185,17,60,63,4761,4834,9595,1104.13333333333,1022.61666666667,2126.75,4457,4791,93.6147868094938,-334
1626168,Trey Lyles,0.86315092834382,0.882148119353183,1.745299047697,93,72,61,73,3297,3197,6494,705.383333333333,684.216666666667,1389.6,3118,3111,94.570821959357,7
203952,Andrew Wiggins,0.715350602119991,1.02190146184508,1.73725206396507,103,59,62,82,6977,6873,13850,1545.03333333333,1437.65,2982.68333333333,6825,6606,97.8214132148488,219
1628374,Lauri Markkanen,-1.41639383484324,3.12807055655446,1.71167672171122,217,5,63,68,4696,4624,9320,994.55,1016.03333333333,2010.58333333333,4237,4616,90.2257240204429,-379
201563,Michael Beasley,1.13350184873598,0.546655093553984,1.68015694228996,72,93,64,73,3918,3874,7792,842.266666666667,806.5,1648.76666666667,3618,3773,92.3430321592649,-155
202362,Lance Stephenson,0.159503349686149,1.50529032821068,1.66479367789683,133,43,65,82,4275,4252,8527,938.666666666667,911.016666666667,1849.68333333333,4006,4136,93.7076023391813,-130
201942,DeMar DeRozan,1.74572748040117,-0.104227553077648,1.64149992732352,42,137,66,80,6445,6384,12829,1357.38333333333,1353.88333333333,2711.26666666667,6409,5979,99.4414274631497,430
201572,Brook Lopez,0.744262499436483,0.84478338647485,1.58904588591133,99,76,67,74,4185,4146,8331,839.633333333333,886.766666666667,1726.4,3884,3968,92.8076463560335,-84
203501,Tim Hardaway Jr.,0.737715930329415,0.818821857693987,1.5565377880234,101,77,68,57,4524,4411,8935,951.7,928.15,1879.85,4190,4255,92.6171529619806,-65
201967,Dante Cunningham,0.872855827611744,0.651708763259574,1.52456459087132,92,89,69,72,3607,3707,7314,762.5,771.916666666667,1534.41666666667,3471,3503,96.229553645689,-32
1938,Manu Ginobili,1.80680024437953,-0.282580577885357,1.52421966649417,39,149,70,65,3034,3017,6051,671.716666666667,632.916666666667,1304.63333333333,2888,2829,95.1878707976269,59
1628372,Dennis Smith Jr.,-1.01610154307882,2.51529806706696,1.49919652398814,196,15,71,69,4651,4683,9334,1051.63333333333,994.566666666667,2046.2,4304,4630,92.5392388733606,-326
201158,Marco Belinelli,0.896201681482591,0.572548495290178,1.46875017677277,90,91,72,80,4635,4637,9272,962.733333333333,985.5,1948.23333333333,4334,4387,93.5059331175836,-53
201188,Marc Gasol,0.151969045671136,1.29034367978999,1.44231272546113,134,49,73,73,5387,5381,10768,1243.71666666667,1158.96666666667,2402.68333333333,4879,5211,90.5698904770744,-332
2733,Shaun Livingston,2.52441583876695,-1.08782136411662,1.43659447465033,22,206,74,70,2540,2660,5200,530.133333333333,579.533333333333,1109.66666666667,2510,2364,98.8188976377953,146
1626150,Andrew Harrison,-0.168492903915376,1.59528533689691,1.42679243298154,154,39,75,56,2950,2928,5878,685.616666666667,632.366666666667,1317.98333333333,2644,2828,89.6271186440678,-184
200826,J.J. Barea,1.38142631291992,0.0434458866313402,1.42487219955126,63,125,76,69,3583,3640,7223,827.333333333333,773.7,1601.03333333333,3498,3504,97.6276862963997,-6
101107,Marvin Williams,0.474266585056819,0.929399068635029,1.40366565369185,115,64,77,78,4783,4701,9484,1006.13333333333,989.966666666667,1996.1,4532,4449,94.7522475433828,83
201933,Blake Griffin,1.75585865150383,-0.406444878695012,1.34941377280882,41,163,78,58,4618,4624,9242,991.566666666667,972.9,1964.46666666667,4382,4322,94.889562581204,60
203210,JaMychal Green,-0.447564096659307,1.77580992197258,1.32824582531327,170,32,79,55,3468,3402,6870,785.766666666667,748.883333333333,1534.65,3124,3344,90.080738177624,-220
201142,Kevin Durant,0.398562406944919,0.885656978743303,1.28421938568822,117,70,80,67,5428,5624,11052,1083.93333333333,1202.08333333333,2286.01666666667,5620,5295,103.537214443626,325
203089,John Henson,2.32801820910216,-1.04630112912038,1.28171707998177,27,201,81,76,4482,4517,8999,941.783333333333,1014.48333333333,1956.26666666667,4402,4228,98.215082552432,174
1627752,Taurean Prince,-0.550771215876903,1.82189664185497,1.27112542597807,174,31,82,82,5777,5869,11646,1241.65,1217.2,2458.85,5344,5659,92.5047602561883,-315
1627854,Bryn Forbes,0.570547408486395,0.669691450199966,1.24023885868636,109,88,83,80,3483,3440,6923,773.016666666667,738.3,1511.31666666667,3293,3193,94.5449325294287,100
201586,Serge Ibaka,2.05998446158937,-0.866078615858162,1.19390584573121,35,190,84,76,4918,4917,9835,1039.7,1044.96666666667,2084.66666666667,4890,4567,99.4306628710858,323
202397,Ish Smith,1.49394302272016,-0.306738164671556,1.18720485804861,56,152,85,82,4719,4713,9432,1008.91666666667,1027.08333333333,2036,4462,4433,94.5539309175673,29
203484,Kentavious Caldwell-Pope,0.204259763254972,0.976439403499516,1.18069916675449,131,62,86,74,5934,5872,11806,1176.9,1272.6,2449.5,5529,5568,93.1749241658241,-39
203901,Elfrid Payton,-1.42085189995638,2.59898112865802,1.17812922870165,218,14,87,63,4286,4380,8666,858.05,935.966666666667,1794.01666666667,3943,4399,91.9972001866542,-456
203092,Tyler Zeller,-1.16055772297848,2.21967968459678,1.05912196161831,203,20,88,66,2629,2581,5210,556.4,546.983333333333,1103.38333333333,2461,2454,93.6097375427919,7
203121,Darius Miller,1.0092646511944,0.0377736084540617,1.04703825964846,84,126,89,81,4545,4676,9221,929.65,994.416666666667,1924.06666666667,4461,4423,98.1518151815182,38
204060,Joe Ingles,0.58102153311836,0.461177793109454,1.04219932622781,108,99,90,82,5902,5858,11760,1317.4,1244.58333333333,2561.98333333333,5605,5352,94.9678075228736,253
201147,Corey Brewer,0.863095458490588,0.166676695087512,1.0297721535781,94,114,91,72,3014,2939,5953,587.616666666667,619.383333333333,1207,2763,2816,91.672196416722,-53
203933,T.J. Warren,0.328628902585521,0.695900304996012,1.02452920758153,122,86,92,65,5178,5187,10365,1064.91666666667,1069.15,2134.06666666667,4634,5080,89.4940131324836,-446
1628404,Josh Hart,0.13076996124765,0.892508511996148,1.0232784732438,135,69,93,63,3478,3492,6970,699,756.35,1455.35,3260,3315,93.7320299022427,-55
200782,PJ Tucker,1.80448232197231,-0.81554087808015,0.988941443892158,40,188,94,82,5303,5277,10580,1128.8,1151.08333333333,2279.88333333333,5397,4877,101.772581557609,520
203944,Julius Randle,1.47200553032093,-0.504435407005872,0.96757012331506,57,168,95,82,5233,5229,10462,1054.41666666667,1129.98333333333,2184.4,4942,4997,94.4391362507166,-55
201229,Anthony Tolliver,1.29232448335742,-0.368033054019953,0.924291429337465,66,159,96,79,4023,4021,8044,871.733333333333,879.4,1751.13333333333,3805,3775,94.5811583395476,30
203095,Evan Fournier,2.23400025712867,-1.32250642398536,0.911493833143307,29,222,97,57,4305,4415,8720,892.783333333333,942.466666666667,1835.25,4147,4271,96.3298490127758,-124
1626179,Terry Rozier,1.1021793028888,-0.242946763546757,0.859232539342045,75,147,98,80,4737,4761,9498,1054.18333333333,1011.2,2065.38333333333,4396,4292,92.8013510660756,104
201566,Russell Westbrook,1.69965307519623,-0.868459753260932,0.831193321935295,44,191,99,80,7176,6771,13947,1383.51666666667,1516.41666666667,2899.93333333333,6747,6352,94.0217391304348,395
203200,Justin Holiday,0.318625115158448,0.507718492980451,0.826343608138899,124,94,100,72,5325,5244,10569,1106.1,1153.46666666667,2259.56666666667,4924,5112,92.4694835680751,-188
203084,Harrison Barnes,-0.0896214960307283,0.875759507012607,0.786138010981879,146,75,101,77,5913,6001,11914,1361.31666666667,1275.4,2636.71666666667,5513,5842,93.2352443767969,-329
201961,Wayne Ellington,1.06292438321691,-0.291704735842792,0.77121964737412,76,150,102,76,4511,4509,9020,1014.03333333333,988.966666666667,2003,4273,4184,94.7240079804921,89
2037,Jamal Crawford,-0.830867663434128,1.55610928432001,0.725241620885887,192,41,103,80,3799,3815,7614,855.8,791.133333333333,1646.93333333333,3634,3818,95.6567517767834,-184
1627783,Pascal Siakam,2.00137265538353,-1.28979696958837,0.711575685795157,36,221,104,81,3901,3894,7795,823.533333333333,854.3,1677.83333333333,3863,3518,99.0258907972315,345
204020,Tyler Johnson,-0.682051076069118,1.38805882220507,0.706007746135952,187,48,105,71,4641,4634,9275,1023.55,999.916666666667,2023.46666666667,4360,4296,93.9452704158587,64
202324,Derrick Favors,0.544929549810758,0.159167010875768,0.704096560686526,110,115,106,77,4891,4840,9731,1105.93333333333,1038.71666666667,2144.65,4612,4473,94.2956450623594,139
1626145,Tyus Jones,2.21650736192035,-1.52273400218651,0.693773359733841,30,228,107,82,3371,3318,6689,751.916666666667,705.516666666667,1457.43333333333,3294,3136,97.715811331949,158
203546,Ian Clark,0.195784850863538,0.483610128140126,0.679394979003665,132,97,108,73,3354,3466,6820,685.4,738.6,1424,3246,3232,96.7799642218247,14
203468,CJ McCollum,0.223425712029133,0.450648318285921,0.674074030315054,129,100,109,81,6811,6743,13554,1492.4,1419.36666666667,2911.76666666667,6417,6303,94.2152400528557,114
203999,Nikola Jokic,1.67687956310804,-1.10046037739221,0.57641918571582,46,209,110,74,5602,5409,11011,1191.95,1189.86666666667,2381.81666666667,5502,5204,98.2149232416994,298
203488,Mike Muscala,0.082144497496309,0.493800485886257,0.575944983382566,137,96,111,53,2535,2558,5093,535.45,523.45,1058.9,2342,2447,92.3865877712032,-105
1628467,Maxi Kleber,0.0490697294936799,0.499056976986177,0.548126706479857,138,95,112,71,2701,2734,5435,621.266666666667,586.75,1208.01666666667,2489,2601,92.1510551647538,-112
1626153,Delon Wright,-0.169417876591144,0.686477948504868,0.517060071913725,155,87,113,69,3327,3328,6655,709.416666666667,715.333333333333,1424.75,3235,3001,97.2347460174331,234
1628379,Luke Kennard,2.46434701352572,-1.95824453053158,0.506102482994142,25,239,114,73,3301,3337,6638,725.45,732.15,1457.6,3164,3070,95.849742502272,94
201587,Nicolas Batum,-1.56241447520087,2.06822318624653,0.505808711045653,222,24,115,64,4738,4631,9369,990.9,984.533333333333,1975.43333333333,4511,4497,95.2089489235965,14
1626192,Pat Connaughton,-0.379744864913405,0.883324799025164,0.503579934111759,166,71,116,82,3471,3420,6891,774.716666666667,712.416666666667,1487.13333333333,3319,3187,95.6208585422069,132
201584,Courtney Lee,-0.332105244668798,0.796472972796019,0.464367728127221,161,78,117,76,5372,5388,10760,1176.65,1126.76666666667,2303.41666666667,4936,5237,91.8838421444527,-301
203894,Shabazz Napier,1.36693694548555,-0.909767474560002,0.457169470925546,64,196,118,74,3517,3515,7032,794.116666666667,740.566666666667,1534.68333333333,3312,3233,94.1711686096105,79
202683,Enes Kanter,-1.74505894639986,2.18773306225449,0.442674115854632,234,21,119,71,4328,4229,8557,931.5,892.316666666667,1823.81666666667,3957,4145,91.4279112754159,-188
202331,Paul George,-0.674371317221604,1.10598029505481,0.43160897783321,186,57,120,79,7018,6722,13740,1385.03333333333,1498.26666666667,2883.3,6536,6346,93.1319464234825,190
200746,LaMarcus Aldridge,1.73255334835669,-1.32513362569838,0.407419722658304,43,223,121,75,5676,5535,11211,1303.21666666667,1194.86666666667,2498.08333333333,5367,5074,94.5560253699789,293
203954,Joel Embiid,1.57270062955356,-1.17832242824531,0.394378201308246,52,212,122,63,4505,4512,9017,934.683333333333,969.816666666667,1904.5,4435,3992,98.4461709211987,443
201973,Jonas Jerebko,0.248058581976232,0.107328605419528,0.35538718739576,127,121,123,74,2566,2556,5122,571.4,552.683333333333,1124.08333333333,2431,2380,94.7388932190179,51
1627819,Isaiah Taylor,1.16878260327524,-0.847398590014563,0.321384013260673,71,189,124,66,2760,2757,5517,583.166666666667,578.666666666667,1161.83333333333,2570,2592,93.1159420289855,-22
1626196,Josh Richardson,-0.330411362084215,0.634780649890676,0.304369287806461,160,90,125,80,6051,6011,12062,1337.58333333333,1298.86666666667,2636.45,5613,5551,92.7615270203272,62
202684,Tristan Thompson,-1.59486035350962,1.87208338270039,0.277223029190768,227,29,126,53,2535,2467,5002,538.933333333333,528.866666666667,1067.8,2401,2502,94.7140039447732,-101
203937,Kyle Anderson,-0.0490498727147945,0.318728986808256,0.269679114093461,143,108,127,74,4488,4450,8938,1022.38333333333,948.383333333333,1970.76666666667,4215,4042,93.9171122994652,173
203078,Bradley Beal,1.00490654078716,-0.735721255024028,0.269185285763131,85,184,128,82,6883,6943,13826,1490.43333333333,1477.6,2968.03333333333,6597,6424,95.8448351009734,173
203925,Joe Harris,0.358624573138844,-0.0900188406122827,0.268605732526561,119,136,129,78,4628,4660,9288,1004.93333333333,965.45,1970.38333333333,4322,4482,93.3880726015557,-160
201949,James Johnson,1.23666715116732,-0.969757928483848,0.266909222683475,69,198,130,72,4347,4393,8740,952.866666666667,938.516666666667,1891.38333333333,4077,4061,93.7888198757764,16
203112,Quincy Acy,0.741678111803861,-0.514803424501242,0.226874687302619,100,170,131,70,3148,3213,6361,688.366666666667,669.616666666667,1357.98333333333,2972,3080,94.4091486658196,-108
203926,Doug McDermott,-0.510292423583927,0.729408592989105,0.219116169405178,172,84,132,81,4121,4104,8225,893.916666666667,869.55,1763.46666666667,3813,3840,92.5260859014802,-27
203459,Allen Crabbe,-0.128147602056457,0.344322324575565,0.216174722519108,149,107,133,75,5203,5243,10446,1107.5,1080.56666666667,2188.06666666667,4914,5008,94.4455122044974,-94
202694,Marcus Morris,-0.55980537185593,0.774286805366578,0.214481433510647,175,82,134,54,3351,3347,6698,731.35,707.016666666667,1438.36666666667,3117,3124,93.0170098478066,-7
101162,Marcin Gortat,-2.83850914249693,3.03781989021714,0.199310747720208,257,6,135,82,4793,4807,9600,1043.93333333333,1025,2068.93333333333,4556,4454,95.0552889630712,102
202335,Patrick Patterson,-0.782901481919382,0.97385318858569,0.190951706666308,191,63,136,82,2877,2910,5787,611.916666666667,655.633333333333,1267.55,2612,2707,90.7890163364616,-95
1628378,Donovan Mitchell,0.67507022818658,-0.506198402150447,0.168871826036133,104,169,137,79,6087,6011,12098,1343.03333333333,1286.43333333333,2629.46666666667,5793,5431,95.1700344997536,362
203506,Victor Oladipo,3.12959729532355,-2.96143229310891,0.168165002214638,14,255,138,75,5859,5946,11805,1250.78333333333,1293.43333333333,2544.21666666667,5698,5400,97.2520908004779,298
1627741,Buddy Hield,1.05385044148749,-0.892364845635631,0.161485595851857,79,194,139,80,4579,4574,9153,1013.66666666667,1008.2,2021.86666666667,4204,4359,91.8104389604717,-155
203077,Michael Kidd-Gilchrist,1.59162028314921,-1.47389607889188,0.11772420425733,51,225,140,74,4406,4294,8700,927.566666666667,914.916666666667,1842.48333333333,4176,4106,94.7798456650023,70
1628462,Milos Teodosic,2.09604480100352,-1.9874442772008,0.108600523802717,34,240,141,45,2681,2726,5407,550.666666666667,580.383333333333,1131.05,2617,2578,97.6128310331966,39
1626144,Emmanuel Mudiay,-1.93088985489448,1.98661586561924,0.0557260107247535,240,28,142,64,3002,2976,5978,625.333333333333,615.6,1240.93333333333,2669,2947,88.9073950699534,-278
203967,Dario Saric,-1.16207081715655,1.16773451746335,0.00566370030679964,204,53,143,77,5505,5498,11003,1117.55,1180,2297.55,5261,4995,95.5676657584014,266
1626170,Jerian Grant,-1.26026259238464,1.25524870143622,-0.00501389094842542,211,51,144,74,3893,3840,7733,822.4,858.666666666667,1681.06666666667,3515,3790,90.2902645774467,-275
1627746,Skal Labissiere,0.20807936795011,-0.241955921604761,-0.0338765536546511,130,146,145,60,2860,2826,5686,620.466666666667,612.55,1233.01666666667,2622,2743,91.6783216783217,-121
101127,Jarrett Jack,0.541820427025712,-0.583975304373467,-0.0421548773477551,111,174,146,62,3611,3582,7193,784.283333333333,756,1540.28333333333,3416,3447,94.5998338410413,-31
201609,Goran Dragic,0.319651234621254,-0.372335392422574,-0.0526841578013202,123,161,147,74,5368,5359,10727,1174.35,1146.58333333333,2320.93333333333,4993,4964,93.0141579731744,29
203991,Clint Capela,-1.01615698801989,0.923311401513391,-0.092845586506498,197,65,148,74,4706,4656,9362,999.95,1024.8,2024.75,4725,4347,100.403739906502,378
203518,Alex Abrines,0.440605457786162,-0.577163549185665,-0.136558091399504,116,173,149,74,2687,2614,5301,549.783333333333,581.583333333333,1131.36666666667,2497,2473,92.9289170078154,24
1628368,De'Aaron Fox,-1.21704699268503,1.01269260985784,-0.204354382827189,208,60,150,73,4690,4668,9358,1015.51666666667,1001.46666666667,2016.98333333333,4206,4611,89.680170575693,-405
201959,Taj Gibson,0.657565132789254,-0.892070793650742,-0.234505660861488,106,193,151,82,6349,6280,12629,1411.35,1315.53333333333,2726.88333333333,6268,5997,98.7242085367775,271
203939,Dwight Powell,-0.145178138744591,-0.117128821882841,-0.262306960627432,152,138,152,79,3737,3765,7502,849.216666666667,812.866666666667,1662.08333333333,3578,3564,95.7452502006958,14
1628384,OG Anunoby,1.67662557735254,-1.9488626039789,-0.27223702662636,47,238,153,74,3452,3459,6911,737.283333333333,731.8,1469.08333333333,3449,3137,99.9130938586327,312
202693,Markieff Morris,-2.88584232910411,2.60713005587281,-0.278712273231295,259,13,154,73,4499,4525,9024,986.433333333333,970.683333333333,1957.11666666667,4286,4252,95.265614581018,34
1628021,David Nwaba,-0.329102677175894,0.0305114959962914,-0.298591181179602,159,128,155,70,3902,3848,7750,792.633333333333,850.433333333333,1643.06666666667,3547,3761,90.9021014864172,-214
1627737,Marquese Chriss,-0.890306089653751,0.572036845180427,-0.318269244473324,195,92,156,72,3711,3694,7405,750.816666666667,768.383333333333,1519.2,3286,3561,88.5475613042307,-275
203490,Otto Porter Jr.,0.661158703193859,-0.985884682432966,-0.324725979239108,105,199,157,77,5613,5617,11230,1213.98333333333,1206.81666666667,2420.8,5447,5185,97.0425797256369,262
1627832,Fred VanVleet,1.46284115666927,-1.82827833858953,-0.36543718192026,58,234,158,76,3520,3541,7061,741.066666666667,775.683333333333,1516.75,3504,3136,99.5454545454546,368
1628382,Justin Jackson,-0.101629652065131,-0.301636816488461,-0.403266468553593,147,151,159,68,3432,3421,6853,753.95,740.633333333333,1494.58333333333,3103,3310,90.4137529137529,-207
1626185,Jarell Martin,-1.21618085429067,0.78043314375273,-0.435747710537937,207,80,160,73,3773,3789,7562,845.416666666667,810.316666666667,1655.73333333333,3370,3626,89.3188444208852,-256
101133,Ian Mahinmi,0.793598194610216,-1.22969533870977,-0.436097144099553,97,215,161,77,2684,2645,5329,576.033333333333,568.133333333333,1144.16666666667,2488,2471,92.6974664679583,17
101141,Ersan Ilyasova,2.2008373105949,-2.64264574062526,-0.441808430030364,31,251,162,69,4066,4106,8172,851.85,871.133333333333,1722.98333333333,3847,3810,94.6138711264142,37
201601,Luc Mbah a Moute,1.02589076441461,-1.48840229402141,-0.462511529606798,81,226,163,61,3570,3623,7193,763.45,798.583333333333,1562.03333333333,3606,3275,101.008403361345,331
203076,Anthony Davis,1.05213217221413,-1.55073988809237,-0.498607715878233,80,230,164,74,6386,6560,12946,1278.31666666667,1402.88333333333,2681.2,6275,5954,98.2618227372377,321
203914,Gary Harris,0.621461694753041,-1.12928386715609,-0.507822172403053,107,210,165,67,5417,5329,10746,1147.83333333333,1150.53333333333,2298.36666666667,5270,5102,97.2863208417944,168
203109,Jae Crowder,-0.341566840381638,-0.208842728668337,-0.550409569049975,162,142,166,80,4835,4875,9710,1043.53333333333,1038.58333333333,2082.11666666667,4677,4640,96.7321613236815,37
203497,Rudy Gobert,-0.143795950406547,-0.415960873239654,-0.559756823646202,151,164,167,56,4221,4138,8359,922.033333333333,885.1,1807.13333333333,3975,3634,94.1719971570718,341
203115,Will Barton,0.0156651921038917,-0.627983141433767,-0.612317949329875,139,176,168,80,6265,6124,12389,1317.88333333333,1313.96666666667,2631.85,5986,5880,95.5466879489226,106
201577,Robin Lopez,-1.78129963814583,1.15898972788507,-0.622309910260756,235,54,169,64,3882,3838,7720,828.9,855.25,1684.15,3515,3741,90.5461102524472,-226
203083,Andre Drummond,-1.08271734433917,0.432222973477531,-0.650494370861634,201,101,170,78,6134,6014,12148,1318.38333333333,1291.31666666667,2609.7,5695,5735,92.8431692207369,-40
202696,Nikola Vucevic,0.377109258236797,-1.0769231771261,-0.699813918889303,118,205,171,57,3933,3987,7920,832.766666666667,842.233333333333,1675,3762,3793,95.6521739130435,-31
1628398,Kyle Kuzma,-0.279253868630049,-0.423036540639319,-0.702290409269368,157,166,172,77,5796,5813,11609,1148.78333333333,1242.2,2390.98333333333,5350,5489,92.3050379572119,-139
202344,Trevor Booker,-0.724192576166256,-0.0223941345784637,-0.74658671074472,189,132,173,68,2748,2736,5484,589.383333333333,568.566666666667,1157.95,2585,2588,94.0684133915575,-3
201960,DeMarre Carroll,0.288219673428073,-1.05572501583036,-0.767505342402283,126,203,174,73,5150,5163,10313,1110.85,1063.68333333333,2174.53333333333,4829,4875,93.7669902912621,-46
203090,Maurice Harkless,-1.70467827087536,0.897888189903619,-0.806790080971737,232,68,175,59,2928,2919,5847,651.6,606.766666666667,1258.36666666667,2734,2716,93.3743169398907,18
201980,Danny Green,-1.01750587095141,0.207538981672911,-0.8099668892785,198,112,176,70,4051,4001,8052,934.316666666667,848.333333333333,1782.65,3743,3638,92.3969390274006,105
1626178,Rondae Hollis-Jefferson,-1.05972902129631,0.23827882983854,-0.821450191457772,199,110,177,68,4531,4628,9159,964.566666666667,950.65,1915.21666666667,4275,4434,94.3500331052748,-159
1628367,Josh Jackson,-0.163048128522024,-0.711101738856986,-0.87414986737901,153,180,178,77,4773,4796,9569,960.4,994.85,1955.25,4166,4639,87.282631468678,-473
1627755,Tyler Ulis,-1.31779137136512,0.400937181952485,-0.916854189412639,214,103,179,71,3967,3940,7907,816.133333333333,835.4,1651.53333333333,3500,3817,88.2278800100832,-317
1628366,Lonzo Ball,-0.583105246675064,-0.354085238328979,-0.937190485004043,177,156,180,52,4346,4305,8651,845.983333333333,927.066666666667,1773.05,3984,4000,91.6705016106765,-16
203932,Aaron Gordon,-0.357387245584965,-0.587132867738489,-0.944520113323454,164,175,181,58,4482,4520,9002,936.966666666667,965.7,1902.66666666667,4218,4305,94.1097724230254,-87
201937,Ricky Rubio,-0.380969785938371,-0.57125099272289,-0.952220778661261,167,172,182,77,5142,5093,10235,1150.13333333333,1094.3,2244.43333333333,4845,4600,94.2240373395566,245
1627733,Dragan Bender,-1.07032541088009,0.115100427436741,-0.955224983443345,200,119,183,82,4934,4988,9922,1019.56666666667,1040.36666666667,2059.93333333333,4401,4879,89.1974057559789,-478
201145,Jeff Green,0.989618135822932,-2.02948647612732,-1.03986834030439,87,242,184,78,4215,4334,8549,901.966666666667,922.433333333333,1824.4,4171,4052,98.9561091340451,119
203458,Alex Len,-0.548130918483658,-0.518308436278362,-1.06643935476202,173,171,185,69,3405,3406,6811,694.833333333333,699.933333333333,1394.76666666667,3051,3328,89.6035242290749,-277
203107,Tomas Satoransky,-0.864383169168932,-0.211640150649176,-1.07602331981811,193,143,186,73,3807,3790,7597,827.866666666667,810.683333333333,1638.55,3616,3532,94.9829261886,84
201596,Mario Chalmers,-0.0703969566188954,-1.00665807570665,-1.07705503232554,145,200,187,66,3347,3327,6674,728.033333333333,694.8,1422.83333333333,3026,3095,90.4093217806991,-69
1626161,Willie Cauley-Stein,-1.25324047906595,0.173492455752613,-1.07974802331334,210,113,188,73,4644,4601,9245,1032.35,1005.18333333333,2037.53333333333,4184,4497,90.0947459086994,-313
1627759,Jaylen Brown,0.00190265658344236,-1.09614890105562,-1.09424624447218,141,208,189,70,4947,4955,9902,1079.45,1070.16666666667,2149.61666666667,4759,4416,96.1997170002022,343
1626164,Devin Booker,-1.20239406814532,0.0493970902199014,-1.15299697792541,206,123,190,54,4610,4587,9197,929.55,930.483333333333,1860.03333333333,4104,4511,89.0238611713666,-407
2199,Tyson Chandler,-2.67221440476697,1.49693079355266,-1.17528361121431,253,44,191,46,2749,2721,5470,576.466666666667,568.766666666667,1145.23333333333,2396,2666,87.1589668970535,-270
203924,Jerami Grant,1.01501953764379,-2.20379817318979,-1.188778635546,83,243,192,81,3851,3826,7677,799.533333333333,844.116666666667,1643.65,3580,3553,92.9628667878473,27
200768,Kyle Lowry,0.521200885420116,-1.71370285679836,-1.19250197137824,112,231,193,78,5911,5884,11795,1246.13333333333,1257.1,2503.23333333333,5860,5440,99.137201827102,420
201599,DeAndre Jordan,-1.989813727441,0.791139323430414,-1.19867440401059,243,79,194,77,5678,5658,11336,1211.71666666667,1196.63333333333,2408.35,5348,5463,94.1880943994364,-115
201936,Tyreke Evans,1.33476250021673,-2.54361391144869,-1.20885141123195,65,249,195,52,3653,3655,7308,819.116666666667,784.25,1603.36666666667,3410,3387,93.3479332055845,23
203486,Mason Plumlee,-0.586387479632289,-0.64070369152711,-1.2270911711594,178,177,196,73,3362,3348,6710,706.683333333333,707.916666666667,1414.6,3156,3184,93.8726948245092,-28
201975,Jodie Meeks,-1.17542960779688,-0.0677590373901234,-1.243188645187,205,134,197,77,2627,2618,5245,562.883333333333,551.3,1114.18333333333,2394,2531,91.1305671869052,-137
202339,Eric Bledsoe,0.50766139988988,-1.76860898617808,-1.2609475862882,114,232,198,74,5368,5461,10829,1109.61666666667,1203.85,2313.46666666667,5262,5134,98.0253353204173,128
1628386,Jarrett Allen,-0.359938848068835,-0.903544007182274,-1.26348285525111,165,195,199,72,3357,3458,6815,734.666666666667,703.05,1437.71666666667,3131,3255,93.2677986297289,-124
1628369,Jayson Tatum,1.25406325047356,-2.53644421805093,-1.28238096757737,67,248,200,80,5514,5594,11108,1217.36666666667,1209.41666666667,2426.78333333333,5291,4971,95.955749002539,320
202685,Jonas Valanciunas,-2.1391013718604,0.775402468213335,-1.36369890364706,246,81,201,77,4049,4035,8084,865.716666666667,853.6,1719.31666666667,3999,3796,98.7651271918993,203
203935,Marcus Smart,0.521168876921027,-1.89436752949261,-1.37319865257158,113,236,202,54,3742,3767,7509,813.366666666667,803.216666666667,1616.58333333333,3543,3330,94.6819882415821,213
101109,Raymond Felton,-0.639269131898238,-0.748939806168247,-1.38820893806648,184,185,203,82,3080,3079,6159,663.7,695.333333333333,1359.03333333333,2803,2852,91.0064935064935,-49
202498,Lance Thomas,-1.63805599322251,0.148798661652983,-1.48925733156953,229,116,204,73,3112,3111,6223,688.366666666667,660.4,1348.76666666667,2821,2985,90.6491002570694,-164
202357,Nemanja Bjelica,-0.633909257528628,-0.87995721060642,-1.51386646813505,181,192,205,67,3176,3165,6341,701.583333333333,658.483333333333,1360.06666666667,3053,3065,96.1272040302267,-12
202325,Wesley Johnson,-0.288040225846496,-1.24024875757639,-1.52828898342288,158,216,206,74,3539,3593,7132,733.266666666667,746.333333333333,1479.6,3318,3374,93.7552981068098,-56
1628415,Dillon Brooks,-0.573014720321693,-0.967725293244147,-1.54074001356584,176,197,207,82,5297,5294,10591,1193.86666666667,1145.46666666667,2339.33333333333,4805,5019,90.7117236171418,-214
1627763,Malcolm Brogdon,-1.63012451546135,0.0884646097929813,-1.54165990566837,228,122,208,48,3243,3287,6530,698.05,738.583333333333,1436.63333333333,3127,3165,96.4230650632131,-38
201163,Wilson Chandler,-1.26734570148136,-0.276660555935619,-1.54400625741698,212,148,209,73,5367,5298,10665,1152.81666666667,1140.41666666667,2293.23333333333,5164,5093,96.2176262343954,71
203516,James Ennis III,-1.23662849362375,-0.323478015776597,-1.56010650940035,209,153,210,72,3643,3692,7335,805.866666666667,796.816666666667,1602.68333333333,3321,3514,91.1611309360417,-193
203476,Gorgui Dieng,-1.56437277716813,-0.00903123983396927,-1.5734040170021,223,131,211,79,3101,3090,6191,691.516666666667,638.916666666667,1330.43333333333,2895,3062,93.3569816188326,-167
1626167,Myles Turner,-0.418243627750542,-1.28724606089207,-1.70548968864261,169,220,212,65,4173,4242,8415,909.85,916.116666666667,1825.96666666667,4036,3913,96.7169901749341,123
200752,Rudy Gay,-0.448323480204513,-1.2799555499131,-1.72827903011761,171,219,213,57,2858,2795,5653,639.066666666667,592.933333333333,1232,2633,2603,92.1273617914626,30
1627747,Caris LeVert,-1.59404402839162,-0.190225766914769,-1.78426979530639,226,140,214,71,4442,4478,8920,947.6,916.166666666667,1863.76666666667,4070,4295,91.6253939666817,-225
202323,Evan Turner,-2.82151619524266,1.03332013629346,-1.7881960589492,255,58,215,79,4743,4725,9468,1045.41666666667,983.083333333333,2028.5,4349,4390,91.6930212945393,-41
202714,Shelvin Mack,-0.594909488674205,-1.24065881207689,-1.83556830075109,180,217,216,69,3110,3156,6266,687.516666666667,674.733333333333,1362.25,2860,2937,91.9614147909968,-77
101161,Amir Johnson,-1.90113928717182,0.047387539166489,-1.85375174800533,239,124,217,74,2812,2805,5617,567.583333333333,601.3,1168.88333333333,2580,2549,91.7496443812233,31
202709,Cory Joseph,-1.52836933372805,-0.369741059867193,-1.89811039359525,219,160,218,82,5108,5109,10217,1109.5,1099.66666666667,2209.16666666667,4777,4797,93.5199686765858,-20
203903,Jordan Clarkson,-1.53539105906701,-0.390755316347164,-1.92614637541418,221,162,219,81,4533,4536,9069,927.683333333333,962.133333333333,1889.81666666667,4171,4259,92.0141186851975,-88
1628400,Semi Ojeleye,-1.98802455783637,0.0276836624443477,-1.96034089539202,242,129,220,73,2598,2660,5258,583.3,564.8,1148.1,2324,2452,89.4534257120862,-128
203463,Ben McLemore,-2.07419025192269,0.113034321026426,-1.96115593089626,245,120,221,56,2522,2531,5053,545.566666666667,545.1,1090.66666666667,2178,2466,86.3600317208565,-288
1626159,Justise Winslow,-0.0685096978329209,-1.89876021484476,-1.96726991267769,144,237,222,67,3791,3785,7576,834.4,822.383333333333,1656.78333333333,3488,3444,92.0073859140069,44
1628389,Bam Adebayo,-2.28657650787334,0.283516404006796,-2.00306010386655,248,109,223,68,3004,3002,6006,685.833333333333,654.833333333333,1340.66666666667,2745,2778,91.3781624500666,-33
2730,Dwight Howard,-2.40176964978951,0.385787951372044,-2.01598169841746,250,104,224,81,5897,5735,11632,1237.36666666667,1217.7,2455.06666666667,5579,5492,94.6074275055113,87
1626220,Royce O'Neale,1.05587761603662,-3.09657609358344,-2.04069847754682,78,260,225,69,2648,2617,5265,585.166666666667,563.05,1148.21666666667,2513,2301,94.9018126888217,212
201950,Jrue Holiday,1.24571941049196,-3.30470503195446,-2.0589856214625,68,262,226,80,6865,6999,13864,1379.25,1504.9,2884.15,6733,6365,98.0772032046613,368
202691,Klay Thompson,-0.111747460112158,-2.02860033382809,-2.14034779394025,148,241,227,72,5716,5947,11663,1161.06666666667,1293.98333333333,2455.05,5810,5471,101.644506648006,339
203087,Jeremy Lamb,0.303660916658386,-2.45277903024471,-2.14911811358632,125,246,228,80,4669,4513,9182,1000.65,965.183333333333,1965.83333333333,4453,4358,95.3737417005783,95
203473,Dewayne Dedmon,-0.74349705532465,-1.51139252416019,-2.25488957948484,190,227,229,62,3578,3632,7210,774.183333333333,760.416666666667,1534.6,3298,3440,92.1743991056456,-142
200765,Rajon Rondo,-1.5301063341501,-0.794133455099791,-2.32423978924989,220,186,230,65,4094,4209,8303,816.55,881.466666666667,1698.01666666667,3946,3887,96.3849535906204,59
1628373,Frank Ntilikina,-1.57794195779058,-0.806227876135329,-2.3841698339259,224,187,231,78,3981,3957,7938,862.75,838.933333333334,1701.68333333333,3601,3667,90.454659633258,-66
203145,Kent Bazemore,-1.67289348490804,-0.720479821184923,-2.39337330609296,231,181,232,65,4147,4259,8406,889.883333333333,891.7,1781.58333333333,3840,3997,92.5970581142995,-157
202340,Avery Bradley,-1.9806390745403,-0.489495179246952,-2.47013425378725,241,167,233,46,3337,3275,6612,721.766666666667,703.666666666667,1425.43333333333,3028,3132,90.7401857956248,-104
2207,Joe Johnson,-2.3110458103203,-0.196376133408711,-2.50742194372901,249,141,234,55,2725,2763,5488,611.916666666667,589.616666666667,1201.53333333333,2495,2584,91.5596330275229,-89
202687,Bismack Biyombo,-3.39070893103863,0.876455510641003,-2.51425342039763,262,74,235,82,3436,3540,6976,743.233333333333,751.916666666667,1495.15,2975,3397,86.5832363213039,-422
203496,Robert Covington,0.853522369282843,-3.38310100637109,-2.52957863708824,95,263,236,80,6064,6002,12066,1225.16666666667,1292.81666666667,2517.98333333333,5871,5307,96.8172823218998,564
200794,Paul Millsap,-1.40798921744926,-1.13555586910051,-2.54354508654977,216,211,237,37,2566,2571,5137,545.033333333333,550.633333333333,1095.66666666667,2508,2394,97.7396726422447,114
202704,Reggie Jackson,-0.00618140999301912,-2.60410872931149,-2.6102901393045,142,250,238,45,2778,2716,5494,611.65,582.566666666667,1194.21666666667,2593,2567,93.3405327573794,26
1627742,Brandon Ingram,-2.81908468452477,0.14666220170132,-2.67242248282345,254,117,239,59,4811,4753,9564,958.083333333333,1009.3,1967.38333333333,4347,4468,90.3554354604032,-121
2772,Trevor Ariza,-0.868890560414757,-1.81830313799601,-2.68719369841077,194,233,240,67,5318,5298,10616,1120.58333333333,1147.91666666667,2268.5,5315,4943,99.943587814968,372
1628414,Sindarius Thornwell,-1.73002349679527,-1.06876583101481,-2.79878932781008,233,204,241,69,2731,2779,5510,561.683333333333,593.066666666667,1154.75,2522,2601,92.3471255950201,-79
1628381,John Collins,-1.27865113812439,-1.52362933305111,-2.8022804711755,213,229,242,74,4172,4246,8418,894.766666666667,888,1782.76666666667,3764,3988,90.2205177372963,-224
201571,D.J. Augustin,-0.59058278352225,-2.24265358789925,-2.8332363714215,179,244,243,75,4078,4143,8221,905.2,851.583333333333,1756.78333333333,3754,3868,92.0549288867092,-114
1627734,Domantas Sabonis,-1.78976883190348,-1.09191396254291,-2.88168279444639,236,207,244,74,4188,4179,8367,893.7,915.95,1809.65,3945,3891,94.1977077363897,54
201585,Kosta Koufos,-2.55131904203418,-0.420941489928473,-2.97226053196265,252,165,245,71,3145,3123,6268,702.216666666667,686.716666666667,1388.93333333333,2752,2980,87.5039745627981,-228
1626204,Larry Nance Jr.,-0.635807826897155,-2.50670061120398,-3.14250843810113,183,247,246,66,3411,3400,6811,683.916666666667,737.8,1421.71666666667,3135,3113,91.9085312225154,22
203500,Steven Adams,-2.82219855336392,-0.35625047203921,-3.17844902540314,256,157,247,76,6132,5727,11859,1194.86666666667,1281.66666666667,2476.53333333333,5700,5383,92.9549902152642,317
1627756,Denzel Valentine,-3.23246480520815,0.0367036747522542,-3.19576113045589,261,127,248,77,4927,4801,9728,1019.76666666667,1070.33333333333,2090.1,4404,4694,89.3850213111427,-290
2548,Dwyane Wade,-1.83367794189784,-1.4332886078496,-3.26696654974744,237,224,249,67,3643,3625,7268,768.133333333333,770.683333333333,1538.81666666667,3427,3409,94.0708207521274,18
204456,T.J. McConnell,-2.03169216761496,-1.27258972778845,-3.30428189540342,244,218,250,76,4088,4149,8237,845.316666666667,863.066666666667,1708.38333333333,3770,3834,92.2211350293542,-64
204001,Kristaps Porzingis,-0.698183171483465,-2.65134090417508,-3.34952407565854,188,252,251,48,3627,3612,7239,782.15,765.366666666667,1547.51666666667,3369,3361,92.8866832092639,8
202066,Garrett Temple,-2.2156134451808,-1.19479355711175,-3.41040700229255,247,213,252,65,3692,3638,7330,830.566666666667,779.583333333333,1610.15,3261,3514,88.3261105092091,-253
1626169,Stanley Johnson,-1.57818302219821,-1.86710245389532,-3.44528547609353,225,235,253,69,4373,4342,8715,952.383333333333,934.733333333333,1887.11666666667,4034,4060,92.2478847473131,-26
202334,Ed Davis,-0.244659150606633,-3.22387898652209,-3.46853813712872,156,261,254,78,3381,3354,6735,767.35,701.766666666667,1469.11666666667,3179,3065,94.0254362614611,114
202355,Hassan Whiteside,-3.42767873605895,-0.0748549269352032,-3.50253366299415,263,135,255,54,3187,3145,6332,704.533333333333,655.966666666667,1360.5,2855,2909,89.5826796360213,-54
1627812,Yogi Ferrell,-0.634411503221817,-3.05629322360376,-3.69070472682557,182,259,256,82,5102,5177,10279,1162.31666666667,1113.81666666667,2276.13333333333,4810,4772,94.2767542140337,38
1627749,Dejounte Murray,-1.09352892667559,-2.99920030983645,-4.09272923651204,202,257,257,81,3997,3920,7917,889.366666666667,839.483333333333,1728.85,3644,3454,91.1683762822117,190
203382,Aron Baynes,-3.09563337253383,-1.22699150021207,-4.3226248727459,260,214,258,81,3323,3308,6631,733.616666666667,729.566666666667,1463.18333333333,3061,2880,92.1155582305146,181
202711,Bojan Bogdanovic,-1.33849731254107,-3.03784492330666,-4.37634223584773,215,258,259,80,5619,5717,11336,1208.26666666667,1240.78333333333,2449.05,5360,5264,95.3906389037195,96
2738,Andre Iguodala,-1.89824637139376,-2.67417723195231,-4.57242360334607,238,253,260,63,3731,3856,7587,773.183333333333,828.75,1601.93333333333,3686,3432,98.7938890377915,254
101139,CJ Miles,-1.66467420720172,-2.97178292231333,-4.63645712951505,230,256,261,70,3162,3147,6309,663,674.2,1337.2,3065,2819,96.932321315623,246
2200,Pau Gasol,-2.48455243406119,-2.25821773338384,-4.74277016744503,251,245,262,77,4103,4108,8211,928.7,877.4,1806.1,3726,3691,90.8116012673653,35
203994,Jusuf Nurkic,-2.86238913538615,-2.90916359905328,-5.77155273443943,258,254,263,79,4870,4848,9718,1056.11666666667,1025.93333333333,2082.05,4557,4423,93.5728952772074,134
