id_player,name_player,orapm,drapm,rapm,orapm_rnk,drapm_rnk,rapm_rnk,gp_calc_total,poss_calc_o,poss_calc_d,poss_calc_total,mp_calc_o,mp_calc_d,mp_calc_total,pts_calc_o,pts_calc_d,pts_o_per100_calc,pm_calc
201575,Brandon Rush,2.00669933079556,2.49911579342318,4.50581512421874,24,1,1,72,2448,2558,5006,499.75,546.516666666667,1046.26666666667,2413,2423,98.5702614379085,-10
202083,Wesley Matthews,2.63628780080001,1.06336587688588,3.69965367768589,7,19,2,78,5852,5956,11808,1350.46666666667,1287.18333333333,2637.65,5650,5548,96.5481886534518,102
202704,Reggie Jackson,2.95312517585095,0.60829442220798,3.56141959805893,4,53,3,79,5732,5466,11198,1207.9,1202.76666666667,2410.66666666667,5232,5079,91.2770411723657,153
202681,Kyrie Irving,1.97697008950992,1.08847424544639,3.06544433495631,25,16,4,53,3788,3686,7474,853.583333333333,801.65,1655.23333333333,3642,3433,96.1457233368532,209
101108,Chris Paul,3.02459256364704,-0.0993808181489814,2.92521174549806,3,132,5,74,5556,5673,11229,1193.38333333333,1220.78333333333,2414.16666666667,5503,4992,99.0460763138949,511
202388,Donald Sloan,2.08497470242523,0.829898285214872,2.9148729876401,20,30,6,61,2967,3007,5974,662.783333333333,652.583333333333,1315.36666666667,2753,2878,92.7873272665993,-125
204456,T.J. McConnell,2.44375291665453,0.465967485080785,2.90972040173531,12,62,7,81,3716,3781,7497,824.616666666667,781.533333333333,1606.15,3288,3570,88.4822389666308,-282
203141,Mirza Teletovic,1.82440645221083,1.03355343183907,2.8579598840499,31,23,8,79,4072,4048,8120,837.416666666667,846.5,1683.91666666667,3707,3890,91.0363457760314,-183
201950,Jrue Holiday,2.16009754709274,0.667257655563419,2.82735520265616,17,45,9,65,4302,4191,8493,869.983333333333,954.866666666667,1824.85,4023,3991,93.5146443514645,32
977,Kobe Bryant,1.28800301669735,1.52263521597635,2.81063823267371,55,7,10,66,4340,4400,8740,957.816666666667,894.5,1852.31666666667,3792,4358,87.3732718894009,-566
202685,Jonas Valanciunas,1.97249084700143,0.79109724367385,2.76358809067528,26,33,11,60,3509,3422,6931,817.933333333333,728.9,1546.83333333333,3349,3238,95.4402963807352,111
203110,Draymond Green,3.65290179701152,-1.05976940649708,2.59313239051444,1,246,12,81,6725,6866,13591,1307.9,1496.45,2804.35,6992,5913,103.970260223048,1079
201144,Mike Conley,2.55224028969392,0.0383860359867168,2.59062632568064,9,114,13,56,3901,3910,7811,907.433333333333,844.866666666667,1752.3,3625,3590,92.924891053576,35
101138,Brandon Bass,2.82420233947587,-0.300368377979131,2.52383396149674,5,161,14,66,3124,3118,6242,674.733333333333,667.283333333333,1342.01666666667,2874,2934,91.9974391805378,-60
2544,LeBron James,3.13693739081855,-0.715752740389932,2.42118465042861,2,223,15,76,6211,6058,12269,1384.83333333333,1319.8,2704.63333333333,6069,5477,97.7137336982773,592
203084,Harrison Barnes,2.43443633044968,-0.0390526099768101,2.39538372047286,13,122,16,66,4810,4882,9692,982.116666666667,1059.33333333333,2041.45,4787,4380,99.5218295218295,407
2225,Tony Parker,2.45115380003233,-0.165783891157062,2.28536990887527,11,149,17,72,4376,4378,8754,1034.38333333333,938.25,1972.63333333333,4192,3782,95.7952468007313,410
201142,Kevin Durant,2.68446192739323,-0.483181415395575,2.20128051199765,6,193,18,72,6243,6148,12391,1250.91666666667,1326.61666666667,2577.53333333333,6113,5475,97.9176677879225,638
202738,Isaiah Thomas,1.95798578387944,0.184896641557976,2.14288242543741,28,98,19,82,6412,6372,12784,1259.08333333333,1383.76666666667,2642.85,5985,5740,93.3406113537118,245
2546,Carmelo Anthony,1.56116866450475,0.540234063148978,2.10140272765373,43,58,20,72,5736,5758,11494,1298.33333333333,1229.45,2527.78333333333,5293,5327,92.2768479776848,-34
101123,Gerald Green,2.06173821085912,0.0395787970107764,2.10131700786989,22,112,21,69,3475,3504,6979,783.783333333333,769.333333333333,1553.11666666667,3197,3175,92,22
202703,Nikola Mirotic,2.23513762927571,-0.149699945242146,2.08543768403356,15,141,22,66,3792,3837,7629,813.533333333333,824.75,1638.28333333333,3522,3507,92.879746835443,15
203499,Shane Larkin,1.26873999144311,0.774099816585806,2.04283980802892,57,35,23,78,4049,4024,8073,881.266666666667,862.85,1744.11666666667,3547,3886,87.6018770066683,-339
202691,Klay Thompson,2.11816965752817,-0.153143232234779,1.96502642529339,18,144,24,80,6258,6477,12735,1242.7,1407.73333333333,2650.43333333333,6495,5651,103.787152444871,844
203081,Damian Lillard,0.907677557178329,1.03679504423125,1.94447260140957,76,22,25,75,6347,6294,12641,1353.58333333333,1320.21666666667,2673.8,6000,5921,94.5328501654325,79
101112,Channing Frye,1.90313469268295,0.0173665782692216,1.92050127095217,29,117,26,70,2664,2658,5322,598.616666666667,594.816666666667,1193.43333333333,2499,2408,93.8063063063063,91
2403,Nene,1.72214199516088,0.189674701403949,1.91181669656483,38,96,27,57,2520,2558,5078,515.383333333333,573.55,1088.93333333333,2374,2318,94.2063492063492,56
203095,Evan Fournier,1.12190366533649,0.767714650705624,1.88961831604212,63,36,28,79,5885,5893,11778,1269.56666666667,1292.33333333333,2561.9,5381,5544,91.4358538657604,-163
200755,JJ Redick,2.07989372666697,-0.190617296666506,1.88927643000046,21,151,29,75,4803,4904,9707,1031.28333333333,1058.2,2089.48333333333,4736,4278,98.6050385175932,458
201942,DeMar DeRozan,1.41249001619599,0.471965040658535,1.88445505685452,48,61,30,78,6370,6282,12652,1464.41666666667,1337.86666666667,2802.28333333333,6005,5833,94.2700156985871,172
201935,James Harden,1.55543040190079,0.326404617473448,1.88183501937424,44,78,31,82,7462,7411,14873,1502.43333333333,1620.7,3123.13333333333,6988,6872,93.6478155990351,116
2747,JR Smith,1.21272763399335,0.643895637649114,1.85662327164246,58,49,32,77,5411,5274,10685,1216.85,1141.95,2358.8,5204,4895,96.1744594344853,309
202322,John Wall,1.59990099109587,0.217251374687351,1.81715236578322,39,89,33,77,6503,6505,13008,1321.68333333333,1453.81666666667,2775.5,6053,5987,93.0801168691373,66
201567,Kevin Love,1.80387248762422,4.20492134262432e-05,1.80391453683764,32,118,34,77,5474,5329,10803,1231.03333333333,1179.71666666667,2410.75,5270,4883,96.2732919254658,387
201962,Toney Douglas,1.00602446447658,0.797564524756501,1.80358898923308,68,32,35,61,2971,2914,5885,623.35,637.166666666667,1260.51666666667,2744,2876,92.3594749242679,-132
201569,Eric Gordon,1.80140027455628,-0.0159859408116842,1.78541433374459,33,120,36,45,3405,3438,6843,722.7,755.9,1478.6,3140,3213,92.2173274596182,-73
201937,Ricky Rubio,2.27274041324674,-0.511083760767749,1.76165665247899,14,197,37,76,5379,5407,10786,1143.41666666667,1171.96666666667,2315.38333333333,5055,5002,93.9765755716676,53
201939,Stephen Curry,2.63279911749132,-0.878608674447916,1.7541904430434,8,236,38,79,6517,6645,13162,1256.28333333333,1438.91666666667,2695.2,6775,5754,103.958876783796,1021
202688,Brandon Knight,0.549332345320485,1.16100073238492,1.7103330777054,103,12,39,52,4479,4426,8905,927.166666666667,943.366666666667,1870.53333333333,3977,4195,88.7921411029248,-218
200746,LaMarcus Aldridge,1.5145676637308,0.186833694730472,1.70140135846127,45,97,40,74,5013,5007,10020,1171.03333333333,1086.86666666667,2257.9,4851,4339,96.7684021543986,512
201167,Arron Afflalo,0.821059380478584,0.878648004952032,1.69970738543062,84,28,41,71,5258,5331,10589,1209.46666666667,1146.71666666667,2356.18333333333,4811,4968,91.4986686953214,-157
202498,Lance Thomas,1.73257268909251,-0.0994748761989682,1.63309781289354,36,133,42,59,2988,3081,6069,675.583333333333,652.45,1328.03333333333,2766,2784,92.570281124498,-18
203078,Bradley Beal,0.570394952265423,1.05905239954851,1.62944735181393,101,21,43,55,4048,4000,8048,816.266666666667,887.65,1703.91666666667,3740,3750,92.3913043478261,-10
203079,Dion Waiters,1.75693654304156,-0.138542634412547,1.61839390862901,35,139,44,78,5244,5109,10353,1069.31666666667,1082.4,2151.71666666667,4926,4708,93.9359267734554,218
203476,Gorgui Dieng,2.10373709085886,-0.495251435305497,1.60848565555336,19,196,45,82,5054,5139,10193,1107.83333333333,1108,2215.83333333333,4748,4788,93.9453897902651,-40
202335,Patrick Patterson,2.2142282057872,-0.61675250103299,1.59747570475421,16,211,46,79,4548,4530,9078,1038.48333333333,977.883333333333,2016.36666666667,4384,4019,96.3940193491645,365
1626161,Willie Cauley-Stein,2.05222892490807,-0.470289304837007,1.58193962007106,23,188,47,66,3387,3401,6788,682.266666666667,721.933333333333,1404.2,3128,3188,92.3531148509005,-60
101181,Jose Calderon,0.978126574708802,0.592758018743174,1.57088459345198,72,54,48,72,4509,4564,9073,1036.15,980.366666666667,2016.51666666667,4148,4251,91.993790197383,-103
203462,Archie Goodwin,-0.28685293574549,1.84173187916862,1.55487894342313,162,3,49,57,2695,2633,5328,557.316666666667,551.466666666667,1108.78333333333,2373,2593,88.0519480519481,-220
203382,Aron Baynes,-0.0790396626137496,1.60816282779195,1.5291231651782,150,5,50,81,2857,2786,5643,620.616666666667,607.45,1228.06666666667,2535,2640,88.7294364718236,-105
202694,Marcus Morris,1.30281235529496,0.205174004229479,1.50798635952444,54,92,51,80,6670,6425,13095,1431.41666666667,1411.58333333333,2843,6061,5921,90.8695652173913,140
203903,Jordan Clarkson,0.362802627186815,1.14261324541791,1.50541587260473,118,13,52,79,5915,5920,11835,1310.46666666667,1224.33333333333,2534.8,5123,5756,86.6103127641589,-633
1891,Jason Terry,0.91319679115695,0.516661978075647,1.4298587692326,75,60,53,72,2992,2979,5971,592.166666666667,659.566666666667,1251.73333333333,2766,2787,92.4465240641711,-21
202340,Avery Bradley,1.46620628839708,-0.0840263757827419,1.38217991261434,46,127,54,76,6057,6078,12135,1199.11666666667,1322.86666666667,2521.98333333333,5684,5430,93.841835892356,254
1626164,Devin Booker,0.609829146369206,0.761859961686692,1.3716891080559,97,37,55,76,5029,5000,10029,1051.3,1047.98333333333,2099.28333333333,4372,4765,86.9357725193876,-393
202695,Kawhi Leonard,2.50187789183675,-1.13709634159573,1.36478155024102,10,248,56,72,5323,5293,10616,1231.1,1144.61666666667,2375.71666666667,5172,4490,97.1632538042457,682
1626171,Bobby Portis,0.230663921629807,1.11225477682397,1.34291869845378,127,14,57,62,2556,2545,5101,551.133333333333,551.533333333333,1102.66666666667,2263,2431,88.5367762128326,-168
203490,Otto Porter Jr.,0.963277317094274,0.369965355840353,1.33324267293463,74,74,58,75,5332,5307,10639,1066.03333333333,1197.26666666667,2263.3,4939,4901,92.629407351838,38
200826,J.J. Barea,0.500153255776357,0.829993435527912,1.33014669130427,106,29,59,74,3783,3857,7640,851.216666666667,808.716666666667,1659.93333333333,3553,3627,93.9201691779011,-74
200752,Rudy Gay,0.500803667749791,0.736052121634792,1.23685578938458,105,41,60,70,5713,5723,11436,1148.16666666667,1221.23333333333,2369.4,5251,5343,91.9131804656048,-92
203486,Mason Plumlee,0.556864360944384,0.623715813749928,1.18058017469431,102,51,61,82,4845,4837,9682,1040.6,1034.85,2075.45,4598,4527,94.9019607843137,71
203506,Victor Oladipo,1.88322982575928,-0.704842274773983,1.1783875509853,30,222,62,72,5527,5590,11117,1176,1199.38333333333,2375.38333333333,5090,5110,92.0933598697304,-20
101150,Lou Williams,0.100619481257887,1.05907331394028,1.15969279519817,139,20,63,67,4445,4486,8931,966.75,939.6,1906.35,3950,4333,88.8638920134983,-383
203952,Andrew Wiggins,0.829695335547611,0.309626132538645,1.13932146808626,83,82,64,81,6593,6591,13184,1409.75,1430.26666666667,2840.01666666667,6123,6189,92.871227059002,-66
2207,Joe Johnson,0.887601924101359,0.249171190226197,1.13677311432756,78,87,65,81,6122,6108,12230,1372.11666666667,1322.13333333333,2694.25,5704,5770,93.172165958837,-66
203933,T.J. Warren,0.214227523629717,0.914144907360192,1.12837243098991,131,27,66,47,2576,2506,5082,537.066666666667,530.316666666667,1067.38333333333,2292,2411,88.9751552795031,-119
1626144,Emmanuel Mudiay,0.467782157008005,0.657991696713167,1.12577385372117,109,47,67,68,4913,4790,9703,1032.81666666667,1027.65,2060.46666666667,4421,4547,89.9857520863016,-126
2755,Kevin Martin,-0.346024470375189,1.43910113995119,1.093076669576,166,8,68,55,2530,2524,5054,557.833333333333,534.95,1092.78333333333,2262,2396,89.4071146245059,-134
101141,Ersan Ilyasova,-1.17453556703213,2.2567673545009,1.08223178746877,230,2,69,74,4503,4274,8777,943.233333333333,933.95,1877.18333333333,3959,4068,87.9191650011104,-109
101162,Marcin Gortat,0.858289142810586,0.204616677524533,1.06290582033512,80,93,70,75,5279,5272,10551,1066.05,1189.65,2255.7,4867,4857,92.1954915703732,10
202696,Nikola Vucevic,0.310581977316091,0.749078227229765,1.05966020454586,121,38,71,65,4711,4631,9342,1025.23333333333,1006.95,2032.18333333333,4295,4354,91.1696030566759,-59
202330,Gordon Hayward,0.993299809222789,0.0533400785673315,1.04663988779012,70,109,72,80,6461,6337,12798,1498.5,1388.13333333333,2886.63333333333,5874,5796,90.9147190837332,78
201566,Russell Westbrook,1.77313136324441,-0.728614959715031,1.04451640352937,34,224,73,80,6698,6548,13246,1322.56666666667,1423.7,2746.26666666667,6497,5842,96.999104210212,655
203463,Ben McLemore,0.866075832078698,0.156334738975211,1.02241057105391,79,100,74,68,3540,3504,7044,688.1,744.666666666667,1432.76666666667,3269,3234,92.3446327683616,35
201583,Ryan Anderson,0.365942982604834,0.63298981984987,0.998932802454704,117,50,75,66,4767,4652,9419,980.566666666667,1031.3,2011.86666666667,4439,4443,93.1193622823579,-4
201143,Al Horford,1.57507904919973,-0.577545191639735,0.997533857559998,42,202,76,82,5977,6229,12206,1258.46666666667,1354.73333333333,2613.2,5567,5373,93.1403714237912,194
203086,Meyers Leonard,1.05665391043505,-0.0643748691462144,0.992279041288835,65,125,77,61,3097,3016,6113,681.05,647.783333333333,1328.83333333333,2924,2842,94.4139489828867,82
203521,Matthew Dellavedova,1.38565788086743,-0.403897083982386,0.98176079688504,51,179,78,76,4258,4179,8437,947.766666666667,926,1873.76666666667,4096,3735,96.195396899953,361
2571,Leandro Barbosa,0.755171187055266,0.20526305865618,0.960434245711447,89,91,79,68,2585,2588,5173,522.5,555.033333333333,1077.53333333333,2427,2387,93.8878143133462,40
200768,Kyle Lowry,1.72571424537509,-0.765663787088981,0.960050458286106,37,226,80,77,6446,6338,12784,1473.55,1363.25,2836.8,6142,5758,95.2838969903816,384
203944,Julius Randle,-0.884973600574221,1.84074312056503,0.955769519990806,211,4,81,81,5313,5268,10581,1179.01666666667,1095.96666666667,2274.98333333333,4573,5239,86.0718991153774,-666
202718,Chandler Parsons,1.39522799771623,-0.456095994941919,0.939132002774309,49,185,82,61,3946,4094,8040,909.066666666667,882.216666666667,1791.28333333333,3749,3738,95.0076026355803,11
202708,Norris Cole,0.222998853106758,0.715416964670805,0.938415817777563,129,43,83,45,2783,2753,5536,576,615.133333333333,1191.13333333333,2529,2650,90.8731584620913,-121
201588,George Hill,1.38714104041718,-0.470728548972095,0.916412491445085,50,189,84,74,5768,5825,11593,1247.65,1260.66666666667,2508.31666666667,5268,5159,91.3314840499307,109
201584,Courtney Lee,1.12352852037537,-0.219473152816902,0.904055367558467,62,155,85,79,5184,5252,10436,1195.01666666667,1126.86666666667,2321.88333333333,4933,4792,95.1581790123457,141
2564,Boris Diaw,1.14142926861672,-0.298650914846814,0.842778353769909,61,159,86,76,3147,3175,6322,712.883333333333,675.1,1387.98333333333,3029,2752,96.250397203686,277
201571,D.J. Augustin,0.98127157375295,-0.151213322619107,0.830058251133843,71,142,87,62,2750,2734,5484,600.233333333333,573.166666666667,1173.4,2518,2541,91.5636363636364,-23
203459,Allen Crabbe,0.310282695557011,0.51874129013704,0.829023985694051,122,59,88,81,4991,4952,9943,1069.56666666667,1032.23333333333,2101.8,4639,4605,92.9473051492687,34
201967,Dante Cunningham,-0.50374426558387,1.31864883941492,0.814904573831046,178,10,89,80,4541,4466,9007,957.466666666667,1012.05,1969.51666666667,4142,4400,91.2133891213389,-258
203114,Khris Middleton,1.16903463739581,-0.355215733979772,0.813818903416038,59,167,90,79,6558,6643,13201,1403.36666666667,1442.48333333333,2845.85,6045,6067,92.1774931381519,-22
203076,Anthony Davis,-0.276051212312157,1.08074962179098,0.804698409478818,160,18,91,61,5029,4961,9990,1053.93333333333,1102.65,2156.58333333333,4582,4771,91.1115529926427,-189
2594,Kyle Korver,1.97054340192433,-1.18301231883765,0.787531083086679,27,249,92,80,5490,5643,11133,1159.38333333333,1218.71666666667,2378.1,5142,4862,93.6612021857924,280
201577,Robin Lopez,-0.401914241394496,1.17604675202631,0.774132510631815,173,11,93,82,4963,4975,9938,1129.28333333333,1070.13333333333,2199.41666666667,4480,4606,90.2679830747532,-126
201954,Darren Collison,0.423693523517761,0.349259962910485,0.772953486428246,113,75,94,74,5331,5387,10718,1080.25,1139.31666666667,2219.56666666667,4918,5031,92.2528606265241,-113
1718,Paul Pierce,0.620669587884506,0.137290587055102,0.757960174939608,96,101,95,68,2708,2835,5543,609.466666666667,610.816666666667,1220.28333333333,2585,2560,95.4579025110783,25
202397,Ish Smith,0.459902281116229,0.297504368694012,0.75740664981024,111,83,96,77,5236,5350,10586,1115.93333333333,1117.91666666667,2233.85,4691,5038,89.5912910618793,-347
202683,Enes Kanter,0.851746014842158,-0.0974636298118712,0.754282385030286,81,130,97,82,4154,4030,8184,864.6,853.216666666667,1717.81666666667,3881,3737,93.4280211844006,144
203999,Nikola Jokic,0.609412598367598,0.0950855727075916,0.70449817107519,98,104,98,80,4066,3868,7934,850.583333333333,873.166666666667,1723.75,3678,3577,90.4574520413182,101
201145,Jeff Green,1.0459324403679,-0.352948125941759,0.69298431442614,67,166,99,80,5013,5129,10142,1141.83333333333,1106.68333333333,2248.51666666667,4630,4676,92.359864352683,-46
201587,Nicolas Batum,1.28258733794182,-0.598865619617807,0.68372171832401,56,207,100,70,5524,5582,11106,1233.33333333333,1204.71666666667,2438.05,5305,5090,96.0354815351195,215
201599,DeAndre Jordan,0.840334730794374,-0.158911541797409,0.681423188996966,82,147,101,77,5936,6066,12002,1277.85,1312.48333333333,2590.33333333333,5812,5335,97.911051212938,477
2419,Tayshaun Prince,0.994402388124744,-0.32647809899496,0.667924289129784,69,162,102,77,3254,3334,6588,724.766666666667,731.933333333333,1456.7,2927,3023,89.9508297480025,-96
202720,Jon Leuer,0.757857986104288,-0.130696109439404,0.627161876664885,88,137,103,67,3015,3013,6028,615.766666666667,637.966666666667,1253.73333333333,2699,2777,89.5190713101161,-78
203460,Andre Roberson,-0.0259226898445987,0.649241097336957,0.623318407492358,143,48,104,70,3676,3648,7324,738.466666666667,804.583333333333,1543.05,3499,3225,95.1849836779108,274
201160,Jason Smith,0.477235509030494,0.136374778837856,0.61361028786835,107,102,105,76,2691,2706,5397,587.6,590.283333333333,1177.88333333333,2473,2511,91.8989223337049,-38
201980,Danny Green,1.58594886196691,-0.998767277168497,0.587181584798414,40,243,106,79,4595,4528,9123,1062.48333333333,984.916666666667,2047.4,4379,3856,95.2992383025027,523
202328,Greg Monroe,0.294557842207816,0.291131268221431,0.585689110429247,123,84,107,79,5273,5301,10574,1143.91666666667,1163.41666666667,2307.33333333333,4858,4983,92.1297174284089,-125
201585,Kosta Koufos,-0.0426924989419152,0.611218726552777,0.568526227610862,144,52,108,78,3537,3563,7100,730.583333333333,751.383333333333,1481.96666666667,3127,3374,88.4082555838281,-247
203914,Gary Harris,0.108206266771262,0.442998684644658,0.55120495141592,137,64,109,76,5800,5622,11422,1217.76666666667,1211.21666666667,2428.98333333333,5205,5396,89.7413793103448,-191
203897,Zach LaVine,-0.566415375465821,1.08950064295422,0.523085267488403,183,15,110,82,5284,5382,10666,1125.95,1161.18333333333,2287.13333333333,4881,5183,92.3732021196064,-302
202682,Derrick Williams,-0.172116635190457,0.658295960772137,0.486179325581681,155,46,111,80,3242,3304,6546,729.75,700.383333333333,1430.13333333333,2832,3071,87.3534855027761,-239
203526,Raul Neto,1.32877357992278,-0.846642776213336,0.482130803709441,53,233,112,81,3235,3230,6465,777.883333333333,712.583333333333,1490.46666666667,2967,2866,91.7156105100464,101
203138,Hollis Thompson,0.43430934171815,0.0477863701113298,0.48209571182948,112,111,113,77,5058,5197,10255,1090.16666666667,1062.61666666667,2152.78333333333,4457,4858,88.1178331356267,-401
2547,Chris Bosh,0.973975999227654,-0.4936138875635,0.480362111664154,73,195,114,53,3882,3964,7846,898.283333333333,874.616666666667,1772.9,3550,3533,91.4477073673364,17
1717,Dirk Nowitzki,1.05524122066037,-0.597137417510786,0.458103803149583,66,204,115,75,5267,5346,10613,1217.38333333333,1142.43333333333,2359.81666666667,5045,4888,95.7850768938675,157
201977,Marcus Thornton,0.583147682150288,-0.15276089684447,0.430386785305818,100,143,116,61,2681,2662,5343,537.066666666667,568.7,1105.76666666667,2460,2438,91.7568071615069,22
2216,Zach Randolph,0.106179982773927,0.321222245466209,0.427402228240136,138,79,117,68,4565,4493,9058,1044.31666666667,967.083333333333,2011.4,4111,4195,90.0547645125958,-84
2561,David West,1.45630469181849,-1.04999525521037,0.406309436608113,47,245,118,78,3139,3140,6279,716.85,679.75,1396.6,3012,2665,95.9541255176808,347
204060,Joe Ingles,0.0275540262953703,0.377365114535414,0.404919140830785,142,72,119,81,2794,2739,5533,648.15,592.783333333333,1240.93333333333,2456,2480,87.9026485325698,-24
2548,Dwyane Wade,-0.575283742950006,0.961240044780851,0.385956301830845,184,25,120,74,5070,5127,10197,1157.98333333333,1089.38333333333,2247.36666666667,4695,4711,92.603550295858,-16
203917,Nik Stauskas,-0.698259993318295,1.08099328252768,0.382733289209383,194,17,121,73,4260,4331,8591,923.116666666667,895.283333333333,1818.4,3649,4099,85.6572769953052,-450
201956,Omri Casspi,0.708252005808935,-0.376992105748637,0.331259900060299,90,171,122,69,4579,4593,9172,907.966666666667,973.033333333333,1881,4238,4206,92.552959161389,32
202324,Derrick Favors,0.797432975319563,-0.482771080948801,0.314661894370761,85,192,123,62,4394,4274,8668,1037.75,937.883333333333,1975.63333333333,4012,3946,91.3063268092854,66
1626157,Karl-Anthony Towns,-0.14080985656023,0.439701781925459,0.298891925365228,152,65,124,82,6063,6076,12139,1291.48333333333,1326.15,2617.63333333333,5647,5763,93.1387102094673,-116
200794,Paul Millsap,0.666816226440274,-0.368547094545611,0.298269131894662,94,170,125,81,6108,6290,12398,1290.45,1345.06666666667,2635.51666666667,5696,5488,93.2547478716437,208
200765,Rajon Rondo,-0.731153972568439,1.01530305857558,0.284149086007142,198,24,126,72,6167,6221,12388,1225.9,1306.01666666667,2531.91666666667,5645,5807,91.5355926706665,-162
202339,Eric Bledsoe,1.11951302378459,-0.841642934655163,0.27787008912943,64,231,127,31,2532,2541,5073,517.733333333333,539.233333333333,1056.96666666667,2293,2328,90.5608214849921,-35
203937,Kyle Anderson,1.3330016668007,-1.0780372900413,0.254964376759408,52,247,128,78,2737,2785,5522,643.25,593.983333333333,1237.23333333333,2632,2431,96.1636828644501,201
101109,Raymond Felton,0.330614499399836,-0.101285684479717,0.229328814920119,119,134,129,80,4928,5054,9982,1131.98333333333,1059.46666666667,2191.45,4618,4662,93.7094155844156,-44
201586,Serge Ibaka,0.0962609719086662,0.0734749015724374,0.169735873481104,140,106,130,78,6001,5935,11936,1203.31666666667,1287.83333333333,2491.15,5802,5309,96.6838860189968,493
203115,Will Barton,-0.237261417754001,0.404496945045764,0.167235527291763,159,68,131,82,5535,5457,10992,1174.73333333333,1177.21666666667,2351.95,4969,5127,89.7741644083108,-158
203090,Maurice Harkless,0.207947578571506,-0.0512340278645931,0.156713550706913,133,123,132,78,3455,3452,6907,737.7,715.366666666667,1453.06666666667,3182,3166,92.0984081041968,16
1938,Manu Ginobili,1.57515587421325,-1.42403263839329,0.151123235819954,41,258,133,58,2613,2646,5259,584.2,558.016666666667,1142.21666666667,2543,2215,97.3210868733257,328
201196,Ramon Sessions,-0.438609887734061,0.582505507372007,0.143895619637946,174,55,134,82,3914,3950,7864,794.583333333333,872.35,1666.93333333333,3583,3652,91.543178334185,-69
201988,Patty Mills,0.761334032649492,-0.618119583394779,0.143214449254713,87,212,135,81,3788,3808,7596,846.15,819.783333333333,1665.93333333333,3685,3293,97.2808870116156,392
203498,Shabazz Muhammad,-1.49326401296594,1.60485993083081,0.111595917864864,244,6,136,82,3882,3925,7807,832.133333333333,848.483333333333,1680.61666666667,3487,3758,89.8248325605358,-271
101139,CJ Miles,0.291864848508796,-0.192409657404011,0.0994551911047852,125,153,137,64,3448,3513,6961,723.683333333333,738.933333333333,1462.61666666667,3150,3167,91.3573085846868,-17
101107,Marvin Williams,0.693060005329607,-0.598849503795688,0.0942105015339193,91,206,138,81,5269,5283,10552,1184.81666666667,1140.01666666667,2324.83333333333,5072,4826,96.2611501233631,246
1626159,Justise Winslow,0.293378771395848,-0.205962745232916,0.0874160261629317,124,154,139,78,5041,5061,10102,1127.9,1101.9,2229.8,4612,4483,91.4897837730609,129
201166,Aaron Brooks,0.476645473044847,-0.390714693075674,0.0859307799691731,108,176,140,69,2569,2551,5120,553.316666666667,554.733333333333,1108.05,2317,2324,90.1907356948229,-7
202702,Kenneth Faried,-0.60210713656178,0.683335820856728,0.0812286842949479,188,44,141,67,4029,3871,7900,853.35,835.45,1688.8,3628,3749,90.0471581037478,-121
201572,Brook Lopez,0.213595454774905,-0.153357033673103,0.0602384211018019,132,146,142,73,5573,5527,11100,1237.6,1205.48333333333,2443.08333333333,5043,5225,90.4898618338417,-182
203507,Giannis Antetokounmpo,-0.494762031944664,0.547754615436653,0.052992583491989,177,57,143,80,6445,6481,12926,1386.33333333333,1428.26666666667,2814.6,5873,6049,91.1249030256012,-176
204038,Langston Galloway,-0.300040453071452,0.314544772839196,0.0145043197677437,163,81,144,82,4631,4655,9286,1025.11666666667,998.566666666667,2023.68333333333,4122,4228,89.0088533793997,-106
202697,Iman Shumpert,1.16166543528841,-1.18883280775391,-0.0271673724655044,60,250,145,54,2983,2960,5943,676.95,637.65,1314.6,2848,2639,95.4743546765002,209
203469,Cody Zeller,0.531318632274446,-0.602178151879406,-0.0708595196049592,104,209,146,73,4032,4007,8039,880.333333333334,882.416666666667,1762.75,3889,3715,96.453373015873,174
202391,Jeremy Lin,0.692331019919732,-0.766028658532673,-0.0736976386129413,92,227,147,78,4682,4730,9412,1043.65,1005.96666666667,2049.61666666667,4328,4218,92.439128577531,110
201229,Anthony Tolliver,-0.999990638628984,0.919960640266244,-0.0800299983627402,219,26,148,72,3109,2996,6105,672.916666666667,664.516666666667,1337.43333333333,2741,2765,88.1633965905436,-24
203468,CJ McCollum,-0.0725964875080336,-0.0360760226493852,-0.108672510157419,149,121,149,80,6519,6419,12938,1408.4,1360.55,2768.95,6079,5933,93.2504985427213,146
202331,Paul George,0.465218606470699,-0.619094751678951,-0.153876145208252,110,213,150,81,6614,6652,13266,1391.66666666667,1423.98333333333,2815.65,6055,5874,91.5482310250983,181
201945,Gerald Henderson,-0.155423969910326,-0.00670867487592495,-0.162132644786251,153,119,151,72,3355,3331,6686,734.083333333333,698.066666666667,1432.15,3090,3058,92.1013412816692,32
202710,Jimmy Butler,0.230221125804026,-0.402079417230652,-0.171858291426626,128,178,152,67,5736,5773,11509,1244.68333333333,1229.08333333333,2473.76666666667,5184,5184,90.3765690376569,0
202684,Tristan Thompson,-0.516111839779618,0.317443658386143,-0.198668181393475,181,80,153,81,5197,5058,10255,1164.7,1104.48333333333,2269.18333333333,4957,4597,95.3819511256494,360
2037,Jamal Crawford,-0.058606106023077,-0.142619963456523,-0.2012260694796,145,140,154,79,4867,4983,9850,1068.25,1051.83333333333,2120.08333333333,4541,4492,93.3018286418738,49
204001,Kristaps Porzingis,0.067593954266734,-0.278442001361531,-0.210848047094797,141,158,155,72,4591,4600,9191,1037.83333333333,992.133333333333,2029.96666666667,4207,4194,91.6358091918972,13
2736,Luol Deng,-0.0616485743600281,-0.183743213098284,-0.245391787458312,147,150,156,74,5441,5434,10875,1230.56666666667,1155.96666666667,2386.53333333333,5019,4968,92.2440727807388,51
202326,DeMarcus Cousins,-0.637521128799389,0.390240858476761,-0.247280270322629,190,70,157,65,5469,5453,10922,1082.78333333333,1157.36666666667,2240.15,5066,5006,92.6311940025599,60
203496,Robert Covington,-0.348156724089687,0.0941716010130276,-0.253985123076659,167,105,158,67,4456,4499,8955,956.266666666667,938.716666666667,1894.98333333333,3885,4149,87.1858168761221,-264
202344,Trevor Booker,0.407839038890518,-0.675122406778755,-0.267283367888237,115,217,159,79,3709,3618,7327,856.8,788.016666666667,1644.81666666667,3308,3207,89.1884605014829,101
200751,Randy Foye,0.411096350965563,-0.682373077538585,-0.271276726573022,114,219,160,81,3857,3814,7671,820.566666666667,815.15,1635.71666666667,3478,3415,90.1737101374125,63
200782,PJ Tucker,-0.732121789086315,0.448449456879847,-0.283672332206468,199,63,161,82,6054,5964,12018,1262.35,1261.88333333333,2524.23333333333,5269,5596,87.0333663693426,-327
201596,Mario Chalmers,0.907320069640887,-1.1959308347042,-0.288610765063313,77,252,162,61,3161,3177,6338,694.533333333333,677.216666666667,1371.75,2889,2791,91.3951281240114,98
203471,Dennis Schroder,0.606421034734062,-0.935640840212454,-0.329219805478392,99,241,163,80,3671,3762,7433,779.35,840.166666666667,1619.51666666667,3440,3192,93.7074366657587,248
202689,Kemba Walker,-0.361089167918693,0.0194346547561221,-0.341654513162571,168,116,164,81,6538,6560,13098,1465.63333333333,1413.71666666667,2879.35,6226,5997,95.2278984398899,229
1626163,Frank Kaminsky,-0.68975170883434,0.347360291994449,-0.342391416839891,193,76,165,81,3890,3904,7794,861.316666666667,842.1,1703.41666666667,3503,3541,90.0514138817481,-38
202699,Tobias Harris,-0.400747401280741,0.0486662156100247,-0.352081185670716,172,110,166,76,5773,5650,11423,1254.6,1248.08333333333,2502.68333333333,5233,5217,90.6461112073445,16
201976,Patrick Beverley,0.192856933605825,-0.556474222218246,-0.363617288612421,134,198,167,71,4813,4779,9592,973.483333333333,1057.48333333333,2030.96666666667,4536,4372,94.2447537918138,164
2772,Trevor Ariza,-0.802179549613433,0.425881660480967,-0.376297889132466,205,66,168,81,6780,6733,13513,1369.28333333333,1482.73333333333,2852.01666666667,6341,6310,93.5250737463127,31
201565,Derrick Rose,-1.14439450799332,0.738413004838428,-0.405981503154896,227,40,169,66,4883,4964,9847,1034.93333333333,1051.76666666667,2086.7,4371,4547,89.5146426377227,-176
203082,Terrence Ross,-0.0599352202992204,-0.367941464958718,-0.427876685257939,146,169,170,73,3918,3892,7810,900.766666666667,843.45,1744.21666666667,3679,3464,93.8999489535477,215
1626156,D'Angelo Russell,-0.712804606035375,0.249032380244358,-0.463772225791017,195,88,171,80,5225,5224,10449,1161.48333333333,1095.45,2256.93333333333,4499,5062,86.1052631578948,-563
203085,Austin Rivers,0.394650437999595,-0.894143808779627,-0.499493370780032,116,238,172,67,3339,3535,6874,734.433333333333,733.883333333333,1468.31666666667,3055,3149,91.4944594189877,-94
202362,Lance Stephenson,-0.546696278021352,0.0394315592785047,-0.507264718742848,182,113,173,69,3200,3175,6375,691,677.566666666667,1368.56666666667,2892,2946,90.375,-54
203926,Doug McDermott,-0.714254875740408,0.193978959168372,-0.520275916572035,197,95,174,81,4342,4354,8696,922.25,938.766666666667,1861.01666666667,3869,4026,89.1064025794565,-157
2733,Shaun Livingston,0.314796352496555,-0.843218730597554,-0.528422378100999,120,232,175,78,3534,3608,7142,730.466666666667,784.966666666667,1515.43333333333,3405,3203,96.3497453310696,202
201188,Marc Gasol,-0.375486649500146,-0.15329364321995,-0.528780292720096,169,145,176,52,3993,3975,7968,930.566666666667,857.583333333333,1788.15,3616,3612,90.5584773353369,4
201162,Jared Dudley,-0.0640919508643753,-0.481065976924666,-0.545157927789041,148,191,177,81,4857,4895,9752,995.733333333333,1099.46666666667,2095.2,4542,4492,93.514515132798,50
203497,Rudy Gobert,0.120933240917368,-0.67961034349305,-0.558677102575682,136,218,178,61,4236,4179,8415,1000.48333333333,924.133333333333,1924.61666666667,3868,3705,91.3125590179415,163
201579,Roy Hibbert,-1.88159740389882,1.31901789798505,-0.562579505913767,251,9,179,81,4296,4358,8654,974.866666666667,890.716666666667,1865.58333333333,3617,4250,84.1945996275605,-633
201609,Goran Dragic,0.625867358757218,-1.21917120034492,-0.593303841587698,95,253,180,72,5402,5386,10788,1205.91666666667,1148.91666666667,2354.83333333333,5017,4798,92.8730099962977,219
202693,Markieff Morris,-1.36379324429907,0.745509725823753,-0.618283518475317,241,39,181,64,3852,3764,7616,796.433333333333,820.966666666667,1617.4,3438,3527,89.2523364485981,-89
201933,Blake Griffin,-0.819970413727651,0.198608373837133,-0.621362039890517,206,94,182,35,2716,2726,5442,579.333333333333,585.983333333333,1165.31666666667,2573,2410,94.7349042709867,163
2585,Zaza Pachulia,-1.07884305769275,0.422577796092338,-0.656265261600416,224,67,183,76,4417,4463,8880,1023.4,973.933333333333,1997.33333333333,4080,4089,92.3703871405932,-9
201155,Rodney Stuckey,-0.581614458491093,-0.0977605234508565,-0.67937498194195,185,131,184,58,2907,2962,5869,630.066666666667,649.533333333333,1279.6,2623,2628,90.2304781561748,-5
2754,Tony Allen,-0.233017387591968,-0.459629741009233,-0.692647128601201,158,186,185,64,3685,3610,7295,826.216666666667,784.55,1610.76666666667,3267,3296,88.6567164179104,-29
2738,Andre Iguodala,-0.282542348930411,-0.411806717691808,-0.694349066622218,161,181,186,65,4152,4251,8403,823.366666666667,906.25,1729.61666666667,4129,3679,99.4460500963391,450
203109,Jae Crowder,0.216397490316009,-0.913536909028513,-0.697139418712505,130,239,187,73,5551,5570,11121,1086.55,1205.51666666667,2292.06666666667,5132,4935,92.4518104845974,197
2440,Matt Barnes,-0.77775531789921,0.0582034655957444,-0.719551852303466,203,108,188,76,5068,4973,10041,1116.56666666667,1072.55,2189.11666666667,4503,4682,88.8516179952644,-179
203918,Rodney Hood,-0.342047261024346,-0.378173908589212,-0.720221169613558,165,173,189,79,5511,5419,10930,1323.03333333333,1197.43333333333,2520.46666666667,5064,4955,91.8889493739793,109
101161,Amir Johnson,0.681895246859189,-1.41315698056654,-0.73126173370735,93,257,190,79,4257,4260,8517,838.933333333334,943.75,1782.68333333333,3956,3754,92.9292929292929,202
203087,Jeremy Lamb,0.771681710333483,-1.5269361408006,-0.755254430467117,86,260,191,66,2801,2818,5619,621.05,604.666666666667,1225.71666666667,2549,2399,91.0032131381649,150
203484,Kentavious Caldwell-Pope,-0.663224995922669,-0.102992887135486,-0.766217883058156,191,135,192,76,6640,6341,12981,1392.15,1393.98333333333,2786.13333333333,5979,5811,90.0451807228916,168
101114,Deron Williams,-0.381821830739154,-0.390417866827865,-0.772239697567019,170,175,193,65,4691,4796,9487,1070.91666666667,1031.1,2102.01666666667,4395,4366,93.6900447665743,29
201568,Danilo Gallinari,-0.998025725584738,0.215206630068909,-0.782819095515829,216,90,194,53,4356,4222,8578,928.8,908,1836.8,3892,4011,89.3480257116621,-119
202355,Hassan Whiteside,-0.393551424810384,-0.39857330951018,-0.792124734320564,171,177,195,73,4796,4802,9598,1086.08333333333,1034.95,2121.03333333333,4384,4296,91.4095079232694,88
201601,Luc Mbah a Moute,0.144417298996557,-0.945640520245546,-0.801223221248988,135,242,196,73,2836,2961,5797,620.283333333333,651.883333333333,1272.16666666667,2776,2537,97.8843441466855,239
2210,Richard Jefferson,-1.03939018231117,0.12929056389044,-0.910099618420725,221,103,197,74,2944,2948,5892,671.35,647.116666666667,1318.46666666667,2649,2692,89.9796195652174,-43
1626209,Mario Hezonja,-0.508827090180861,-0.404480921643222,-0.913308011824083,180,180,198,79,3250,3236,6486,699.75,707.65,1407.4,2959,3013,91.0461538461538,-54
203960,JaKarr Sampson,-0.588583608120294,-0.336005156331385,-0.92458876445168,187,163,199,73,2693,2717,5410,572.033333333333,575.433333333333,1147.46666666667,2344,2503,87.0404753063498,-159
202730,Lavoy Allen,-0.164495631266983,-0.774698215051224,-0.939193846318207,154,228,200,79,3677,3649,7326,789.633333333333,804.733333333333,1594.36666666667,3351,3170,91.1340766929562,181
202329,Al-Farouq Aminu,-0.998965518620705,0.0375636788251269,-0.961401839795578,218,115,201,82,5501,5500,11001,1174.88333333333,1159.55,2334.43333333333,5180,5111,94.1646973277586,69
201959,Taj Gibson,-0.713715362104645,-0.253952106719369,-0.967667468824014,196,157,202,73,4438,4523,8961,960.783333333333,969.866666666667,1930.65,3970,4073,89.4547093285264,-103
1626168,Trey Lyles,-1.25200144108448,0.277763088296996,-0.974238352787485,235,85,203,80,3007,3014,6021,725.716666666667,653.716666666667,1379.43333333333,2701,2759,89.8237445959428,-58
101133,Ian Mahinmi,-0.2329582005781,-0.791020454498355,-1.02397865507646,157,230,204,71,4178,4208,8386,886.95,918.55,1805.5,3824,3694,91.5270464337003,130
202325,Wesley Johnson,-0.0947029395269834,-0.935214200807788,-1.02991714033477,151,240,205,80,3861,3952,7813,830.666666666667,832.2,1662.86666666667,3550,3451,91.9450919450919,99
2449,Luis Scola,-0.954330913202924,-0.0897956372279544,-1.04412655043088,214,129,206,76,3684,3614,7298,858.066666666667,772.6,1630.66666666667,3380,3433,91.7480998914224,-53
202087,Alonzo Gee,-0.618921907836159,-0.438144614369235,-1.05706652220539,189,182,207,73,3817,3808,7625,794.166666666667,835.25,1629.41666666667,3395,3545,88.9441970133613,-150
202334,Ed Davis,-0.507318247705277,-0.55772202767878,-1.06504027538406,179,200,208,81,3959,3907,7866,865.433333333333,821.416666666667,1686.85,3589,3555,90.6542056074766,34
203935,Marcus Smart,-0.470075651843381,-0.634188551294637,-1.10426420313802,176,214,209,61,4117,4061,8178,805.216666666667,875.033333333333,1680.25,3717,3596,90.284187515181,121
201589,Darrell Arthur,-0.46480013032419,-0.655793292883978,-1.12059342320817,175,216,210,70,3530,3529,7059,755.866666666667,757.883333333333,1513.75,3147,3206,89.1501416430595,-59
201147,Corey Brewer,-0.798855447572816,-0.337351890994058,-1.13620733856687,204,164,211,82,4056,4085,8141,797.45,874.783333333333,1672.23333333333,3643,3697,89.8175542406312,-54
1626170,Jerian Grant,-1.416032734506,0.265144283083918,-1.15088845142209,242,86,212,76,2880,2923,5803,640.916666666667,627.65,1268.56666666667,2495,2651,86.6319444444445,-156
2200,Pau Gasol,-0.736654949394399,-0.449696223455104,-1.1863511728495,201,183,213,72,5308,5420,10728,1148.15,1139.61666666667,2287.76666666667,4800,4867,90.4295403165034,-67
101106,Andrew Bogut,-0.844401848194883,-0.34600406675239,-1.19040591494727,207,165,214,70,3361,3441,6802,680.016666666667,762.2,1442.21666666667,3378,2941,100.505801844689,437
201573,Jerryd Bayless,-1.77747926152178,0.568805820245025,-1.20867344127675,249,56,215,52,3379,3455,6834,748.016666666667,750.633333333333,1498.65,3052,3233,90.3225806451613,-181
202389,Timofey Mozgov,-0.761726774103124,-0.463562225145834,-1.22528899924896,202,187,216,76,2944,2939,5883,669.366666666667,647.766666666667,1317.13333333333,2736,2687,92.9347826086957,49
203210,JaMychal Green,-1.29293372587974,0.0586620947998904,-1.23427163107985,236,107,217,78,3401,3272,6673,720.866666666667,715.15,1436.01666666667,3032,3068,89.1502499264922,-36
1626167,Myles Turner,-0.946810004286521,-0.300290235196144,-1.24710023948266,213,160,218,60,3170,3270,6440,677.816666666667,689.833333333333,1367.65,2827,2889,89.1798107255521,-62
200757,Thabo Sefolosha,-0.58298594584574,-0.683175732183024,-1.26616167802876,186,220,219,75,3995,4152,8147,844.266666666667,910.483333333333,1754.75,3660,3574,91.6145181476846,86
203924,Jerami Grant,-1.05339229142317,-0.231701595027121,-1.28509388645029,223,156,220,77,4773,4941,9714,1038.78333333333,1017.95,2056.73333333333,4131,4543,86.5493400377121,-412
202711,Bojan Bogdanovic,-1.15665488715637,-0.191546865510214,-1.34820175266659,229,152,221,79,4846,4887,9733,1072.51666666667,1041.81666666667,2114.33333333333,4297,4704,88.6710689228229,-407
202734,E'Twaun Moore,-0.3296743888034,-1.03982614898216,-1.36950053778556,164,244,222,59,2907,2973,5880,626.583333333333,632.8,1259.38333333333,2676,2698,92.0536635706914,-22
201152,Thaddeus Young,-1.75426094738087,0.382173131644964,-1.37208781573591,247,71,223,73,5476,5447,10923,1214.75,1183.36666666667,2398.11666666667,4978,5195,90.9057706355004,-217
201952,Jeff Teague,-1.04683847988915,-0.378144100323715,-1.42498258021286,222,172,224,79,5203,5406,10609,1094.65,1147.58333333333,2242.23333333333,4777,4735,91.8124159138958,42
1495,Tim Duncan,0.286692568742449,-1.71508284254765,-1.4283902738052,126,261,225,61,3437,3384,6821,798.683333333333,734.35,1533.03333333333,3248,2851,94.5010183299389,397
101145,Monta Ellis,-0.851250304711929,-0.597195533196439,-1.44844583790837,208,205,226,81,6413,6474,12887,1347.91666666667,1382.61666666667,2730.53333333333,5829,5713,90.8934975830345,116
203901,Elfrid Payton,-1.31143368935375,-0.159757362136931,-1.47119105149068,238,148,227,73,5030,4935,9965,1058.68333333333,1078.6,2137.28333333333,4505,4575,89.5626242544732,-70
203504,Trey Burke,-1.35662271974154,-0.132383830131535,-1.48900654987308,240,138,228,64,3100,3035,6135,710.35,659.45,1369.8,2715,2767,87.5806451612903,-52
203798,PJ Hairston,-2.34641560956061,0.829616719231548,-1.51679889032906,257,31,229,66,2959,2978,5937,658.9,645.333333333333,1304.23333333333,2677,2845,90.4697532950321,-168
203487,Michael Carter-Williams,-1.20244150021262,-0.357534219779551,-1.55997571999217,231,168,230,54,3816,3847,7663,809.883333333333,833.15,1643.03333333333,3409,3525,89.3343815513627,-116
203096,Jared Sullinger,-0.927830363293653,-0.644501768965231,-1.57233213225888,212,215,231,81,4590,4542,9132,907.966666666667,1000.55,1908.51666666667,4207,4048,91.6557734204793,159
2734,Devin Harris,-0.998149996488794,-0.585822758593792,-1.58397275508259,217,203,232,64,2949,3041,5990,658.5,621.016666666667,1279.51666666667,2672,2736,90.606985418786,-64
201941,Jordan Hill,-0.976165716719397,-0.610546030032994,-1.58671174675239,215,210,233,73,3493,3500,6993,768.7,746.483333333333,1515.18333333333,3134,3114,89.7223017463499,20
202323,Evan Turner,-0.85638314347669,-0.741402825543676,-1.59778596902037,209,225,234,81,5457,5430,10887,1095.78333333333,1170.85,2266.63333333333,4882,4789,89.463074949606,93
201951,Ty Lawson,-1.78098973644003,0.180179383661213,-1.60081035277881,250,99,235,66,3380,3400,6780,688.683333333333,723.75,1412.43333333333,2983,3142,88.2544378698225,-159
202066,Garrett Temple,-1.12471493790195,-0.556763368830548,-1.6814783067325,226,199,236,79,4498,4549,9047,918.433333333333,1024.13333333333,1942.56666666667,4112,4105,91.418408181414,7
1626143,Jahlil Okafor,-2.03711459271942,0.338358447249417,-1.69875614547,253,77,237,53,3615,3655,7270,828.716666666667,752.866666666667,1581.58333333333,2973,3480,82.240663900415,-507
2730,Dwight Howard,-1.2111910458686,-0.493051432003399,-1.70424247787199,232,194,238,71,5391,5321,10712,1091.55,1179.45,2271,4945,4922,91.726952327954,23
202709,Cory Joseph,-0.867083746370652,-0.847698545717249,-1.7147822920879,210,234,239,80,4652,4631,9283,1062.75,978.9,2041.65,4366,4100,93.8521066208083,266
1626169,Stanley Johnson,-1.70342201670571,-0.0592512565353115,-1.76267327324102,246,124,240,73,3994,3849,7843,847.433333333333,839.733333333333,1687.16666666667,3481,3586,87.1557336004006,-105
203477,Isaiah Canaan,-2.16097762525933,0.37158926203258,-1.78938836322675,254,73,241,77,4579,4641,9220,1003.98333333333,952.55,1956.53333333333,3885,4396,84.843852369513,-511
203932,Aaron Gordon,-1.15261621158878,-0.696352205181094,-1.84896841676987,228,221,242,78,4355,4351,8706,915.733333333333,946.066666666667,1861.8,3939,4010,90.4477611940299,-71
203953,Jabari Parker,-1.76872355491936,-0.0863063636196644,-1.85502991853902,248,128,243,76,5484,5541,11025,1179.31666666667,1214,2393.31666666667,4962,5154,90.4814004376368,-192
202687,Bismack Biyombo,-1.29800863645479,-0.557750452031297,-1.85575908848608,237,201,244,82,4080,4067,8147,929.75,879.183333333333,1808.93333333333,3747,3594,91.8382352941177,153
203482,Kelly Olynyk,-0.665990029531302,-1.22544669233078,-1.89143672186208,192,254,245,69,3352,3366,6718,676.133333333333,713.4,1389.53333333333,3031,2900,90.4236276849642,131
203458,Alex Len,-2.31684770582156,0.398577958421992,-1.91826974739957,256,69,246,78,4343,4265,8608,907.7,903.466666666667,1811.16666666667,3708,3967,85.3787704351831,-259
201973,Jonas Jerebko,-0.734430831477611,-1.19220179470911,-1.92663262618672,200,251,247,78,2819,2803,5622,576.583333333333,596.583333333333,1173.16666666667,2516,2422,89.251507626818,94
203500,Steven Adams,-1.08890116340233,-0.885059169522903,-1.97396033292523,225,237,248,80,4821,4712,9533,969.366666666667,1040.05,2009.41666666667,4559,4101,94.5654428541796,458
201564,O.J. Mayo,-1.68953500739534,-0.381516160445219,-2.07105116784056,245,174,249,41,2481,2534,5015,528.3,555.65,1083.95,2218,2266,89.3994357114067,-48
203083,Andre Drummond,-1.24170526790633,-0.868039862806188,-2.10974513071252,234,235,250,81,6306,5998,12304,1331.21666666667,1329.65,2660.86666666667,5656,5485,89.6923564858865,171
1626204,Larry Nance Jr.,-1.34293089385412,-0.78757234352058,-2.13050323737469,239,229,251,63,2915,2903,5818,649.383333333333,617.333333333333,1266.71666666667,2574,2683,88.3018867924528,-109
203503,Tony Snell,-0.186798582229382,-2.09622921256804,-2.28302779479742,156,262,252,64,3051,3081,6132,640.816666666667,655.966666666667,1296.78333333333,2731,2604,89.5116355293346,127
201158,Marco Belinelli,-2.2611793727681,-0.0807689340488293,-2.34194830681693,255,126,253,68,3990,4025,8015,826.466666666667,845.866666666667,1672.33333333333,3537,3757,88.6466165413534,-220
201600,Omer Asik,-3.16468350356584,0.734436008863535,-2.4302474947023,261,42,254,68,2722,2636,5358,584.1,587.783333333333,1171.88333333333,2344,2561,86.1131520940485,-217
203991,Clint Capela,-1.01373084062896,-1.48368284607936,-2.49741368670831,220,259,255,77,3558,3505,7063,700.683333333333,766.916666666667,1467.6,3242,3135,91.1186059584036,107
203943,Noah Vonleh,-1.92643966027242,-0.598984615096328,-2.52542427536875,252,208,256,78,2696,2660,5356,587.5,573.4,1160.9,2415,2458,89.5771513353116,-43
203457,Nerlens Noel,-2.40179087088481,-0.130387383220458,-2.53217825410527,259,136,257,67,4561,4674,9235,999.116666666667,963.65,1962.76666666667,3869,4306,84.8278886209165,-437
203145,Kent Bazemore,-1.22615527475828,-1.32033558427571,-2.546490859034,233,256,258,75,4763,4982,9745,1000.25,1065.5,2065.75,4385,4309,92.0638253201764,76
203118,Mike Scott,-1.48117834080292,-1.24409626111855,-2.72527460192147,243,255,259,75,2630,2684,5314,554.883333333333,593.033333333333,1147.91666666667,2401,2268,91.2927756653992,133
101179,Ronnie Price,-2.36700947712406,-0.478052413321605,-2.84506189044567,258,190,260,62,2910,2829,5739,601.35,610.15,1211.5,2490,2547,85.5670103092784,-57
2199,Tyson Chandler,-4.06437103459762,0.774839181954007,-3.28953185264361,262,34,261,66,3838,3759,7597,816.85,798.216666666667,1615.06666666667,3204,3577,83.4809796769151,-373
201961,Wayne Ellington,-3.1608270562797,-0.453379210315044,-3.61420626659474,260,184,262,76,3679,3680,7359,821.316666666667,787.9,1609.21666666667,3158,3462,85.8385430823593,-304
