season,id_player,name_player,orapm,drapm,rapm,orapm_rnk,drapm_rnk,rapm_rnk,gp_calc_total,poss_calc_o,poss_calc_d,poss_calc_total,mp_calc_o,mp_calc_d,mp_calc_total,pts_calc_o,pts_calc_d,pts_o_per100_calc,pm_calc
2015,201575,Brandon Rush,2.00669933079556,2.49911579342318,4.50581512421874,24,1,1,72,2448,2558,5006,499.75,546.516666666667,1046.26666666667,2413,2423,98.5702614379085,-10
2015,202083,Wesley Matthews,2.63628780080001,1.06336587688588,3.69965367768589,7,19,2,78,5852,5956,11808,1350.46666666667,1287.18333333333,2637.65,5650,5548,96.5481886534518,102
2015,202704,Reggie Jackson,2.95312517585095,0.60829442220798,3.56141959805893,4,53,3,79,5732,5466,11198,1207.9,1202.76666666667,2410.66666666667,5232,5079,91.2770411723657,153
2015,202681,Kyrie Irving,1.97697008950992,1.08847424544639,3.06544433495631,25,16,4,53,3788,3686,7474,853.583333333333,801.65,1655.23333333333,3642,3433,96.1457233368532,209
2015,101108,Chris Paul,3.02459256364704,-0.0993808181489814,2.92521174549806,3,132,5,74,5556,5673,11229,1193.38333333333,1220.78333333333,2414.16666666667,5503,4992,99.0460763138949,511
2015,202388,Donald Sloan,2.08497470242523,0.829898285214872,2.9148729876401,20,30,6,61,2967,3007,5974,662.783333333333,652.583333333333,1315.36666666667,2753,2878,92.7873272665993,-125
2015,204456,T.J. McConnell,2.44375291665453,0.465967485080785,2.90972040173531,12,62,7,81,3716,3781,7497,824.616666666667,781.533333333333,1606.15,3288,3570,88.4822389666308,-282
2015,203141,Mirza Teletovic,1.82440645221083,1.03355343183907,2.8579598840499,31,23,8,79,4072,4048,8120,837.416666666667,846.5,1683.91666666667,3707,3890,91.0363457760314,-183
2015,201950,Jrue Holiday,2.16009754709274,0.667257655563419,2.82735520265616,17,45,9,65,4302,4191,8493,869.983333333333,954.866666666667,1824.85,4023,3991,93.5146443514645,32
2015,977,Kobe Bryant,1.28800301669735,1.52263521597635,2.81063823267371,55,7,10,66,4340,4400,8740,957.816666666667,894.5,1852.31666666667,3792,4358,87.3732718894009,-566
2015,202685,Jonas Valanciunas,1.97249084700143,0.79109724367385,2.76358809067528,26,33,11,60,3509,3422,6931,817.933333333333,728.9,1546.83333333333,3349,3238,95.4402963807352,111
2015,203110,Draymond Green,3.65290179701152,-1.05976940649708,2.59313239051444,1,246,12,81,6725,6866,13591,1307.9,1496.45,2804.35,6992,5913,103.970260223048,1079
2015,201144,Mike Conley,2.55224028969392,0.0383860359867168,2.59062632568064,9,114,13,56,3901,3910,7811,907.433333333333,844.866666666667,1752.3,3625,3590,92.924891053576,35
2015,101138,Brandon Bass,2.82420233947587,-0.300368377979131,2.52383396149674,5,161,14,66,3124,3118,6242,674.733333333333,667.283333333333,1342.01666666667,2874,2934,91.9974391805378,-60
2015,2544,LeBron James,3.13693739081855,-0.715752740389932,2.42118465042861,2,223,15,76,6211,6058,12269,1384.83333333333,1319.8,2704.63333333333,6069,5477,97.7137336982773,592
2015,203084,Harrison Barnes,2.43443633044968,-0.0390526099768101,2.39538372047286,13,122,16,66,4810,4882,9692,982.116666666667,1059.33333333333,2041.45,4787,4380,99.5218295218295,407
2015,2225,Tony Parker,2.45115380003233,-0.165783891157062,2.28536990887527,11,149,17,72,4376,4378,8754,1034.38333333333,938.25,1972.63333333333,4192,3782,95.7952468007313,410
2015,201142,Kevin Durant,2.68446192739323,-0.483181415395575,2.20128051199765,6,193,18,72,6243,6148,12391,1250.91666666667,1326.61666666667,2577.53333333333,6113,5475,97.9176677879225,638
2015,202738,Isaiah Thomas,1.95798578387944,0.184896641557976,2.14288242543741,28,98,19,82,6412,6372,12784,1259.08333333333,1383.76666666667,2642.85,5985,5740,93.3406113537118,245
2015,2546,Carmelo Anthony,1.56116866450475,0.540234063148978,2.10140272765373,43,58,20,72,5736,5758,11494,1298.33333333333,1229.45,2527.78333333333,5293,5327,92.2768479776848,-34
2015,101123,Gerald Green,2.06173821085912,0.0395787970107764,2.10131700786989,22,112,21,69,3475,3504,6979,783.783333333333,769.333333333333,1553.11666666667,3197,3175,92,22
2015,202703,Nikola Mirotic,2.23513762927571,-0.149699945242146,2.08543768403356,15,141,22,66,3792,3837,7629,813.533333333333,824.75,1638.28333333333,3522,3507,92.879746835443,15
2015,203499,Shane Larkin,1.26873999144311,0.774099816585806,2.04283980802892,57,35,23,78,4049,4024,8073,881.266666666667,862.85,1744.11666666667,3547,3886,87.6018770066683,-339
2015,202691,Klay Thompson,2.11816965752817,-0.153143232234779,1.96502642529339,18,144,24,80,6258,6477,12735,1242.7,1407.73333333333,2650.43333333333,6495,5651,103.787152444871,844
2015,203081,Damian Lillard,0.907677557178329,1.03679504423125,1.94447260140957,76,22,25,75,6347,6294,12641,1353.58333333333,1320.21666666667,2673.8,6000,5921,94.5328501654325,79
2015,101112,Channing Frye,1.90313469268295,0.0173665782692216,1.92050127095217,29,117,26,70,2664,2658,5322,598.616666666667,594.816666666667,1193.43333333333,2499,2408,93.8063063063063,91
2015,2403,Nene,1.72214199516088,0.189674701403949,1.91181669656483,38,96,27,57,2520,2558,5078,515.383333333333,573.55,1088.93333333333,2374,2318,94.2063492063492,56
2015,203095,Evan Fournier,1.12190366533649,0.767714650705624,1.88961831604212,63,36,28,79,5885,5893,11778,1269.56666666667,1292.33333333333,2561.9,5381,5544,91.4358538657604,-163
2015,200755,JJ Redick,2.07989372666697,-0.190617296666506,1.88927643000046,21,151,29,75,4803,4904,9707,1031.28333333333,1058.2,2089.48333333333,4736,4278,98.6050385175932,458
2015,201942,DeMar DeRozan,1.41249001619599,0.471965040658535,1.88445505685452,48,61,30,78,6370,6282,12652,1464.41666666667,1337.86666666667,2802.28333333333,6005,5833,94.2700156985871,172
2015,201935,James Harden,1.55543040190079,0.326404617473448,1.88183501937424,44,78,31,82,7462,7411,14873,1502.43333333333,1620.7,3123.13333333333,6988,6872,93.6478155990351,116
2015,2747,JR Smith,1.21272763399335,0.643895637649114,1.85662327164246,58,49,32,77,5411,5274,10685,1216.85,1141.95,2358.8,5204,4895,96.1744594344853,309
2015,202322,John Wall,1.59990099109587,0.217251374687351,1.81715236578322,39,89,33,77,6503,6505,13008,1321.68333333333,1453.81666666667,2775.5,6053,5987,93.0801168691373,66
2015,201567,Kevin Love,1.80387248762422,4.20492134262432e-05,1.80391453683764,32,118,34,77,5474,5329,10803,1231.03333333333,1179.71666666667,2410.75,5270,4883,96.2732919254658,387
2015,201962,Toney Douglas,1.00602446447658,0.797564524756501,1.80358898923308,68,32,35,61,2971,2914,5885,623.35,637.166666666667,1260.51666666667,2744,2876,92.3594749242679,-132
2015,201569,Eric Gordon,1.80140027455628,-0.0159859408116842,1.78541433374459,33,120,36,45,3405,3438,6843,722.7,755.9,1478.6,3140,3213,92.2173274596182,-73
2015,201937,Ricky Rubio,2.27274041324674,-0.511083760767749,1.76165665247899,14,197,37,76,5379,5407,10786,1143.41666666667,1171.96666666667,2315.38333333333,5055,5002,93.9765755716676,53
2015,201939,Stephen Curry,2.63279911749132,-0.878608674447916,1.7541904430434,8,236,38,79,6517,6645,13162,1256.28333333333,1438.91666666667,2695.2,6775,5754,103.958876783796,1021
2015,202688,Brandon Knight,0.549332345320485,1.16100073238492,1.7103330777054,103,12,39,52,4479,4426,8905,927.166666666667,943.366666666667,1870.53333333333,3977,4195,88.7921411029248,-218
2015,200746,LaMarcus Aldridge,1.5145676637308,0.186833694730472,1.70140135846127,45,97,40,74,5013,5007,10020,1171.03333333333,1086.86666666667,2257.9,4851,4339,96.7684021543986,512
2015,201167,Arron Afflalo,0.821059380478584,0.878648004952032,1.69970738543062,84,28,41,71,5258,5331,10589,1209.46666666667,1146.71666666667,2356.18333333333,4811,4968,91.4986686953214,-157
2015,202498,Lance Thomas,1.73257268909251,-0.0994748761989682,1.63309781289354,36,133,42,59,2988,3081,6069,675.583333333333,652.45,1328.03333333333,2766,2784,92.570281124498,-18
2015,203078,Bradley Beal,0.570394952265423,1.05905239954851,1.62944735181393,101,21,43,55,4048,4000,8048,816.266666666667,887.65,1703.91666666667,3740,3750,92.3913043478261,-10
2015,203079,Dion Waiters,1.75693654304156,-0.138542634412547,1.61839390862901,35,139,44,78,5244,5109,10353,1069.31666666667,1082.4,2151.71666666667,4926,4708,93.9359267734554,218
2015,203476,Gorgui Dieng,2.10373709085886,-0.495251435305497,1.60848565555336,19,196,45,82,5054,5139,10193,1107.83333333333,1108,2215.83333333333,4748,4788,93.9453897902651,-40
2015,202335,Patrick Patterson,2.2142282057872,-0.61675250103299,1.59747570475421,16,211,46,79,4548,4530,9078,1038.48333333333,977.883333333333,2016.36666666667,4384,4019,96.3940193491645,365
2015,1626161,Willie Cauley-Stein,2.05222892490807,-0.470289304837007,1.58193962007106,23,188,47,66,3387,3401,6788,682.266666666667,721.933333333333,1404.2,3128,3188,92.3531148509005,-60
2015,101181,Jose Calderon,0.978126574708802,0.592758018743174,1.57088459345198,72,54,48,72,4509,4564,9073,1036.15,980.366666666667,2016.51666666667,4148,4251,91.993790197383,-103
2015,203462,Archie Goodwin,-0.28685293574549,1.84173187916862,1.55487894342313,162,3,49,57,2695,2633,5328,557.316666666667,551.466666666667,1108.78333333333,2373,2593,88.0519480519481,-220
2015,203382,Aron Baynes,-0.0790396626137496,1.60816282779195,1.5291231651782,150,5,50,81,2857,2786,5643,620.616666666667,607.45,1228.06666666667,2535,2640,88.7294364718236,-105
2015,202694,Marcus Morris,1.30281235529496,0.205174004229479,1.50798635952444,54,92,51,80,6670,6425,13095,1431.41666666667,1411.58333333333,2843,6061,5921,90.8695652173913,140
2015,203903,Jordan Clarkson,0.362802627186815,1.14261324541791,1.50541587260473,118,13,52,79,5915,5920,11835,1310.46666666667,1224.33333333333,2534.8,5123,5756,86.6103127641589,-633
2015,1891,Jason Terry,0.91319679115695,0.516661978075647,1.4298587692326,75,60,53,72,2992,2979,5971,592.166666666667,659.566666666667,1251.73333333333,2766,2787,92.4465240641711,-21
2015,202340,Avery Bradley,1.46620628839708,-0.0840263757827419,1.38217991261434,46,127,54,76,6057,6078,12135,1199.11666666667,1322.86666666667,2521.98333333333,5684,5430,93.841835892356,254
2015,1626164,Devin Booker,0.609829146369206,0.761859961686692,1.3716891080559,97,37,55,76,5029,5000,10029,1051.3,1047.98333333333,2099.28333333333,4372,4765,86.9357725193876,-393
2015,202695,Kawhi Leonard,2.50187789183675,-1.13709634159573,1.36478155024102,10,248,56,72,5323,5293,10616,1231.1,1144.61666666667,2375.71666666667,5172,4490,97.1632538042457,682
2015,1626171,Bobby Portis,0.230663921629807,1.11225477682397,1.34291869845378,127,14,57,62,2556,2545,5101,551.133333333333,551.533333333333,1102.66666666667,2263,2431,88.5367762128326,-168
2015,203490,Otto Porter Jr.,0.963277317094274,0.369965355840353,1.33324267293463,74,74,58,75,5332,5307,10639,1066.03333333333,1197.26666666667,2263.3,4939,4901,92.629407351838,38
2015,200826,J.J. Barea,0.500153255776357,0.829993435527912,1.33014669130427,106,29,59,74,3783,3857,7640,851.216666666667,808.716666666667,1659.93333333333,3553,3627,93.9201691779011,-74
2015,200752,Rudy Gay,0.500803667749791,0.736052121634792,1.23685578938458,105,41,60,70,5713,5723,11436,1148.16666666667,1221.23333333333,2369.4,5251,5343,91.9131804656048,-92
2015,203486,Mason Plumlee,0.556864360944384,0.623715813749928,1.18058017469431,102,51,61,82,4845,4837,9682,1040.6,1034.85,2075.45,4598,4527,94.9019607843137,71
2015,203506,Victor Oladipo,1.88322982575928,-0.704842274773983,1.1783875509853,30,222,62,72,5527,5590,11117,1176,1199.38333333333,2375.38333333333,5090,5110,92.0933598697304,-20
2015,101150,Lou Williams,0.100619481257887,1.05907331394028,1.15969279519817,139,20,63,67,4445,4486,8931,966.75,939.6,1906.35,3950,4333,88.8638920134983,-383
2015,203952,Andrew Wiggins,0.829695335547611,0.309626132538645,1.13932146808626,83,82,64,81,6593,6591,13184,1409.75,1430.26666666667,2840.01666666667,6123,6189,92.871227059002,-66
2015,2207,Joe Johnson,0.887601924101359,0.249171190226197,1.13677311432756,78,87,65,81,6122,6108,12230,1372.11666666667,1322.13333333333,2694.25,5704,5770,93.172165958837,-66
2015,203933,T.J. Warren,0.214227523629717,0.914144907360192,1.12837243098991,131,27,66,47,2576,2506,5082,537.066666666667,530.316666666667,1067.38333333333,2292,2411,88.9751552795031,-119
2015,1626144,Emmanuel Mudiay,0.467782157008005,0.657991696713167,1.12577385372117,109,47,67,68,4913,4790,9703,1032.81666666667,1027.65,2060.46666666667,4421,4547,89.9857520863016,-126
2015,2755,Kevin Martin,-0.346024470375189,1.43910113995119,1.093076669576,166,8,68,55,2530,2524,5054,557.833333333333,534.95,1092.78333333333,2262,2396,89.4071146245059,-134
2015,101141,Ersan Ilyasova,-1.17453556703213,2.2567673545009,1.08223178746877,230,2,69,74,4503,4274,8777,943.233333333333,933.95,1877.18333333333,3959,4068,87.9191650011104,-109
2015,101162,Marcin Gortat,0.858289142810586,0.204616677524533,1.06290582033512,80,93,70,75,5279,5272,10551,1066.05,1189.65,2255.7,4867,4857,92.1954915703732,10
2015,202696,Nikola Vucevic,0.310581977316091,0.749078227229765,1.05966020454586,121,38,71,65,4711,4631,9342,1025.23333333333,1006.95,2032.18333333333,4295,4354,91.1696030566759,-59
2015,202330,Gordon Hayward,0.993299809222789,0.0533400785673315,1.04663988779012,70,109,72,80,6461,6337,12798,1498.5,1388.13333333333,2886.63333333333,5874,5796,90.9147190837332,78
2015,201566,Russell Westbrook,1.77313136324441,-0.728614959715031,1.04451640352937,34,224,73,80,6698,6548,13246,1322.56666666667,1423.7,2746.26666666667,6497,5842,96.999104210212,655
2015,203463,Ben McLemore,0.866075832078698,0.156334738975211,1.02241057105391,79,100,74,68,3540,3504,7044,688.1,744.666666666667,1432.76666666667,3269,3234,92.3446327683616,35
2015,201583,Ryan Anderson,0.365942982604834,0.63298981984987,0.998932802454704,117,50,75,66,4767,4652,9419,980.566666666667,1031.3,2011.86666666667,4439,4443,93.1193622823579,-4
2015,201143,Al Horford,1.57507904919973,-0.577545191639735,0.997533857559998,42,202,76,82,5977,6229,12206,1258.46666666667,1354.73333333333,2613.2,5567,5373,93.1403714237912,194
2015,203086,Meyers Leonard,1.05665391043505,-0.0643748691462144,0.992279041288835,65,125,77,61,3097,3016,6113,681.05,647.783333333333,1328.83333333333,2924,2842,94.4139489828867,82
2015,203521,Matthew Dellavedova,1.38565788086743,-0.403897083982386,0.98176079688504,51,179,78,76,4258,4179,8437,947.766666666667,926,1873.76666666667,4096,3735,96.195396899953,361
2015,2571,Leandro Barbosa,0.755171187055266,0.20526305865618,0.960434245711447,89,91,79,68,2585,2588,5173,522.5,555.033333333333,1077.53333333333,2427,2387,93.8878143133462,40
2015,200768,Kyle Lowry,1.72571424537509,-0.765663787088981,0.960050458286106,37,226,80,77,6446,6338,12784,1473.55,1363.25,2836.8,6142,5758,95.2838969903816,384
2015,203944,Julius Randle,-0.884973600574221,1.84074312056503,0.955769519990806,211,4,81,81,5313,5268,10581,1179.01666666667,1095.96666666667,2274.98333333333,4573,5239,86.0718991153774,-666
2015,202718,Chandler Parsons,1.39522799771623,-0.456095994941919,0.939132002774309,49,185,82,61,3946,4094,8040,909.066666666667,882.216666666667,1791.28333333333,3749,3738,95.0076026355803,11
2015,202708,Norris Cole,0.222998853106758,0.715416964670805,0.938415817777563,129,43,83,45,2783,2753,5536,576,615.133333333333,1191.13333333333,2529,2650,90.8731584620913,-121
2015,201588,George Hill,1.38714104041718,-0.470728548972095,0.916412491445085,50,189,84,74,5768,5825,11593,1247.65,1260.66666666667,2508.31666666667,5268,5159,91.3314840499307,109
2015,201584,Courtney Lee,1.12352852037537,-0.219473152816902,0.904055367558467,62,155,85,79,5184,5252,10436,1195.01666666667,1126.86666666667,2321.88333333333,4933,4792,95.1581790123457,141
2015,2564,Boris Diaw,1.14142926861672,-0.298650914846814,0.842778353769909,61,159,86,76,3147,3175,6322,712.883333333333,675.1,1387.98333333333,3029,2752,96.250397203686,277
2015,201571,D.J. Augustin,0.98127157375295,-0.151213322619107,0.830058251133843,71,142,87,62,2750,2734,5484,600.233333333333,573.166666666667,1173.4,2518,2541,91.5636363636364,-23
2015,203459,Allen Crabbe,0.310282695557011,0.51874129013704,0.829023985694051,122,59,88,81,4991,4952,9943,1069.56666666667,1032.23333333333,2101.8,4639,4605,92.9473051492687,34
2015,201967,Dante Cunningham,-0.50374426558387,1.31864883941492,0.814904573831046,178,10,89,80,4541,4466,9007,957.466666666667,1012.05,1969.51666666667,4142,4400,91.2133891213389,-258
2015,203114,Khris Middleton,1.16903463739581,-0.355215733979772,0.813818903416038,59,167,90,79,6558,6643,13201,1403.36666666667,1442.48333333333,2845.85,6045,6067,92.1774931381519,-22
2015,203076,Anthony Davis,-0.276051212312157,1.08074962179098,0.804698409478818,160,18,91,61,5029,4961,9990,1053.93333333333,1102.65,2156.58333333333,4582,4771,91.1115529926427,-189
2015,2594,Kyle Korver,1.97054340192433,-1.18301231883765,0.787531083086679,27,249,92,80,5490,5643,11133,1159.38333333333,1218.71666666667,2378.1,5142,4862,93.6612021857924,280
2015,201577,Robin Lopez,-0.401914241394496,1.17604675202631,0.774132510631815,173,11,93,82,4963,4975,9938,1129.28333333333,1070.13333333333,2199.41666666667,4480,4606,90.2679830747532,-126
2015,201954,Darren Collison,0.423693523517761,0.349259962910485,0.772953486428246,113,75,94,74,5331,5387,10718,1080.25,1139.31666666667,2219.56666666667,4918,5031,92.2528606265241,-113
2015,1718,Paul Pierce,0.620669587884506,0.137290587055102,0.757960174939608,96,101,95,68,2708,2835,5543,609.466666666667,610.816666666667,1220.28333333333,2585,2560,95.4579025110783,25
2015,202397,Ish Smith,0.459902281116229,0.297504368694012,0.75740664981024,111,83,96,77,5236,5350,10586,1115.93333333333,1117.91666666667,2233.85,4691,5038,89.5912910618793,-347
2015,202683,Enes Kanter,0.851746014842158,-0.0974636298118712,0.754282385030286,81,130,97,82,4154,4030,8184,864.6,853.216666666667,1717.81666666667,3881,3737,93.4280211844006,144
2015,203999,Nikola Jokic,0.609412598367598,0.0950855727075916,0.70449817107519,98,104,98,80,4066,3868,7934,850.583333333333,873.166666666667,1723.75,3678,3577,90.4574520413182,101
2015,201145,Jeff Green,1.0459324403679,-0.352948125941759,0.69298431442614,67,166,99,80,5013,5129,10142,1141.83333333333,1106.68333333333,2248.51666666667,4630,4676,92.359864352683,-46
2015,201587,Nicolas Batum,1.28258733794182,-0.598865619617807,0.68372171832401,56,207,100,70,5524,5582,11106,1233.33333333333,1204.71666666667,2438.05,5305,5090,96.0354815351195,215
2015,201599,DeAndre Jordan,0.840334730794374,-0.158911541797409,0.681423188996966,82,147,101,77,5936,6066,12002,1277.85,1312.48333333333,2590.33333333333,5812,5335,97.911051212938,477
2015,2419,Tayshaun Prince,0.994402388124744,-0.32647809899496,0.667924289129784,69,162,102,77,3254,3334,6588,724.766666666667,731.933333333333,1456.7,2927,3023,89.9508297480025,-96
2015,202720,Jon Leuer,0.757857986104288,-0.130696109439404,0.627161876664885,88,137,103,67,3015,3013,6028,615.766666666667,637.966666666667,1253.73333333333,2699,2777,89.5190713101161,-78
2015,203460,Andre Roberson,-0.0259226898445987,0.649241097336957,0.623318407492358,143,48,104,70,3676,3648,7324,738.466666666667,804.583333333333,1543.05,3499,3225,95.1849836779108,274
2015,201160,Jason Smith,0.477235509030494,0.136374778837856,0.61361028786835,107,102,105,76,2691,2706,5397,587.6,590.283333333333,1177.88333333333,2473,2511,91.8989223337049,-38
2015,201980,Danny Green,1.58594886196691,-0.998767277168497,0.587181584798414,40,243,106,79,4595,4528,9123,1062.48333333333,984.916666666667,2047.4,4379,3856,95.2992383025027,523
2015,202328,Greg Monroe,0.294557842207816,0.291131268221431,0.585689110429247,123,84,107,79,5273,5301,10574,1143.91666666667,1163.41666666667,2307.33333333333,4858,4983,92.1297174284089,-125
2015,201585,Kosta Koufos,-0.0426924989419152,0.611218726552777,0.568526227610862,144,52,108,78,3537,3563,7100,730.583333333333,751.383333333333,1481.96666666667,3127,3374,88.4082555838281,-247
2015,203914,Gary Harris,0.108206266771262,0.442998684644658,0.55120495141592,137,64,109,76,5800,5622,11422,1217.76666666667,1211.21666666667,2428.98333333333,5205,5396,89.7413793103448,-191
2015,203897,Zach LaVine,-0.566415375465821,1.08950064295422,0.523085267488403,183,15,110,82,5284,5382,10666,1125.95,1161.18333333333,2287.13333333333,4881,5183,92.3732021196064,-302
2015,202682,Derrick Williams,-0.172116635190457,0.658295960772137,0.486179325581681,155,46,111,80,3242,3304,6546,729.75,700.383333333333,1430.13333333333,2832,3071,87.3534855027761,-239
2015,203526,Raul Neto,1.32877357992278,-0.846642776213336,0.482130803709441,53,233,112,81,3235,3230,6465,777.883333333333,712.583333333333,1490.46666666667,2967,2866,91.7156105100464,101
2015,203138,Hollis Thompson,0.43430934171815,0.0477863701113298,0.48209571182948,112,111,113,77,5058,5197,10255,1090.16666666667,1062.61666666667,2152.78333333333,4457,4858,88.1178331356267,-401
2015,2547,Chris Bosh,0.973975999227654,-0.4936138875635,0.480362111664154,73,195,114,53,3882,3964,7846,898.283333333333,874.616666666667,1772.9,3550,3533,91.4477073673364,17
2015,1717,Dirk Nowitzki,1.05524122066037,-0.597137417510786,0.458103803149583,66,204,115,75,5267,5346,10613,1217.38333333333,1142.43333333333,2359.81666666667,5045,4888,95.7850768938675,157
2015,201977,Marcus Thornton,0.583147682150288,-0.15276089684447,0.430386785305818,100,143,116,61,2681,2662,5343,537.066666666667,568.7,1105.76666666667,2460,2438,91.7568071615069,22
2015,2216,Zach Randolph,0.106179982773927,0.321222245466209,0.427402228240136,138,79,117,68,4565,4493,9058,1044.31666666667,967.083333333333,2011.4,4111,4195,90.0547645125958,-84
2015,2561,David West,1.45630469181849,-1.04999525521037,0.406309436608113,47,245,118,78,3139,3140,6279,716.85,679.75,1396.6,3012,2665,95.9541255176808,347
2015,204060,Joe Ingles,0.0275540262953703,0.377365114535414,0.404919140830785,142,72,119,81,2794,2739,5533,648.15,592.783333333333,1240.93333333333,2456,2480,87.9026485325698,-24
2015,2548,Dwyane Wade,-0.575283742950006,0.961240044780851,0.385956301830845,184,25,120,74,5070,5127,10197,1157.98333333333,1089.38333333333,2247.36666666667,4695,4711,92.603550295858,-16
2015,203917,Nik Stauskas,-0.698259993318295,1.08099328252768,0.382733289209383,194,17,121,73,4260,4331,8591,923.116666666667,895.283333333333,1818.4,3649,4099,85.6572769953052,-450
2015,201956,Omri Casspi,0.708252005808935,-0.376992105748637,0.331259900060299,90,171,122,69,4579,4593,9172,907.966666666667,973.033333333333,1881,4238,4206,92.552959161389,32
2015,202324,Derrick Favors,0.797432975319563,-0.482771080948801,0.314661894370761,85,192,123,62,4394,4274,8668,1037.75,937.883333333333,1975.63333333333,4012,3946,91.3063268092854,66
2015,1626157,Karl-Anthony Towns,-0.14080985656023,0.439701781925459,0.298891925365228,152,65,124,82,6063,6076,12139,1291.48333333333,1326.15,2617.63333333333,5647,5763,93.1387102094673,-116
2015,200794,Paul Millsap,0.666816226440274,-0.368547094545611,0.298269131894662,94,170,125,81,6108,6290,12398,1290.45,1345.06666666667,2635.51666666667,5696,5488,93.2547478716437,208
2015,200765,Rajon Rondo,-0.731153972568439,1.01530305857558,0.284149086007142,198,24,126,72,6167,6221,12388,1225.9,1306.01666666667,2531.91666666667,5645,5807,91.5355926706665,-162
2015,202339,Eric Bledsoe,1.11951302378459,-0.841642934655163,0.27787008912943,64,231,127,31,2532,2541,5073,517.733333333333,539.233333333333,1056.96666666667,2293,2328,90.5608214849921,-35
2015,203937,Kyle Anderson,1.3330016668007,-1.0780372900413,0.254964376759408,52,247,128,78,2737,2785,5522,643.25,593.983333333333,1237.23333333333,2632,2431,96.1636828644501,201
2015,101109,Raymond Felton,0.330614499399836,-0.101285684479717,0.229328814920119,119,134,129,80,4928,5054,9982,1131.98333333333,1059.46666666667,2191.45,4618,4662,93.7094155844156,-44
2015,201586,Serge Ibaka,0.0962609719086662,0.0734749015724374,0.169735873481104,140,106,130,78,6001,5935,11936,1203.31666666667,1287.83333333333,2491.15,5802,5309,96.6838860189968,493
2015,203115,Will Barton,-0.237261417754001,0.404496945045764,0.167235527291763,159,68,131,82,5535,5457,10992,1174.73333333333,1177.21666666667,2351.95,4969,5127,89.7741644083108,-158
2015,203090,Maurice Harkless,0.207947578571506,-0.0512340278645931,0.156713550706913,133,123,132,78,3455,3452,6907,737.7,715.366666666667,1453.06666666667,3182,3166,92.0984081041968,16
2015,1938,Manu Ginobili,1.57515587421325,-1.42403263839329,0.151123235819954,41,258,133,58,2613,2646,5259,584.2,558.016666666667,1142.21666666667,2543,2215,97.3210868733257,328
2015,201196,Ramon Sessions,-0.438609887734061,0.582505507372007,0.143895619637946,174,55,134,82,3914,3950,7864,794.583333333333,872.35,1666.93333333333,3583,3652,91.543178334185,-69
2015,201988,Patty Mills,0.761334032649492,-0.618119583394779,0.143214449254713,87,212,135,81,3788,3808,7596,846.15,819.783333333333,1665.93333333333,3685,3293,97.2808870116156,392
2015,203498,Shabazz Muhammad,-1.49326401296594,1.60485993083081,0.111595917864864,244,6,136,82,3882,3925,7807,832.133333333333,848.483333333333,1680.61666666667,3487,3758,89.8248325605358,-271
2015,101139,CJ Miles,0.291864848508796,-0.192409657404011,0.0994551911047852,125,153,137,64,3448,3513,6961,723.683333333333,738.933333333333,1462.61666666667,3150,3167,91.3573085846868,-17
2015,101107,Marvin Williams,0.693060005329607,-0.598849503795688,0.0942105015339193,91,206,138,81,5269,5283,10552,1184.81666666667,1140.01666666667,2324.83333333333,5072,4826,96.2611501233631,246
2015,1626159,Justise Winslow,0.293378771395848,-0.205962745232916,0.0874160261629317,124,154,139,78,5041,5061,10102,1127.9,1101.9,2229.8,4612,4483,91.4897837730609,129
2015,201166,Aaron Brooks,0.476645473044847,-0.390714693075674,0.0859307799691731,108,176,140,69,2569,2551,5120,553.316666666667,554.733333333333,1108.05,2317,2324,90.1907356948229,-7
2015,202702,Kenneth Faried,-0.60210713656178,0.683335820856728,0.0812286842949479,188,44,141,67,4029,3871,7900,853.35,835.45,1688.8,3628,3749,90.0471581037478,-121
2015,201572,Brook Lopez,0.213595454774905,-0.153357033673103,0.0602384211018019,132,146,142,73,5573,5527,11100,1237.6,1205.48333333333,2443.08333333333,5043,5225,90.4898618338417,-182
2015,203507,Giannis Antetokounmpo,-0.494762031944664,0.547754615436653,0.052992583491989,177,57,143,80,6445,6481,12926,1386.33333333333,1428.26666666667,2814.6,5873,6049,91.1249030256012,-176
2015,204038,Langston Galloway,-0.300040453071452,0.314544772839196,0.0145043197677437,163,81,144,82,4631,4655,9286,1025.11666666667,998.566666666667,2023.68333333333,4122,4228,89.0088533793997,-106
2015,202697,Iman Shumpert,1.16166543528841,-1.18883280775391,-0.0271673724655044,60,250,145,54,2983,2960,5943,676.95,637.65,1314.6,2848,2639,95.4743546765002,209
2015,203469,Cody Zeller,0.531318632274446,-0.602178151879406,-0.0708595196049592,104,209,146,73,4032,4007,8039,880.333333333334,882.416666666667,1762.75,3889,3715,96.453373015873,174
2015,202391,Jeremy Lin,0.692331019919732,-0.766028658532673,-0.0736976386129413,92,227,147,78,4682,4730,9412,1043.65,1005.96666666667,2049.61666666667,4328,4218,92.439128577531,110
2015,201229,Anthony Tolliver,-0.999990638628984,0.919960640266244,-0.0800299983627402,219,26,148,72,3109,2996,6105,672.916666666667,664.516666666667,1337.43333333333,2741,2765,88.1633965905436,-24
2015,203468,CJ McCollum,-0.0725964875080336,-0.0360760226493852,-0.108672510157419,149,121,149,80,6519,6419,12938,1408.4,1360.55,2768.95,6079,5933,93.2504985427213,146
2015,202331,Paul George,0.465218606470699,-0.619094751678951,-0.153876145208252,110,213,150,81,6614,6652,13266,1391.66666666667,1423.98333333333,2815.65,6055,5874,91.5482310250983,181
2015,201945,Gerald Henderson,-0.155423969910326,-0.00670867487592495,-0.162132644786251,153,119,151,72,3355,3331,6686,734.083333333333,698.066666666667,1432.15,3090,3058,92.1013412816692,32
2015,202710,Jimmy Butler,0.230221125804026,-0.402079417230652,-0.171858291426626,128,178,152,67,5736,5773,11509,1244.68333333333,1229.08333333333,2473.76666666667,5184,5184,90.3765690376569,0
2015,202684,Tristan Thompson,-0.516111839779618,0.317443658386143,-0.198668181393475,181,80,153,81,5197,5058,10255,1164.7,1104.48333333333,2269.18333333333,4957,4597,95.3819511256494,360
2015,2037,Jamal Crawford,-0.058606106023077,-0.142619963456523,-0.2012260694796,145,140,154,79,4867,4983,9850,1068.25,1051.83333333333,2120.08333333333,4541,4492,93.3018286418738,49
2015,204001,Kristaps Porzingis,0.067593954266734,-0.278442001361531,-0.210848047094797,141,158,155,72,4591,4600,9191,1037.83333333333,992.133333333333,2029.96666666667,4207,4194,91.6358091918972,13
2015,2736,Luol Deng,-0.0616485743600281,-0.183743213098284,-0.245391787458312,147,150,156,74,5441,5434,10875,1230.56666666667,1155.96666666667,2386.53333333333,5019,4968,92.2440727807388,51
2015,202326,DeMarcus Cousins,-0.637521128799389,0.390240858476761,-0.247280270322629,190,70,157,65,5469,5453,10922,1082.78333333333,1157.36666666667,2240.15,5066,5006,92.6311940025599,60
2015,203496,Robert Covington,-0.348156724089687,0.0941716010130276,-0.253985123076659,167,105,158,67,4456,4499,8955,956.266666666667,938.716666666667,1894.98333333333,3885,4149,87.1858168761221,-264
2015,202344,Trevor Booker,0.407839038890518,-0.675122406778755,-0.267283367888237,115,217,159,79,3709,3618,7327,856.8,788.016666666667,1644.81666666667,3308,3207,89.1884605014829,101
2015,200751,Randy Foye,0.411096350965563,-0.682373077538585,-0.271276726573022,114,219,160,81,3857,3814,7671,820.566666666667,815.15,1635.71666666667,3478,3415,90.1737101374125,63
2015,200782,PJ Tucker,-0.732121789086315,0.448449456879847,-0.283672332206468,199,63,161,82,6054,5964,12018,1262.35,1261.88333333333,2524.23333333333,5269,5596,87.0333663693426,-327
2015,201596,Mario Chalmers,0.907320069640887,-1.1959308347042,-0.288610765063313,77,252,162,61,3161,3177,6338,694.533333333333,677.216666666667,1371.75,2889,2791,91.3951281240114,98
2015,203471,Dennis Schroder,0.606421034734062,-0.935640840212454,-0.329219805478392,99,241,163,80,3671,3762,7433,779.35,840.166666666667,1619.51666666667,3440,3192,93.7074366657587,248
2015,202689,Kemba Walker,-0.361089167918693,0.0194346547561221,-0.341654513162571,168,116,164,81,6538,6560,13098,1465.63333333333,1413.71666666667,2879.35,6226,5997,95.2278984398899,229
2015,1626163,Frank Kaminsky,-0.68975170883434,0.347360291994449,-0.342391416839891,193,76,165,81,3890,3904,7794,861.316666666667,842.1,1703.41666666667,3503,3541,90.0514138817481,-38
2015,202699,Tobias Harris,-0.400747401280741,0.0486662156100247,-0.352081185670716,172,110,166,76,5773,5650,11423,1254.6,1248.08333333333,2502.68333333333,5233,5217,90.6461112073445,16
2015,201976,Patrick Beverley,0.192856933605825,-0.556474222218246,-0.363617288612421,134,198,167,71,4813,4779,9592,973.483333333333,1057.48333333333,2030.96666666667,4536,4372,94.2447537918138,164
2015,2772,Trevor Ariza,-0.802179549613433,0.425881660480967,-0.376297889132466,205,66,168,81,6780,6733,13513,1369.28333333333,1482.73333333333,2852.01666666667,6341,6310,93.5250737463127,31
2015,201565,Derrick Rose,-1.14439450799332,0.738413004838428,-0.405981503154896,227,40,169,66,4883,4964,9847,1034.93333333333,1051.76666666667,2086.7,4371,4547,89.5146426377227,-176
2015,203082,Terrence Ross,-0.0599352202992204,-0.367941464958718,-0.427876685257939,146,169,170,73,3918,3892,7810,900.766666666667,843.45,1744.21666666667,3679,3464,93.8999489535477,215
2015,1626156,D'Angelo Russell,-0.712804606035375,0.249032380244358,-0.463772225791017,195,88,171,80,5225,5224,10449,1161.48333333333,1095.45,2256.93333333333,4499,5062,86.1052631578948,-563
2015,203085,Austin Rivers,0.394650437999595,-0.894143808779627,-0.499493370780032,116,238,172,67,3339,3535,6874,734.433333333333,733.883333333333,1468.31666666667,3055,3149,91.4944594189877,-94
2015,202362,Lance Stephenson,-0.546696278021352,0.0394315592785047,-0.507264718742848,182,113,173,69,3200,3175,6375,691,677.566666666667,1368.56666666667,2892,2946,90.375,-54
2015,203926,Doug McDermott,-0.714254875740408,0.193978959168372,-0.520275916572035,197,95,174,81,4342,4354,8696,922.25,938.766666666667,1861.01666666667,3869,4026,89.1064025794565,-157
2015,2733,Shaun Livingston,0.314796352496555,-0.843218730597554,-0.528422378100999,120,232,175,78,3534,3608,7142,730.466666666667,784.966666666667,1515.43333333333,3405,3203,96.3497453310696,202
2015,201188,Marc Gasol,-0.375486649500146,-0.15329364321995,-0.528780292720096,169,145,176,52,3993,3975,7968,930.566666666667,857.583333333333,1788.15,3616,3612,90.5584773353369,4
2015,201162,Jared Dudley,-0.0640919508643753,-0.481065976924666,-0.545157927789041,148,191,177,81,4857,4895,9752,995.733333333333,1099.46666666667,2095.2,4542,4492,93.514515132798,50
2015,203497,Rudy Gobert,0.120933240917368,-0.67961034349305,-0.558677102575682,136,218,178,61,4236,4179,8415,1000.48333333333,924.133333333333,1924.61666666667,3868,3705,91.3125590179415,163
2015,201579,Roy Hibbert,-1.88159740389882,1.31901789798505,-0.562579505913767,251,9,179,81,4296,4358,8654,974.866666666667,890.716666666667,1865.58333333333,3617,4250,84.1945996275605,-633
2015,201609,Goran Dragic,0.625867358757218,-1.21917120034492,-0.593303841587698,95,253,180,72,5402,5386,10788,1205.91666666667,1148.91666666667,2354.83333333333,5017,4798,92.8730099962977,219
2015,202693,Markieff Morris,-1.36379324429907,0.745509725823753,-0.618283518475317,241,39,181,64,3852,3764,7616,796.433333333333,820.966666666667,1617.4,3438,3527,89.2523364485981,-89
2015,201933,Blake Griffin,-0.819970413727651,0.198608373837133,-0.621362039890517,206,94,182,35,2716,2726,5442,579.333333333333,585.983333333333,1165.31666666667,2573,2410,94.7349042709867,163
2015,2585,Zaza Pachulia,-1.07884305769275,0.422577796092338,-0.656265261600416,224,67,183,76,4417,4463,8880,1023.4,973.933333333333,1997.33333333333,4080,4089,92.3703871405932,-9
2015,201155,Rodney Stuckey,-0.581614458491093,-0.0977605234508565,-0.67937498194195,185,131,184,58,2907,2962,5869,630.066666666667,649.533333333333,1279.6,2623,2628,90.2304781561748,-5
2015,2754,Tony Allen,-0.233017387591968,-0.459629741009233,-0.692647128601201,158,186,185,64,3685,3610,7295,826.216666666667,784.55,1610.76666666667,3267,3296,88.6567164179104,-29
2015,2738,Andre Iguodala,-0.282542348930411,-0.411806717691808,-0.694349066622218,161,181,186,65,4152,4251,8403,823.366666666667,906.25,1729.61666666667,4129,3679,99.4460500963391,450
2015,203109,Jae Crowder,0.216397490316009,-0.913536909028513,-0.697139418712505,130,239,187,73,5551,5570,11121,1086.55,1205.51666666667,2292.06666666667,5132,4935,92.4518104845974,197
2015,2440,Matt Barnes,-0.77775531789921,0.0582034655957444,-0.719551852303466,203,108,188,76,5068,4973,10041,1116.56666666667,1072.55,2189.11666666667,4503,4682,88.8516179952644,-179
2015,203918,Rodney Hood,-0.342047261024346,-0.378173908589212,-0.720221169613558,165,173,189,79,5511,5419,10930,1323.03333333333,1197.43333333333,2520.46666666667,5064,4955,91.8889493739793,109
2015,101161,Amir Johnson,0.681895246859189,-1.41315698056654,-0.73126173370735,93,257,190,79,4257,4260,8517,838.933333333334,943.75,1782.68333333333,3956,3754,92.9292929292929,202
2015,203087,Jeremy Lamb,0.771681710333483,-1.5269361408006,-0.755254430467117,86,260,191,66,2801,2818,5619,621.05,604.666666666667,1225.71666666667,2549,2399,91.0032131381649,150
2015,203484,Kentavious Caldwell-Pope,-0.663224995922669,-0.102992887135486,-0.766217883058156,191,135,192,76,6640,6341,12981,1392.15,1393.98333333333,2786.13333333333,5979,5811,90.0451807228916,168
2015,101114,Deron Williams,-0.381821830739154,-0.390417866827865,-0.772239697567019,170,175,193,65,4691,4796,9487,1070.91666666667,1031.1,2102.01666666667,4395,4366,93.6900447665743,29
2015,201568,Danilo Gallinari,-0.998025725584738,0.215206630068909,-0.782819095515829,216,90,194,53,4356,4222,8578,928.8,908,1836.8,3892,4011,89.3480257116621,-119
2015,202355,Hassan Whiteside,-0.393551424810384,-0.39857330951018,-0.792124734320564,171,177,195,73,4796,4802,9598,1086.08333333333,1034.95,2121.03333333333,4384,4296,91.4095079232694,88
2015,201601,Luc Mbah a Moute,0.144417298996557,-0.945640520245546,-0.801223221248988,135,242,196,73,2836,2961,5797,620.283333333333,651.883333333333,1272.16666666667,2776,2537,97.8843441466855,239
2015,2210,Richard Jefferson,-1.03939018231117,0.12929056389044,-0.910099618420725,221,103,197,74,2944,2948,5892,671.35,647.116666666667,1318.46666666667,2649,2692,89.9796195652174,-43
2015,1626209,Mario Hezonja,-0.508827090180861,-0.404480921643222,-0.913308011824083,180,180,198,79,3250,3236,6486,699.75,707.65,1407.4,2959,3013,91.0461538461538,-54
2015,203960,JaKarr Sampson,-0.588583608120294,-0.336005156331385,-0.92458876445168,187,163,199,73,2693,2717,5410,572.033333333333,575.433333333333,1147.46666666667,2344,2503,87.0404753063498,-159
2015,202730,Lavoy Allen,-0.164495631266983,-0.774698215051224,-0.939193846318207,154,228,200,79,3677,3649,7326,789.633333333333,804.733333333333,1594.36666666667,3351,3170,91.1340766929562,181
2015,202329,Al-Farouq Aminu,-0.998965518620705,0.0375636788251269,-0.961401839795578,218,115,201,82,5501,5500,11001,1174.88333333333,1159.55,2334.43333333333,5180,5111,94.1646973277586,69
2015,201959,Taj Gibson,-0.713715362104645,-0.253952106719369,-0.967667468824014,196,157,202,73,4438,4523,8961,960.783333333333,969.866666666667,1930.65,3970,4073,89.4547093285264,-103
2015,1626168,Trey Lyles,-1.25200144108448,0.277763088296996,-0.974238352787485,235,85,203,80,3007,3014,6021,725.716666666667,653.716666666667,1379.43333333333,2701,2759,89.8237445959428,-58
2015,101133,Ian Mahinmi,-0.2329582005781,-0.791020454498355,-1.02397865507646,157,230,204,71,4178,4208,8386,886.95,918.55,1805.5,3824,3694,91.5270464337003,130
2015,202325,Wesley Johnson,-0.0947029395269834,-0.935214200807788,-1.02991714033477,151,240,205,80,3861,3952,7813,830.666666666667,832.2,1662.86666666667,3550,3451,91.9450919450919,99
2015,2449,Luis Scola,-0.954330913202924,-0.0897956372279544,-1.04412655043088,214,129,206,76,3684,3614,7298,858.066666666667,772.6,1630.66666666667,3380,3433,91.7480998914224,-53
2015,202087,Alonzo Gee,-0.618921907836159,-0.438144614369235,-1.05706652220539,189,182,207,73,3817,3808,7625,794.166666666667,835.25,1629.41666666667,3395,3545,88.9441970133613,-150
2015,202334,Ed Davis,-0.507318247705277,-0.55772202767878,-1.06504027538406,179,200,208,81,3959,3907,7866,865.433333333333,821.416666666667,1686.85,3589,3555,90.6542056074766,34
2015,203935,Marcus Smart,-0.470075651843381,-0.634188551294637,-1.10426420313802,176,214,209,61,4117,4061,8178,805.216666666667,875.033333333333,1680.25,3717,3596,90.284187515181,121
2015,201589,Darrell Arthur,-0.46480013032419,-0.655793292883978,-1.12059342320817,175,216,210,70,3530,3529,7059,755.866666666667,757.883333333333,1513.75,3147,3206,89.1501416430595,-59
2015,201147,Corey Brewer,-0.798855447572816,-0.337351890994058,-1.13620733856687,204,164,211,82,4056,4085,8141,797.45,874.783333333333,1672.23333333333,3643,3697,89.8175542406312,-54
2015,1626170,Jerian Grant,-1.416032734506,0.265144283083918,-1.15088845142209,242,86,212,76,2880,2923,5803,640.916666666667,627.65,1268.56666666667,2495,2651,86.6319444444445,-156
2015,2200,Pau Gasol,-0.736654949394399,-0.449696223455104,-1.1863511728495,201,183,213,72,5308,5420,10728,1148.15,1139.61666666667,2287.76666666667,4800,4867,90.4295403165034,-67
2015,101106,Andrew Bogut,-0.844401848194883,-0.34600406675239,-1.19040591494727,207,165,214,70,3361,3441,6802,680.016666666667,762.2,1442.21666666667,3378,2941,100.505801844689,437
2015,201573,Jerryd Bayless,-1.77747926152178,0.568805820245025,-1.20867344127675,249,56,215,52,3379,3455,6834,748.016666666667,750.633333333333,1498.65,3052,3233,90.3225806451613,-181
2015,202389,Timofey Mozgov,-0.761726774103124,-0.463562225145834,-1.22528899924896,202,187,216,76,2944,2939,5883,669.366666666667,647.766666666667,1317.13333333333,2736,2687,92.9347826086957,49
2015,203210,JaMychal Green,-1.29293372587974,0.0586620947998904,-1.23427163107985,236,107,217,78,3401,3272,6673,720.866666666667,715.15,1436.01666666667,3032,3068,89.1502499264922,-36
2015,1626167,Myles Turner,-0.946810004286521,-0.300290235196144,-1.24710023948266,213,160,218,60,3170,3270,6440,677.816666666667,689.833333333333,1367.65,2827,2889,89.1798107255521,-62
2015,200757,Thabo Sefolosha,-0.58298594584574,-0.683175732183024,-1.26616167802876,186,220,219,75,3995,4152,8147,844.266666666667,910.483333333333,1754.75,3660,3574,91.6145181476846,86
2015,203924,Jerami Grant,-1.05339229142317,-0.231701595027121,-1.28509388645029,223,156,220,77,4773,4941,9714,1038.78333333333,1017.95,2056.73333333333,4131,4543,86.5493400377121,-412
2015,202711,Bojan Bogdanovic,-1.15665488715637,-0.191546865510214,-1.34820175266659,229,152,221,79,4846,4887,9733,1072.51666666667,1041.81666666667,2114.33333333333,4297,4704,88.6710689228229,-407
2015,202734,E'Twaun Moore,-0.3296743888034,-1.03982614898216,-1.36950053778556,164,244,222,59,2907,2973,5880,626.583333333333,632.8,1259.38333333333,2676,2698,92.0536635706914,-22
2015,201152,Thaddeus Young,-1.75426094738087,0.382173131644964,-1.37208781573591,247,71,223,73,5476,5447,10923,1214.75,1183.36666666667,2398.11666666667,4978,5195,90.9057706355004,-217
2015,201952,Jeff Teague,-1.04683847988915,-0.378144100323715,-1.42498258021286,222,172,224,79,5203,5406,10609,1094.65,1147.58333333333,2242.23333333333,4777,4735,91.8124159138958,42
2015,1495,Tim Duncan,0.286692568742449,-1.71508284254765,-1.4283902738052,126,261,225,61,3437,3384,6821,798.683333333333,734.35,1533.03333333333,3248,2851,94.5010183299389,397
2015,101145,Monta Ellis,-0.851250304711929,-0.597195533196439,-1.44844583790837,208,205,226,81,6413,6474,12887,1347.91666666667,1382.61666666667,2730.53333333333,5829,5713,90.8934975830345,116
2015,203901,Elfrid Payton,-1.31143368935375,-0.159757362136931,-1.47119105149068,238,148,227,73,5030,4935,9965,1058.68333333333,1078.6,2137.28333333333,4505,4575,89.5626242544732,-70
2015,203504,Trey Burke,-1.35662271974154,-0.132383830131535,-1.48900654987308,240,138,228,64,3100,3035,6135,710.35,659.45,1369.8,2715,2767,87.5806451612903,-52
2015,203798,PJ Hairston,-2.34641560956061,0.829616719231548,-1.51679889032906,257,31,229,66,2959,2978,5937,658.9,645.333333333333,1304.23333333333,2677,2845,90.4697532950321,-168
2015,203487,Michael Carter-Williams,-1.20244150021262,-0.357534219779551,-1.55997571999217,231,168,230,54,3816,3847,7663,809.883333333333,833.15,1643.03333333333,3409,3525,89.3343815513627,-116
2015,203096,Jared Sullinger,-0.927830363293653,-0.644501768965231,-1.57233213225888,212,215,231,81,4590,4542,9132,907.966666666667,1000.55,1908.51666666667,4207,4048,91.6557734204793,159
2015,2734,Devin Harris,-0.998149996488794,-0.585822758593792,-1.58397275508259,217,203,232,64,2949,3041,5990,658.5,621.016666666667,1279.51666666667,2672,2736,90.606985418786,-64
2015,201941,Jordan Hill,-0.976165716719397,-0.610546030032994,-1.58671174675239,215,210,233,73,3493,3500,6993,768.7,746.483333333333,1515.18333333333,3134,3114,89.7223017463499,20
2015,202323,Evan Turner,-0.85638314347669,-0.741402825543676,-1.59778596902037,209,225,234,81,5457,5430,10887,1095.78333333333,1170.85,2266.63333333333,4882,4789,89.463074949606,93
2015,201951,Ty Lawson,-1.78098973644003,0.180179383661213,-1.60081035277881,250,99,235,66,3380,3400,6780,688.683333333333,723.75,1412.43333333333,2983,3142,88.2544378698225,-159
2015,202066,Garrett Temple,-1.12471493790195,-0.556763368830548,-1.6814783067325,226,199,236,79,4498,4549,9047,918.433333333333,1024.13333333333,1942.56666666667,4112,4105,91.418408181414,7
2015,1626143,Jahlil Okafor,-2.03711459271942,0.338358447249417,-1.69875614547,253,77,237,53,3615,3655,7270,828.716666666667,752.866666666667,1581.58333333333,2973,3480,82.240663900415,-507
2015,2730,Dwight Howard,-1.2111910458686,-0.493051432003399,-1.70424247787199,232,194,238,71,5391,5321,10712,1091.55,1179.45,2271,4945,4922,91.726952327954,23
2015,202709,Cory Joseph,-0.867083746370652,-0.847698545717249,-1.7147822920879,210,234,239,80,4652,4631,9283,1062.75,978.9,2041.65,4366,4100,93.8521066208083,266
2015,1626169,Stanley Johnson,-1.70342201670571,-0.0592512565353115,-1.76267327324102,246,124,240,73,3994,3849,7843,847.433333333333,839.733333333333,1687.16666666667,3481,3586,87.1557336004006,-105
2015,203477,Isaiah Canaan,-2.16097762525933,0.37158926203258,-1.78938836322675,254,73,241,77,4579,4641,9220,1003.98333333333,952.55,1956.53333333333,3885,4396,84.843852369513,-511
2015,203932,Aaron Gordon,-1.15261621158878,-0.696352205181094,-1.84896841676987,228,221,242,78,4355,4351,8706,915.733333333333,946.066666666667,1861.8,3939,4010,90.4477611940299,-71
2015,203953,Jabari Parker,-1.76872355491936,-0.0863063636196644,-1.85502991853902,248,128,243,76,5484,5541,11025,1179.31666666667,1214,2393.31666666667,4962,5154,90.4814004376368,-192
2015,202687,Bismack Biyombo,-1.29800863645479,-0.557750452031297,-1.85575908848608,237,201,244,82,4080,4067,8147,929.75,879.183333333333,1808.93333333333,3747,3594,91.8382352941177,153
2015,203482,Kelly Olynyk,-0.665990029531302,-1.22544669233078,-1.89143672186208,192,254,245,69,3352,3366,6718,676.133333333333,713.4,1389.53333333333,3031,2900,90.4236276849642,131
2015,203458,Alex Len,-2.31684770582156,0.398577958421992,-1.91826974739957,256,69,246,78,4343,4265,8608,907.7,903.466666666667,1811.16666666667,3708,3967,85.3787704351831,-259
2015,201973,Jonas Jerebko,-0.734430831477611,-1.19220179470911,-1.92663262618672,200,251,247,78,2819,2803,5622,576.583333333333,596.583333333333,1173.16666666667,2516,2422,89.251507626818,94
2015,203500,Steven Adams,-1.08890116340233,-0.885059169522903,-1.97396033292523,225,237,248,80,4821,4712,9533,969.366666666667,1040.05,2009.41666666667,4559,4101,94.5654428541796,458
2015,201564,O.J. Mayo,-1.68953500739534,-0.381516160445219,-2.07105116784056,245,174,249,41,2481,2534,5015,528.3,555.65,1083.95,2218,2266,89.3994357114067,-48
2015,203083,Andre Drummond,-1.24170526790633,-0.868039862806188,-2.10974513071252,234,235,250,81,6306,5998,12304,1331.21666666667,1329.65,2660.86666666667,5656,5485,89.6923564858865,171
2015,1626204,Larry Nance Jr.,-1.34293089385412,-0.78757234352058,-2.13050323737469,239,229,251,63,2915,2903,5818,649.383333333333,617.333333333333,1266.71666666667,2574,2683,88.3018867924528,-109
2015,203503,Tony Snell,-0.186798582229382,-2.09622921256804,-2.28302779479742,156,262,252,64,3051,3081,6132,640.816666666667,655.966666666667,1296.78333333333,2731,2604,89.5116355293346,127
2015,201158,Marco Belinelli,-2.2611793727681,-0.0807689340488293,-2.34194830681693,255,126,253,68,3990,4025,8015,826.466666666667,845.866666666667,1672.33333333333,3537,3757,88.6466165413534,-220
2015,201600,Omer Asik,-3.16468350356584,0.734436008863535,-2.4302474947023,261,42,254,68,2722,2636,5358,584.1,587.783333333333,1171.88333333333,2344,2561,86.1131520940485,-217
2015,203991,Clint Capela,-1.01373084062896,-1.48368284607936,-2.49741368670831,220,259,255,77,3558,3505,7063,700.683333333333,766.916666666667,1467.6,3242,3135,91.1186059584036,107
2015,203943,Noah Vonleh,-1.92643966027242,-0.598984615096328,-2.52542427536875,252,208,256,78,2696,2660,5356,587.5,573.4,1160.9,2415,2458,89.5771513353116,-43
2015,203457,Nerlens Noel,-2.40179087088481,-0.130387383220458,-2.53217825410527,259,136,257,67,4561,4674,9235,999.116666666667,963.65,1962.76666666667,3869,4306,84.8278886209165,-437
2015,203145,Kent Bazemore,-1.22615527475828,-1.32033558427571,-2.546490859034,233,256,258,75,4763,4982,9745,1000.25,1065.5,2065.75,4385,4309,92.0638253201764,76
2015,203118,Mike Scott,-1.48117834080292,-1.24409626111855,-2.72527460192147,243,255,259,75,2630,2684,5314,554.883333333333,593.033333333333,1147.91666666667,2401,2268,91.2927756653992,133
2015,101179,Ronnie Price,-2.36700947712406,-0.478052413321605,-2.84506189044567,258,190,260,62,2910,2829,5739,601.35,610.15,1211.5,2490,2547,85.5670103092784,-57
2015,2199,Tyson Chandler,-4.06437103459762,0.774839181954007,-3.28953185264361,262,34,261,66,3838,3759,7597,816.85,798.216666666667,1615.06666666667,3204,3577,83.4809796769151,-373
2015,201961,Wayne Ellington,-3.1608270562797,-0.453379210315044,-3.61420626659474,260,184,262,76,3679,3680,7359,821.316666666667,787.9,1609.21666666667,3158,3462,85.8385430823593,-304
2016,202738,Isaiah Thomas,4.02105438821346,0.959152277764303,4.98020666597777,2,28,1,76,5935,6102,12037,1258.71666666667,1297,2555.71666666667,6024,5786,101.499578770008,238
2016,202695,Kawhi Leonard,4.11417210160418,0.360349944473813,4.47452204607799,1,83,2,74,5536,5533,11069,1259.46666666667,1201,2460.46666666667,5509,5101,99.5122832369942,408
2016,200755,JJ Redick,2.36294085493888,1.51719446350558,3.88013531844445,23,3,3,78,5092,5116,10208,1092.3,1096.15,2188.45,5156,4743,101.256873527101,413
2016,101108,Chris Paul,3.79522917658153,-0.183102355734675,3.61212682084686,3,166,4,61,4426,4415,8841,959.666666666667,954.216666666667,1913.88333333333,4527,3983,102.281970176231,544
2016,203914,Gary Harris,1.95684513479515,1.51522812300865,3.47207325780381,33,4,5,57,4262,4148,8410,887.766666666667,889.4,1777.16666666667,4293,4216,100.727358047865,77
2016,202681,Kyrie Irving,3.29046287432005,0.103450547381786,3.39391342170183,4,121,6,72,5933,5881,11814,1273.68333333333,1251.16666666667,2524.85,5987,5667,100.910163492331,320
2016,101150,Lou Williams,2.74787167403202,0.543798530530822,3.29167020456284,15,62,7,81,4870,4847,9717,971.383333333333,1013.3,1984.68333333333,4667,4639,95.8316221765914,28
2016,201578,Marreese Speights,3.00815668156131,0.238688043196087,3.2468447247574,9,100,8,82,2889,2981,5870,655.033333333333,628.05,1283.08333333333,2776,2813,96.0886119764625,-37
2016,201935,James Harden,2.28286940181384,0.823108488827497,3.10597789064134,24,38,9,81,7106,7105,14211,1411.71666666667,1534.38333333333,2946.1,7192,6792,101.210244863496,400
2016,202689,Kemba Walker,2.86652862858842,0.220698133865278,3.0872267624537,14,105,10,79,6246,6214,12460,1378.63333333333,1352.53333333333,2731.16666666667,6101,5889,97.6785142491194,212
2016,203486,Mason Plumlee,2.48972930646078,0.576892472780611,3.06662177924139,20,58,11,81,4984,5021,10005,1062.76666666667,1068.6,2131.36666666667,4903,4885,98.3747993579454,18
2016,204060,Joe Ingles,2.69256050049774,0.310751297513934,3.00331179801168,16,92,12,82,4350,4346,8696,1011.61666666667,954.333333333333,1965.95,4223,4065,97.0804597701149,158
2016,202322,John Wall,2.58367944652781,0.343850559517171,2.92753000604498,19,87,13,78,6728,6733,13461,1372.16666666667,1449.81666666667,2821.98333333333,6624,6370,98.4542211652794,254
2016,203952,Andrew Wiggins,1.69038633493338,1.21529757161647,2.90568390654985,42,10,14,81,7080,6870,13950,1549.25,1460.83333333333,3010.08333333333,6741,6778,95.2118644067797,-37
2016,201568,Danilo Gallinari,2.90527580906422,-0.0660059179837995,2.83926989108042,12,149,15,63,5103,4998,10101,1056.95,1070.65,2127.6,5003,4861,98.0403684107388,142
2016,1626157,Karl-Anthony Towns,2.46925382190521,0.299593959343388,2.7688477812486,21,93,16,81,7000,6803,13803,1537.7,1448.35,2986.05,6644,6708,94.9142857142857,-64
2016,202328,Greg Monroe,2.43871861339126,0.295363478541917,2.73408209193318,22,94,17,81,4132,4163,8295,911.2,920.783333333333,1831.98333333333,4052,3948,98.0638915779284,104
2016,201142,Kevin Durant,3.02138369087665,-0.326682442746528,2.69470124813012,8,184,18,62,4956,5079,10035,967.55,1096.28333333333,2063.83333333333,5207,4536,105.064568200161,671
2016,203999,Nikola Jokic,3.04662676536401,-0.37249280720933,2.67413395815468,6,190,19,73,4890,4726,9616,1006.33333333333,1023,2029.33333333333,4925,4643,100.715746421268,282
2016,2544,LeBron James,3.19781686493475,-0.535131337563634,2.66268552737111,5,215,20,74,6476,6424,12900,1407.65,1374.21666666667,2781.86666666667,6567,6107,101.405188387894,460
2016,203085,Austin Rivers,1.59219149637175,0.912762092445087,2.50495358881683,45,31,21,74,4720,4755,9475,1046.51666666667,1002.35,2048.86666666667,4547,4510,96.3347457627119,37
2016,201144,Mike Conley,2.6803483237858,-0.25923724270107,2.42111108108473,17,174,22,69,5169,5055,10224,1198.18333333333,1086.93333333333,2285.11666666667,4906,4732,94.9119752369898,174
2016,201939,Stephen Curry,2.92208576299206,-0.63327342397873,2.28881233901333,11,223,23,79,6475,6539,13014,1231.01666666667,1402.08333333333,2633.1,6801,5819,105.034749034749,982
2016,201566,Russell Westbrook,1.72040261742885,0.563207255048708,2.28360987247756,38,60,24,81,6936,6632,13568,1319.31666666667,1475.03333333333,2794.35,6443,6200,92.8921568627451,243
2016,201156,Nick Young,1.16061738555079,1.09402942525116,2.25464681080196,64,18,25,60,3725,3709,7434,780.3,779.95,1560.25,3467,3662,93.0738255033557,-195
2016,203078,Bradley Beal,2.63621249905242,-0.38746415028699,2.24874834876543,18,197,26,77,6301,6325,12626,1299.58333333333,1370.71666666667,2670.3,6243,5926,99.0795111887002,317
2016,201973,Jonas Jerebko,1.52420285170247,0.6905975049679,2.21480035667037,48,47,27,78,2807,2912,5719,619.316666666667,610.866666666667,1230.18333333333,2736,2706,97.4706091913075,30
2016,202329,Al-Farouq Aminu,3.04536679289766,-0.86209258864995,2.18327420424771,7,244,28,61,4021,4123,8144,891.333333333333,882.266666666667,1773.6,3898,3859,96.9410594379508,39
2016,201586,Serge Ibaka,1.99236590433986,0.155691245638518,2.14805714997838,31,115,29,79,5520,5526,11046,1204.46666666667,1205.16666666667,2409.63333333333,5124,5255,92.8260869565217,-131
2016,203090,Maurice Harkless,1.97889976729876,0.0796821301779809,2.05858189747674,32,124,30,77,5194,5260,10454,1113.13333333333,1105.41666666667,2218.55,5105,4993,98.2864844050828,112
2016,202326,DeMarcus Cousins,1.40006335190083,0.616890550640677,2.01695390254151,50,52,31,72,5636,5575,11211,1262.61666666667,1197.48333333333,2460.1,5330,5382,94.5706174591909,-52
2016,201942,DeMar DeRozan,1.78471234132728,0.223497032931831,2.00820937425911,36,104,32,74,6031,6082,12113,1339.95,1284.46666666667,2624.41666666667,5880,5736,97.4962692754104,144
2016,1938,Manu Ginobili,2.89632665110839,-0.949508051748756,1.94681859935964,13,248,33,69,3062,3053,6115,644.483333333333,645.883333333333,1290.36666666667,3019,2756,98.5956890920967,263
2016,201954,Darren Collison,1.65107929493621,0.248590552103642,1.89966984703986,44,99,34,68,4641,4657,9298,1067.5,992.533333333333,2060.03333333333,4400,4541,94.807153630683,-141
2016,201933,Blake Griffin,1.12363666000363,0.772957457111789,1.89659411711542,67,42,35,61,4812,4799,9611,1034.45,1036.68333333333,2071.13333333333,4891,4457,101.641729010806,434
2016,2207,Joe Johnson,1.90409319157899,-0.03885680458961,1.86523638698938,34,146,36,78,4016,4020,8036,958.883333333333,884.416666666667,1843.3,3899,3744,97.0866533864542,155
2016,201961,Wayne Ellington,2.24272561766248,-0.380433026784812,1.86229259087767,25,193,37,62,3449,3453,6902,775.216666666667,719.733333333333,1494.95,3266,3171,94.6941142360104,95
2016,101161,Amir Johnson,2.96707261190904,-1.10518050477154,1.86189210713751,10,259,38,80,3646,3721,7367,785.216666666667,815.2,1600.41666666667,3647,3364,100.027427317608,283
2016,203521,Matthew Dellavedova,0.767903307268834,1.03273295220756,1.80063625947639,87,23,39,76,4541,4586,9127,971.416666666667,1010.96666666667,1982.38333333333,4268,4342,93.9881083461793,-74
2016,201584,Courtney Lee,1.2862298159884,0.463253124777622,1.74948294076602,54,71,40,77,5682,5706,11388,1236.06666666667,1203.63333333333,2439.7,5276,5525,92.8546286518831,-249
2016,203501,Tim Hardaway Jr.,1.69663215622062,0.0362879190438826,1.7329200752645,40,132,41,79,5098,5084,10182,1042.75,1106.91666666667,2149.66666666667,4782,4657,93.8014907806983,125
2016,203939,Dwight Powell,0.460478005621025,1.24728874409362,1.70776674971465,106,9,42,77,2923,2954,5877,684.2,644.75,1328.95,2741,2892,93.7735203557988,-151
2016,1626163,Frank Kaminsky,1.23290760306789,0.397005604895175,1.62991320796307,57,80,43,75,4439,4460,8899,994.85,958.8,1953.65,4348,4279,97.9499887362019,69
2016,201967,Dante Cunningham,1.23131027557191,0.38035498848836,1.61166526406027,58,81,44,66,3823,3888,7711,798.6,851.566666666667,1650.16666666667,3626,3675,94.846978812451,-49
2016,101145,Monta Ellis,2.06505765429441,-0.508450790497317,1.5566068637971,29,212,45,74,4513,4653,9166,997.633333333333,991.466666666667,1989.1,4339,4363,96.1444715267007,-24
2016,1626181,Norman Powell,1.37262879433819,0.149583048798376,1.52221184313657,52,116,46,76,3123,3160,6283,688.65,675.816666666667,1364.46666666667,3025,2953,96.8619916746718,72
2016,201583,Ryan Anderson,1.6965623455826,-0.177041531995433,1.51952081358717,41,165,47,72,5047,5010,10057,1013.73333333333,1095.13333333333,2108.86666666667,5067,4733,100.39627501486,334
2016,201229,Anthony Tolliver,0.964565136299142,0.528901983193749,1.49346711949289,73,64,48,65,3376,3382,6758,763.233333333333,715.766666666667,1479,3208,3320,95.0236966824645,-112
2016,203086,Meyers Leonard,0.493188512200113,0.965138131746009,1.45832664394612,103,27,49,74,2792,2851,5643,627.783333333333,589.566666666667,1217.35,2657,2722,95.1647564469914,-65
2016,101139,CJ Miles,1.26652400909717,0.173755480471877,1.44027948956904,56,110,50,76,4044,4055,8099,889.916666666667,877.916666666667,1767.83333333333,3866,3826,95.5984174085064,40
2016,101107,Marvin Williams,0.00529881058742018,1.43289128213447,1.43819009272189,148,5,51,76,5185,5153,10338,1154.03333333333,1122.5,2276.53333333333,4910,4946,94.6962391513983,-36
2016,204038,Langston Galloway,1.40287812596563,-0.0138377760940427,1.38904034987159,49,143,52,74,3452,3502,6954,724.533333333333,771.116666666667,1495.65,3202,3272,92.7578215527231,-70
2016,201952,Jeff Teague,0.343196717524019,1.0403184263807,1.38351514390472,120,22,53,82,6069,6246,12315,1323.11666666667,1337.41666666667,2660.53333333333,5905,5853,97.2977426264624,52
2016,1717,Dirk Nowitzki,1.28153919508907,0.0552030100530262,1.3367422051421,55,126,54,54,3115,3174,6289,743.766666666667,678.2,1421.96666666667,2971,3047,95.3772070626003,-76
2016,201158,Marco Belinelli,0.961485353402669,0.334580341601812,1.29606569500448,74,89,55,74,4021,4034,8055,905.15,870.3,1775.45,3893,3913,96.8167122606317,-20
2016,203926,Doug McDermott,0.321705730204822,0.974239972183669,1.29594570238849,123,26,56,66,3568,3430,6998,747.733333333333,755.666666666667,1503.4,3253,3299,91.1715246636771,-46
2016,202083,Wesley Matthews,0.35555676844955,0.935584431207342,1.29114119965689,118,30,57,73,5367,5497,10864,1307.53333333333,1185.8,2493.33333333333,5042,5219,93.9444754984163,-177
2016,1627812,Yogi Ferrell,0.449057388561117,0.824303881580458,1.27336127014157,110,37,58,46,2637,2684,5321,618.116666666667,576.35,1194.46666666667,2495,2597,94.6150929086083,-102
2016,201588,George Hill,1.33513173423219,-0.0876629383715474,1.24746879586064,53,151,59,49,3381,3298,6679,803.266666666667,732.283333333333,1535.55,3269,3013,96.6873706004141,256
2016,1627737,Marquese Chriss,-0.436562204606878,1.64962281302515,1.21306060841828,196,2,60,81,4265,4189,8454,829.983333333333,883.133333333333,1713.11666666667,3828,4181,89.7538100820633,-353
2016,1627747,Caris LeVert,0.412861343038295,0.797961439638969,1.21082278267726,114,40,61,57,2989,3046,6035,592.083333333333,639.383333333333,1231.46666666667,2815,2915,94.1786550685848,-100
2016,101135,David Lee,2.18754466641647,-0.978323513082224,1.20922115333425,28,249,62,79,3381,3415,6796,739.716666666667,736.716666666667,1476.43333333333,3299,3021,97.5746820467317,278
2016,101114,Deron Williams,-0.0133184657827532,1.21181527866731,1.19849681288455,152,11,63,64,3580,3645,7225,856.666666666667,796.683333333333,1653.35,3394,3475,94.804469273743,-81
2016,202697,Iman Shumpert,0.983030849767881,0.212945891843653,1.19597674161153,72,107,64,76,4371,4463,8834,973.25,952.466666666667,1925.71666666667,4318,4258,98.7874628231526,60
2016,2210,Richard Jefferson,2.01650506502231,-0.837975026152297,1.17853003887001,30,241,65,79,3678,3702,7380,809.716666666667,792.016666666667,1601.73333333333,3630,3480,98.694942903752,150
2016,202330,Gordon Hayward,1.38688966875824,-0.219332910554167,1.16755675820407,51,173,66,73,5510,5499,11009,1299.21666666667,1210.96666666667,2510.18333333333,5340,5017,96.9147005444646,323
2016,203468,CJ McCollum,1.17966262208843,-0.0126242947305327,1.1670383273579,60,142,67,80,6479,6563,13042,1404.33333333333,1380.63333333333,2784.96666666667,6258,6243,96.5889797808304,15
2016,2037,Jamal Crawford,0.0655560514899918,1.09304824584771,1.1586042973377,141,19,68,82,4976,4990,9966,1106.71666666667,1043.1,2149.81666666667,4755,4759,95.5586816720257,-4
2016,203484,Kentavious Caldwell-Pope,0.306712944206191,0.83844109625843,1.14515404046462,125,35,69,76,5865,5676,11541,1251.63333333333,1275.15,2526.78333333333,5357,5513,91.3384484228474,-156
2016,200768,Kyle Lowry,2.21133451582197,-1.06827055272355,1.14306396309842,27,256,70,60,5100,5079,10179,1116.3,1108.65,2224.95,5057,4684,99.156862745098,373
2016,203933,T.J. Warren,0.230235818421969,0.908745926830537,1.13898174525251,134,33,71,66,5072,5008,10080,993.133333333333,1050.53333333333,2043.66666666667,4639,4931,91.4629337539432,-292
2016,201587,Nicolas Batum,0.666550396261506,0.460934064432376,1.12748446069388,92,72,72,77,5985,5995,11980,1311.83333333333,1297.98333333333,2609.81666666667,5786,5714,96.6750208855472,72
2016,201188,Marc Gasol,0.901183477932263,0.204636395827748,1.10581987376001,79,108,73,74,5664,5567,11231,1324.93333333333,1200.11666666667,2525.05,5290,5223,93.3968926553672,67
2016,201565,Derrick Rose,1.12604829828071,-0.0286942927936292,1.09735400548708,66,144,74,64,4912,4925,9837,1048.55,1026.5,2075.05,4606,4757,93.7703583061889,-151
2016,1626164,Devin Booker,0.663330151920077,0.41261218793425,1.07594233985433,94,78,75,77,6692,6598,13290,1311.71666666667,1380.18333333333,2691.9,6156,6379,91.9904363419008,-223
2016,203503,Tony Snell,0.75803132961696,0.317767551025551,1.07579888064251,88,91,76,80,5242,5380,10622,1150,1180.15,2330.15,5014,5122,95.6505150705838,-108
2016,202397,Ish Smith,0.994036298799892,0.0802600937835173,1.07429639258341,71,123,77,81,4532,4414,8946,974,983.45,1957.45,4180,4159,92.2330097087379,21
2016,203109,Jae Crowder,2.23194602836058,-1.17570182902612,1.05624419933446,26,263,78,72,5369,5524,10893,1137.96666666667,1182.76666666667,2320.73333333333,5412,5058,100.800894021233,354
2016,203087,Jeremy Lamb,0.795596423067534,0.250798190055585,1.04639461312312,85,98,79,62,2574,2572,5146,591.783333333333,546.933333333333,1138.71666666667,2455,2483,95.3768453768454,-28
2016,203084,Harrison Barnes,0.898874760356323,0.132722849491254,1.03159760984758,80,117,80,79,6015,6144,12159,1468.56666666667,1330.21666666667,2798.78333333333,5670,5795,94.2643391521197,-125
2016,201960,DeMarre Carroll,1.70380097432572,-0.686213345457374,1.01758762886834,39,228,81,72,4278,4295,8573,952.533333333333,922.516666666667,1875.05,4128,4011,96.4936886395512,117
2016,1626156,D'Angelo Russell,-0.738930020989991,1.75007884456404,1.01114882357405,209,1,82,63,4314,4334,8648,894.233333333333,906.8,1801.03333333333,3964,4320,91.8868799258229,-356
2016,203546,Ian Clark,1.19263946811774,-0.200599561320513,0.992039906797224,59,168,83,77,2686,2786,5472,558.833333333333,579.7,1138.53333333333,2543,2484,94.6760982874162,59
2016,1627742,Brandon Ingram,0.254497965664676,0.725445336026928,0.979943301691604,128,43,84,79,5453,5415,10868,1139.51666666667,1137.11666666667,2276.63333333333,5000,5339,91.6926462497708,-339
2016,203459,Allen Crabbe,-0.0599278564124804,1.00694039694887,0.947012540536394,157,24,85,79,5243,5307,10550,1136.46666666667,1120,2256.46666666667,4963,5135,94.6595460614152,-172
2016,202711,Bojan Bogdanovic,-0.0358688782298516,0.975590263666173,0.939721385436322,154,25,86,81,4934,5020,9954,1006.8,1061.2,2068,4583,4862,92.8860964734495,-279
2016,101162,Marcin Gortat,-0.243153873369172,1.17965366113295,0.936499787763781,176,13,87,82,5995,5979,11974,1241.06666666667,1308.61666666667,2549.68333333333,5851,5677,97.5979983319433,174
2016,203471,Dennis Schroder,0.434675654523457,0.497313869209682,0.93198952373314,112,68,88,79,5879,5903,11782,1214.75,1259.93333333333,2474.68333333333,5341,5453,90.8487838067699,-112
2016,201943,Brandon Jennings,0.571900273655172,0.352261720133765,0.924161993788937,98,84,89,81,4290,4302,8592,893,910.7,1803.7,3981,4039,92.7972027972028,-58
2016,1627750,Jamal Murray,1.13223894240878,-0.214455376407987,0.917783566000794,65,171,90,82,4237,4178,8415,865.75,894.183333333333,1759.93333333333,4066,4014,95.9641255605381,52
2016,203082,Terrence Ross,0.874974897328407,0.0426736729965238,0.917648570324931,81,129,91,78,4599,4589,9188,954.75,996.116666666667,1950.86666666667,4512,4371,98.1082844096543,141
2016,1626149,Montrezl Harrell,0.939932331625348,-0.0526242507829211,0.887308080842426,75,148,92,58,2552,2606,5158,508.516666666667,547.066666666667,1055.58333333333,2557,2453,100.19592476489,104
2016,1713,Vince Carter,1.16325933718456,-0.295174032160097,0.868085305024465,63,179,93,73,4058,3959,8017,941.716666666667,858.683333333334,1800.4,3831,3677,94.4061113849187,154
2016,202683,Enes Kanter,0.202154830950369,0.660054280034747,0.862209110985116,136,49,94,72,3682,3568,7250,747.466666666667,783.25,1530.71666666667,3413,3406,92.6941879413362,7
2016,202339,Eric Bledsoe,0.012442780248743,0.83239826841183,0.844841048660573,147,36,95,65,5272,5177,10449,1047.45,1093.65,2141.1,4884,5066,92.6403641881639,-182
2016,202331,Paul George,1.11358114743406,-0.269552696677051,0.844028450757006,68,175,96,75,6106,6241,12347,1336.15,1357.46666666667,2693.61666666667,5980,5827,97.9364559449722,153
2016,203930,Sean Kilpatrick,0.241837073607725,0.59801993140485,0.839857005012575,130,57,97,70,4211,4296,8507,850.866666666667,902.216666666667,1753.08333333333,3872,4110,91.9496556637378,-238
2016,1626155,Sam Dekker,0.911782343209517,-0.0759941590529807,0.835788184156536,76,150,98,77,3406,3441,6847,670.983333333333,746.366666666667,1417.35,3321,3202,97.5044039929536,119
2016,203953,Jabari Parker,-0.291373999539496,1.12153726120178,0.830163261662284,183,17,99,51,3972,4042,8014,840.183333333333,885,1725.18333333333,3775,3874,95.0402819738167,-99
2016,202710,Jimmy Butler,1.57947107185725,-0.770222239766354,0.809248832090896,46,233,100,76,6597,6438,13035,1430.08333333333,1374.71666666667,2804.8,6107,5902,92.5723813854782,205
2016,202335,Patrick Patterson,1.67159659683901,-0.871766248206014,0.799830348632994,43,246,101,65,3671,3668,7339,798.933333333334,799.483333333333,1598.41666666667,3670,3343,99.9727594660855,327
2016,203901,Elfrid Payton,0.453296226410669,0.340465875548696,0.793762101959365,109,88,102,82,5693,5642,11335,1170.61666666667,1235.23333333333,2405.85,5258,5413,92.3590374143685,-155
2016,203524,Solomon Hill,0.560611416359744,0.228256801599015,0.788868217958758,99,102,103,80,5518,5626,11144,1144.6,1222.56666666667,2367.16666666667,5167,5135,93.6389996375498,32
2016,101112,Channing Frye,1.16742218424043,-0.384613987690292,0.782808196550139,62,196,104,74,3156,3229,6385,699.5,696.083333333333,1395.58333333333,3146,3084,99.6831432192649,62
2016,201988,Patty Mills,1.90094143580054,-1.12619404749399,0.774747388306551,35,261,105,80,4101,4093,8194,878.3,884.2,1762.5,4047,3653,98.6832479882955,394
2016,201143,Al Horford,0.90608229131475,-0.1385612105099,0.767521080804849,78,160,106,68,5002,5140,10142,1076.75,1105.2,2181.95,4962,4798,99.2003198720512,164
2016,2594,Kyle Korver,0.057448037752604,0.708149061208314,0.765597098960918,144,45,107,67,4076,4144,8220,866.933333333333,887.766666666667,1754.7,3825,4005,93.8420019627085,-180
2016,202702,Kenneth Faried,0.23278773029332,0.518440786759,0.751228517052319,133,66,108,61,3176,3045,6221,649.4,648.466666666667,1297.86666666667,2996,3058,94.3324937027708,-62
2016,2772,Trevor Ariza,0.130798909645117,0.60848724685782,0.739286156502938,138,56,109,80,6671,6673,13344,1327.48333333333,1441.66666666667,2769.15,6691,6362,100.299805126668,329
2016,201976,Patrick Beverley,0.839807340462411,-0.102539608537963,0.737267731924448,83,154,110,67,4922,4915,9837,971.65,1066.63333333333,2038.28333333333,4901,4573,99.573344169037,328
2016,203081,Damian Lillard,0.467009804820482,0.257846035008919,0.724855839829401,105,97,111,75,6362,6308,12670,1362.56666666667,1325.61666666667,2688.18333333333,6164,6060,96.8877711411506,104
2016,1627785,Isaiah Whitehead,1.17476570767746,-0.475717907080759,0.699047800596704,61,209,112,73,3914,4007,7921,785.983333333333,848.566666666667,1634.55,3627,3723,92.6673479816045,-96
2016,1627763,Malcolm Brogdon,0.908478709211183,-0.212190624099167,0.696288085112017,77,170,113,75,4456,4522,8978,973.8,1000.93333333333,1974.73333333333,4323,4242,97.0152603231598,81
2016,2546,Carmelo Anthony,0.233058284082692,0.442975385400631,0.676033669483324,132,74,114,74,5962,5963,11925,1289.21666666667,1243.06666666667,2532.28333333333,5529,5772,92.7373364642737,-243
2016,201951,Ty Lawson,0.666672678210392,-0.0290509592771316,0.637621718933261,91,145,115,69,3987,4056,8043,875.25,854.7,1729.95,3710,3849,93.0524203661901,-139
2016,1627741,Buddy Hield,-0.465431650792975,1.06816811278447,0.602736461991499,198,20,116,82,4306,4391,8697,922.666666666667,955.316666666667,1877.98333333333,3963,4176,92.0343706456108,-213
2016,201609,Goran Dragic,0.691196232768593,-0.0898154389186747,0.601380793849918,90,152,117,73,5725,5685,11410,1269.25,1183.76666666667,2453.01666666667,5378,5302,93.938864628821,76
2016,2738,Andre Iguodala,1.75708717640084,-1.16489797237209,0.592189204028748,37,262,118,76,4744,4923,9667,950.116666666667,1050.61666666667,2000.73333333333,4834,4325,101.897133220911,509
2016,201167,Arron Afflalo,-0.23425722565206,0.816953341692126,0.582696116040066,174,39,119,61,3522,3581,7103,830.216666666667,746.816666666667,1577.03333333333,3298,3538,93.6399772856332,-240
2016,1627827,Dorian Finney-Smith,0.53930245927993,0.0321591564906136,0.571461615770544,100,133,120,80,3540,3607,7147,847.433333333333,785.933333333333,1633.36666666667,3318,3387,93.728813559322,-69
2016,1626147,Justin Anderson,0.182341365274627,0.376294854393764,0.558636219668391,137,82,121,75,2806,2839,5645,627.1,595.45,1222.55,2525,2720,89.9857448325018,-195
2016,202340,Avery Bradley,-0.22034166278869,0.776875576490127,0.556533913701437,172,41,122,55,4223,4340,8563,899.8,927.766666666667,1827.56666666667,4126,4059,97.7030547004499,67
2016,201145,Jeff Green,-0.0600980943106083,0.608727812180976,0.548629717870368,158,54,123,69,3573,3599,7172,765.816666666667,775.6,1541.41666666667,3084,3421,86.3140218303946,-337
2016,202699,Tobias Harris,0.665528174600993,-0.121787956019918,0.543740218581075,93,159,124,82,5865,5691,11556,1270.08333333333,1281.81666666667,2551.9,5428,5444,92.5490196078431,-16
2016,203552,Seth Curry,0.410566654011908,0.126501328204758,0.537067982216666,115,118,125,70,4347,4413,8760,1066.5,959.6,2026.1,4144,4166,95.3301127214171,-22
2016,203944,Julius Randle,-0.442545201614514,0.9559076388227,0.513362437208185,197,29,126,74,5125,5103,10228,1073.93333333333,1060.8,2134.73333333333,4654,5077,90.809756097561,-423
2016,1626158,Richaun Holmes,-0.396632195445665,0.909386167835471,0.512753972389806,193,32,127,57,2768,2860,5628,586.45,598.116666666667,1184.56666666667,2548,2767,92.0520231213873,-219
2016,203991,Clint Capela,0.708522179966949,-0.215423230894323,0.493098949072626,89,172,128,65,3658,3668,7326,731.3,811.983333333333,1543.28333333333,3663,3464,100.136686714051,199
2016,203585,Rodney McGruder,1.03102141524973,-0.542776997748168,0.48824441750156,70,217,129,78,4489,4475,8964,1003.23333333333,952.983333333333,1956.21666666667,4173,4168,92.9605702829138,5
2016,202066,Garrett Temple,-0.0186307002516136,0.505637138662085,0.487006438410472,153,67,130,65,3931,3985,7916,873.883333333333,852.5,1726.38333333333,3674,3842,93.4622233528364,-168
2016,1627755,Tyler Ulis,-0.00195125042922963,0.465453376479407,0.463502126050178,150,70,131,60,2751,2718,5469,535.916666666667,567.333333333333,1103.25,2455,2595,89.240276263177,-140
2016,201599,DeAndre Jordan,0.611131319363681,-0.172844673388374,0.438286645975307,96,163,132,81,5937,5943,11880,1284.83333333333,1276.31666666667,2561.15,5935,5463,99.9663129526697,472
2016,201937,Ricky Rubio,-0.24973535567934,0.651736698393242,0.402001342713902,177,50,133,74,5690,5543,11233,1256.48333333333,1181.33333333333,2437.81666666667,5387,5408,94.6748681898067,-21
2016,203915,Spencer Dinwiddie,0.5179282613236,-0.118837915590205,0.399090345733395,101,157,134,59,3122,3176,6298,650.65,679.383333333333,1330.03333333333,2871,2991,91.9602818705958,-120
2016,201147,Corey Brewer,0.459043164560302,-0.169942390231871,0.289100774328431,107,162,135,82,3064,3050,6114,606.316666666667,668.283333333333,1274.6,2915,2809,95.1370757180157,106
2016,200794,Paul Millsap,0.845204103802072,-0.563650643801538,0.281553460000533,82,220,136,69,5498,5529,11027,1148.33333333333,1188.88333333333,2337.21666666667,5108,5020,92.9065114587123,88
2016,2199,Tyson Chandler,-0.287575532103814,0.56169531876637,0.274119786662556,182,61,137,46,3123,3086,6209,627.683333333333,652.416666666667,1280.1,2904,2984,92.9875120076849,-80
2016,1626169,Stanley Johnson,0.233917682531882,0.0100590594524589,0.243976741984341,131,138,138,77,3180,3056,6236,685.466666666667,682.8,1368.26666666667,2898,2884,91.1320754716981,14
2016,203500,Steven Adams,0.0589639749981394,0.168840801377242,0.227804776375382,143,111,139,80,5849,5579,11428,1132.91666666667,1248.18333333333,2381.1,5358,5184,91.6054026329287,174
2016,200751,Randy Foye,-0.349609421459189,0.542720945516542,0.193111524057353,186,63,140,69,3037,3128,6165,625.883333333333,650.566666666667,1276.45,2789,3026,91.8340467566678,-237
2016,202324,Derrick Favors,0.590176202701173,-0.43075169038169,0.159424512319483,97,203,141,50,2570,2548,5118,613.45,567.516666666667,1180.96666666667,2400,2344,93.3852140077821,56
2016,201572,Brook Lopez,-0.0105688886061431,0.164463271388728,0.153894382782585,151,112,142,75,5333,5431,10764,1084.1,1131.4,2215.5,4955,5175,92.9120570035627,-220
2016,2749,Jameer Nelson,0.0643165952366133,0.089134982042346,0.153451577278959,142,122,143,75,4943,4708,9651,1020.06666666667,1015.93333333333,2036,4768,4627,96.4596398948007,141
2016,202709,Cory Joseph,-0.116244582192507,0.226355958044928,0.110111375852421,163,103,144,80,4595,4621,9216,1011.63333333333,990.283333333333,2001.91666666667,4418,4357,96.1479869423286,61
2016,202703,Nikola Mirotic,0.422146768128687,-0.321974521753758,0.100172246374929,113,182,145,70,3944,3872,7816,836.483333333333,839.783333333333,1676.26666666667,3699,3512,93.7880324543611,187
2016,203918,Rodney Hood,0.054054152247192,0.0144521692348973,0.0685063214820893,145,137,146,59,3447,3467,6914,829.366666666667,756.816666666667,1586.18333333333,3293,3167,95.5323469683783,126
2016,204025,Tim Frazier,-0.151106102482732,0.218014673615162,0.0669085711324305,169,106,147,65,3555,3586,7141,744.516666666667,777.1,1521.61666666667,3289,3400,92.5175808720113,-111
2016,2200,Pau Gasol,0.805820132960966,-0.74789268270683,0.0579274502541357,84,232,148,64,3603,3626,7229,827.716666666667,787.4,1615.11666666667,3559,3341,98.7787954482376,218
2016,203145,Kent Bazemore,0.326268318616269,-0.271406219286118,0.054862099330151,122,176,149,73,4638,4675,9313,949.7,1002.75,1952.45,4194,4296,90.4269081500647,-102
2016,203903,Jordan Clarkson,-1.28801853542234,1.3390629836246,0.0510444482022616,237,8,150,82,5740,5715,11455,1184.9,1195.75,2380.65,5194,5629,90.4878048780488,-435
2016,201160,Jason Smith,-0.140581669462386,0.187126581382925,0.0465449119205387,165,109,151,74,2494,2526,5020,532.85,540.783333333333,1073.63333333333,2344,2369,93.9855653568565,-25
2016,2736,Luol Deng,-0.527430230087392,0.568192009873266,0.0407617797858749,201,59,152,56,3515,3524,7039,741.916666666667,740.15,1482.06666666667,3171,3369,90.2133712660028,-198
2016,202691,Klay Thompson,1.08416191847547,-1.05310429466458,0.0310576238108891,69,255,153,78,6252,6461,12713,1239.06666666667,1398,2637.06666666667,6465,5690,103.406909788868,775
2016,203490,Otto Porter Jr.,-1.38266755364904,1.40612817714279,0.023460623493748,239,6,154,80,6136,6119,12255,1259.2,1326.21666666667,2585.41666666667,5969,5812,97.2783572359844,157
2016,203932,Aaron Gordon,0.347086324139936,-0.354184796975566,-0.0070984728356292,119,188,155,80,5383,5352,10735,1125.61666666667,1162.38333333333,2288,5013,5148,93.1265093813859,-135
2016,202355,Hassan Whiteside,0.456113522096485,-0.472488306150887,-0.0163747840544017,108,208,156,77,5791,5724,11515,1289.8,1214.23333333333,2504.03333333333,5429,5330,93.7489207390779,99
2016,1626161,Willie Cauley-Stein,-0.138398787701094,0.115396871273967,-0.0230019164271267,164,120,157,75,3182,3273,6455,713.833333333333,700.5,1414.33333333333,2937,3111,92.3004399748586,-174
2016,2585,Zaza Pachulia,0.488262107399377,-0.513604346449504,-0.0253422390501269,104,213,158,70,3039,3038,6077,581.85,676.25,1258.1,3128,2687,102.928594932544,441
2016,201163,Wilson Chandler,-0.690683920765951,0.663091034754972,-0.0275928860109789,208,48,159,71,5299,5132,10431,1099.7,1094.23333333333,2193.93333333333,5097,5108,96.1879599924514,-11
2016,200746,LaMarcus Aldridge,0.33998663014862,-0.383856335826902,-0.0438697056782815,121,195,160,72,5186,5169,10355,1207.5,1128.11666666667,2335.61666666667,5001,4737,96.4327034323178,264
2016,203079,Dion Waiters,0.78493122483119,-0.832111777968883,-0.0471805531376923,86,238,161,46,3174,3201,6375,706.983333333333,674.533333333333,1381.51666666667,3015,2903,94.9905482041588,112
2016,203210,JaMychal Green,0.511881109353996,-0.559979567986363,-0.0480984586323674,102,219,162,77,4673,4621,9294,1084.85,1006.1,2090.95,4326,4255,92.574363364006,71
2016,2747,JR Smith,0.126587061570177,-0.196331432212771,-0.0697443706425938,139,167,163,41,2757,2806,5563,605.666666666667,585.5,1191.16666666667,2735,2671,99.2020311933261,64
2016,2564,Boris Diaw,-0.508175330964745,0.408557678599215,-0.0996176523655299,199,79,164,73,2774,2798,5572,663.45,614.1,1277.55,2608,2608,94.0158615717376,0
2016,203512,Lucas Nogueira,1.54776451272323,-1.66007543933286,-0.112310926609626,47,269,165,55,2494,2563,5057,540.716666666667,546.683333333333,1087.4,2489,2316,99.7995188452285,173
2016,202685,Jonas Valanciunas,-0.191577110286584,0.0708788312092842,-0.120698279077299,171,125,166,80,4705,4665,9370,1058.2,1000.78333333333,2058.98333333333,4526,4427,96.1955366631243,99
2016,204456,T.J. McConnell,-0.14914032260738,0.0267539535755439,-0.122386369031836,168,134,167,81,5033,5186,10219,1066.1,1064.86666666667,2130.96666666667,4558,4857,90.5622888933042,-299
2016,101109,Raymond Felton,-0.191108776548383,0.0397493569155489,-0.151359419632834,170,130,168,80,3874,3981,7855,866.466666666667,829.95,1696.41666666667,3641,3794,93.9855446566856,-153
2016,203967,Dario Saric,-0.373744792896733,0.157501648559946,-0.216243144336787,189,113,169,81,5038,5104,10142,1078.46666666667,1049.11666666667,2127.58333333333,4498,4818,89.2814608971814,-320
2016,203897,Zach LaVine,-1.26135465404002,1.04125721736219,-0.22009743667783,236,21,170,46,3950,3844,7794,862.833333333333,840.483333333333,1703.31666666667,3643,3786,92.2278481012658,-143
2016,200771,Sergio Rodriguez,-0.0428184161822784,-0.206866190723407,-0.249684606905685,155,169,171,68,3552,3544,7096,762.6,747.783333333333,1510.38333333333,3183,3341,89.6114864864865,-158
2016,201949,James Johnson,0.650622297568134,-0.90768394752624,-0.257061649958107,95,247,172,76,4853,4826,9679,1072.91666666667,1011.38333333333,2084.3,4521,4376,93.158870801566,145
2016,203093,Terrence Jones,-0.386670093390289,0.11728520860159,-0.2693848847887,192,119,173,54,2918,2991,5909,620.083333333333,648.533333333333,1268.61666666667,2715,2796,93.0431802604524,-81
2016,1626167,Myles Turner,0.29173156164247,-0.568623612568409,-0.276892050925939,126,221,174,81,5740,5909,11649,1246.61666666667,1288.8,2535.41666666667,5616,5451,97.8397212543554,165
2016,203507,Giannis Antetokounmpo,-0.296658827799684,0.0185620565847241,-0.27809677121496,184,135,175,80,6400,6485,12885,1389.08333333333,1445.6,2834.68333333333,6095,6044,95.234375,51
2016,101141,Ersan Ilyasova,0.445662414332739,-0.738070546994333,-0.292408132661594,111,231,176,82,5105,5136,10241,1052.21666666667,1083.36666666667,2135.58333333333,4651,4658,91.1067580803134,-7
2016,203482,Kelly Olynyk,0.0204115374918933,-0.349791756694278,-0.329380219202385,146,187,177,75,3554,3623,7177,767.783333333333,770.4,1538.18333333333,3305,3316,92.9938097917839,-11
2016,202734,E'Twaun Moore,-0.543904117453821,0.156289092295887,-0.387615025157934,203,114,178,73,4232,4305,8537,889.233333333333,925.366666666667,1814.6,3938,4070,93.0529300567108,-132
2016,203124,Kyle O'Quinn,-1.03505506544708,0.608505840255941,-0.42654922519114,223,55,179,79,2886,2877,5763,631.083333333333,601.116666666667,1232.2,2576,2738,89.2584892584893,-162
2016,203516,James Ennis III,0.225098864927125,-0.651965174954496,-0.426866310027371,135,225,180,64,3411,3360,6771,792.35,707.516666666667,1499.86666666667,3120,3052,91.4687774846086,68
2016,1891,Jason Terry,0.401356437882112,-0.835924833325496,-0.434568395443384,116,239,181,74,3051,3101,6152,675.583333333333,688.483333333333,1364.06666666667,2913,2794,95.4768928220256,119
2016,203077,Michael Kidd-Gilchrist,-0.283469204950795,-0.176893915058728,-0.460363120009523,181,164,182,81,5329,5316,10645,1184.98333333333,1154.55,2339.53333333333,5006,4966,93.9388252955526,40
2016,203141,Mirza Teletovic,-0.0889341555841622,-0.415448884923432,-0.504383040507594,159,200,183,70,2549,2579,5128,559.166666666667,568.583333333333,1127.75,2419,2341,94.899960768929,78
2016,201945,Gerald Henderson,-0.979241317001455,0.470852676791097,-0.508388640210358,218,69,184,72,3949,3980,7929,847.916666666667,825.133333333333,1673.05,3491,3820,88.4021271207901,-329
2016,203518,Alex Abrines,-1.8946343264398,1.38517572520884,-0.509458601230952,253,7,185,68,2583,2493,5076,515.266666666667,536.633333333333,1051.9,2363,2420,91.4827719705769,-57
2016,1626178,Rondae Hollis-Jefferson,-0.799902243700315,0.262678614638839,-0.537223629061476,213,96,186,78,4227,4373,8600,852.483333333333,906.95,1759.43333333333,3904,4135,92.3586467944168,-231
2016,202704,Reggie Jackson,-1.72248295521444,1.183492035249,-0.538990919965449,246,12,187,52,3290,3125,6415,703.483333333333,710.3,1413.78333333333,2928,3125,88.9969604863222,-197
2016,203584,Troy Daniels,0.244080901457585,-0.78866427918742,-0.544583377729835,129,235,188,67,2743,2634,5377,620.05,561.266666666667,1181.31666666667,2499,2460,91.1046299671892,39
2016,203935,Marcus Smart,-0.114826303343933,-0.4322193842551,-0.547045687599033,162,204,189,79,5639,5691,11330,1198.31666666667,1208.41666666667,2406.73333333333,5407,5283,95.8857953537861,124
2016,202323,Evan Turner,-0.993767486381768,0.442777361037593,-0.550990125344175,221,75,190,65,3826,3891,7717,840.783333333333,817.733333333333,1658.51666666667,3529,3695,92.2373235755358,-166
2016,1626144,Emmanuel Mudiay,-1.72135631547835,1.13989742066468,-0.581458894813669,245,16,191,55,3422,3336,6758,698.7,704.083333333333,1402.78333333333,3191,3335,93.249561659848,-144
2016,201152,Thaddeus Young,-0.226342546827031,-0.378143914327827,-0.604486461154858,173,192,192,74,5077,5259,10336,1105.68333333333,1125.41666666667,2231.1,4924,4827,96.9864092968288,97
2016,203506,Victor Oladipo,-0.987250244352949,0.347495425515719,-0.63975481883723,219,86,193,67,5384,5177,10561,1062.96666666667,1148.66666666667,2211.63333333333,4926,4721,91.4933135215453,205
2016,202688,Brandon Knight,-1.79747582838601,1.14488149300263,-0.652594335383373,249,15,194,53,2690,2691,5381,545.35,565.966666666667,1111.31666666667,2338,2653,86.9144981412639,-315
2016,2403,Nene,0.317855750617946,-0.993901681854287,-0.676045931236341,124,250,195,67,2976,2929,5905,572.716666666667,631.833333333333,1204.55,2902,2686,97.5134408602151,216
2016,203095,Evan Fournier,-1.22356582750052,0.5234852673248,-0.700080560175718,233,65,196,68,5268,5193,10461,1100.8,1128.73333333333,2229.53333333333,4748,4954,90.1290812452544,-206
2016,201567,Kevin Love,0.119466765606749,-0.820494971048826,-0.701028205442077,140,237,197,60,4494,4392,8886,956.05,931.733333333333,1887.78333333333,4456,4142,99.1544281263907,314
2016,2440,Matt Barnes,-0.0479829285413919,-0.682164659102386,-0.730147587643778,156,227,198,74,4083,4109,8192,897.216666666667,879.133333333333,1776.35,3807,3859,93.2402645113887,-52
2016,1627789,Timothe Luwawu-Cabarrot,0.388102163857399,-1.1191164169423,-0.731014253084903,117,260,199,69,2821,2860,5681,580.7,604.183333333333,1184.88333333333,2564,2614,90.8897554058844,-50
2016,201577,Robin Lopez,-1.43893022385061,0.706063325156082,-0.732866898694524,240,46,200,81,5319,5168,10487,1159.86666666667,1101.86666666667,2261.73333333333,4840,4801,90.9945478473397,39
2016,1626162,Kelly Oubre Jr.,-0.972164699114819,0.238258203258739,-0.73390649585608,217,101,201,79,3720,3803,7523,787.5,808.25,1595.75,3514,3525,94.4623655913979,-11
2016,203488,Mike Muscala,-1.45973229835873,0.716520298085706,-0.743212000273023,242,44,202,70,2920,2876,5796,604.516666666667,635.05,1239.56666666667,2634,2704,90.2054794520548,-70
2016,1626179,Terry Rozier,-0.42300118258387,-0.321502481696022,-0.744503664279892,194,181,203,74,2916,2944,5860,634.6,628.15,1262.75,2670,2661,91.5637860082304,9
2016,2225,Tony Parker,-0.31395134721214,-0.43755789757195,-0.751509244784091,185,205,204,63,3498,3483,6981,828.233333333333,757.266666666667,1585.5,3350,3154,95.7690108633505,196
2016,203463,Ben McLemore,-0.434384239590835,-0.323966164920451,-0.758350404511286,195,183,205,61,2671,2675,5346,599.3,571.983333333333,1171.28333333333,2451,2574,91.7633845001872,-123
2016,203076,Anthony Davis,-0.00122109744113185,-0.79597581687091,-0.797196914312042,149,236,206,75,6271,6404,12675,1299.03333333333,1405.25,2704.28333333333,5841,5797,93.1430393876575,44
2016,201959,Taj Gibson,-1.24414276422497,0.439922351025573,-0.804220413199399,235,76,207,78,4771,4560,9331,1001.25,984.9,1986.15,4291,4264,89.9392160972542,27
2016,2733,Shaun Livingston,-0.364926483329708,-0.461407077493639,-0.826333560823347,188,206,208,76,3067,3171,6238,648.633333333333,691.816666666667,1340.45,2935,2778,95.6961199869579,157
2016,203200,Justin Holiday,-0.382979229643369,-0.47985060772301,-0.862829837366378,191,211,209,82,3887,3863,7750,816.8,829.15,1645.95,3524,3556,90.6611782865964,-32
2016,203498,Shabazz Muhammad,-0.2585027144517,-0.66026025401589,-0.91876296846759,179,226,210,77,3550,3460,7010,766.233333333333,739.9,1506.13333333333,3258,3300,91.7746478873239,-42
2016,201601,Luc Mbah a Moute,-0.382328473301469,-0.543903880067453,-0.926232353368922,190,218,211,80,4083,4170,8253,883.133333333333,896.583333333333,1779.71666666667,4082,3761,99.9755082047514,321
2016,1627759,Jaylen Brown,-1.55352686102157,0.615927990896186,-0.937598870125379,243,53,212,78,3063,3134,6197,659.633333333333,673.916666666667,1333.55,2857,2928,93.2745674175645,-71
2016,1626204,Larry Nance Jr.,-0.988844936629822,0.0498245377622892,-0.939020398867533,220,127,213,63,3441,3411,6852,712.25,718.333333333333,1430.58333333333,3110,3277,90.3807032839291,-167
2016,203496,Robert Covington,-0.109993212225679,-0.837117423076676,-0.947110635302355,160,240,214,67,5008,5027,10035,1056.2,1050.76666666667,2106.96666666667,4465,4594,89.1573482428115,-129
2016,201950,Jrue Holiday,-0.583344468774969,-0.391597533269649,-0.974942002044619,204,198,215,67,5084,5168,10252,1047.66666666667,1139.35,2187.01666666667,4721,4695,92.8599527930763,26
2016,203460,Andre Roberson,-0.886287220041706,-0.111444768454399,-0.997731988496106,216,156,216,79,5782,5574,11356,1121.8,1249.8,2371.6,5310,5144,91.8367346938775,166
2016,200782,PJ Tucker,-0.531877502154054,-0.476400741691473,-1.00827824384553,202,210,217,80,5309,5201,10510,1100.1,1108.06666666667,2208.16666666667,4871,4909,91.7498587304577,-38
2016,1627098,Malcolm Delaney,-0.148906176319602,-0.86430862851223,-1.01321480483183,167,245,218,73,2883,2876,5759,613.066666666667,636.3,1249.36666666667,2646,2590,91.7793964620187,56
2016,1626195,Willy Hernangomez,-1.03600186555801,0.00927818107428907,-1.02672368448372,224,139,219,72,3121,3124,6245,659.7,658.816666666667,1318.51666666667,2861,2928,91.6693367510413,-67
2016,203115,Will Barton,-1.45330468865311,0.424476714638879,-1.02882797401424,241,77,220,60,4091,3962,8053,842.233333333333,857.15,1699.38333333333,3835,3912,93.7423612808604,-77
2016,203917,Nik Stauskas,-0.770454107508217,-0.292670307532573,-1.06312441504079,210,177,221,80,5152,5223,10375,1089.93333333333,1092.75,2182.68333333333,4686,4902,90.9549689440994,-216
2016,203497,Rudy Gobert,0.286518019932034,-1.36777459612774,-1.0812565761957,127,266,222,81,5994,5959,11953,1418.16666666667,1315.93333333333,2734.1,5775,5334,96.3463463463464,441
2016,203957,Dante Exum,-0.618635961665129,-0.467135247016863,-1.08577120868199,206,207,223,66,2699,2721,5420,629.75,595.9,1225.65,2486,2444,92.1081882178585,42
2016,201585,Kosta Koufos,-0.249927886261182,-0.840658934989102,-1.09058682125028,178,242,224,71,3199,3201,6400,731.4,679.333333333333,1410.73333333333,2897,3034,90.559549859331,-137
2016,204020,Tyler Johnson,-0.783567191229317,-0.327662105469938,-1.11122929669926,212,185,225,73,5076,5010,10086,1112.2,1056.2,2168.4,4653,4612,91.6666666666667,41
2016,203083,Andre Drummond,-1.17186786588953,0.0176880810678528,-1.15417978482168,229,136,226,81,5573,5333,10906,1202.86666666667,1207,2409.86666666667,5002,5252,89.7541719002333,-250
2016,203110,Draymond Green,-0.237596382898329,-0.997344707160188,-1.23494109005852,175,251,227,76,5923,6045,11968,1144.7,1311.91666666667,2456.61666666667,6079,5293,102.633800438967,786
2016,202687,Bismack Biyombo,-1.1630371105164,-0.0935312670601336,-1.25656837757654,228,153,228,81,4086,4081,8167,901.066666666667,887.083333333333,1788.15,3569,3891,87.3470386686246,-322
2016,201569,Eric Gordon,-0.625098443883063,-0.64091917677789,-1.26601762066095,207,224,229,75,5628,5696,11324,1101.05,1224.38333333333,2325.43333333333,5535,5232,98.3475479744136,303
2016,1626143,Jahlil Okafor,-1.3044988203739,0.0375727514542916,-1.26692606891961,238,131,230,50,2615,2625,5240,593.583333333333,542.45,1136.03333333333,2227,2529,85.1625239005736,-302
2016,201980,Danny Green,-0.279937853262745,-1.02375851257761,-1.30369636584036,180,253,231,68,3987,4015,8002,928.7,871.45,1800.15,3837,3573,96.2377727614748,264
2016,2548,Dwyane Wade,-1.58670414496351,0.266788546549035,-1.31991559841448,244,95,232,60,4237,4115,8352,902.783333333333,880.633333333333,1783.41666666667,3748,3850,88.4588151994336,-102
2016,203089,John Henson,-1.0236034616907,-0.356632222163667,-1.38023568385437,222,189,233,58,2557,2597,5154,550.566666666667,565.45,1116.01666666667,2375,2408,92.8822839264763,-33
2016,201571,D.J. Augustin,-2.53467356521558,1.15250760975786,-1.38216595545773,264,14,234,78,3496,3522,7018,784.5,750.316666666667,1534.81666666667,2965,3409,84.8112128146453,-444
2016,202693,Markieff Morris,-1.08503460838847,-0.329786971672133,-1.4148215800606,226,186,235,76,5545,5544,11089,1157.16666666667,1193.68333333333,2350.85,5373,5162,96.8981064021641,211
2016,202694,Marcus Morris,-0.357891906300956,-1.09380299669324,-1.4516949029942,187,258,236,79,5940,5712,11652,1280.98333333333,1283.96666666667,2564.95,5348,5447,90.03367003367,-99
2016,1626150,Andrew Harrison,-0.613509252103899,-0.852772543633675,-1.46628179573757,205,243,237,72,3322,3308,6630,776.616666666667,696.533333333333,1473.15,2983,2990,89.7953040337146,-7
2016,203469,Cody Zeller,-0.783452650912531,-0.718309484218082,-1.50176213513061,211,229,238,62,3930,3841,7771,861.633333333333,853.5,1715.13333333333,3797,3569,96.6157760814249,228
2016,203382,Aron Baynes,-0.143064575292069,-1.40480482413513,-1.5478693994272,166,267,239,75,2624,2615,5239,575.45,583.983333333333,1159.43333333333,2432,2322,92.6829268292683,110
2016,202714,Shelvin Mack,-1.15531464757207,-0.398475264571854,-1.55378991214392,227,199,240,55,2646,2659,5305,623.616666666667,578.8,1202.41666666667,2459,2466,92.9327286470144,-7
2016,202357,Nemanja Bjelica,-0.827269371964859,-0.729054448465675,-1.55632382043053,214,230,241,64,2740,2714,5454,594.05,581.933333333333,1175.98333333333,2508,2500,91.5328467153285,8
2016,203120,Justin Hamilton,-1.91082262289994,0.351125221065908,-1.55969740183403,255,85,242,64,2812,2894,5706,567.8,605,1172.8,2489,2796,88.5135135135135,-307
2016,202720,Jon Leuer,-1.21800311075921,-0.373237503558143,-1.59124061431735,232,191,243,75,4492,4323,8815,965.816666666667,973.983333333333,1939.8,4012,4078,89.3143365983972,-66
2016,203476,Gorgui Dieng,-1.23653491171205,-0.38175068734981,-1.61828559906186,234,194,244,81,6071,5912,11983,1347.83333333333,1267.55,2615.38333333333,5709,5706,94.0372261571405,3
2016,1627775,Patrick McCaw,-2.13131823647897,0.458828843744712,-1.67248939273426,259,73,245,70,2590,2619,5209,525.133333333333,548.016666666667,1073.15,2398,2418,92.5868725868726,-20
2016,203943,Noah Vonleh,-2.05103471487982,0.321840123696815,-1.72919459118301,257,90,246,74,2923,2930,5853,638.833333333333,621.233333333333,1260.06666666667,2658,2746,90.9339719466302,-88
2016,203613,Jonathon Simmons,-0.112088124292527,-1.64537076705915,-1.75745889135168,161,268,247,78,3194,3212,6406,711.65,688.216666666667,1399.86666666667,3013,2773,94.3331246086412,240
2016,204001,Kristaps Porzingis,-0.518887337722591,-1.23999877696257,-1.75888611468516,200,264,248,66,5067,5098,10165,1080.01666666667,1077.73333333333,2157.75,4675,4782,92.2636668640221,-107
2016,203924,Jerami Grant,-1.80739206607912,-0.0124302227249045,-1.81982228880403,250,141,249,80,3694,3613,7307,740.883333333333,788.966666666667,1529.85,3345,3464,90.5522468868435,-119
2016,1627739,Kris Dunn,-1.87627938888698,0.00815859497824545,-1.86812079390874,252,140,250,77,3071,3005,6076,669.35,641.683333333333,1311.03333333333,2795,2889,91.0126994464344,-94
2016,2754,Tony Allen,-0.843877519174937,-1.03558207239386,-1.8794595915688,215,254,251,71,4299,4214,8513,992.566666666667,912.866666666667,1905.43333333333,3948,3871,91.8353105373343,77
2016,203994,Jusuf Nurkic,-1.7475455940537,-0.166145676799058,-1.91369127085276,248,161,252,65,3351,3281,6632,696.833333333333,686.933333333333,1383.76666666667,3030,3101,90.420769919427,-71
2016,202344,Trevor Booker,-1.18820667611367,-0.778443034082343,-1.96664971019601,230,234,253,71,4184,4309,8493,855.983333333333,898.766666666667,1754.75,3754,4023,89.7227533460803,-269
2016,201162,Jared Dudley,-1.05803667792463,-1.08021981470058,-2.13825649262521,225,257,254,63,3259,3271,6530,652.483333333333,684.566666666667,1337.05,2940,3015,90.2117213869285,-75
2016,204028,Tarik Black,-1.19420605069999,-1.01508906731922,-2.20929511801921,231,252,255,67,2644,2559,5203,537.533333333333,548.483333333333,1086.01666666667,2357,2387,89.1452344931921,-30
2016,1626168,Trey Lyles,-1.80746323990619,-0.424214342089072,-2.23167758199527,251,202,256,71,2571,2567,5138,591.133333333333,563.133333333333,1154.26666666667,2359,2349,91.754181252431,10
2016,200757,Thabo Sefolosha,-1.73944985570366,-0.541955102039114,-2.28140495774278,247,216,257,62,3741,3756,7497,786.266666666667,810.4,1596.66666666667,3397,3447,90.8045977011494,-50
2016,2216,Zach Randolph,-2.22668303724591,-0.304340121724507,-2.53102315897042,260,180,258,73,4094,3925,8019,949.666666666667,840.183333333333,1789.85,3661,3686,89.4235466536395,-25
2016,203458,Alex Len,-3.22038894532498,0.638014186034732,-2.58237475929025,268,51,259,76,3773,3742,7515,743.65,784.233333333333,1527.88333333333,3260,3650,86.4033925258415,-390
2016,203922,Glenn Robinson III,-2.49761059759769,-0.103522235617996,-2.60113283321568,263,155,260,69,3255,3351,6606,714.466666666667,706.316666666667,1420.78333333333,3046,3115,93.57910906298,-69
2016,1626196,Josh Richardson,-2.1087761962359,-0.514255364227607,-2.62303156046351,258,214,261,53,3708,3696,7404,824.616666666667,788.183333333333,1612.8,3403,3409,91.7745415318231,-6
2016,2730,Dwight Howard,-2.02406447677059,-0.599111076663931,-2.62317555343452,256,222,262,74,5205,5159,10364,1069.05,1123.71666666667,2192.76666666667,4602,4705,88.4149855907781,-103
2016,1627734,Domantas Sabonis,-2.28152572210389,-0.420123115739378,-2.70164883784327,261,201,263,81,3824,3755,7579,764.616666666667,847.866666666667,1612.48333333333,3426,3414,89.592050209205,12
2016,202684,Tristan Thompson,-2.44464542371374,-0.295148951289086,-2.73979437500283,262,178,264,78,5457,5396,10853,1183.08333333333,1151.78333333333,2334.86666666667,5307,5156,97.2512369433755,151
2016,203925,Joe Harris,-2.72765084133586,-0.0421615352004368,-2.7698123765363,265,147,265,52,2816,2857,5673,556.683333333333,584.2,1140.88333333333,2449,2718,86.9673295454546,-269
2016,200765,Rajon Rondo,-2.92856605943704,0.0492064897653127,-2.87935956967173,266,128,266,69,4321,4268,8589,926.666666666667,911.066666666667,1837.73333333333,3907,4005,90.4188845174728,-98
2016,202389,Timofey Mozgov,-3.82209999840976,0.868387468370641,-2.95371253003912,269,34,267,54,2637,2564,5201,570.666666666667,541.6,1112.26666666667,2313,2490,87.7133105802048,-177
2016,203473,Dewayne Dedmon,-1.90210809962614,-1.29869383534306,-3.20080193496919,254,265,268,76,3038,3019,6057,676.516666666667,656.983333333333,1333.5,2820,2603,92.8242264647795,217
2016,202696,Nikola Vucevic,-3.20514606710399,-0.119760572873558,-3.32490663997755,267,158,269,75,5139,5057,10196,1054.11666666667,1102.91666666667,2157.03333333333,4650,4818,90.4845300642148,-168
2017,201939,Stephen Curry,7.46308845384572,-0.35970500566344,7.10338344818228,1,158,1,50,3888,3986,7874,742.016666666667,852.55,1594.56666666667,4205,3740,108.15329218107,465
2017,1626157,Karl-Anthony Towns,3.39109182553566,3.43682010624891,6.82791193178456,10,1,2,82,6725,6635,13360,1502.78333333333,1404.8,2907.58333333333,6701,6362,99.6431226765799,339
2017,203482,Kelly Olynyk,4.58837526888104,1.52866277420847,6.1170380430895,4,42,3,75,3898,3891,7789,869.6,864.25,1733.85,3817,3633,97.9220112878399,184
2017,203081,Damian Lillard,4.1842080261303,1.40580353321699,5.59001155934729,6,47,4,73,6293,6217,12510,1371.11666666667,1297.9,2669.01666666667,6063,5741,96.3451453996504,322
2017,2544,LeBron James,3.95271534421456,1.42767504089739,5.38039038511196,7,46,5,82,7021,7094,14115,1514.26666666667,1508.35,3022.61666666667,7097,7015,101.082466885059,82
2017,101108,Chris Paul,5.45890712648649,-0.215683339132589,5.2432237873539,2,144,6,58,4222,4219,8441,914.983333333333,923.533333333333,1838.51666666667,4427,3926,104.855518711511,501
2017,1717,Dirk Nowitzki,2.53574341778176,2.50013343887103,5.03587685665279,21,16,7,77,4213,4270,8483,980.6,905.45,1886.05,4095,4187,97.1991455020176,-92
2017,201935,James Harden,5.2502850390566,-0.349708133732833,4.90057690532377,3,155,8,72,5902,5913,11815,1255.81666666667,1288.3,2544.11666666667,6067,5524,102.795662487292,543
2017,201567,Kevin Love,3.16246196025856,1.61398393797691,4.77644589823547,12,35,9,59,3809,3805,7614,832.166666666667,812.033333333333,1644.2,3823,3767,100.367550538199,56
2017,203918,Rodney Hood,1.94086506807969,2.78399673170378,4.72486179978348,37,9,10,60,3660,3685,7345,811.9,799.666666666667,1611.56666666667,3533,3583,96.5300546448088,-50
2017,201588,George Hill,3.48103119646427,0.916690498834173,4.39772169529844,8,66,11,67,4124,4065,8189,931.216666666667,873.966666666667,1805.18333333333,3937,4052,95.4655674102813,-115
2017,1627750,Jamal Murray,2.09636841651713,2.27028932613745,4.36665774265457,33,19,12,80,5860,5735,11595,1251.41666666667,1259.31666666667,2510.73333333333,5825,5613,99.4027303754266,212
2017,2747,JR Smith,1.12958665218187,3.22963862383943,4.3592252760213,73,4,13,80,5186,5237,10423,1124.71666666667,1110.05,2234.76666666667,5113,5250,98.5923640570768,-137
2017,1627751,Jakob Poeltl,2.6046263877995,1.601267722234,4.2058941100335,20,37,14,82,3583,3534,7117,750.55,769.15,1519.7,3524,3240,98.3533351939715,284
2017,203992,Bogdan Bogdanovic,0.89078814451854,3.30569512002051,4.19648326453905,91,2,15,78,4958,4900,9858,1101.85,1068.3,2170.15,4498,4861,90.722065348931,-363
2017,203085,Austin Rivers,1.42153491257078,2.77346361676875,4.19499852933952,61,10,16,61,4785,4776,9561,1034.51666666667,1010.56666666667,2045.08333333333,4600,4672,96.1337513061651,-72
2017,202689,Kemba Walker,4.38321599708174,-0.330360433916238,4.0528555631655,5,154,17,80,6515,6359,12874,1376.68333333333,1353.6,2730.28333333333,6294,6098,96.6078280890253,196
2017,202734,E'Twaun Moore,1.67693186809353,2.15483969298851,3.83177156108204,45,22,18,81,6033,6200,12233,1219.31666666667,1328.58333333333,2547.9,5914,5735,98.0275153323388,179
2017,1626163,Frank Kaminsky,1.01804095101148,2.70683164478255,3.72487259579403,82,11,19,79,4313,4187,8500,931.433333333333,902.133333333333,1833.56666666667,4076,4165,94.5049849292836,-89
2017,201954,Darren Collison,2.82002780894532,0.88195580890241,3.70198361784773,18,73,20,69,4580,4682,9262,999.6,1011.28333333333,2010.88333333333,4511,4397,98.4934497816594,114
2017,2216,Zach Randolph,0.237175100494912,3.28335347750683,3.52052857800174,128,3,21,59,3427,3360,6787,788.283333333333,712.533333333333,1500.81666666667,3077,3437,89.78698570178,-360
2017,201952,Jeff Teague,2.13859569995864,1.19538026316635,3.33397596312498,32,52,22,70,5414,5353,10767,1194.96666666667,1114.15,2309.11666666667,5327,5187,98.3930550424825,140
2017,203584,Troy Daniels,0.341442228162551,2.95352480802093,3.29496703618349,120,8,23,79,3859,3894,7753,801.916666666667,815.5,1617.41666666667,3475,3892,90.0492355532521,-417
2017,202329,Al-Farouq Aminu,2.82283041173854,0.466392458591052,3.2892228703296,17,98,24,69,4847,4820,9667,1054.33333333333,1008.88333333333,2063.21666666667,4653,4435,95.9975242417991,218
2017,201988,Patty Mills,1.45343237366545,1.82982702193888,3.28325939560433,59,30,25,82,4845,4805,9650,1088.43333333333,1020.96666666667,2109.4,4593,4494,94.7987616099071,99
2017,2594,Kyle Korver,3.08697552662755,0.143052879942891,3.23002840657044,15,118,26,73,3666,3714,7380,764.766666666667,806.183333333333,1570.95,3695,3471,100.791052918713,224
2017,202326,DeMarcus Cousins,1.55261734732867,1.59602764823171,3.14864499556038,53,38,27,47,3959,3973,7932,835.016666666667,858.233333333333,1693.25,3835,3716,96.8678959333165,119
2017,203915,Spencer Dinwiddie,1.0616011705682,2.07667373390234,3.13827490447054,77,23,28,80,5358,5370,10728,1178.98333333333,1121.96666666667,2300.95,5093,5181,95.0541246733856,-88
2017,1626149,Montrezl Harrell,1.50751111533753,1.6033382444302,3.11084935976773,55,36,29,76,3113,3154,6267,621.066666666667,671.766666666667,1292.83333333333,3026,2973,97.2052682300032,53
2017,1627748,Thon Maker,1.41668066241814,1.68751497313403,3.10419563555217,62,33,30,74,2759,2859,5618,601.05,635.383333333333,1236.43333333333,2645,2799,95.8680681406307,-154
2017,2734,Devin Harris,3.44947145109236,-0.661088013392628,2.78838343769973,9,178,31,70,3018,3051,6069,674.25,636.35,1310.6,2962,2867,98.1444665341286,95
2017,201583,Ryan Anderson,-0.418009336384223,3.0291571841694,2.61114784778518,168,7,32,66,4018,3958,7976,845.05,865.85,1710.9,4033,3788,100.373320059731,245
2017,202699,Tobias Harris,0.945977273182556,1.62660432431604,2.57258159749859,88,34,33,80,6241,6160,12401,1344.3,1314.71666666667,2659.01666666667,5895,6015,94.4560166639962,-120
2017,202703,Nikola Mirotic,2.48850208134996,-0.000937259171237705,2.48756482217872,23,130,34,55,3601,3620,7221,709.516666666667,781.483333333333,1491,3511,3390,97.5006942515968,121
2017,202710,Jimmy Butler,3.14614636075257,-0.667109512734866,2.4790368480177,13,179,35,59,4964,4887,9851,1125.4,1034.68333333333,2160.08333333333,4954,4574,99.798549556809,380
2017,1627732,Ben Simmons,1.00259417242151,1.45724139319668,2.45983556561819,86,45,36,81,6566,6585,13151,1321.11666666667,1398.38333333333,2719.5,6335,5923,96.4818763326226,412
2017,203124,Kyle O'Quinn,0.830974657863406,1.56630425939761,2.39727891726102,96,40,37,77,3200,3245,6445,703.183333333333,681.183333333333,1384.36666666667,3018,3070,94.3125,-52
2017,200755,JJ Redick,1.66440557225619,0.716950874099393,2.38135644635558,48,85,38,70,5103,5125,10228,1032.9,1076.06666666667,2108.96666666667,4966,4654,97.3153047227121,312
2017,1627739,Kris Dunn,0.331910997344423,2.01668981126757,2.34860080861199,121,26,39,52,3561,3533,7094,740.133333333333,779.716666666667,1519.85,3246,3504,91.1541701769166,-258
2017,203503,Tony Snell,0.00599696623516378,2.33907404382302,2.34507101005818,140,18,40,75,4658,4753,9411,978.883333333333,1065.7,2044.58333333333,4568,4596,98.0678402747961,-28
2017,201569,Eric Gordon,3.38557368738965,-1.05345329623071,2.33212039115894,11,202,41,69,5095,5037,10132,1040.05,1110.98333333333,2151.03333333333,5216,4634,102.374877330716,582
2017,202322,John Wall,1.43086142159526,0.900689256179495,2.33155067777475,60,67,42,41,3342,3370,6712,700.466666666667,703.683333333333,1404.15,3237,3114,96.8581687612208,123
2017,1626156,D'Angelo Russell,-0.344804039656129,2.64940100563992,2.30459696598379,163,12,43,48,2963,3053,6016,622.083333333333,607.733333333333,1229.81666666667,2771,2979,93.5200809989875,-208
2017,203110,Draymond Green,3.03386513951259,-0.73037451839155,2.30349062112104,16,182,44,69,5266,5485,10751,1051.16666666667,1194.36666666667,2245.53333333333,5359,5056,101.766046334979,303
2017,1626171,Bobby Portis,2.44009590294877,-0.167585433673736,2.27251046927504,26,139,45,73,3941,3850,7791,789.716666666667,856.1,1645.81666666667,3698,3778,93.8340522709972,-80
2017,203118,Mike Scott,2.4848850825975,-0.23426805738675,2.25061702521075,24,145,46,76,3267,3297,6564,704.666666666667,697.783333333333,1402.45,3058,3144,93.6026936026936,-86
2017,101150,Lou Williams,1.9040328148523,0.346473180176182,2.25050599502848,38,106,47,79,6251,6277,12528,1265.88333333333,1317.31666666667,2583.2,6116,6070,97.8403455447129,46
2017,201143,Al Horford,2.28221980872803,-0.0579639022123635,2.22425590651567,28,133,48,72,5117,5191,10308,1141.3,1124.71666666667,2266.01666666667,5003,4664,97.7721321086574,339
2017,2546,Carmelo Anthony,0.111489323990303,2.01474307686767,2.12623240085797,136,27,49,78,6152,5771,11923,1205.93333333333,1288.43333333333,2494.36666666667,5769,5485,93.7743823146944,284
2017,201156,Nick Young,1.11383900913117,1.00669870452839,2.12053771365956,74,61,50,79,3222,3328,6550,672.333333333333,704.45,1376.78333333333,3139,3108,97.4239602731223,31
2017,1626162,Kelly Oubre Jr.,0.9426415195081,1.1548299236027,2.0974714431108,89,55,51,81,5238,5279,10517,1118.35,1108.58333333333,2226.93333333333,4902,5004,93.5853379152348,-102
2017,201152,Thaddeus Young,2.79686487297711,-0.732764480917152,2.06410039205996,19,183,52,81,5917,6009,11926,1282.31666666667,1316.76666666667,2599.08333333333,5723,5527,96.7213114754098,196
2017,203114,Khris Middleton,1.63365009816321,0.40936082326079,2.043010921424,49,102,53,82,6795,6908,13703,1430.18333333333,1541.75,2971.93333333333,6665,6596,98.0868285504047,69
2017,203613,Jonathon Simmons,0.722038882566636,1.27079007074281,1.99282895330945,102,50,54,69,4710,4807,9517,1003.48333333333,1020.08333333333,2023.56666666667,4416,4709,93.7579617834395,-293
2017,1626209,Mario Hezonja,1.19628591433395,0.763196528549905,1.95948244288386,70,83,55,75,3808,3886,7694,829.533333333333,817.6,1647.13333333333,3513,3733,92.2531512605042,-220
2017,203471,Dennis Schroder,-0.129834650652068,2.03198828428292,1.90215363363085,150,25,56,67,4850,4915,9765,1039.4,1030.1,2069.5,4489,4749,92.5567010309278,-260
2017,203493,Reggie Bullock,1.52959720832739,0.36215461062654,1.89175181895393,54,105,57,62,4035,4008,8043,872.65,854.6,1727.25,3806,3794,94.3246592317224,12
2017,202681,Kyrie Irving,0.772242778373829,1.11701896977317,1.889261748147,98,56,58,60,4453,4491,8944,965.966666666667,959.75,1925.71666666667,4333,4108,97.3051875140355,225
2017,203507,Giannis Antetokounmpo,1.62705019120582,0.230555531002772,1.8576057222086,50,111,59,75,6282,6351,12633,1313.41666666667,1436.11666666667,2749.53333333333,6118,5969,97.3893664438077,149
2017,202083,Wesley Matthews,-0.662122738789016,2.47328867158443,1.81116593279542,185,17,60,63,4761,4834,9595,1104.13333333333,1022.61666666667,2126.75,4457,4791,93.6147868094938,-334
2017,1626168,Trey Lyles,0.86315092834382,0.882148119353183,1.745299047697,93,72,61,73,3297,3197,6494,705.383333333333,684.216666666667,1389.6,3118,3111,94.570821959357,7
2017,203952,Andrew Wiggins,0.715350602119991,1.02190146184508,1.73725206396507,103,59,62,82,6977,6873,13850,1545.03333333333,1437.65,2982.68333333333,6825,6606,97.8214132148488,219
2017,1628374,Lauri Markkanen,-1.41639383484324,3.12807055655446,1.71167672171122,217,5,63,68,4696,4624,9320,994.55,1016.03333333333,2010.58333333333,4237,4616,90.2257240204429,-379
2017,201563,Michael Beasley,1.13350184873598,0.546655093553984,1.68015694228996,72,93,64,73,3918,3874,7792,842.266666666667,806.5,1648.76666666667,3618,3773,92.3430321592649,-155
2017,202362,Lance Stephenson,0.159503349686149,1.50529032821068,1.66479367789683,133,43,65,82,4275,4252,8527,938.666666666667,911.016666666667,1849.68333333333,4006,4136,93.7076023391813,-130
2017,201942,DeMar DeRozan,1.74572748040117,-0.104227553077648,1.64149992732352,42,137,66,80,6445,6384,12829,1357.38333333333,1353.88333333333,2711.26666666667,6409,5979,99.4414274631497,430
2017,201572,Brook Lopez,0.744262499436483,0.84478338647485,1.58904588591133,99,76,67,74,4185,4146,8331,839.633333333333,886.766666666667,1726.4,3884,3968,92.8076463560335,-84
2017,203501,Tim Hardaway Jr.,0.737715930329415,0.818821857693987,1.5565377880234,101,77,68,57,4524,4411,8935,951.7,928.15,1879.85,4190,4255,92.6171529619806,-65
2017,201967,Dante Cunningham,0.872855827611744,0.651708763259574,1.52456459087132,92,89,69,72,3607,3707,7314,762.5,771.916666666667,1534.41666666667,3471,3503,96.229553645689,-32
2017,1938,Manu Ginobili,1.80680024437953,-0.282580577885357,1.52421966649417,39,149,70,65,3034,3017,6051,671.716666666667,632.916666666667,1304.63333333333,2888,2829,95.1878707976269,59
2017,1628372,Dennis Smith Jr.,-1.01610154307882,2.51529806706696,1.49919652398814,196,15,71,69,4651,4683,9334,1051.63333333333,994.566666666667,2046.2,4304,4630,92.5392388733606,-326
2017,201158,Marco Belinelli,0.896201681482591,0.572548495290178,1.46875017677277,90,91,72,80,4635,4637,9272,962.733333333333,985.5,1948.23333333333,4334,4387,93.5059331175836,-53
2017,201188,Marc Gasol,0.151969045671136,1.29034367978999,1.44231272546113,134,49,73,73,5387,5381,10768,1243.71666666667,1158.96666666667,2402.68333333333,4879,5211,90.5698904770744,-332
2017,2733,Shaun Livingston,2.52441583876695,-1.08782136411662,1.43659447465033,22,206,74,70,2540,2660,5200,530.133333333333,579.533333333333,1109.66666666667,2510,2364,98.8188976377953,146
2017,1626150,Andrew Harrison,-0.168492903915376,1.59528533689691,1.42679243298154,154,39,75,56,2950,2928,5878,685.616666666667,632.366666666667,1317.98333333333,2644,2828,89.6271186440678,-184
2017,200826,J.J. Barea,1.38142631291992,0.0434458866313402,1.42487219955126,63,125,76,69,3583,3640,7223,827.333333333333,773.7,1601.03333333333,3498,3504,97.6276862963997,-6
2017,101107,Marvin Williams,0.474266585056819,0.929399068635029,1.40366565369185,115,64,77,78,4783,4701,9484,1006.13333333333,989.966666666667,1996.1,4532,4449,94.7522475433828,83
2017,201933,Blake Griffin,1.75585865150383,-0.406444878695012,1.34941377280882,41,163,78,58,4618,4624,9242,991.566666666667,972.9,1964.46666666667,4382,4322,94.889562581204,60
2017,203210,JaMychal Green,-0.447564096659307,1.77580992197258,1.32824582531327,170,32,79,55,3468,3402,6870,785.766666666667,748.883333333333,1534.65,3124,3344,90.080738177624,-220
2017,201142,Kevin Durant,0.398562406944919,0.885656978743303,1.28421938568822,117,70,80,67,5428,5624,11052,1083.93333333333,1202.08333333333,2286.01666666667,5620,5295,103.537214443626,325
2017,203089,John Henson,2.32801820910216,-1.04630112912038,1.28171707998177,27,201,81,76,4482,4517,8999,941.783333333333,1014.48333333333,1956.26666666667,4402,4228,98.215082552432,174
2017,1627752,Taurean Prince,-0.550771215876903,1.82189664185497,1.27112542597807,174,31,82,82,5777,5869,11646,1241.65,1217.2,2458.85,5344,5659,92.5047602561883,-315
2017,1627854,Bryn Forbes,0.570547408486395,0.669691450199966,1.24023885868636,109,88,83,80,3483,3440,6923,773.016666666667,738.3,1511.31666666667,3293,3193,94.5449325294287,100
2017,201586,Serge Ibaka,2.05998446158937,-0.866078615858162,1.19390584573121,35,190,84,76,4918,4917,9835,1039.7,1044.96666666667,2084.66666666667,4890,4567,99.4306628710858,323
2017,202397,Ish Smith,1.49394302272016,-0.306738164671556,1.18720485804861,56,152,85,82,4719,4713,9432,1008.91666666667,1027.08333333333,2036,4462,4433,94.5539309175673,29
2017,203484,Kentavious Caldwell-Pope,0.204259763254972,0.976439403499516,1.18069916675449,131,62,86,74,5934,5872,11806,1176.9,1272.6,2449.5,5529,5568,93.1749241658241,-39
2017,203901,Elfrid Payton,-1.42085189995638,2.59898112865802,1.17812922870165,218,14,87,63,4286,4380,8666,858.05,935.966666666667,1794.01666666667,3943,4399,91.9972001866542,-456
2017,203092,Tyler Zeller,-1.16055772297848,2.21967968459678,1.05912196161831,203,20,88,66,2629,2581,5210,556.4,546.983333333333,1103.38333333333,2461,2454,93.6097375427919,7
2017,203121,Darius Miller,1.0092646511944,0.0377736084540617,1.04703825964846,84,126,89,81,4545,4676,9221,929.65,994.416666666667,1924.06666666667,4461,4423,98.1518151815182,38
2017,204060,Joe Ingles,0.58102153311836,0.461177793109454,1.04219932622781,108,99,90,82,5902,5858,11760,1317.4,1244.58333333333,2561.98333333333,5605,5352,94.9678075228736,253
2017,201147,Corey Brewer,0.863095458490588,0.166676695087512,1.0297721535781,94,114,91,72,3014,2939,5953,587.616666666667,619.383333333333,1207,2763,2816,91.672196416722,-53
2017,203933,T.J. Warren,0.328628902585521,0.695900304996012,1.02452920758153,122,86,92,65,5178,5187,10365,1064.91666666667,1069.15,2134.06666666667,4634,5080,89.4940131324836,-446
2017,1628404,Josh Hart,0.13076996124765,0.892508511996148,1.0232784732438,135,69,93,63,3478,3492,6970,699,756.35,1455.35,3260,3315,93.7320299022427,-55
2017,200782,PJ Tucker,1.80448232197231,-0.81554087808015,0.988941443892158,40,188,94,82,5303,5277,10580,1128.8,1151.08333333333,2279.88333333333,5397,4877,101.772581557609,520
2017,203944,Julius Randle,1.47200553032093,-0.504435407005872,0.96757012331506,57,168,95,82,5233,5229,10462,1054.41666666667,1129.98333333333,2184.4,4942,4997,94.4391362507166,-55
2017,201229,Anthony Tolliver,1.29232448335742,-0.368033054019953,0.924291429337465,66,159,96,79,4023,4021,8044,871.733333333333,879.4,1751.13333333333,3805,3775,94.5811583395476,30
2017,203095,Evan Fournier,2.23400025712867,-1.32250642398536,0.911493833143307,29,222,97,57,4305,4415,8720,892.783333333333,942.466666666667,1835.25,4147,4271,96.3298490127758,-124
2017,1626179,Terry Rozier,1.1021793028888,-0.242946763546757,0.859232539342045,75,147,98,80,4737,4761,9498,1054.18333333333,1011.2,2065.38333333333,4396,4292,92.8013510660756,104
2017,201566,Russell Westbrook,1.69965307519623,-0.868459753260932,0.831193321935295,44,191,99,80,7176,6771,13947,1383.51666666667,1516.41666666667,2899.93333333333,6747,6352,94.0217391304348,395
2017,203200,Justin Holiday,0.318625115158448,0.507718492980451,0.826343608138899,124,94,100,72,5325,5244,10569,1106.1,1153.46666666667,2259.56666666667,4924,5112,92.4694835680751,-188
2017,203084,Harrison Barnes,-0.0896214960307283,0.875759507012607,0.786138010981879,146,75,101,77,5913,6001,11914,1361.31666666667,1275.4,2636.71666666667,5513,5842,93.2352443767969,-329
2017,201961,Wayne Ellington,1.06292438321691,-0.291704735842792,0.77121964737412,76,150,102,76,4511,4509,9020,1014.03333333333,988.966666666667,2003,4273,4184,94.7240079804921,89
2017,2037,Jamal Crawford,-0.830867663434128,1.55610928432001,0.725241620885887,192,41,103,80,3799,3815,7614,855.8,791.133333333333,1646.93333333333,3634,3818,95.6567517767834,-184
2017,1627783,Pascal Siakam,2.00137265538353,-1.28979696958837,0.711575685795157,36,221,104,81,3901,3894,7795,823.533333333333,854.3,1677.83333333333,3863,3518,99.0258907972315,345
2017,204020,Tyler Johnson,-0.682051076069118,1.38805882220507,0.706007746135952,187,48,105,71,4641,4634,9275,1023.55,999.916666666667,2023.46666666667,4360,4296,93.9452704158587,64
2017,202324,Derrick Favors,0.544929549810758,0.159167010875768,0.704096560686526,110,115,106,77,4891,4840,9731,1105.93333333333,1038.71666666667,2144.65,4612,4473,94.2956450623594,139
2017,1626145,Tyus Jones,2.21650736192035,-1.52273400218651,0.693773359733841,30,228,107,82,3371,3318,6689,751.916666666667,705.516666666667,1457.43333333333,3294,3136,97.715811331949,158
2017,203546,Ian Clark,0.195784850863538,0.483610128140126,0.679394979003665,132,97,108,73,3354,3466,6820,685.4,738.6,1424,3246,3232,96.7799642218247,14
2017,203468,CJ McCollum,0.223425712029133,0.450648318285921,0.674074030315054,129,100,109,81,6811,6743,13554,1492.4,1419.36666666667,2911.76666666667,6417,6303,94.2152400528557,114
2017,203999,Nikola Jokic,1.67687956310804,-1.10046037739221,0.57641918571582,46,209,110,74,5602,5409,11011,1191.95,1189.86666666667,2381.81666666667,5502,5204,98.2149232416994,298
2017,203488,Mike Muscala,0.082144497496309,0.493800485886257,0.575944983382566,137,96,111,53,2535,2558,5093,535.45,523.45,1058.9,2342,2447,92.3865877712032,-105
2017,1628467,Maxi Kleber,0.0490697294936799,0.499056976986177,0.548126706479857,138,95,112,71,2701,2734,5435,621.266666666667,586.75,1208.01666666667,2489,2601,92.1510551647538,-112
2017,1626153,Delon Wright,-0.169417876591144,0.686477948504868,0.517060071913725,155,87,113,69,3327,3328,6655,709.416666666667,715.333333333333,1424.75,3235,3001,97.2347460174331,234
2017,1628379,Luke Kennard,2.46434701352572,-1.95824453053158,0.506102482994142,25,239,114,73,3301,3337,6638,725.45,732.15,1457.6,3164,3070,95.849742502272,94
2017,201587,Nicolas Batum,-1.56241447520087,2.06822318624653,0.505808711045653,222,24,115,64,4738,4631,9369,990.9,984.533333333333,1975.43333333333,4511,4497,95.2089489235965,14
2017,1626192,Pat Connaughton,-0.379744864913405,0.883324799025164,0.503579934111759,166,71,116,82,3471,3420,6891,774.716666666667,712.416666666667,1487.13333333333,3319,3187,95.6208585422069,132
2017,201584,Courtney Lee,-0.332105244668798,0.796472972796019,0.464367728127221,161,78,117,76,5372,5388,10760,1176.65,1126.76666666667,2303.41666666667,4936,5237,91.8838421444527,-301
2017,203894,Shabazz Napier,1.36693694548555,-0.909767474560002,0.457169470925546,64,196,118,74,3517,3515,7032,794.116666666667,740.566666666667,1534.68333333333,3312,3233,94.1711686096105,79
2017,202683,Enes Kanter,-1.74505894639986,2.18773306225449,0.442674115854632,234,21,119,71,4328,4229,8557,931.5,892.316666666667,1823.81666666667,3957,4145,91.4279112754159,-188
2017,202331,Paul George,-0.674371317221604,1.10598029505481,0.43160897783321,186,57,120,79,7018,6722,13740,1385.03333333333,1498.26666666667,2883.3,6536,6346,93.1319464234825,190
2017,200746,LaMarcus Aldridge,1.73255334835669,-1.32513362569838,0.407419722658304,43,223,121,75,5676,5535,11211,1303.21666666667,1194.86666666667,2498.08333333333,5367,5074,94.5560253699789,293
2017,203954,Joel Embiid,1.57270062955356,-1.17832242824531,0.394378201308246,52,212,122,63,4505,4512,9017,934.683333333333,969.816666666667,1904.5,4435,3992,98.4461709211987,443
2017,201973,Jonas Jerebko,0.248058581976232,0.107328605419528,0.35538718739576,127,121,123,74,2566,2556,5122,571.4,552.683333333333,1124.08333333333,2431,2380,94.7388932190179,51
2017,1627819,Isaiah Taylor,1.16878260327524,-0.847398590014563,0.321384013260673,71,189,124,66,2760,2757,5517,583.166666666667,578.666666666667,1161.83333333333,2570,2592,93.1159420289855,-22
2017,1626196,Josh Richardson,-0.330411362084215,0.634780649890676,0.304369287806461,160,90,125,80,6051,6011,12062,1337.58333333333,1298.86666666667,2636.45,5613,5551,92.7615270203272,62
2017,202684,Tristan Thompson,-1.59486035350962,1.87208338270039,0.277223029190768,227,29,126,53,2535,2467,5002,538.933333333333,528.866666666667,1067.8,2401,2502,94.7140039447732,-101
2017,203937,Kyle Anderson,-0.0490498727147945,0.318728986808256,0.269679114093461,143,108,127,74,4488,4450,8938,1022.38333333333,948.383333333333,1970.76666666667,4215,4042,93.9171122994652,173
2017,203078,Bradley Beal,1.00490654078716,-0.735721255024028,0.269185285763131,85,184,128,82,6883,6943,13826,1490.43333333333,1477.6,2968.03333333333,6597,6424,95.8448351009734,173
2017,203925,Joe Harris,0.358624573138844,-0.0900188406122827,0.268605732526561,119,136,129,78,4628,4660,9288,1004.93333333333,965.45,1970.38333333333,4322,4482,93.3880726015557,-160
2017,201949,James Johnson,1.23666715116732,-0.969757928483848,0.266909222683475,69,198,130,72,4347,4393,8740,952.866666666667,938.516666666667,1891.38333333333,4077,4061,93.7888198757764,16
2017,203112,Quincy Acy,0.741678111803861,-0.514803424501242,0.226874687302619,100,170,131,70,3148,3213,6361,688.366666666667,669.616666666667,1357.98333333333,2972,3080,94.4091486658196,-108
2017,203926,Doug McDermott,-0.510292423583927,0.729408592989105,0.219116169405178,172,84,132,81,4121,4104,8225,893.916666666667,869.55,1763.46666666667,3813,3840,92.5260859014802,-27
2017,203459,Allen Crabbe,-0.128147602056457,0.344322324575565,0.216174722519108,149,107,133,75,5203,5243,10446,1107.5,1080.56666666667,2188.06666666667,4914,5008,94.4455122044974,-94
2017,202694,Marcus Morris,-0.55980537185593,0.774286805366578,0.214481433510647,175,82,134,54,3351,3347,6698,731.35,707.016666666667,1438.36666666667,3117,3124,93.0170098478066,-7
2017,101162,Marcin Gortat,-2.83850914249693,3.03781989021714,0.199310747720208,257,6,135,82,4793,4807,9600,1043.93333333333,1025,2068.93333333333,4556,4454,95.0552889630712,102
2017,202335,Patrick Patterson,-0.782901481919382,0.97385318858569,0.190951706666308,191,63,136,82,2877,2910,5787,611.916666666667,655.633333333333,1267.55,2612,2707,90.7890163364616,-95
2017,1628378,Donovan Mitchell,0.67507022818658,-0.506198402150447,0.168871826036133,104,169,137,79,6087,6011,12098,1343.03333333333,1286.43333333333,2629.46666666667,5793,5431,95.1700344997536,362
2017,203506,Victor Oladipo,3.12959729532355,-2.96143229310891,0.168165002214638,14,255,138,75,5859,5946,11805,1250.78333333333,1293.43333333333,2544.21666666667,5698,5400,97.2520908004779,298
2017,1627741,Buddy Hield,1.05385044148749,-0.892364845635631,0.161485595851857,79,194,139,80,4579,4574,9153,1013.66666666667,1008.2,2021.86666666667,4204,4359,91.8104389604717,-155
2017,203077,Michael Kidd-Gilchrist,1.59162028314921,-1.47389607889188,0.11772420425733,51,225,140,74,4406,4294,8700,927.566666666667,914.916666666667,1842.48333333333,4176,4106,94.7798456650023,70
2017,1628462,Milos Teodosic,2.09604480100352,-1.9874442772008,0.108600523802717,34,240,141,45,2681,2726,5407,550.666666666667,580.383333333333,1131.05,2617,2578,97.6128310331966,39
2017,1626144,Emmanuel Mudiay,-1.93088985489448,1.98661586561924,0.0557260107247535,240,28,142,64,3002,2976,5978,625.333333333333,615.6,1240.93333333333,2669,2947,88.9073950699534,-278
2017,203967,Dario Saric,-1.16207081715655,1.16773451746335,0.00566370030679964,204,53,143,77,5505,5498,11003,1117.55,1180,2297.55,5261,4995,95.5676657584014,266
2017,1626170,Jerian Grant,-1.26026259238464,1.25524870143622,-0.00501389094842542,211,51,144,74,3893,3840,7733,822.4,858.666666666667,1681.06666666667,3515,3790,90.2902645774467,-275
2017,1627746,Skal Labissiere,0.20807936795011,-0.241955921604761,-0.0338765536546511,130,146,145,60,2860,2826,5686,620.466666666667,612.55,1233.01666666667,2622,2743,91.6783216783217,-121
2017,101127,Jarrett Jack,0.541820427025712,-0.583975304373467,-0.0421548773477551,111,174,146,62,3611,3582,7193,784.283333333333,756,1540.28333333333,3416,3447,94.5998338410413,-31
2017,201609,Goran Dragic,0.319651234621254,-0.372335392422574,-0.0526841578013202,123,161,147,74,5368,5359,10727,1174.35,1146.58333333333,2320.93333333333,4993,4964,93.0141579731744,29
2017,203991,Clint Capela,-1.01615698801989,0.923311401513391,-0.092845586506498,197,65,148,74,4706,4656,9362,999.95,1024.8,2024.75,4725,4347,100.403739906502,378
2017,203518,Alex Abrines,0.440605457786162,-0.577163549185665,-0.136558091399504,116,173,149,74,2687,2614,5301,549.783333333333,581.583333333333,1131.36666666667,2497,2473,92.9289170078154,24
2017,1628368,De'Aaron Fox,-1.21704699268503,1.01269260985784,-0.204354382827189,208,60,150,73,4690,4668,9358,1015.51666666667,1001.46666666667,2016.98333333333,4206,4611,89.680170575693,-405
2017,201959,Taj Gibson,0.657565132789254,-0.892070793650742,-0.234505660861488,106,193,151,82,6349,6280,12629,1411.35,1315.53333333333,2726.88333333333,6268,5997,98.7242085367775,271
2017,203939,Dwight Powell,-0.145178138744591,-0.117128821882841,-0.262306960627432,152,138,152,79,3737,3765,7502,849.216666666667,812.866666666667,1662.08333333333,3578,3564,95.7452502006958,14
2017,1628384,OG Anunoby,1.67662557735254,-1.9488626039789,-0.27223702662636,47,238,153,74,3452,3459,6911,737.283333333333,731.8,1469.08333333333,3449,3137,99.9130938586327,312
2017,202693,Markieff Morris,-2.88584232910411,2.60713005587281,-0.278712273231295,259,13,154,73,4499,4525,9024,986.433333333333,970.683333333333,1957.11666666667,4286,4252,95.265614581018,34
2017,1628021,David Nwaba,-0.329102677175894,0.0305114959962914,-0.298591181179602,159,128,155,70,3902,3848,7750,792.633333333333,850.433333333333,1643.06666666667,3547,3761,90.9021014864172,-214
2017,1627737,Marquese Chriss,-0.890306089653751,0.572036845180427,-0.318269244473324,195,92,156,72,3711,3694,7405,750.816666666667,768.383333333333,1519.2,3286,3561,88.5475613042307,-275
2017,203490,Otto Porter Jr.,0.661158703193859,-0.985884682432966,-0.324725979239108,105,199,157,77,5613,5617,11230,1213.98333333333,1206.81666666667,2420.8,5447,5185,97.0425797256369,262
2017,1627832,Fred VanVleet,1.46284115666927,-1.82827833858953,-0.36543718192026,58,234,158,76,3520,3541,7061,741.066666666667,775.683333333333,1516.75,3504,3136,99.5454545454546,368
2017,1628382,Justin Jackson,-0.101629652065131,-0.301636816488461,-0.403266468553593,147,151,159,68,3432,3421,6853,753.95,740.633333333333,1494.58333333333,3103,3310,90.4137529137529,-207
2017,1626185,Jarell Martin,-1.21618085429067,0.78043314375273,-0.435747710537937,207,80,160,73,3773,3789,7562,845.416666666667,810.316666666667,1655.73333333333,3370,3626,89.3188444208852,-256
2017,101133,Ian Mahinmi,0.793598194610216,-1.22969533870977,-0.436097144099553,97,215,161,77,2684,2645,5329,576.033333333333,568.133333333333,1144.16666666667,2488,2471,92.6974664679583,17
2017,101141,Ersan Ilyasova,2.2008373105949,-2.64264574062526,-0.441808430030364,31,251,162,69,4066,4106,8172,851.85,871.133333333333,1722.98333333333,3847,3810,94.6138711264142,37
2017,201601,Luc Mbah a Moute,1.02589076441461,-1.48840229402141,-0.462511529606798,81,226,163,61,3570,3623,7193,763.45,798.583333333333,1562.03333333333,3606,3275,101.008403361345,331
2017,203076,Anthony Davis,1.05213217221413,-1.55073988809237,-0.498607715878233,80,230,164,74,6386,6560,12946,1278.31666666667,1402.88333333333,2681.2,6275,5954,98.2618227372377,321
2017,203914,Gary Harris,0.621461694753041,-1.12928386715609,-0.507822172403053,107,210,165,67,5417,5329,10746,1147.83333333333,1150.53333333333,2298.36666666667,5270,5102,97.2863208417944,168
2017,203109,Jae Crowder,-0.341566840381638,-0.208842728668337,-0.550409569049975,162,142,166,80,4835,4875,9710,1043.53333333333,1038.58333333333,2082.11666666667,4677,4640,96.7321613236815,37
2017,203497,Rudy Gobert,-0.143795950406547,-0.415960873239654,-0.559756823646202,151,164,167,56,4221,4138,8359,922.033333333333,885.1,1807.13333333333,3975,3634,94.1719971570718,341
2017,203115,Will Barton,0.0156651921038917,-0.627983141433767,-0.612317949329875,139,176,168,80,6265,6124,12389,1317.88333333333,1313.96666666667,2631.85,5986,5880,95.5466879489226,106
2017,201577,Robin Lopez,-1.78129963814583,1.15898972788507,-0.622309910260756,235,54,169,64,3882,3838,7720,828.9,855.25,1684.15,3515,3741,90.5461102524472,-226
2017,203083,Andre Drummond,-1.08271734433917,0.432222973477531,-0.650494370861634,201,101,170,78,6134,6014,12148,1318.38333333333,1291.31666666667,2609.7,5695,5735,92.8431692207369,-40
2017,202696,Nikola Vucevic,0.377109258236797,-1.0769231771261,-0.699813918889303,118,205,171,57,3933,3987,7920,832.766666666667,842.233333333333,1675,3762,3793,95.6521739130435,-31
2017,1628398,Kyle Kuzma,-0.279253868630049,-0.423036540639319,-0.702290409269368,157,166,172,77,5796,5813,11609,1148.78333333333,1242.2,2390.98333333333,5350,5489,92.3050379572119,-139
2017,202344,Trevor Booker,-0.724192576166256,-0.0223941345784637,-0.74658671074472,189,132,173,68,2748,2736,5484,589.383333333333,568.566666666667,1157.95,2585,2588,94.0684133915575,-3
2017,201960,DeMarre Carroll,0.288219673428073,-1.05572501583036,-0.767505342402283,126,203,174,73,5150,5163,10313,1110.85,1063.68333333333,2174.53333333333,4829,4875,93.7669902912621,-46
2017,203090,Maurice Harkless,-1.70467827087536,0.897888189903619,-0.806790080971737,232,68,175,59,2928,2919,5847,651.6,606.766666666667,1258.36666666667,2734,2716,93.3743169398907,18
2017,201980,Danny Green,-1.01750587095141,0.207538981672911,-0.8099668892785,198,112,176,70,4051,4001,8052,934.316666666667,848.333333333333,1782.65,3743,3638,92.3969390274006,105
2017,1626178,Rondae Hollis-Jefferson,-1.05972902129631,0.23827882983854,-0.821450191457772,199,110,177,68,4531,4628,9159,964.566666666667,950.65,1915.21666666667,4275,4434,94.3500331052748,-159
2017,1628367,Josh Jackson,-0.163048128522024,-0.711101738856986,-0.87414986737901,153,180,178,77,4773,4796,9569,960.4,994.85,1955.25,4166,4639,87.282631468678,-473
2017,1627755,Tyler Ulis,-1.31779137136512,0.400937181952485,-0.916854189412639,214,103,179,71,3967,3940,7907,816.133333333333,835.4,1651.53333333333,3500,3817,88.2278800100832,-317
2017,1628366,Lonzo Ball,-0.583105246675064,-0.354085238328979,-0.937190485004043,177,156,180,52,4346,4305,8651,845.983333333333,927.066666666667,1773.05,3984,4000,91.6705016106765,-16
2017,203932,Aaron Gordon,-0.357387245584965,-0.587132867738489,-0.944520113323454,164,175,181,58,4482,4520,9002,936.966666666667,965.7,1902.66666666667,4218,4305,94.1097724230254,-87
2017,201937,Ricky Rubio,-0.380969785938371,-0.57125099272289,-0.952220778661261,167,172,182,77,5142,5093,10235,1150.13333333333,1094.3,2244.43333333333,4845,4600,94.2240373395566,245
2017,1627733,Dragan Bender,-1.07032541088009,0.115100427436741,-0.955224983443345,200,119,183,82,4934,4988,9922,1019.56666666667,1040.36666666667,2059.93333333333,4401,4879,89.1974057559789,-478
2017,201145,Jeff Green,0.989618135822932,-2.02948647612732,-1.03986834030439,87,242,184,78,4215,4334,8549,901.966666666667,922.433333333333,1824.4,4171,4052,98.9561091340451,119
2017,203458,Alex Len,-0.548130918483658,-0.518308436278362,-1.06643935476202,173,171,185,69,3405,3406,6811,694.833333333333,699.933333333333,1394.76666666667,3051,3328,89.6035242290749,-277
2017,203107,Tomas Satoransky,-0.864383169168932,-0.211640150649176,-1.07602331981811,193,143,186,73,3807,3790,7597,827.866666666667,810.683333333333,1638.55,3616,3532,94.9829261886,84
2017,201596,Mario Chalmers,-0.0703969566188954,-1.00665807570665,-1.07705503232554,145,200,187,66,3347,3327,6674,728.033333333333,694.8,1422.83333333333,3026,3095,90.4093217806991,-69
2017,1626161,Willie Cauley-Stein,-1.25324047906595,0.173492455752613,-1.07974802331334,210,113,188,73,4644,4601,9245,1032.35,1005.18333333333,2037.53333333333,4184,4497,90.0947459086994,-313
2017,1627759,Jaylen Brown,0.00190265658344236,-1.09614890105562,-1.09424624447218,141,208,189,70,4947,4955,9902,1079.45,1070.16666666667,2149.61666666667,4759,4416,96.1997170002022,343
2017,1626164,Devin Booker,-1.20239406814532,0.0493970902199014,-1.15299697792541,206,123,190,54,4610,4587,9197,929.55,930.483333333333,1860.03333333333,4104,4511,89.0238611713666,-407
2017,2199,Tyson Chandler,-2.67221440476697,1.49693079355266,-1.17528361121431,253,44,191,46,2749,2721,5470,576.466666666667,568.766666666667,1145.23333333333,2396,2666,87.1589668970535,-270
2017,203924,Jerami Grant,1.01501953764379,-2.20379817318979,-1.188778635546,83,243,192,81,3851,3826,7677,799.533333333333,844.116666666667,1643.65,3580,3553,92.9628667878473,27
2017,200768,Kyle Lowry,0.521200885420116,-1.71370285679836,-1.19250197137824,112,231,193,78,5911,5884,11795,1246.13333333333,1257.1,2503.23333333333,5860,5440,99.137201827102,420
2017,201599,DeAndre Jordan,-1.989813727441,0.791139323430414,-1.19867440401059,243,79,194,77,5678,5658,11336,1211.71666666667,1196.63333333333,2408.35,5348,5463,94.1880943994364,-115
2017,201936,Tyreke Evans,1.33476250021673,-2.54361391144869,-1.20885141123195,65,249,195,52,3653,3655,7308,819.116666666667,784.25,1603.36666666667,3410,3387,93.3479332055845,23
2017,203486,Mason Plumlee,-0.586387479632289,-0.64070369152711,-1.2270911711594,178,177,196,73,3362,3348,6710,706.683333333333,707.916666666667,1414.6,3156,3184,93.8726948245092,-28
2017,201975,Jodie Meeks,-1.17542960779688,-0.0677590373901234,-1.243188645187,205,134,197,77,2627,2618,5245,562.883333333333,551.3,1114.18333333333,2394,2531,91.1305671869052,-137
2017,202339,Eric Bledsoe,0.50766139988988,-1.76860898617808,-1.2609475862882,114,232,198,74,5368,5461,10829,1109.61666666667,1203.85,2313.46666666667,5262,5134,98.0253353204173,128
2017,1628386,Jarrett Allen,-0.359938848068835,-0.903544007182274,-1.26348285525111,165,195,199,72,3357,3458,6815,734.666666666667,703.05,1437.71666666667,3131,3255,93.2677986297289,-124
2017,1628369,Jayson Tatum,1.25406325047356,-2.53644421805093,-1.28238096757737,67,248,200,80,5514,5594,11108,1217.36666666667,1209.41666666667,2426.78333333333,5291,4971,95.955749002539,320
2017,202685,Jonas Valanciunas,-2.1391013718604,0.775402468213335,-1.36369890364706,246,81,201,77,4049,4035,8084,865.716666666667,853.6,1719.31666666667,3999,3796,98.7651271918993,203
2017,203935,Marcus Smart,0.521168876921027,-1.89436752949261,-1.37319865257158,113,236,202,54,3742,3767,7509,813.366666666667,803.216666666667,1616.58333333333,3543,3330,94.6819882415821,213
2017,101109,Raymond Felton,-0.639269131898238,-0.748939806168247,-1.38820893806648,184,185,203,82,3080,3079,6159,663.7,695.333333333333,1359.03333333333,2803,2852,91.0064935064935,-49
2017,202498,Lance Thomas,-1.63805599322251,0.148798661652983,-1.48925733156953,229,116,204,73,3112,3111,6223,688.366666666667,660.4,1348.76666666667,2821,2985,90.6491002570694,-164
2017,202357,Nemanja Bjelica,-0.633909257528628,-0.87995721060642,-1.51386646813505,181,192,205,67,3176,3165,6341,701.583333333333,658.483333333333,1360.06666666667,3053,3065,96.1272040302267,-12
2017,202325,Wesley Johnson,-0.288040225846496,-1.24024875757639,-1.52828898342288,158,216,206,74,3539,3593,7132,733.266666666667,746.333333333333,1479.6,3318,3374,93.7552981068098,-56
2017,1628415,Dillon Brooks,-0.573014720321693,-0.967725293244147,-1.54074001356584,176,197,207,82,5297,5294,10591,1193.86666666667,1145.46666666667,2339.33333333333,4805,5019,90.7117236171418,-214
2017,1627763,Malcolm Brogdon,-1.63012451546135,0.0884646097929813,-1.54165990566837,228,122,208,48,3243,3287,6530,698.05,738.583333333333,1436.63333333333,3127,3165,96.4230650632131,-38
2017,201163,Wilson Chandler,-1.26734570148136,-0.276660555935619,-1.54400625741698,212,148,209,73,5367,5298,10665,1152.81666666667,1140.41666666667,2293.23333333333,5164,5093,96.2176262343954,71
2017,203516,James Ennis III,-1.23662849362375,-0.323478015776597,-1.56010650940035,209,153,210,72,3643,3692,7335,805.866666666667,796.816666666667,1602.68333333333,3321,3514,91.1611309360417,-193
2017,203476,Gorgui Dieng,-1.56437277716813,-0.00903123983396927,-1.5734040170021,223,131,211,79,3101,3090,6191,691.516666666667,638.916666666667,1330.43333333333,2895,3062,93.3569816188326,-167
2017,1626167,Myles Turner,-0.418243627750542,-1.28724606089207,-1.70548968864261,169,220,212,65,4173,4242,8415,909.85,916.116666666667,1825.96666666667,4036,3913,96.7169901749341,123
2017,200752,Rudy Gay,-0.448323480204513,-1.2799555499131,-1.72827903011761,171,219,213,57,2858,2795,5653,639.066666666667,592.933333333333,1232,2633,2603,92.1273617914626,30
2017,1627747,Caris LeVert,-1.59404402839162,-0.190225766914769,-1.78426979530639,226,140,214,71,4442,4478,8920,947.6,916.166666666667,1863.76666666667,4070,4295,91.6253939666817,-225
2017,202323,Evan Turner,-2.82151619524266,1.03332013629346,-1.7881960589492,255,58,215,79,4743,4725,9468,1045.41666666667,983.083333333333,2028.5,4349,4390,91.6930212945393,-41
2017,202714,Shelvin Mack,-0.594909488674205,-1.24065881207689,-1.83556830075109,180,217,216,69,3110,3156,6266,687.516666666667,674.733333333333,1362.25,2860,2937,91.9614147909968,-77
2017,101161,Amir Johnson,-1.90113928717182,0.047387539166489,-1.85375174800533,239,124,217,74,2812,2805,5617,567.583333333333,601.3,1168.88333333333,2580,2549,91.7496443812233,31
2017,202709,Cory Joseph,-1.52836933372805,-0.369741059867193,-1.89811039359525,219,160,218,82,5108,5109,10217,1109.5,1099.66666666667,2209.16666666667,4777,4797,93.5199686765858,-20
2017,203903,Jordan Clarkson,-1.53539105906701,-0.390755316347164,-1.92614637541418,221,162,219,81,4533,4536,9069,927.683333333333,962.133333333333,1889.81666666667,4171,4259,92.0141186851975,-88
2017,1628400,Semi Ojeleye,-1.98802455783637,0.0276836624443477,-1.96034089539202,242,129,220,73,2598,2660,5258,583.3,564.8,1148.1,2324,2452,89.4534257120862,-128
2017,203463,Ben McLemore,-2.07419025192269,0.113034321026426,-1.96115593089626,245,120,221,56,2522,2531,5053,545.566666666667,545.1,1090.66666666667,2178,2466,86.3600317208565,-288
2017,1626159,Justise Winslow,-0.0685096978329209,-1.89876021484476,-1.96726991267769,144,237,222,67,3791,3785,7576,834.4,822.383333333333,1656.78333333333,3488,3444,92.0073859140069,44
2017,1628389,Bam Adebayo,-2.28657650787334,0.283516404006796,-2.00306010386655,248,109,223,68,3004,3002,6006,685.833333333333,654.833333333333,1340.66666666667,2745,2778,91.3781624500666,-33
2017,2730,Dwight Howard,-2.40176964978951,0.385787951372044,-2.01598169841746,250,104,224,81,5897,5735,11632,1237.36666666667,1217.7,2455.06666666667,5579,5492,94.6074275055113,87
2017,1626220,Royce O'Neale,1.05587761603662,-3.09657609358344,-2.04069847754682,78,260,225,69,2648,2617,5265,585.166666666667,563.05,1148.21666666667,2513,2301,94.9018126888217,212
2017,201950,Jrue Holiday,1.24571941049196,-3.30470503195446,-2.0589856214625,68,262,226,80,6865,6999,13864,1379.25,1504.9,2884.15,6733,6365,98.0772032046613,368
2017,202691,Klay Thompson,-0.111747460112158,-2.02860033382809,-2.14034779394025,148,241,227,72,5716,5947,11663,1161.06666666667,1293.98333333333,2455.05,5810,5471,101.644506648006,339
2017,203087,Jeremy Lamb,0.303660916658386,-2.45277903024471,-2.14911811358632,125,246,228,80,4669,4513,9182,1000.65,965.183333333333,1965.83333333333,4453,4358,95.3737417005783,95
2017,203473,Dewayne Dedmon,-0.74349705532465,-1.51139252416019,-2.25488957948484,190,227,229,62,3578,3632,7210,774.183333333333,760.416666666667,1534.6,3298,3440,92.1743991056456,-142
2017,200765,Rajon Rondo,-1.5301063341501,-0.794133455099791,-2.32423978924989,220,186,230,65,4094,4209,8303,816.55,881.466666666667,1698.01666666667,3946,3887,96.3849535906204,59
2017,1628373,Frank Ntilikina,-1.57794195779058,-0.806227876135329,-2.3841698339259,224,187,231,78,3981,3957,7938,862.75,838.933333333334,1701.68333333333,3601,3667,90.454659633258,-66
2017,203145,Kent Bazemore,-1.67289348490804,-0.720479821184923,-2.39337330609296,231,181,232,65,4147,4259,8406,889.883333333333,891.7,1781.58333333333,3840,3997,92.5970581142995,-157
2017,202340,Avery Bradley,-1.9806390745403,-0.489495179246952,-2.47013425378725,241,167,233,46,3337,3275,6612,721.766666666667,703.666666666667,1425.43333333333,3028,3132,90.7401857956248,-104
2017,2207,Joe Johnson,-2.3110458103203,-0.196376133408711,-2.50742194372901,249,141,234,55,2725,2763,5488,611.916666666667,589.616666666667,1201.53333333333,2495,2584,91.5596330275229,-89
2017,202687,Bismack Biyombo,-3.39070893103863,0.876455510641003,-2.51425342039763,262,74,235,82,3436,3540,6976,743.233333333333,751.916666666667,1495.15,2975,3397,86.5832363213039,-422
2017,203496,Robert Covington,0.853522369282843,-3.38310100637109,-2.52957863708824,95,263,236,80,6064,6002,12066,1225.16666666667,1292.81666666667,2517.98333333333,5871,5307,96.8172823218998,564
2017,200794,Paul Millsap,-1.40798921744926,-1.13555586910051,-2.54354508654977,216,211,237,37,2566,2571,5137,545.033333333333,550.633333333333,1095.66666666667,2508,2394,97.7396726422447,114
2017,202704,Reggie Jackson,-0.00618140999301912,-2.60410872931149,-2.6102901393045,142,250,238,45,2778,2716,5494,611.65,582.566666666667,1194.21666666667,2593,2567,93.3405327573794,26
2017,1627742,Brandon Ingram,-2.81908468452477,0.14666220170132,-2.67242248282345,254,117,239,59,4811,4753,9564,958.083333333333,1009.3,1967.38333333333,4347,4468,90.3554354604032,-121
2017,2772,Trevor Ariza,-0.868890560414757,-1.81830313799601,-2.68719369841077,194,233,240,67,5318,5298,10616,1120.58333333333,1147.91666666667,2268.5,5315,4943,99.943587814968,372
2017,1628414,Sindarius Thornwell,-1.73002349679527,-1.06876583101481,-2.79878932781008,233,204,241,69,2731,2779,5510,561.683333333333,593.066666666667,1154.75,2522,2601,92.3471255950201,-79
2017,1628381,John Collins,-1.27865113812439,-1.52362933305111,-2.8022804711755,213,229,242,74,4172,4246,8418,894.766666666667,888,1782.76666666667,3764,3988,90.2205177372963,-224
2017,201571,D.J. Augustin,-0.59058278352225,-2.24265358789925,-2.8332363714215,179,244,243,75,4078,4143,8221,905.2,851.583333333333,1756.78333333333,3754,3868,92.0549288867092,-114
2017,1627734,Domantas Sabonis,-1.78976883190348,-1.09191396254291,-2.88168279444639,236,207,244,74,4188,4179,8367,893.7,915.95,1809.65,3945,3891,94.1977077363897,54
2017,201585,Kosta Koufos,-2.55131904203418,-0.420941489928473,-2.97226053196265,252,165,245,71,3145,3123,6268,702.216666666667,686.716666666667,1388.93333333333,2752,2980,87.5039745627981,-228
2017,1626204,Larry Nance Jr.,-0.635807826897155,-2.50670061120398,-3.14250843810113,183,247,246,66,3411,3400,6811,683.916666666667,737.8,1421.71666666667,3135,3113,91.9085312225154,22
2017,203500,Steven Adams,-2.82219855336392,-0.35625047203921,-3.17844902540314,256,157,247,76,6132,5727,11859,1194.86666666667,1281.66666666667,2476.53333333333,5700,5383,92.9549902152642,317
2017,1627756,Denzel Valentine,-3.23246480520815,0.0367036747522542,-3.19576113045589,261,127,248,77,4927,4801,9728,1019.76666666667,1070.33333333333,2090.1,4404,4694,89.3850213111427,-290
2017,2548,Dwyane Wade,-1.83367794189784,-1.4332886078496,-3.26696654974744,237,224,249,67,3643,3625,7268,768.133333333333,770.683333333333,1538.81666666667,3427,3409,94.0708207521274,18
2017,204456,T.J. McConnell,-2.03169216761496,-1.27258972778845,-3.30428189540342,244,218,250,76,4088,4149,8237,845.316666666667,863.066666666667,1708.38333333333,3770,3834,92.2211350293542,-64
2017,204001,Kristaps Porzingis,-0.698183171483465,-2.65134090417508,-3.34952407565854,188,252,251,48,3627,3612,7239,782.15,765.366666666667,1547.51666666667,3369,3361,92.8866832092639,8
2017,202066,Garrett Temple,-2.2156134451808,-1.19479355711175,-3.41040700229255,247,213,252,65,3692,3638,7330,830.566666666667,779.583333333333,1610.15,3261,3514,88.3261105092091,-253
2017,1626169,Stanley Johnson,-1.57818302219821,-1.86710245389532,-3.44528547609353,225,235,253,69,4373,4342,8715,952.383333333333,934.733333333333,1887.11666666667,4034,4060,92.2478847473131,-26
2017,202334,Ed Davis,-0.244659150606633,-3.22387898652209,-3.46853813712872,156,261,254,78,3381,3354,6735,767.35,701.766666666667,1469.11666666667,3179,3065,94.0254362614611,114
2017,202355,Hassan Whiteside,-3.42767873605895,-0.0748549269352032,-3.50253366299415,263,135,255,54,3187,3145,6332,704.533333333333,655.966666666667,1360.5,2855,2909,89.5826796360213,-54
2017,1627812,Yogi Ferrell,-0.634411503221817,-3.05629322360376,-3.69070472682557,182,259,256,82,5102,5177,10279,1162.31666666667,1113.81666666667,2276.13333333333,4810,4772,94.2767542140337,38
2017,1627749,Dejounte Murray,-1.09352892667559,-2.99920030983645,-4.09272923651204,202,257,257,81,3997,3920,7917,889.366666666667,839.483333333333,1728.85,3644,3454,91.1683762822117,190
2017,203382,Aron Baynes,-3.09563337253383,-1.22699150021207,-4.3226248727459,260,214,258,81,3323,3308,6631,733.616666666667,729.566666666667,1463.18333333333,3061,2880,92.1155582305146,181
2017,202711,Bojan Bogdanovic,-1.33849731254107,-3.03784492330666,-4.37634223584773,215,258,259,80,5619,5717,11336,1208.26666666667,1240.78333333333,2449.05,5360,5264,95.3906389037195,96
2017,2738,Andre Iguodala,-1.89824637139376,-2.67417723195231,-4.57242360334607,238,253,260,63,3731,3856,7587,773.183333333333,828.75,1601.93333333333,3686,3432,98.7938890377915,254
2017,101139,CJ Miles,-1.66467420720172,-2.97178292231333,-4.63645712951505,230,256,261,70,3162,3147,6309,663,674.2,1337.2,3065,2819,96.932321315623,246
2017,2200,Pau Gasol,-2.48455243406119,-2.25821773338384,-4.74277016744503,251,245,262,77,4103,4108,8211,928.7,877.4,1806.1,3726,3691,90.8116012673653,35
2017,203994,Jusuf Nurkic,-2.86238913538615,-2.90916359905328,-5.77155273443943,258,254,263,79,4870,4848,9718,1056.11666666667,1025.93333333333,2082.05,4557,4423,93.5728952772074,134
